a_state_code,a_state_name,b_state_code,b_state_name,b_county_fips,b_county_name,inflow,outflow,net_migration
1,Alabama,1,Alabama,1,Autauga County,4147,2645,1502
1,Alabama,1,Alabama,3,Baldwin County,3194,4286,-1092
1,Alabama,1,Alabama,5,Barbour County,1139,893,246
1,Alabama,1,Alabama,7,Bibb County,1282,1631,-349
1,Alabama,1,Alabama,9,Blount County,2837,1500,1337
1,Alabama,1,Alabama,11,Bullock County,642,166,476
1,Alabama,1,Alabama,13,Butler County,706,303,403
1,Alabama,1,Alabama,15,Calhoun County,3274,5020,-1746
1,Alabama,1,Alabama,17,Chambers County,874,896,-22
1,Alabama,1,Alabama,19,Cherokee County,771,722,49
1,Alabama,1,Alabama,21,Chilton County,1192,1074,118
1,Alabama,1,Alabama,23,Choctaw County,434,172,262
1,Alabama,1,Alabama,25,Clarke County,788,238,550
1,Alabama,1,Alabama,27,Clay County,255,230,25
1,Alabama,1,Alabama,29,Cleburne County,378,428,-50
1,Alabama,1,Alabama,31,Coffee County,1764,2769,-1005
1,Alabama,1,Alabama,33,Colbert County,2566,1679,887
1,Alabama,1,Alabama,35,Conecuh County,587,180,407
1,Alabama,1,Alabama,37,Coosa County,410,691,-281
1,Alabama,1,Alabama,39,Covington County,977,967,10
1,Alabama,1,Alabama,41,Crenshaw County,459,353,106
1,Alabama,1,Alabama,43,Cullman County,2405,1767,638
1,Alabama,1,Alabama,45,Dale County,2261,1810,451
1,Alabama,1,Alabama,47,Dallas County,1459,975,484
1,Alabama,1,Alabama,49,DeKalb County,2062,2376,-314
1,Alabama,1,Alabama,51,Elmore County,4752,5659,-907
1,Alabama,1,Alabama,53,Escambia County,896,627,269
1,Alabama,1,Alabama,55,Etowah County,2959,3186,-227
1,Alabama,1,Alabama,57,Fayette County,567,626,-59
1,Alabama,1,Alabama,59,Franklin County,1017,1144,-127
1,Alabama,1,Alabama,61,Geneva County,963,543,420
1,Alabama,1,Alabama,63,Greene County,154,136,18
1,Alabama,1,Alabama,65,Hale County,810,329,481
1,Alabama,1,Alabama,67,Henry County,881,435,446
1,Alabama,1,Alabama,69,Houston County,3376,2202,1174
1,Alabama,1,Alabama,71,Jackson County,1183,826,357
1,Alabama,1,Alabama,73,Jefferson County,18122,17784,338
1,Alabama,1,Alabama,75,Lamar County,714,446,268
1,Alabama,1,Alabama,77,Lauderdale County,2854,4077,-1223
1,Alabama,1,Alabama,79,Lawrence County,1199,973,226
1,Alabama,1,Alabama,81,Lee County,5621,7652,-2031
1,Alabama,1,Alabama,83,Limestone County,3499,4160,-661
1,Alabama,1,Alabama,85,Lowndes County,414,235,179
1,Alabama,1,Alabama,87,Macon County,1188,654,534
1,Alabama,1,Alabama,89,Madison County,7448,8080,-632
1,Alabama,1,Alabama,91,Marengo County,789,459,330
1,Alabama,1,Alabama,93,Marion County,942,1447,-505
1,Alabama,1,Alabama,95,Marshall County,3549,3953,-404
1,Alabama,1,Alabama,97,Mobile County,5869,4010,1859
1,Alabama,1,Alabama,99,Monroe County,255,439,-184
1,Alabama,1,Alabama,101,Montgomery County,7132,8849,-1717
1,Alabama,1,Alabama,103,Morgan County,3795,4370,-575
1,Alabama,1,Alabama,105,Perry County,545,353,192
1,Alabama,1,Alabama,107,Pickens County,677,369,308
1,Alabama,1,Alabama,109,Pike County,1366,1244,122
1,Alabama,1,Alabama,111,Randolph County,630,444,186
1,Alabama,1,Alabama,113,Russell County,1453,1555,-102
1,Alabama,1,Alabama,115,St. Clair County,3523,4444,-921
1,Alabama,1,Alabama,117,Shelby County,8332,9125,-793
1,Alabama,1,Alabama,119,Sumter County,404,305,99
1,Alabama,1,Alabama,121,Talladega County,4151,2537,1614
1,Alabama,1,Alabama,123,Tallapoosa County,1631,869,762
1,Alabama,1,Alabama,125,Tuscaloosa County,5058,7712,-2654
1,Alabama,1,Alabama,127,Walker County,1417,2160,-743
1,Alabama,1,Alabama,129,Washington County,557,572,-15
1,Alabama,1,Alabama,131,Wilcox County,900,299,601
1,Alabama,1,Alabama,133,Winston County,1442,837,605
1,Alabama,10,Delaware,1,Kent County,9,148,-139
1,Alabama,10,Delaware,3,New Castle County,31,0,31
1,Alabama,10,Delaware,5,Sussex County,8,0,8
1,Alabama,11,District of Columbia,1,District of Columbia,212,310,-98
1,Alabama,12,Florida,1,Alachua County,414,75,339
1,Alabama,12,Florida,3,Baker County,9,0,9
1,Alabama,12,Florida,5,Bay County,744,746,-2
1,Alabama,12,Florida,7,Bradford County,12,0,12
1,Alabama,12,Florida,9,Brevard County,309,301,8
1,Alabama,12,Florida,11,Broward County,504,333,171
1,Alabama,12,Florida,13,Calhoun County,17,0,17
1,Alabama,12,Florida,15,Charlotte County,18,0,18
1,Alabama,12,Florida,17,Citrus County,12,30,-18
1,Alabama,12,Florida,19,Clay County,261,176,85
1,Alabama,12,Florida,21,Collier County,60,69,-9
1,Alabama,12,Florida,23,Columbia County,50,41,9
1,Alabama,12,Florida,29,Dixie County,0,63,-63
1,Alabama,12,Florida,31,Duval County,990,552,438
1,Alabama,12,Florida,33,Escambia County,2367,1568,799
1,Alabama,12,Florida,35,Flagler County,88,24,64
1,Alabama,12,Florida,37,Franklin County,52,19,33
1,Alabama,12,Florida,39,Gadsden County,38,11,27
1,Alabama,12,Florida,41,Gilchrist County,0,51,-51
1,Alabama,12,Florida,45,Gulf County,7,39,-32
1,Alabama,12,Florida,49,Hardee County,18,0,18
1,Alabama,12,Florida,53,Hernando County,4,95,-91
1,Alabama,12,Florida,55,Highlands County,79,43,36
1,Alabama,12,Florida,57,Hillsborough County,1180,463,717
1,Alabama,12,Florida,59,Holmes County,185,165,20
1,Alabama,12,Florida,61,Indian River County,27,36,-9
1,Alabama,12,Florida,63,Jackson County,254,412,-158
1,Alabama,12,Florida,65,Jefferson County,0,5,-5
1,Alabama,12,Florida,69,Lake County,177,16,161
1,Alabama,12,Florida,71,Lee County,109,64,45
1,Alabama,12,Florida,73,Leon County,271,281,-10
1,Alabama,12,Florida,75,Levy County,0,17,-17
1,Alabama,12,Florida,79,Madison County,16,3,13
1,Alabama,12,Florida,81,Manatee County,154,258,-104
1,Alabama,12,Florida,83,Marion County,116,199,-83
1,Alabama,12,Florida,85,Martin County,44,0,44
1,Alabama,12,Florida,86,Miami-Dade County,727,467,260
1,Alabama,12,Florida,87,Monroe County,29,37,-8
1,Alabama,12,Florida,89,Nassau County,76,5,71
1,Alabama,12,Florida,91,Okaloosa County,927,864,63
1,Alabama,12,Florida,93,Okeechobee County,12,0,12
1,Alabama,12,Florida,95,Orange County,605,265,340
1,Alabama,12,Florida,97,Osceola County,246,0,246
1,Alabama,12,Florida,99,Palm Beach County,274,332,-58
1,Alabama,12,Florida,101,Pasco County,92,160,-68
1,Alabama,12,Florida,103,Pinellas County,244,268,-24
1,Alabama,12,Florida,105,Polk County,165,455,-290
1,Alabama,12,Florida,107,Putnam County,14,0,14
1,Alabama,12,Florida,109,St. Johns County,660,40,620
1,Alabama,12,Florida,111,St. Lucie County,66,25,41
1,Alabama,12,Florida,113,Santa Rosa County,904,1198,-294
1,Alabama,12,Florida,115,Sarasota County,69,442,-373
1,Alabama,12,Florida,117,Seminole County,207,167,40
1,Alabama,12,Florida,119,Sumter County,24,19,5
1,Alabama,12,Florida,121,Suwannee County,0,126,-126
1,Alabama,12,Florida,123,Taylor County,0,15,-15
1,Alabama,12,Florida,125,Union County,0,12,-12
1,Alabama,12,Florida,127,Volusia County,135,130,5
1,Alabama,12,Florida,129,Wakulla County,14,5,9
1,Alabama,12,Florida,131,Walton County,167,333,-166
1,Alabama,12,Florida,133,Washington County,119,4,115
1,Alabama,13,Georgia,1,Appling County,13,0,13
1,Alabama,13,Georgia,3,Atkinson County,0,4,-4
1,Alabama,13,Georgia,7,Baker County,28,0,28
1,Alabama,13,Georgia,9,Baldwin County,61,57,4
1,Alabama,13,Georgia,11,Banks County,25,24,1
1,Alabama,13,Georgia,13,Barrow County,96,36,60
1,Alabama,13,Georgia,15,Bartow County,310,99,211
1,Alabama,13,Georgia,17,Ben Hill County,0,17,-17
1,Alabama,13,Georgia,19,Berrien County,0,42,-42
1,Alabama,13,Georgia,21,Bibb County,165,98,67
1,Alabama,13,Georgia,25,Brantley County,18,0,18
1,Alabama,13,Georgia,27,Brooks County,0,4,-4
1,Alabama,13,Georgia,29,Bryan County,0,13,-13
1,Alabama,13,Georgia,31,Bulloch County,90,109,-19
1,Alabama,13,Georgia,35,Butts County,24,25,-1
1,Alabama,13,Georgia,37,Calhoun County,0,4,-4
1,Alabama,13,Georgia,39,Camden County,74,99,-25
1,Alabama,13,Georgia,43,Candler County,0,4,-4
1,Alabama,13,Georgia,45,Carroll County,415,344,71
1,Alabama,13,Georgia,47,Catoosa County,84,62,22
1,Alabama,13,Georgia,51,Chatham County,534,433,101
1,Alabama,13,Georgia,53,Chattahoochee County,169,265,-96
1,Alabama,13,Georgia,55,Chattooga County,149,107,42
1,Alabama,13,Georgia,57,Cherokee County,232,426,-194
1,Alabama,13,Georgia,59,Clarke County,191,167,24
1,Alabama,13,Georgia,61,Clay County,16,49,-33
1,Alabama,13,Georgia,63,Clayton County,574,708,-134
1,Alabama,13,Georgia,67,Cobb County,1352,1046,306
1,Alabama,13,Georgia,69,Coffee County,25,169,-144
1,Alabama,13,Georgia,71,Colquitt County,37,14,23
1,Alabama,13,Georgia,73,Columbia County,149,257,-108
1,Alabama,13,Georgia,75,Cook County,3,20,-17
1,Alabama,13,Georgia,77,Coweta County,363,400,-37
1,Alabama,13,Georgia,81,Crisp County,10,3,7
1,Alabama,13,Georgia,83,Dade County,177,55,122
1,Alabama,13,Georgia,85,Dawson County,6,0,6
1,Alabama,13,Georgia,87,Decatur County,5,8,-3
1,Alabama,13,Georgia,89,DeKalb County,1136,1002,134
1,Alabama,13,Georgia,93,Dooly County,0,7,-7
1,Alabama,13,Georgia,95,Dougherty County,160,157,3
1,Alabama,13,Georgia,97,Douglas County,154,433,-279
1,Alabama,13,Georgia,99,Early County,71,0,71
1,Alabama,13,Georgia,103,Effingham County,97,62,35
1,Alabama,13,Georgia,105,Elbert County,8,15,-7
1,Alabama,13,Georgia,107,Emanuel County,0,18,-18
1,Alabama,13,Georgia,113,Fayette County,263,438,-175
1,Alabama,13,Georgia,115,Floyd County,678,280,398
1,Alabama,13,Georgia,117,Forsyth County,220,149,71
1,Alabama,13,Georgia,121,Fulton County,1814,1441,373
1,Alabama,13,Georgia,127,Glynn County,67,80,-13
1,Alabama,13,Georgia,129,Gordon County,45,0,45
1,Alabama,13,Georgia,131,Grady County,34,0,34
1,Alabama,13,Georgia,133,Greene County,15,6,9
1,Alabama,13,Georgia,135,Gwinnett County,1038,816,222
1,Alabama,13,Georgia,137,Habersham County,0,13,-13
1,Alabama,13,Georgia,139,Hall County,137,73,64
1,Alabama,13,Georgia,141,Hancock County,36,0,36
1,Alabama,13,Georgia,143,Haralson County,520,325,195
1,Alabama,13,Georgia,145,Harris County,251,127,124
1,Alabama,13,Georgia,147,Hart County,0,42,-42
1,Alabama,13,Georgia,149,Heard County,46,134,-88
1,Alabama,13,Georgia,151,Henry County,734,79,655
1,Alabama,13,Georgia,153,Houston County,227,119,108
1,Alabama,13,Georgia,155,Irwin County,15,1,14
1,Alabama,13,Georgia,157,Jackson County,60,23,37
1,Alabama,13,Georgia,161,Jeff Davis County,0,3,-3
1,Alabama,13,Georgia,165,Jenkins County,0,4,-4
1,Alabama,13,Georgia,167,Johnson County,0,8,-8
1,Alabama,13,Georgia,169,Jones County,159,11,148
1,Alabama,13,Georgia,175,Laurens County,120,16,104
1,Alabama,13,Georgia,177,Lee County,109,234,-125
1,Alabama,13,Georgia,179,Liberty County,264,262,2
1,Alabama,13,Georgia,181,Lincoln County,0,8,-8
1,Alabama,13,Georgia,183,Long County,24,0,24
1,Alabama,13,Georgia,185,Lowndes County,276,324,-48
1,Alabama,13,Georgia,187,Lumpkin County,0,12,-12
1,Alabama,13,Georgia,189,McDuffie County,0,5,-5
1,Alabama,13,Georgia,197,Marion County,0,92,-92
1,Alabama,13,Georgia,199,Meriwether County,25,0,25
1,Alabama,13,Georgia,201,Miller County,1,5,-4
1,Alabama,13,Georgia,205,Mitchell County,97,9,88
1,Alabama,13,Georgia,207,Monroe County,23,34,-11
1,Alabama,13,Georgia,211,Morgan County,264,0,264
1,Alabama,13,Georgia,213,Murray County,35,9,26
1,Alabama,13,Georgia,215,Muscogee County,3552,2431,1121
1,Alabama,13,Georgia,217,Newton County,89,176,-87
1,Alabama,13,Georgia,219,Oconee County,8,28,-20
1,Alabama,13,Georgia,223,Paulding County,532,141,391
1,Alabama,13,Georgia,225,Peach County,0,56,-56
1,Alabama,13,Georgia,227,Pickens County,62,1,61
1,Alabama,13,Georgia,231,Pike County,0,27,-27
1,Alabama,13,Georgia,233,Polk County,218,120,98
1,Alabama,13,Georgia,235,Pulaski County,8,0,8
1,Alabama,13,Georgia,237,Putnam County,35,0,35
1,Alabama,13,Georgia,239,Quitman County,116,87,29
1,Alabama,13,Georgia,241,Rabun County,0,8,-8
1,Alabama,13,Georgia,243,Randolph County,101,38,63
1,Alabama,13,Georgia,245,Richmond County,64,174,-110
1,Alabama,13,Georgia,247,Rockdale County,135,508,-373
1,Alabama,13,Georgia,251,Screven County,0,7,-7
1,Alabama,13,Georgia,253,Seminole County,108,40,68
1,Alabama,13,Georgia,255,Spalding County,134,28,106
1,Alabama,13,Georgia,257,Stephens County,8,4,4
1,Alabama,13,Georgia,259,Stewart County,43,0,43
1,Alabama,13,Georgia,261,Sumter County,10,57,-47
1,Alabama,13,Georgia,265,Taliaferro County,0,3,-3
1,Alabama,13,Georgia,267,Tattnall County,0,12,-12
1,Alabama,13,Georgia,269,Taylor County,23,3,20
1,Alabama,13,Georgia,275,Thomas County,60,163,-103
1,Alabama,13,Georgia,277,Tift County,2,0,2
1,Alabama,13,Georgia,279,Toombs County,7,41,-34
1,Alabama,13,Georgia,281,Towns County,14,0,14
1,Alabama,13,Georgia,285,Troup County,931,396,535
1,Alabama,13,Georgia,291,Union County,0,1,-1
1,Alabama,13,Georgia,293,Upson County,71,0,71
1,Alabama,13,Georgia,295,Walker County,271,87,184
1,Alabama,13,Georgia,297,Walton County,53,391,-338
1,Alabama,13,Georgia,305,Wayne County,18,5,13
1,Alabama,13,Georgia,307,Webster County,0,36,-36
1,Alabama,13,Georgia,313,Whitfield County,90,8,82
1,Alabama,13,Georgia,315,Wilcox County,0,10,-10
1,Alabama,13,Georgia,321,Worth County,36,0,36
1,Alabama,15,Hawaii,1,Hawaii County,109,11,98
1,Alabama,15,Hawaii,3,Honolulu County,782,506,276
1,Alabama,15,Hawaii,7,Kauai County,0,47,-47
1,Alabama,15,Hawaii,9,Maui County,29,0,29
1,Alabama,16,Idaho,1,Ada County,82,0,82
1,Alabama,16,Idaho,5,Bannock County,21,0,21
1,Alabama,16,Idaho,17,Bonner County,0,17,-17
1,Alabama,16,Idaho,23,Butte County,0,4,-4
1,Alabama,16,Idaho,39,Elmore County,0,23,-23
1,Alabama,16,Idaho,41,Franklin County,0,2,-2
1,Alabama,16,Idaho,45,Gem County,0,50,-50
1,Alabama,16,Idaho,55,Kootenai County,28,0,28
1,Alabama,16,Idaho,57,Latah County,11,3,8
1,Alabama,16,Idaho,65,Madison County,11,32,-21
1,Alabama,16,Idaho,67,Minidoka County,44,0,44
1,Alabama,16,Idaho,83,Twin Falls County,20,10,10
1,Alabama,17,Illinois,1,Adams County,0,71,-71
1,Alabama,17,Illinois,5,Bond County,8,0,8
1,Alabama,17,Illinois,19,Champaign County,9,58,-49
1,Alabama,17,Illinois,27,Clinton County,0,3,-3
1,Alabama,17,Illinois,29,Coles County,0,112,-112
1,Alabama,17,Illinois,31,Cook County,827,334,493
1,Alabama,17,Illinois,33,Crawford County,33,0,33
1,Alabama,17,Illinois,39,De Witt County,10,16,-6
1,Alabama,17,Illinois,43,DuPage County,125,85,40
1,Alabama,17,Illinois,45,Edgar County,9,52,-43
1,Alabama,17,Illinois,49,Effingham County,0,2,-2
1,Alabama,17,Illinois,55,Franklin County,0,8,-8
1,Alabama,17,Illinois,63,Grundy County,0,2,-2
1,Alabama,17,Illinois,65,Hamilton County,22,0,22
1,Alabama,17,Illinois,71,Henderson County,0,12,-12
1,Alabama,17,Illinois,73,Henry County,0,14,-14
1,Alabama,17,Illinois,77,Jackson County,2,80,-78
1,Alabama,17,Illinois,83,Jersey County,67,4,63
1,Alabama,17,Illinois,89,Kane County,162,63,99
1,Alabama,17,Illinois,97,Lake County,171,183,-12
1,Alabama,17,Illinois,101,Lawrence County,9,0,9
1,Alabama,17,Illinois,103,Lee County,30,0,30
1,Alabama,17,Illinois,105,Livingston County,0,1,-1
1,Alabama,17,Illinois,107,Logan County,7,0,7
1,Alabama,17,Illinois,111,McHenry County,19,7,12
1,Alabama,17,Illinois,113,McLean County,111,137,-26
1,Alabama,17,Illinois,115,Macon County,98,11,87
1,Alabama,17,Illinois,117,Macoupin County,0,22,-22
1,Alabama,17,Illinois,119,Madison County,103,29,74
1,Alabama,17,Illinois,121,Marion County,140,26,114
1,Alabama,17,Illinois,137,Morgan County,53,7,46
1,Alabama,17,Illinois,141,Ogle County,0,3,-3
1,Alabama,17,Illinois,143,Peoria County,47,44,3
1,Alabama,17,Illinois,145,Perry County,0,13,-13
1,Alabama,17,Illinois,157,Randolph County,0,13,-13
1,Alabama,17,Illinois,163,St. Clair County,85,323,-238
1,Alabama,17,Illinois,167,Sangamon County,38,0,38
1,Alabama,17,Illinois,177,Stephenson County,49,0,49
1,Alabama,17,Illinois,179,Tazewell County,0,22,-22
1,Alabama,17,Illinois,183,Vermilion County,17,0,17
1,Alabama,17,Illinois,187,Warren County,0,10,-10
1,Alabama,17,Illinois,197,Will County,114,74,40
1,Alabama,17,Illinois,199,Williamson County,240,16,224
1,Alabama,17,Illinois,201,Winnebago County,30,32,-2
1,Alabama,18,Indiana,1,Adams County,0,21,-21
1,Alabama,18,Indiana,3,Allen County,235,130,105
1,Alabama,18,Indiana,5,Bartholomew County,15,6,9
1,Alabama,18,Indiana,9,Blackford County,0,5,-5
1,Alabama,18,Indiana,11,Boone County,29,14,15
1,Alabama,18,Indiana,17,Cass County,0,5,-5
1,Alabama,18,Indiana,19,Clark County,0,11,-11
1,Alabama,18,Indiana,23,Clinton County,0,3,-3
1,Alabama,18,Indiana,29,Dearborn County,0,16,-16
1,Alabama,18,Indiana,33,DeKalb County,0,16,-16
1,Alabama,18,Indiana,35,Delaware County,0,2,-2
1,Alabama,18,Indiana,39,Elkhart County,0,7,-7
1,Alabama,18,Indiana,43,Floyd County,33,59,-26
1,Alabama,18,Indiana,45,Fountain County,53,0,53
1,Alabama,18,Indiana,47,Franklin County,5,0,5
1,Alabama,18,Indiana,51,Gibson County,0,10,-10
1,Alabama,18,Indiana,53,Grant County,204,15,189
1,Alabama,18,Indiana,55,Greene County,0,8,-8
1,Alabama,18,Indiana,57,Hamilton County,193,77,116
1,Alabama,18,Indiana,61,Harrison County,57,0,57
1,Alabama,18,Indiana,63,Hendricks County,52,52,0
1,Alabama,18,Indiana,67,Howard County,34,26,8
1,Alabama,18,Indiana,73,Jasper County,3,0,3
1,Alabama,18,Indiana,79,Jennings County,0,16,-16
1,Alabama,18,Indiana,81,Johnson County,174,23,151
1,Alabama,18,Indiana,85,Kosciusko County,3,36,-33
1,Alabama,18,Indiana,89,Lake County,86,135,-49
1,Alabama,18,Indiana,91,LaPorte County,24,0,24
1,Alabama,18,Indiana,95,Madison County,16,0,16
1,Alabama,18,Indiana,97,Marion County,117,207,-90
1,Alabama,18,Indiana,99,Marshall County,11,0,11
1,Alabama,18,Indiana,105,Monroe County,15,2,13
1,Alabama,18,Indiana,107,Montgomery County,12,0,12
1,Alabama,18,Indiana,119,Owen County,21,4,17
1,Alabama,18,Indiana,123,Perry County,10,0,10
1,Alabama,18,Indiana,127,Porter County,0,160,-160
1,Alabama,18,Indiana,139,Rush County,16,0,16
1,Alabama,18,Indiana,141,St. Joseph County,34,65,-31
1,Alabama,18,Indiana,143,Scott County,4,0,4
1,Alabama,18,Indiana,157,Tippecanoe County,31,24,7
1,Alabama,18,Indiana,163,Vanderburgh County,34,59,-25
1,Alabama,18,Indiana,167,Vigo County,43,19,24
1,Alabama,18,Indiana,173,Warrick County,28,0,28
1,Alabama,18,Indiana,175,Washington County,0,3,-3
1,Alabama,18,Indiana,177,Wayne County,0,49,-49
1,Alabama,18,Indiana,179,Wells County,0,53,-53
1,Alabama,18,Indiana,183,Whitley County,0,24,-24
1,Alabama,19,Iowa,13,Black Hawk County,78,3,75
1,Alabama,19,Iowa,35,Cherokee County,0,3,-3
1,Alabama,19,Iowa,37,Chickasaw County,0,3,-3
1,Alabama,19,Iowa,45,Clinton County,14,0,14
1,Alabama,19,Iowa,49,Dallas County,3,0,3
1,Alabama,19,Iowa,53,Decatur County,21,0,21
1,Alabama,19,Iowa,57,Des Moines County,0,67,-67
1,Alabama,19,Iowa,61,Dubuque County,0,111,-111
1,Alabama,19,Iowa,65,Fayette County,21,0,21
1,Alabama,19,Iowa,67,Floyd County,0,6,-6
1,Alabama,19,Iowa,69,Franklin County,0,19,-19
1,Alabama,19,Iowa,71,Fremont County,0,1,-1
1,Alabama,19,Iowa,75,Grundy County,0,10,-10
1,Alabama,19,Iowa,81,Hancock County,0,46,-46
1,Alabama,19,Iowa,89,Howard County,0,4,-4
1,Alabama,19,Iowa,91,Humboldt County,3,0,3
1,Alabama,19,Iowa,93,Ida County,0,1,-1
1,Alabama,19,Iowa,101,Jefferson County,0,107,-107
1,Alabama,19,Iowa,103,Johnson County,49,40,9
1,Alabama,19,Iowa,113,Linn County,19,21,-2
1,Alabama,19,Iowa,129,Mills County,59,0,59
1,Alabama,19,Iowa,145,Page County,0,3,-3
1,Alabama,19,Iowa,153,Polk County,6,5,1
1,Alabama,19,Iowa,155,Pottawattamie County,64,0,64
1,Alabama,19,Iowa,159,Ringgold County,13,0,13
1,Alabama,19,Iowa,163,Scott County,60,25,35
1,Alabama,19,Iowa,169,Story County,80,27,53
1,Alabama,19,Iowa,179,Wapello County,0,12,-12
1,Alabama,19,Iowa,183,Washington County,7,0,7
1,Alabama,19,Iowa,187,Webster County,11,6,5
1,Alabama,19,Iowa,193,Woodbury County,0,11,-11
1,Alabama,2,Alaska,16,Aleutians West Census Area,0,3,-3
1,Alabama,2,Alaska,20,Anchorage Municipality,401,124,277
1,Alabama,2,Alaska,60,Bristol Bay Borough,0,2,-2
1,Alabama,2,Alaska,90,Fairbanks North Star Borough,228,217,11
1,Alabama,2,Alaska,110,Juneau City and Borough,0,3,-3
1,Alabama,2,Alaska,122,Kenai Peninsula Borough,42,0,42
1,Alabama,2,Alaska,130,Ketchikan Gateway Borough,0,4,-4
1,Alabama,2,Alaska,150,Kodiak Island Borough,101,35,66
1,Alabama,2,Alaska,170,Matanuska-Susitna Borough,0,109,-109
1,Alabama,2,Alaska,185,North Slope Borough,0,3,-3
1,Alabama,2,Alaska,261,Valdez-Cordova Census Area,0,132,-132
1,Alabama,20,Kansas,5,Atchison County,0,5,-5
1,Alabama,20,Kansas,11,Bourbon County,4,0,4
1,Alabama,20,Kansas,15,Butler County,0,4,-4
1,Alabama,20,Kansas,41,Dickinson County,20,0,20
1,Alabama,20,Kansas,43,Doniphan County,0,5,-5
1,Alabama,20,Kansas,45,Douglas County,0,22,-22
1,Alabama,20,Kansas,51,Ellis County,20,0,20
1,Alabama,20,Kansas,55,Finney County,13,0,13
1,Alabama,20,Kansas,57,Ford County,0,24,-24
1,Alabama,20,Kansas,61,Geary County,48,52,-4
1,Alabama,20,Kansas,79,Harvey County,21,0,21
1,Alabama,20,Kansas,91,Johnson County,191,51,140
1,Alabama,20,Kansas,103,Leavenworth County,78,88,-10
1,Alabama,20,Kansas,107,Linn County,0,28,-28
1,Alabama,20,Kansas,111,Lyon County,0,5,-5
1,Alabama,20,Kansas,115,Marion County,0,3,-3
1,Alabama,20,Kansas,125,Montgomery County,9,0,9
1,Alabama,20,Kansas,139,Osage County,0,17,-17
1,Alabama,20,Kansas,155,Reno County,0,5,-5
1,Alabama,20,Kansas,161,Riley County,252,95,157
1,Alabama,20,Kansas,169,Saline County,38,63,-25
1,Alabama,20,Kansas,173,Sedgwick County,115,109,6
1,Alabama,20,Kansas,175,Seward County,0,66,-66
1,Alabama,20,Kansas,177,Shawnee County,80,28,52
1,Alabama,20,Kansas,209,Wyandotte County,20,0,20
1,Alabama,21,Kentucky,1,Adair County,2,31,-29
1,Alabama,21,Kentucky,9,Barren County,5,59,-54
1,Alabama,21,Kentucky,13,Bell County,9,16,-7
1,Alabama,21,Kentucky,15,Boone County,24,225,-201
1,Alabama,21,Kentucky,17,Bourbon County,14,0,14
1,Alabama,21,Kentucky,19,Boyd County,0,9,-9
1,Alabama,21,Kentucky,21,Boyle County,0,28,-28
1,Alabama,21,Kentucky,23,Bracken County,3,0,3
1,Alabama,21,Kentucky,29,Bullitt County,15,0,15
1,Alabama,21,Kentucky,31,Butler County,9,0,9
1,Alabama,21,Kentucky,35,Calloway County,3,12,-9
1,Alabama,21,Kentucky,37,Campbell County,37,0,37
1,Alabama,21,Kentucky,43,Carter County,0,16,-16
1,Alabama,21,Kentucky,45,Casey County,5,0,5
1,Alabama,21,Kentucky,47,Christian County,168,209,-41
1,Alabama,21,Kentucky,51,Clay County,42,4,38
1,Alabama,21,Kentucky,55,Crittenden County,13,0,13
1,Alabama,21,Kentucky,59,Daviess County,0,11,-11
1,Alabama,21,Kentucky,61,Edmonson County,0,9,-9
1,Alabama,21,Kentucky,67,Fayette County,350,163,187
1,Alabama,21,Kentucky,71,Floyd County,0,7,-7
1,Alabama,21,Kentucky,73,Franklin County,0,2,-2
1,Alabama,21,Kentucky,75,Fulton County,9,0,9
1,Alabama,21,Kentucky,85,Grayson County,48,0,48
1,Alabama,21,Kentucky,93,Hardin County,97,109,-12
1,Alabama,21,Kentucky,95,Harlan County,11,8,3
1,Alabama,21,Kentucky,99,Hart County,12,0,12
1,Alabama,21,Kentucky,101,Henderson County,1,13,-12
1,Alabama,21,Kentucky,103,Henry County,9,0,9
1,Alabama,21,Kentucky,107,Hopkins County,15,10,5
1,Alabama,21,Kentucky,111,Jefferson County,305,184,121
1,Alabama,21,Kentucky,113,Jessamine County,37,92,-55
1,Alabama,21,Kentucky,115,Johnson County,0,52,-52
1,Alabama,21,Kentucky,117,Kenton County,65,40,25
1,Alabama,21,Kentucky,121,Knox County,82,1,81
1,Alabama,21,Kentucky,129,Lee County,13,0,13
1,Alabama,21,Kentucky,137,Lincoln County,25,0,25
1,Alabama,21,Kentucky,141,Logan County,15,0,15
1,Alabama,21,Kentucky,145,McCracken County,21,27,-6
1,Alabama,21,Kentucky,147,McCreary County,0,17,-17
1,Alabama,21,Kentucky,151,Madison County,77,46,31
1,Alabama,21,Kentucky,155,Marion County,2,0,2
1,Alabama,21,Kentucky,157,Marshall County,20,0,20
1,Alabama,21,Kentucky,163,Meade County,0,18,-18
1,Alabama,21,Kentucky,165,Menifee County,0,8,-8
1,Alabama,21,Kentucky,167,Mercer County,0,9,-9
1,Alabama,21,Kentucky,173,Montgomery County,2,0,2
1,Alabama,21,Kentucky,179,Nelson County,7,0,7
1,Alabama,21,Kentucky,183,Ohio County,5,0,5
1,Alabama,21,Kentucky,185,Oldham County,185,11,174
1,Alabama,21,Kentucky,191,Pendleton County,14,0,14
1,Alabama,21,Kentucky,197,Powell County,2,0,2
1,Alabama,21,Kentucky,199,Pulaski County,80,0,80
1,Alabama,21,Kentucky,205,Rowan County,79,0,79
1,Alabama,21,Kentucky,207,Russell County,2,0,2
1,Alabama,21,Kentucky,209,Scott County,28,90,-62
1,Alabama,21,Kentucky,211,Shelby County,13,32,-19
1,Alabama,21,Kentucky,213,Simpson County,0,8,-8
1,Alabama,21,Kentucky,217,Taylor County,0,41,-41
1,Alabama,21,Kentucky,225,Union County,2,75,-73
1,Alabama,21,Kentucky,227,Warren County,163,140,23
1,Alabama,21,Kentucky,229,Washington County,0,13,-13
1,Alabama,21,Kentucky,231,Wayne County,23,5,18
1,Alabama,21,Kentucky,233,Webster County,5,0,5
1,Alabama,21,Kentucky,235,Whitley County,0,15,-15
1,Alabama,21,Kentucky,239,Woodford County,0,8,-8
1,Alabama,22,Louisiana,1,Acadia Parish,47,0,47
1,Alabama,22,Louisiana,3,Allen Parish,0,41,-41
1,Alabama,22,Louisiana,5,Ascension Parish,31,109,-78
1,Alabama,22,Louisiana,13,Bienville Parish,0,3,-3
1,Alabama,22,Louisiana,15,Bossier Parish,28,46,-18
1,Alabama,22,Louisiana,17,Caddo Parish,37,383,-346
1,Alabama,22,Louisiana,19,Calcasieu Parish,5,74,-69
1,Alabama,22,Louisiana,23,Cameron Parish,0,7,-7
1,Alabama,22,Louisiana,29,Concordia Parish,0,6,-6
1,Alabama,22,Louisiana,33,East Baton Rouge Parish,236,856,-620
1,Alabama,22,Louisiana,39,Evangeline Parish,9,9,0
1,Alabama,22,Louisiana,41,Franklin Parish,0,15,-15
1,Alabama,22,Louisiana,43,Grant Parish,15,17,-2
1,Alabama,22,Louisiana,45,Iberia Parish,20,0,20
1,Alabama,22,Louisiana,47,Iberville Parish,14,9,5
1,Alabama,22,Louisiana,49,Jackson Parish,0,9,-9
1,Alabama,22,Louisiana,51,Jefferson Parish,225,369,-144
1,Alabama,22,Louisiana,55,Lafayette Parish,46,285,-239
1,Alabama,22,Louisiana,57,Lafourche Parish,0,5,-5
1,Alabama,22,Louisiana,59,LaSalle Parish,0,9,-9
1,Alabama,22,Louisiana,61,Lincoln Parish,0,12,-12
1,Alabama,22,Louisiana,63,Livingston Parish,74,39,35
1,Alabama,22,Louisiana,67,Morehouse Parish,0,19,-19
1,Alabama,22,Louisiana,69,Natchitoches Parish,6,0,6
1,Alabama,22,Louisiana,71,Orleans Parish,252,246,6
1,Alabama,22,Louisiana,73,Ouachita Parish,74,11,63
1,Alabama,22,Louisiana,75,Plaquemines Parish,116,22,94
1,Alabama,22,Louisiana,79,Rapides Parish,95,26,69
1,Alabama,22,Louisiana,83,Richland Parish,4,0,4
1,Alabama,22,Louisiana,87,St. Bernard Parish,15,0,15
1,Alabama,22,Louisiana,89,St. Charles Parish,0,73,-73
1,Alabama,22,Louisiana,93,St. James Parish,0,52,-52
1,Alabama,22,Louisiana,97,St. Landry Parish,18,72,-54
1,Alabama,22,Louisiana,101,St. Mary Parish,27,0,27
1,Alabama,22,Louisiana,103,St. Tammany Parish,259,509,-250
1,Alabama,22,Louisiana,105,Tangipahoa Parish,5,205,-200
1,Alabama,22,Louisiana,109,Terrebonne Parish,0,49,-49
1,Alabama,22,Louisiana,115,Vernon Parish,44,58,-14
1,Alabama,22,Louisiana,117,Washington Parish,2,0,2
1,Alabama,22,Louisiana,119,Webster Parish,0,12,-12
1,Alabama,22,Louisiana,121,West Baton Rouge Parish,34,76,-42
1,Alabama,22,Louisiana,123,West Carroll Parish,0,3,-3
1,Alabama,22,Louisiana,125,West Feliciana Parish,0,53,-53
1,Alabama,22,Louisiana,127,Winn Parish,7,16,-9
1,Alabama,23,Maine,1,Androscoggin County,8,0,8
1,Alabama,23,Maine,3,Aroostook County,0,6,-6
1,Alabama,23,Maine,5,Cumberland County,19,65,-46
1,Alabama,23,Maine,11,Kennebec County,30,0,30
1,Alabama,23,Maine,13,Knox County,11,0,11
1,Alabama,23,Maine,19,Penobscot County,0,12,-12
1,Alabama,23,Maine,23,Sagadahoc County,0,20,-20
1,Alabama,23,Maine,25,Somerset County,0,30,-30
1,Alabama,24,Maryland,1,Allegany County,0,27,-27
1,Alabama,24,Maryland,3,Anne Arundel County,176,173,3
1,Alabama,24,Maryland,5,Baltimore County,139,52,87
1,Alabama,24,Maryland,9,Calvert County,0,26,-26
1,Alabama,24,Maryland,13,Carroll County,31,22,9
1,Alabama,24,Maryland,15,Cecil County,31,8,23
1,Alabama,24,Maryland,17,Charles County,0,126,-126
1,Alabama,24,Maryland,21,Frederick County,207,109,98
1,Alabama,24,Maryland,25,Harford County,76,53,23
1,Alabama,24,Maryland,27,Howard County,74,55,19
1,Alabama,24,Maryland,31,Montgomery County,194,269,-75
1,Alabama,24,Maryland,33,Prince George's County,187,112,75
1,Alabama,24,Maryland,37,St. Mary's County,28,30,-2
1,Alabama,24,Maryland,39,Somerset County,34,0,34
1,Alabama,24,Maryland,45,Wicomico County,0,30,-30
1,Alabama,24,Maryland,47,Worcester County,9,20,-11
1,Alabama,24,Maryland,510,Baltimore city,72,58,14
1,Alabama,25,Massachusetts,1,Barnstable County,30,35,-5
1,Alabama,25,Massachusetts,3,Berkshire County,32,0,32
1,Alabama,25,Massachusetts,5,Bristol County,14,0,14
1,Alabama,25,Massachusetts,9,Essex County,12,54,-42
1,Alabama,25,Massachusetts,11,Franklin County,0,7,-7
1,Alabama,25,Massachusetts,13,Hampden County,17,66,-49
1,Alabama,25,Massachusetts,15,Hampshire County,15,5,10
1,Alabama,25,Massachusetts,17,Middlesex County,211,66,145
1,Alabama,25,Massachusetts,21,Norfolk County,200,31,169
1,Alabama,25,Massachusetts,23,Plymouth County,36,10,26
1,Alabama,25,Massachusetts,25,Suffolk County,132,92,40
1,Alabama,25,Massachusetts,27,Worcester County,34,30,4
1,Alabama,26,Michigan,5,Allegan County,35,0,35
1,Alabama,26,Michigan,11,Arenac County,0,7,-7
1,Alabama,26,Michigan,15,Barry County,0,38,-38
1,Alabama,26,Michigan,17,Bay County,97,0,97
1,Alabama,26,Michigan,19,Benzie County,14,0,14
1,Alabama,26,Michigan,21,Berrien County,35,85,-50
1,Alabama,26,Michigan,23,Branch County,0,5,-5
1,Alabama,26,Michigan,25,Calhoun County,10,9,1
1,Alabama,26,Michigan,29,Charlevoix County,124,0,124
1,Alabama,26,Michigan,31,Cheboygan County,0,3,-3
1,Alabama,26,Michigan,33,Chippewa County,21,0,21
1,Alabama,26,Michigan,35,Clare County,0,3,-3
1,Alabama,26,Michigan,37,Clinton County,14,0,14
1,Alabama,26,Michigan,39,Crawford County,0,8,-8
1,Alabama,26,Michigan,49,Genesee County,105,34,71
1,Alabama,26,Michigan,51,Gladwin County,2,0,2
1,Alabama,26,Michigan,53,Gogebic County,0,2,-2
1,Alabama,26,Michigan,55,Grand Traverse County,32,13,19
1,Alabama,26,Michigan,57,Gratiot County,0,8,-8
1,Alabama,26,Michigan,59,Hillsdale County,0,20,-20
1,Alabama,26,Michigan,61,Houghton County,0,42,-42
1,Alabama,26,Michigan,65,Ingham County,107,87,20
1,Alabama,26,Michigan,69,Iosco County,11,24,-13
1,Alabama,26,Michigan,71,Iron County,0,3,-3
1,Alabama,26,Michigan,75,Jackson County,0,31,-31
1,Alabama,26,Michigan,77,Kalamazoo County,14,110,-96
1,Alabama,26,Michigan,79,Kalkaska County,0,4,-4
1,Alabama,26,Michigan,81,Kent County,144,46,98
1,Alabama,26,Michigan,87,Lapeer County,0,49,-49
1,Alabama,26,Michigan,91,Lenawee County,29,4,25
1,Alabama,26,Michigan,93,Livingston County,0,14,-14
1,Alabama,26,Michigan,99,Macomb County,210,41,169
1,Alabama,26,Michigan,101,Manistee County,33,11,22
1,Alabama,26,Michigan,103,Marquette County,2,0,2
1,Alabama,26,Michigan,105,Mason County,28,0,28
1,Alabama,26,Michigan,107,Mecosta County,16,0,16
1,Alabama,26,Michigan,111,Midland County,0,45,-45
1,Alabama,26,Michigan,113,Missaukee County,0,16,-16
1,Alabama,26,Michigan,115,Monroe County,74,0,74
1,Alabama,26,Michigan,117,Montcalm County,0,10,-10
1,Alabama,26,Michigan,121,Muskegon County,59,33,26
1,Alabama,26,Michigan,125,Oakland County,298,319,-21
1,Alabama,26,Michigan,127,Oceana County,13,0,13
1,Alabama,26,Michigan,129,Ogemaw County,0,5,-5
1,Alabama,26,Michigan,133,Osceola County,0,15,-15
1,Alabama,26,Michigan,139,Ottawa County,147,5,142
1,Alabama,26,Michigan,141,Presque Isle County,0,5,-5
1,Alabama,26,Michigan,145,Saginaw County,29,5,24
1,Alabama,26,Michigan,147,St. Clair County,0,112,-112
1,Alabama,26,Michigan,149,St. Joseph County,5,0,5
1,Alabama,26,Michigan,151,Sanilac County,84,0,84
1,Alabama,26,Michigan,153,Schoolcraft County,8,0,8
1,Alabama,26,Michigan,157,Tuscola County,68,77,-9
1,Alabama,26,Michigan,159,Van Buren County,4,0,4
1,Alabama,26,Michigan,161,Washtenaw County,154,75,79
1,Alabama,26,Michigan,163,Wayne County,542,1029,-487
1,Alabama,26,Michigan,165,Wexford County,0,16,-16
1,Alabama,27,Minnesota,3,Anoka County,8,15,-7
1,Alabama,27,Minnesota,5,Becker County,0,2,-2
1,Alabama,27,Minnesota,7,Beltrami County,0,6,-6
1,Alabama,27,Minnesota,13,Blue Earth County,4,0,4
1,Alabama,27,Minnesota,35,Crow Wing County,0,3,-3
1,Alabama,27,Minnesota,37,Dakota County,41,133,-92
1,Alabama,27,Minnesota,53,Hennepin County,160,35,125
1,Alabama,27,Minnesota,97,Morrison County,0,1,-1
1,Alabama,27,Minnesota,103,Nicollet County,21,0,21
1,Alabama,27,Minnesota,107,Norman County,4,0,4
1,Alabama,27,Minnesota,109,Olmsted County,8,44,-36
1,Alabama,27,Minnesota,115,Pine County,0,9,-9
1,Alabama,27,Minnesota,123,Ramsey County,0,11,-11
1,Alabama,27,Minnesota,131,Rice County,14,0,14
1,Alabama,27,Minnesota,137,St. Louis County,0,10,-10
1,Alabama,27,Minnesota,139,Scott County,39,0,39
1,Alabama,27,Minnesota,143,Sibley County,0,32,-32
1,Alabama,27,Minnesota,147,Steele County,47,14,33
1,Alabama,27,Minnesota,159,Wadena County,3,0,3
1,Alabama,28,Mississippi,1,Adams County,90,14,76
1,Alabama,28,Mississippi,3,Alcorn County,68,124,-56
1,Alabama,28,Mississippi,7,Attala County,0,39,-39
1,Alabama,28,Mississippi,9,Benton County,36,3,33
1,Alabama,28,Mississippi,11,Bolivar County,18,0,18
1,Alabama,28,Mississippi,13,Calhoun County,0,4,-4
1,Alabama,28,Mississippi,15,Carroll County,44,0,44
1,Alabama,28,Mississippi,17,Chickasaw County,14,9,5
1,Alabama,28,Mississippi,21,Claiborne County,0,18,-18
1,Alabama,28,Mississippi,23,Clarke County,11,115,-104
1,Alabama,28,Mississippi,25,Clay County,11,27,-16
1,Alabama,28,Mississippi,27,Coahoma County,32,29,3
1,Alabama,28,Mississippi,29,Copiah County,0,8,-8
1,Alabama,28,Mississippi,31,Covington County,0,8,-8
1,Alabama,28,Mississippi,33,DeSoto County,112,144,-32
1,Alabama,28,Mississippi,35,Forrest County,385,227,158
1,Alabama,28,Mississippi,39,George County,94,322,-228
1,Alabama,28,Mississippi,41,Greene County,107,17,90
1,Alabama,28,Mississippi,43,Grenada County,12,7,5
1,Alabama,28,Mississippi,45,Hancock County,60,80,-20
1,Alabama,28,Mississippi,47,Harrison County,966,688,278
1,Alabama,28,Mississippi,49,Hinds County,389,242,147
1,Alabama,28,Mississippi,51,Holmes County,20,0,20
1,Alabama,28,Mississippi,53,Humphreys County,4,5,-1
1,Alabama,28,Mississippi,57,Itawamba County,98,22,76
1,Alabama,28,Mississippi,59,Jackson County,336,605,-269
1,Alabama,28,Mississippi,61,Jasper County,59,4,55
1,Alabama,28,Mississippi,67,Jones County,44,88,-44
1,Alabama,28,Mississippi,69,Kemper County,30,27,3
1,Alabama,28,Mississippi,71,Lafayette County,76,266,-190
1,Alabama,28,Mississippi,73,Lamar County,514,103,411
1,Alabama,28,Mississippi,75,Lauderdale County,234,458,-224
1,Alabama,28,Mississippi,79,Leake County,0,126,-126
1,Alabama,28,Mississippi,81,Lee County,167,199,-32
1,Alabama,28,Mississippi,83,Leflore County,20,21,-1
1,Alabama,28,Mississippi,85,Lincoln County,79,16,63
1,Alabama,28,Mississippi,87,Lowndes County,374,366,8
1,Alabama,28,Mississippi,89,Madison County,346,292,54
1,Alabama,28,Mississippi,91,Marion County,36,74,-38
1,Alabama,28,Mississippi,93,Marshall County,11,32,-21
1,Alabama,28,Mississippi,95,Monroe County,83,53,30
1,Alabama,28,Mississippi,97,Montgomery County,46,0,46
1,Alabama,28,Mississippi,99,Neshoba County,9,0,9
1,Alabama,28,Mississippi,101,Newton County,40,16,24
1,Alabama,28,Mississippi,103,Noxubee County,16,1,15
1,Alabama,28,Mississippi,105,Oktibbeha County,347,483,-136
1,Alabama,28,Mississippi,107,Panola County,18,6,12
1,Alabama,28,Mississippi,109,Pearl River County,26,90,-64
1,Alabama,28,Mississippi,111,Perry County,0,11,-11
1,Alabama,28,Mississippi,113,Pike County,9,5,4
1,Alabama,28,Mississippi,115,Pontotoc County,0,56,-56
1,Alabama,28,Mississippi,117,Prentiss County,6,16,-10
1,Alabama,28,Mississippi,119,Quitman County,3,0,3
1,Alabama,28,Mississippi,121,Rankin County,616,593,23
1,Alabama,28,Mississippi,123,Scott County,79,0,79
1,Alabama,28,Mississippi,125,Sharkey County,0,3,-3
1,Alabama,28,Mississippi,127,Simpson County,79,11,68
1,Alabama,28,Mississippi,131,Stone County,7,0,7
1,Alabama,28,Mississippi,133,Sunflower County,1,74,-73
1,Alabama,28,Mississippi,137,Tate County,11,16,-5
1,Alabama,28,Mississippi,139,Tippah County,16,59,-43
1,Alabama,28,Mississippi,141,Tishomingo County,434,49,385
1,Alabama,28,Mississippi,143,Tunica County,0,5,-5
1,Alabama,28,Mississippi,145,Union County,11,8,3
1,Alabama,28,Mississippi,149,Warren County,5,0,5
1,Alabama,28,Mississippi,151,Washington County,48,35,13
1,Alabama,28,Mississippi,153,Wayne County,205,0,205
1,Alabama,28,Mississippi,155,Webster County,0,2,-2
1,Alabama,28,Mississippi,159,Winston County,42,10,32
1,Alabama,28,Mississippi,163,Yazoo County,33,36,-3
1,Alabama,29,Missouri,15,Benton County,2,0,2
1,Alabama,29,Missouri,19,Boone County,85,105,-20
1,Alabama,29,Missouri,21,Buchanan County,2,9,-7
1,Alabama,29,Missouri,23,Butler County,13,2,11
1,Alabama,29,Missouri,27,Callaway County,52,22,30
1,Alabama,29,Missouri,29,Camden County,3,77,-74
1,Alabama,29,Missouri,31,Cape Girardeau County,30,57,-27
1,Alabama,29,Missouri,37,Cass County,86,1,85
1,Alabama,29,Missouri,43,Christian County,18,0,18
1,Alabama,29,Missouri,47,Clay County,156,0,156
1,Alabama,29,Missouri,67,Douglas County,47,0,47
1,Alabama,29,Missouri,69,Dunklin County,10,0,10
1,Alabama,29,Missouri,71,Franklin County,6,0,6
1,Alabama,29,Missouri,73,Gasconade County,56,0,56
1,Alabama,29,Missouri,77,Greene County,37,44,-7
1,Alabama,29,Missouri,79,Grundy County,0,39,-39
1,Alabama,29,Missouri,95,Jackson County,75,57,18
1,Alabama,29,Missouri,97,Jasper County,58,27,31
1,Alabama,29,Missouri,99,Jefferson County,40,20,20
1,Alabama,29,Missouri,101,Johnson County,40,13,27
1,Alabama,29,Missouri,103,Knox County,0,5,-5
1,Alabama,29,Missouri,109,Lawrence County,53,8,45
1,Alabama,29,Missouri,111,Lewis County,0,16,-16
1,Alabama,29,Missouri,113,Lincoln County,0,16,-16
1,Alabama,29,Missouri,131,Miller County,87,0,87
1,Alabama,29,Missouri,135,Moniteau County,0,5,-5
1,Alabama,29,Missouri,141,Morgan County,18,0,18
1,Alabama,29,Missouri,145,Newton County,4,18,-14
1,Alabama,29,Missouri,153,Ozark County,0,6,-6
1,Alabama,29,Missouri,155,Pemiscot County,0,8,-8
1,Alabama,29,Missouri,161,Phelps County,20,59,-39
1,Alabama,29,Missouri,165,Platte County,4,24,-20
1,Alabama,29,Missouri,169,Pulaski County,120,689,-569
1,Alabama,29,Missouri,173,Ralls County,0,10,-10
1,Alabama,29,Missouri,183,St. Charles County,20,114,-94
1,Alabama,29,Missouri,187,St. Francois County,0,45,-45
1,Alabama,29,Missouri,189,St. Louis County,302,489,-187
1,Alabama,29,Missouri,201,Scott County,16,10,6
1,Alabama,29,Missouri,213,Taney County,75,52,23
1,Alabama,29,Missouri,215,Texas County,38,0,38
1,Alabama,29,Missouri,221,Washington County,0,4,-4
1,Alabama,29,Missouri,510,St. Louis city,35,43,-8
1,Alabama,30,Montana,1,Beaverhead County,9,5,4
1,Alabama,30,Montana,13,Cascade County,119,36,83
1,Alabama,30,Montana,17,Custer County,0,3,-3
1,Alabama,30,Montana,29,Flathead County,7,10,-3
1,Alabama,30,Montana,31,Gallatin County,20,9,11
1,Alabama,30,Montana,35,Glacier County,0,4,-4
1,Alabama,30,Montana,43,Jefferson County,0,1,-1
1,Alabama,30,Montana,45,Judith Basin County,16,0,16
1,Alabama,30,Montana,53,Lincoln County,0,13,-13
1,Alabama,30,Montana,61,Mineral County,41,0,41
1,Alabama,30,Montana,63,Missoula County,83,27,56
1,Alabama,30,Montana,67,Park County,0,3,-3
1,Alabama,30,Montana,71,Phillips County,0,4,-4
1,Alabama,30,Montana,89,Sanders County,0,14,-14
1,Alabama,30,Montana,111,Yellowstone County,40,11,29
1,Alabama,31,Nebraska,21,Burt County,0,2,-2
1,Alabama,31,Nebraska,41,Custer County,0,2,-2
1,Alabama,31,Nebraska,43,Dakota County,0,26,-26
1,Alabama,31,Nebraska,55,Douglas County,42,85,-43
1,Alabama,31,Nebraska,57,Dundy County,0,1,-1
1,Alabama,31,Nebraska,67,Gage County,34,0,34
1,Alabama,31,Nebraska,69,Garden County,0,4,-4
1,Alabama,31,Nebraska,109,Lancaster County,52,51,1
1,Alabama,31,Nebraska,119,Madison County,0,31,-31
1,Alabama,31,Nebraska,137,Phelps County,0,4,-4
1,Alabama,31,Nebraska,141,Platte County,0,8,-8
1,Alabama,31,Nebraska,153,Sarpy County,42,84,-42
1,Alabama,31,Nebraska,157,Scotts Bluff County,0,5,-5
1,Alabama,31,Nebraska,159,Seward County,0,23,-23
1,Alabama,32,Nevada,3,Clark County,520,617,-97
1,Alabama,32,Nevada,19,Lyon County,14,0,14
1,Alabama,32,Nevada,23,Nye County,52,10,42
1,Alabama,32,Nevada,27,Pershing County,42,0,42
1,Alabama,32,Nevada,31,Washoe County,43,47,-4
1,Alabama,32,Nevada,510,Carson City,30,31,-1
1,Alabama,33,New Hampshire,1,Belknap County,2,22,-20
1,Alabama,33,New Hampshire,7,Coos County,9,0,9
1,Alabama,33,New Hampshire,11,Hillsborough County,92,51,41
1,Alabama,33,New Hampshire,15,Rockingham County,44,42,2
1,Alabama,33,New Hampshire,17,Strafford County,3,0,3
1,Alabama,34,New Jersey,1,Atlantic County,0,58,-58
1,Alabama,34,New Jersey,3,Bergen County,98,24,74
1,Alabama,34,New Jersey,5,Burlington County,97,53,44
1,Alabama,34,New Jersey,7,Camden County,0,11,-11
1,Alabama,34,New Jersey,9,Cape May County,74,25,49
1,Alabama,34,New Jersey,11,Cumberland County,34,0,34
1,Alabama,34,New Jersey,13,Essex County,69,10,59
1,Alabama,34,New Jersey,15,Gloucester County,0,7,-7
1,Alabama,34,New Jersey,17,Hudson County,69,11,58
1,Alabama,34,New Jersey,19,Hunterdon County,13,0,13
1,Alabama,34,New Jersey,21,Mercer County,8,38,-30
1,Alabama,34,New Jersey,23,Middlesex County,67,15,52
1,Alabama,34,New Jersey,25,Monmouth County,46,5,41
1,Alabama,34,New Jersey,27,Morris County,35,0,35
1,Alabama,34,New Jersey,29,Ocean County,3,10,-7
1,Alabama,34,New Jersey,35,Somerset County,31,21,10
1,Alabama,34,New Jersey,37,Sussex County,0,14,-14
1,Alabama,34,New Jersey,39,Union County,87,3,84
1,Alabama,35,New Mexico,1,Bernalillo County,321,10,311
1,Alabama,35,New Mexico,5,Chaves County,0,78,-78
1,Alabama,35,New Mexico,9,Curry County,382,100,282
1,Alabama,35,New Mexico,11,De Baca County,24,0,24
1,Alabama,35,New Mexico,13,Doña Ana County,70,33,37
1,Alabama,35,New Mexico,15,Eddy County,26,0,26
1,Alabama,35,New Mexico,35,Otero County,35,15,20
1,Alabama,35,New Mexico,41,Roosevelt County,46,0,46
1,Alabama,35,New Mexico,43,Sandoval County,23,33,-10
1,Alabama,35,New Mexico,47,San Miguel County,29,0,29
1,Alabama,35,New Mexico,49,Santa Fe County,1,12,-11
1,Alabama,35,New Mexico,53,Socorro County,35,8,27
1,Alabama,36,New York,1,Albany County,14,0,14
1,Alabama,36,New York,3,Allegany County,0,3,-3
1,Alabama,36,New York,5,Bronx County,153,40,113
1,Alabama,36,New York,7,Broome County,8,11,-3
1,Alabama,36,New York,13,Chautauqua County,26,8,18
1,Alabama,36,New York,15,Chemung County,20,0,20
1,Alabama,36,New York,19,Clinton County,12,0,12
1,Alabama,36,New York,27,Dutchess County,35,23,12
1,Alabama,36,New York,29,Erie County,187,47,140
1,Alabama,36,New York,33,Franklin County,0,10,-10
1,Alabama,36,New York,35,Fulton County,21,0,21
1,Alabama,36,New York,43,Herkimer County,8,0,8
1,Alabama,36,New York,45,Jefferson County,342,231,111
1,Alabama,36,New York,47,Kings County,279,120,159
1,Alabama,36,New York,49,Lewis County,0,8,-8
1,Alabama,36,New York,55,Monroe County,204,188,16
1,Alabama,36,New York,59,Nassau County,54,3,51
1,Alabama,36,New York,61,New York County,308,147,161
1,Alabama,36,New York,63,Niagara County,16,0,16
1,Alabama,36,New York,65,Oneida County,1,13,-12
1,Alabama,36,New York,67,Onondaga County,78,80,-2
1,Alabama,36,New York,69,Ontario County,0,9,-9
1,Alabama,36,New York,71,Orange County,89,10,79
1,Alabama,36,New York,75,Oswego County,9,0,9
1,Alabama,36,New York,81,Queens County,216,16,200
1,Alabama,36,New York,85,Richmond County,61,19,42
1,Alabama,36,New York,87,Rockland County,11,0,11
1,Alabama,36,New York,89,St. Lawrence County,18,2,16
1,Alabama,36,New York,91,Saratoga County,3,0,3
1,Alabama,36,New York,101,Steuben County,41,26,15
1,Alabama,36,New York,103,Suffolk County,140,157,-17
1,Alabama,36,New York,109,Tompkins County,19,11,8
1,Alabama,36,New York,111,Ulster County,25,0,25
1,Alabama,36,New York,119,Westchester County,79,14,65
1,Alabama,36,New York,123,Yates County,0,2,-2
1,Alabama,37,North Carolina,1,Alamance County,1,27,-26
1,Alabama,37,North Carolina,7,Anson County,0,3,-3
1,Alabama,37,North Carolina,9,Ashe County,50,0,50
1,Alabama,37,North Carolina,11,Avery County,0,12,-12
1,Alabama,37,North Carolina,13,Beaufort County,16,0,16
1,Alabama,37,North Carolina,19,Brunswick County,22,10,12
1,Alabama,37,North Carolina,21,Buncombe County,95,99,-4
1,Alabama,37,North Carolina,23,Burke County,0,24,-24
1,Alabama,37,North Carolina,25,Cabarrus County,139,109,30
1,Alabama,37,North Carolina,27,Caldwell County,53,0,53
1,Alabama,37,North Carolina,31,Carteret County,15,16,-1
1,Alabama,37,North Carolina,35,Catawba County,20,52,-32
1,Alabama,37,North Carolina,39,Cherokee County,23,0,23
1,Alabama,37,North Carolina,45,Cleveland County,46,12,34
1,Alabama,37,North Carolina,49,Craven County,29,47,-18
1,Alabama,37,North Carolina,51,Cumberland County,930,671,259
1,Alabama,37,North Carolina,55,Dare County,0,91,-91
1,Alabama,37,North Carolina,57,Davidson County,3,0,3
1,Alabama,37,North Carolina,59,Davie County,0,48,-48
1,Alabama,37,North Carolina,63,Durham County,98,209,-111
1,Alabama,37,North Carolina,65,Edgecombe County,47,0,47
1,Alabama,37,North Carolina,67,Forsyth County,117,134,-17
1,Alabama,37,North Carolina,69,Franklin County,9,48,-39
1,Alabama,37,North Carolina,71,Gaston County,23,19,4
1,Alabama,37,North Carolina,77,Granville County,0,14,-14
1,Alabama,37,North Carolina,81,Guilford County,92,80,12
1,Alabama,37,North Carolina,83,Halifax County,0,14,-14
1,Alabama,37,North Carolina,85,Harnett County,197,94,103
1,Alabama,37,North Carolina,87,Haywood County,0,87,-87
1,Alabama,37,North Carolina,89,Henderson County,63,42,21
1,Alabama,37,North Carolina,93,Hoke County,6,31,-25
1,Alabama,37,North Carolina,97,Iredell County,41,45,-4
1,Alabama,37,North Carolina,99,Jackson County,14,35,-21
1,Alabama,37,North Carolina,101,Johnston County,82,4,78
1,Alabama,37,North Carolina,107,Lenoir County,32,0,32
1,Alabama,37,North Carolina,109,Lincoln County,0,32,-32
1,Alabama,37,North Carolina,111,McDowell County,10,0,10
1,Alabama,37,North Carolina,113,Macon County,29,66,-37
1,Alabama,37,North Carolina,119,Mecklenburg County,379,695,-316
1,Alabama,37,North Carolina,125,Moore County,80,0,80
1,Alabama,37,North Carolina,127,Nash County,58,0,58
1,Alabama,37,North Carolina,129,New Hanover County,0,25,-25
1,Alabama,37,North Carolina,133,Onslow County,316,363,-47
1,Alabama,37,North Carolina,135,Orange County,51,2,49
1,Alabama,37,North Carolina,139,Pasquotank County,7,11,-4
1,Alabama,37,North Carolina,141,Pender County,0,1,-1
1,Alabama,37,North Carolina,147,Pitt County,115,19,96
1,Alabama,37,North Carolina,151,Randolph County,0,17,-17
1,Alabama,37,North Carolina,155,Robeson County,0,16,-16
1,Alabama,37,North Carolina,163,Sampson County,6,0,6
1,Alabama,37,North Carolina,165,Scotland County,4,68,-64
1,Alabama,37,North Carolina,169,Stokes County,5,0,5
1,Alabama,37,North Carolina,171,Surry County,0,3,-3
1,Alabama,37,North Carolina,175,Transylvania County,0,9,-9
1,Alabama,37,North Carolina,179,Union County,223,39,184
1,Alabama,37,North Carolina,181,Vance County,0,8,-8
1,Alabama,37,North Carolina,183,Wake County,237,333,-96
1,Alabama,37,North Carolina,189,Watauga County,23,0,23
1,Alabama,37,North Carolina,191,Wayne County,502,45,457
1,Alabama,37,North Carolina,195,Wilson County,1,38,-37
1,Alabama,37,North Carolina,197,Yadkin County,10,0,10
1,Alabama,37,North Carolina,199,Yancey County,0,15,-15
1,Alabama,38,North Dakota,17,Cass County,0,71,-71
1,Alabama,38,North Dakota,25,Dunn County,15,12,3
1,Alabama,38,North Dakota,35,Grand Forks County,26,38,-12
1,Alabama,38,North Dakota,37,Grant County,30,0,30
1,Alabama,38,North Dakota,49,McHenry County,0,2,-2
1,Alabama,38,North Dakota,101,Ward County,204,0,204
1,Alabama,38,North Dakota,105,Williams County,31,0,31
1,Alabama,39,Ohio,3,Allen County,3,0,3
1,Alabama,39,Ohio,7,Ashtabula County,77,0,77
1,Alabama,39,Ohio,11,Auglaize County,15,0,15
1,Alabama,39,Ohio,13,Belmont County,31,0,31
1,Alabama,39,Ohio,17,Butler County,122,48,74
1,Alabama,39,Ohio,19,Carroll County,26,0,26
1,Alabama,39,Ohio,21,Champaign County,0,12,-12
1,Alabama,39,Ohio,23,Clark County,0,111,-111
1,Alabama,39,Ohio,25,Clermont County,10,0,10
1,Alabama,39,Ohio,27,Clinton County,58,0,58
1,Alabama,39,Ohio,29,Columbiana County,81,67,14
1,Alabama,39,Ohio,31,Coshocton County,0,35,-35
1,Alabama,39,Ohio,35,Cuyahoga County,143,217,-74
1,Alabama,39,Ohio,41,Delaware County,8,0,8
1,Alabama,39,Ohio,45,Fairfield County,4,5,-1
1,Alabama,39,Ohio,47,Fayette County,0,14,-14
1,Alabama,39,Ohio,49,Franklin County,340,340,0
1,Alabama,39,Ohio,53,Gallia County,0,9,-9
1,Alabama,39,Ohio,57,Greene County,111,59,52
1,Alabama,39,Ohio,59,Guernsey County,29,0,29
1,Alabama,39,Ohio,61,Hamilton County,434,194,240
1,Alabama,39,Ohio,63,Hancock County,13,82,-69
1,Alabama,39,Ohio,73,Hocking County,7,0,7
1,Alabama,39,Ohio,81,Jefferson County,12,34,-22
1,Alabama,39,Ohio,83,Knox County,0,22,-22
1,Alabama,39,Ohio,85,Lake County,0,50,-50
1,Alabama,39,Ohio,89,Licking County,15,0,15
1,Alabama,39,Ohio,91,Logan County,57,0,57
1,Alabama,39,Ohio,93,Lorain County,50,4,46
1,Alabama,39,Ohio,95,Lucas County,98,110,-12
1,Alabama,39,Ohio,99,Mahoning County,28,0,28
1,Alabama,39,Ohio,103,Medina County,30,93,-63
1,Alabama,39,Ohio,109,Miami County,199,0,199
1,Alabama,39,Ohio,113,Montgomery County,92,131,-39
1,Alabama,39,Ohio,115,Morgan County,3,0,3
1,Alabama,39,Ohio,123,Ottawa County,0,9,-9
1,Alabama,39,Ohio,139,Richland County,0,18,-18
1,Alabama,39,Ohio,147,Seneca County,0,2,-2
1,Alabama,39,Ohio,151,Stark County,99,116,-17
1,Alabama,39,Ohio,153,Summit County,96,115,-19
1,Alabama,39,Ohio,155,Trumbull County,88,10,78
1,Alabama,39,Ohio,157,Tuscarawas County,17,0,17
1,Alabama,39,Ohio,159,Union County,0,15,-15
1,Alabama,39,Ohio,165,Warren County,112,73,39
1,Alabama,39,Ohio,173,Wood County,23,14,9
1,Alabama,4,Arizona,1,Apache County,10,2,8
1,Alabama,4,Arizona,3,Cochise County,92,78,14
1,Alabama,4,Arizona,5,Coconino County,0,39,-39
1,Alabama,4,Arizona,9,Graham County,23,0,23
1,Alabama,4,Arizona,13,Maricopa County,622,371,251
1,Alabama,4,Arizona,15,Mohave County,19,23,-4
1,Alabama,4,Arizona,17,Navajo County,8,0,8
1,Alabama,4,Arizona,19,Pima County,300,444,-144
1,Alabama,4,Arizona,21,Pinal County,86,66,20
1,Alabama,4,Arizona,25,Yavapai County,2,22,-20
1,Alabama,4,Arizona,27,Yuma County,74,19,55
1,Alabama,40,Oklahoma,3,Alfalfa County,0,2,-2
1,Alabama,40,Oklahoma,13,Bryan County,0,13,-13
1,Alabama,40,Oklahoma,15,Caddo County,0,4,-4
1,Alabama,40,Oklahoma,19,Carter County,0,16,-16
1,Alabama,40,Oklahoma,21,Cherokee County,0,16,-16
1,Alabama,40,Oklahoma,25,Cimarron County,53,0,53
1,Alabama,40,Oklahoma,27,Cleveland County,63,10,53
1,Alabama,40,Oklahoma,31,Comanche County,206,229,-23
1,Alabama,40,Oklahoma,41,Delaware County,18,5,13
1,Alabama,40,Oklahoma,47,Garfield County,2,9,-7
1,Alabama,40,Oklahoma,49,Garvin County,7,0,7
1,Alabama,40,Oklahoma,51,Grady County,0,17,-17
1,Alabama,40,Oklahoma,65,Jackson County,124,0,124
1,Alabama,40,Oklahoma,69,Johnston County,0,9,-9
1,Alabama,40,Oklahoma,91,McIntosh County,11,0,11
1,Alabama,40,Oklahoma,107,Okfuskee County,0,4,-4
1,Alabama,40,Oklahoma,109,Oklahoma County,76,236,-160
1,Alabama,40,Oklahoma,111,Okmulgee County,0,6,-6
1,Alabama,40,Oklahoma,115,Ottawa County,0,9,-9
1,Alabama,40,Oklahoma,119,Payne County,23,54,-31
1,Alabama,40,Oklahoma,121,Pittsburg County,6,21,-15
1,Alabama,40,Oklahoma,123,Pontotoc County,3,0,3
1,Alabama,40,Oklahoma,131,Rogers County,0,26,-26
1,Alabama,40,Oklahoma,135,Sequoyah County,17,13,4
1,Alabama,40,Oklahoma,137,Stephens County,12,0,12
1,Alabama,40,Oklahoma,143,Tulsa County,301,153,148
1,Alabama,40,Oklahoma,145,Wagoner County,0,11,-11
1,Alabama,40,Oklahoma,147,Washington County,0,8,-8
1,Alabama,41,Oregon,3,Benton County,12,4,8
1,Alabama,41,Oregon,5,Clackamas County,28,0,28
1,Alabama,41,Oregon,7,Clatsop County,0,1,-1
1,Alabama,41,Oregon,19,Douglas County,9,6,3
1,Alabama,41,Oregon,29,Jackson County,0,18,-18
1,Alabama,41,Oregon,33,Josephine County,0,106,-106
1,Alabama,41,Oregon,39,Lane County,71,0,71
1,Alabama,41,Oregon,47,Marion County,19,87,-68
1,Alabama,41,Oregon,51,Multnomah County,128,10,118
1,Alabama,41,Oregon,57,Tillamook County,0,1,-1
1,Alabama,41,Oregon,59,Umatilla County,12,1,11
1,Alabama,41,Oregon,67,Washington County,168,63,105
1,Alabama,42,Pennsylvania,1,Adams County,15,0,15
1,Alabama,42,Pennsylvania,3,Allegheny County,431,234,197
1,Alabama,42,Pennsylvania,5,Armstrong County,0,5,-5
1,Alabama,42,Pennsylvania,7,Beaver County,35,0,35
1,Alabama,42,Pennsylvania,11,Berks County,34,26,8
1,Alabama,42,Pennsylvania,13,Blair County,8,0,8
1,Alabama,42,Pennsylvania,17,Bucks County,96,0,96
1,Alabama,42,Pennsylvania,19,Butler County,2,0,2
1,Alabama,42,Pennsylvania,21,Cambria County,0,19,-19
1,Alabama,42,Pennsylvania,27,Centre County,34,0,34
1,Alabama,42,Pennsylvania,29,Chester County,181,17,164
1,Alabama,42,Pennsylvania,37,Columbia County,0,4,-4
1,Alabama,42,Pennsylvania,41,Cumberland County,37,31,6
1,Alabama,42,Pennsylvania,43,Dauphin County,20,36,-16
1,Alabama,42,Pennsylvania,45,Delaware County,19,69,-50
1,Alabama,42,Pennsylvania,49,Erie County,15,14,1
1,Alabama,42,Pennsylvania,51,Fayette County,0,6,-6
1,Alabama,42,Pennsylvania,55,Franklin County,0,81,-81
1,Alabama,42,Pennsylvania,61,Huntingdon County,0,1,-1
1,Alabama,42,Pennsylvania,69,Lackawanna County,0,28,-28
1,Alabama,42,Pennsylvania,71,Lancaster County,53,71,-18
1,Alabama,42,Pennsylvania,73,Lawrence County,6,11,-5
1,Alabama,42,Pennsylvania,75,Lebanon County,3,0,3
1,Alabama,42,Pennsylvania,77,Lehigh County,26,29,-3
1,Alabama,42,Pennsylvania,79,Luzerne County,0,8,-8
1,Alabama,42,Pennsylvania,83,McKean County,7,0,7
1,Alabama,42,Pennsylvania,85,Mercer County,23,11,12
1,Alabama,42,Pennsylvania,87,Mifflin County,0,176,-176
1,Alabama,42,Pennsylvania,89,Monroe County,39,0,39
1,Alabama,42,Pennsylvania,91,Montgomery County,52,45,7
1,Alabama,42,Pennsylvania,95,Northampton County,27,0,27
1,Alabama,42,Pennsylvania,101,Philadelphia County,190,188,2
1,Alabama,42,Pennsylvania,107,Schuylkill County,13,31,-18
1,Alabama,42,Pennsylvania,111,Somerset County,22,0,22
1,Alabama,42,Pennsylvania,113,Sullivan County,3,0,3
1,Alabama,42,Pennsylvania,117,Tioga County,0,112,-112
1,Alabama,42,Pennsylvania,119,Union County,0,9,-9
1,Alabama,42,Pennsylvania,121,Venango County,0,45,-45
1,Alabama,42,Pennsylvania,123,Warren County,0,3,-3
1,Alabama,42,Pennsylvania,125,Washington County,19,10,9
1,Alabama,42,Pennsylvania,129,Westmoreland County,15,0,15
1,Alabama,42,Pennsylvania,133,York County,15,112,-97
1,Alabama,44,Rhode Island,3,Kent County,4,10,-6
1,Alabama,44,Rhode Island,5,Newport County,219,33,186
1,Alabama,44,Rhode Island,7,Providence County,4,96,-92
1,Alabama,44,Rhode Island,9,Washington County,6,52,-46
1,Alabama,45,South Carolina,3,Aiken County,108,24,84
1,Alabama,45,South Carolina,7,Anderson County,12,75,-63
1,Alabama,45,South Carolina,11,Barnwell County,70,0,70
1,Alabama,45,South Carolina,13,Beaufort County,35,124,-89
1,Alabama,45,South Carolina,15,Berkeley County,72,79,-7
1,Alabama,45,South Carolina,19,Charleston County,124,213,-89
1,Alabama,45,South Carolina,33,Dillon County,42,3,39
1,Alabama,45,South Carolina,35,Dorchester County,108,227,-119
1,Alabama,45,South Carolina,37,Edgefield County,33,10,23
1,Alabama,45,South Carolina,41,Florence County,6,107,-101
1,Alabama,45,South Carolina,43,Georgetown County,53,0,53
1,Alabama,45,South Carolina,45,Greenville County,266,389,-123
1,Alabama,45,South Carolina,47,Greenwood County,54,39,15
1,Alabama,45,South Carolina,49,Hampton County,10,0,10
1,Alabama,45,South Carolina,51,Horry County,91,85,6
1,Alabama,45,South Carolina,63,Lexington County,196,84,112
1,Alabama,45,South Carolina,69,Marlboro County,20,0,20
1,Alabama,45,South Carolina,71,Newberry County,0,4,-4
1,Alabama,45,South Carolina,73,Oconee County,61,17,44
1,Alabama,45,South Carolina,75,Orangeburg County,0,18,-18
1,Alabama,45,South Carolina,77,Pickens County,41,38,3
1,Alabama,45,South Carolina,79,Richland County,213,553,-340
1,Alabama,45,South Carolina,83,Spartanburg County,232,79,153
1,Alabama,45,South Carolina,85,Sumter County,208,135,73
1,Alabama,45,South Carolina,91,York County,16,105,-89
1,Alabama,46,South Dakota,11,Brookings County,22,0,22
1,Alabama,46,South Dakota,37,Day County,0,8,-8
1,Alabama,46,South Dakota,65,Hughes County,0,12,-12
1,Alabama,46,South Dakota,83,Lincoln County,4,0,4
1,Alabama,46,South Dakota,85,Lyman County,0,17,-17
1,Alabama,46,South Dakota,93,Meade County,20,4,16
1,Alabama,46,South Dakota,103,Pennington County,49,0,49
1,Alabama,47,Tennessee,1,Anderson County,74,41,33
1,Alabama,47,Tennessee,3,Bedford County,137,40,97
1,Alabama,47,Tennessee,5,Benton County,14,0,14
1,Alabama,47,Tennessee,7,Bledsoe County,0,7,-7
1,Alabama,47,Tennessee,9,Blount County,79,194,-115
1,Alabama,47,Tennessee,11,Bradley County,295,146,149
1,Alabama,47,Tennessee,13,Campbell County,86,0,86
1,Alabama,47,Tennessee,17,Carroll County,0,12,-12
1,Alabama,47,Tennessee,21,Cheatham County,24,17,7
1,Alabama,47,Tennessee,23,Chester County,8,21,-13
1,Alabama,47,Tennessee,29,Cocke County,0,24,-24
1,Alabama,47,Tennessee,31,Coffee County,88,261,-173
1,Alabama,47,Tennessee,35,Cumberland County,0,60,-60
1,Alabama,47,Tennessee,37,Davidson County,1035,1197,-162
1,Alabama,47,Tennessee,39,Decatur County,0,4,-4
1,Alabama,47,Tennessee,41,DeKalb County,27,3,24
1,Alabama,47,Tennessee,43,Dickson County,9,0,9
1,Alabama,47,Tennessee,45,Dyer County,46,32,14
1,Alabama,47,Tennessee,47,Fayette County,18,0,18
1,Alabama,47,Tennessee,49,Fentress County,0,11,-11
1,Alabama,47,Tennessee,51,Franklin County,65,148,-83
1,Alabama,47,Tennessee,53,Gibson County,28,53,-25
1,Alabama,47,Tennessee,55,Giles County,159,238,-79
1,Alabama,47,Tennessee,57,Grainger County,0,1,-1
1,Alabama,47,Tennessee,59,Greene County,94,16,78
1,Alabama,47,Tennessee,61,Grundy County,1,6,-5
1,Alabama,47,Tennessee,65,Hamilton County,827,713,114
1,Alabama,47,Tennessee,71,Hardin County,172,10,162
1,Alabama,47,Tennessee,73,Hawkins County,5,0,5
1,Alabama,47,Tennessee,75,Haywood County,12,7,5
1,Alabama,47,Tennessee,79,Henry County,2,7,-5
1,Alabama,47,Tennessee,81,Hickman County,12,0,12
1,Alabama,47,Tennessee,83,Houston County,0,7,-7
1,Alabama,47,Tennessee,87,Jackson County,4,6,-2
1,Alabama,47,Tennessee,89,Jefferson County,2,16,-14
1,Alabama,47,Tennessee,91,Johnson County,11,0,11
1,Alabama,47,Tennessee,93,Knox County,229,466,-237
1,Alabama,47,Tennessee,99,Lawrence County,284,233,51
1,Alabama,47,Tennessee,101,Lewis County,2,0,2
1,Alabama,47,Tennessee,103,Lincoln County,429,688,-259
1,Alabama,47,Tennessee,105,Loudon County,0,89,-89
1,Alabama,47,Tennessee,107,McMinn County,0,119,-119
1,Alabama,47,Tennessee,109,McNairy County,106,18,88
1,Alabama,47,Tennessee,111,Macon County,1,0,1
1,Alabama,47,Tennessee,113,Madison County,136,84,52
1,Alabama,47,Tennessee,115,Marion County,190,23,167
1,Alabama,47,Tennessee,117,Marshall County,36,74,-38
1,Alabama,47,Tennessee,119,Maury County,0,172,-172
1,Alabama,47,Tennessee,123,Monroe County,14,0,14
1,Alabama,47,Tennessee,125,Montgomery County,1011,490,521
1,Alabama,47,Tennessee,129,Morgan County,7,0,7
1,Alabama,47,Tennessee,131,Obion County,0,6,-6
1,Alabama,47,Tennessee,141,Putnam County,109,77,32
1,Alabama,47,Tennessee,143,Rhea County,44,6,38
1,Alabama,47,Tennessee,145,Roane County,0,42,-42
1,Alabama,47,Tennessee,147,Robertson County,17,54,-37
1,Alabama,47,Tennessee,149,Rutherford County,142,430,-288
1,Alabama,47,Tennessee,151,Scott County,56,0,56
1,Alabama,47,Tennessee,153,Sequatchie County,29,55,-26
1,Alabama,47,Tennessee,155,Sevier County,33,86,-53
1,Alabama,47,Tennessee,157,Shelby County,1031,788,243
1,Alabama,47,Tennessee,159,Smith County,10,0,10
1,Alabama,47,Tennessee,161,Stewart County,25,19,6
1,Alabama,47,Tennessee,163,Sullivan County,110,89,21
1,Alabama,47,Tennessee,165,Sumner County,89,235,-146
1,Alabama,47,Tennessee,167,Tipton County,22,53,-31
1,Alabama,47,Tennessee,169,Trousdale County,0,11,-11
1,Alabama,47,Tennessee,173,Union County,0,2,-2
1,Alabama,47,Tennessee,175,Van Buren County,0,9,-9
1,Alabama,47,Tennessee,177,Warren County,0,24,-24
1,Alabama,47,Tennessee,179,Washington County,88,2,86
1,Alabama,47,Tennessee,181,Wayne County,103,4,99
1,Alabama,47,Tennessee,183,Weakley County,30,0,30
1,Alabama,47,Tennessee,187,Williamson County,433,857,-424
1,Alabama,47,Tennessee,189,Wilson County,17,94,-77
1,Alabama,48,Texas,1,Anderson County,0,11,-11
1,Alabama,48,Texas,5,Angelina County,62,0,62
1,Alabama,48,Texas,13,Atascosa County,56,0,56
1,Alabama,48,Texas,21,Bastrop County,23,0,23
1,Alabama,48,Texas,25,Bee County,0,4,-4
1,Alabama,48,Texas,27,Bell County,208,336,-128
1,Alabama,48,Texas,29,Bexar County,696,546,150
1,Alabama,48,Texas,31,Blanco County,0,2,-2
1,Alabama,48,Texas,35,Bosque County,0,11,-11
1,Alabama,48,Texas,37,Bowie County,16,0,16
1,Alabama,48,Texas,39,Brazoria County,68,276,-208
1,Alabama,48,Texas,41,Brazos County,139,78,61
1,Alabama,48,Texas,55,Caldwell County,0,21,-21
1,Alabama,48,Texas,71,Chambers County,0,63,-63
1,Alabama,48,Texas,73,Cherokee County,0,15,-15
1,Alabama,48,Texas,85,Collin County,382,307,75
1,Alabama,48,Texas,91,Comal County,15,12,3
1,Alabama,48,Texas,93,Comanche County,0,1,-1
1,Alabama,48,Texas,99,Coryell County,50,168,-118
1,Alabama,48,Texas,105,Crockett County,0,2,-2
1,Alabama,48,Texas,113,Dallas County,428,806,-378
1,Alabama,48,Texas,121,Denton County,109,224,-115
1,Alabama,48,Texas,135,Ector County,10,0,10
1,Alabama,48,Texas,139,Ellis County,43,110,-67
1,Alabama,48,Texas,141,El Paso County,146,295,-149
1,Alabama,48,Texas,143,Erath County,1,0,1
1,Alabama,48,Texas,157,Fort Bend County,184,288,-104
1,Alabama,48,Texas,167,Galveston County,51,29,22
1,Alabama,48,Texas,179,Gray County,0,3,-3
1,Alabama,48,Texas,181,Grayson County,7,0,7
1,Alabama,48,Texas,183,Gregg County,8,18,-10
1,Alabama,48,Texas,187,Guadalupe County,151,67,84
1,Alabama,48,Texas,199,Hardin County,64,0,64
1,Alabama,48,Texas,201,Harris County,1382,1442,-60
1,Alabama,48,Texas,209,Hays County,17,159,-142
1,Alabama,48,Texas,213,Henderson County,0,4,-4
1,Alabama,48,Texas,215,Hidalgo County,48,75,-27
1,Alabama,48,Texas,217,Hill County,0,1,-1
1,Alabama,48,Texas,219,Hockley County,0,10,-10
1,Alabama,48,Texas,221,Hood County,0,35,-35
1,Alabama,48,Texas,225,Houston County,0,2,-2
1,Alabama,48,Texas,231,Hunt County,24,28,-4
1,Alabama,48,Texas,233,Hutchinson County,15,0,15
1,Alabama,48,Texas,245,Jefferson County,266,30,236
1,Alabama,48,Texas,251,Johnson County,0,24,-24
1,Alabama,48,Texas,253,Jones County,7,0,7
1,Alabama,48,Texas,255,Karnes County,0,16,-16
1,Alabama,48,Texas,257,Kaufman County,0,44,-44
1,Alabama,48,Texas,271,Kinney County,14,0,14
1,Alabama,48,Texas,275,Knox County,0,6,-6
1,Alabama,48,Texas,291,Liberty County,0,11,-11
1,Alabama,48,Texas,293,Limestone County,3,0,3
1,Alabama,48,Texas,297,Live Oak County,10,0,10
1,Alabama,48,Texas,303,Lubbock County,50,139,-89
1,Alabama,48,Texas,309,McLennan County,96,117,-21
1,Alabama,48,Texas,313,Madison County,0,6,-6
1,Alabama,48,Texas,315,Marion County,0,43,-43
1,Alabama,48,Texas,321,Matagorda County,0,28,-28
1,Alabama,48,Texas,325,Medina County,81,27,54
1,Alabama,48,Texas,329,Midland County,158,5,153
1,Alabama,48,Texas,331,Milam County,0,12,-12
1,Alabama,48,Texas,339,Montgomery County,237,153,84
1,Alabama,48,Texas,347,Nacogdoches County,54,24,30
1,Alabama,48,Texas,355,Nueces County,243,50,193
1,Alabama,48,Texas,361,Orange County,80,12,68
1,Alabama,48,Texas,367,Parker County,0,46,-46
1,Alabama,48,Texas,375,Potter County,10,43,-33
1,Alabama,48,Texas,377,Presidio County,0,16,-16
1,Alabama,48,Texas,381,Randall County,0,27,-27
1,Alabama,48,Texas,395,Robertson County,0,74,-74
1,Alabama,48,Texas,397,Rockwall County,0,6,-6
1,Alabama,48,Texas,403,Sabine County,6,0,6
1,Alabama,48,Texas,407,San Jacinto County,0,8,-8
1,Alabama,48,Texas,423,Smith County,9,19,-10
1,Alabama,48,Texas,439,Tarrant County,414,525,-111
1,Alabama,48,Texas,441,Taylor County,62,135,-73
1,Alabama,48,Texas,451,Tom Green County,0,58,-58
1,Alabama,48,Texas,453,Travis County,202,154,48
1,Alabama,48,Texas,455,Trinity County,5,0,5
1,Alabama,48,Texas,465,Val Verde County,11,0,11
1,Alabama,48,Texas,477,Washington County,0,19,-19
1,Alabama,48,Texas,479,Webb County,26,0,26
1,Alabama,48,Texas,485,Wichita County,88,236,-148
1,Alabama,48,Texas,491,Williamson County,147,264,-117
1,Alabama,48,Texas,499,Wood County,5,0,5
1,Alabama,48,Texas,503,Young County,0,13,-13
1,Alabama,49,Utah,5,Cache County,9,0,9
1,Alabama,49,Utah,11,Davis County,214,26,188
1,Alabama,49,Utah,29,Morgan County,10,0,10
1,Alabama,49,Utah,35,Salt Lake County,107,178,-71
1,Alabama,49,Utah,37,San Juan County,0,5,-5
1,Alabama,49,Utah,39,Sanpete County,0,11,-11
1,Alabama,49,Utah,43,Summit County,43,0,43
1,Alabama,49,Utah,49,Utah County,345,267,78
1,Alabama,49,Utah,51,Wasatch County,12,0,12
1,Alabama,49,Utah,53,Washington County,5,0,5
1,Alabama,49,Utah,57,Weber County,68,0,68
1,Alabama,5,Arkansas,7,Benton County,121,116,5
1,Alabama,5,Arkansas,9,Boone County,15,0,15
1,Alabama,5,Arkansas,11,Bradley County,35,0,35
1,Alabama,5,Arkansas,19,Clark County,58,0,58
1,Alabama,5,Arkansas,23,Cleburne County,0,25,-25
1,Alabama,5,Arkansas,27,Columbia County,0,7,-7
1,Alabama,5,Arkansas,31,Craighead County,145,43,102
1,Alabama,5,Arkansas,35,Crittenden County,0,1,-1
1,Alabama,5,Arkansas,45,Faulkner County,25,17,8
1,Alabama,5,Arkansas,51,Garland County,40,0,40
1,Alabama,5,Arkansas,55,Greene County,0,3,-3
1,Alabama,5,Arkansas,63,Independence County,13,0,13
1,Alabama,5,Arkansas,65,Izard County,0,20,-20
1,Alabama,5,Arkansas,69,Jefferson County,74,38,36
1,Alabama,5,Arkansas,75,Lawrence County,0,2,-2
1,Alabama,5,Arkansas,77,Lee County,0,2,-2
1,Alabama,5,Arkansas,79,Lincoln County,0,6,-6
1,Alabama,5,Arkansas,85,Lonoke County,0,150,-150
1,Alabama,5,Arkansas,87,Madison County,11,0,11
1,Alabama,5,Arkansas,91,Miller County,0,69,-69
1,Alabama,5,Arkansas,93,Mississippi County,7,0,7
1,Alabama,5,Arkansas,99,Nevada County,0,101,-101
1,Alabama,5,Arkansas,111,Poinsett County,0,9,-9
1,Alabama,5,Arkansas,115,Pope County,5,0,5
1,Alabama,5,Arkansas,119,Pulaski County,268,205,63
1,Alabama,5,Arkansas,123,St. Francis County,10,24,-14
1,Alabama,5,Arkansas,125,Saline County,134,14,120
1,Alabama,5,Arkansas,131,Sebastian County,0,45,-45
1,Alabama,5,Arkansas,139,Union County,29,0,29
1,Alabama,5,Arkansas,143,Washington County,73,92,-19
1,Alabama,5,Arkansas,145,White County,10,123,-113
1,Alabama,50,Vermont,1,Addison County,2,39,-37
1,Alabama,50,Vermont,9,Essex County,0,4,-4
1,Alabama,50,Vermont,11,Franklin County,68,0,68
1,Alabama,51,Virginia,1,Accomack County,80,0,80
1,Alabama,51,Virginia,3,Albemarle County,15,35,-20
1,Alabama,51,Virginia,9,Amherst County,0,4,-4
1,Alabama,51,Virginia,11,Appomattox County,0,9,-9
1,Alabama,51,Virginia,13,Arlington County,65,110,-45
1,Alabama,51,Virginia,15,Augusta County,3,28,-25
1,Alabama,51,Virginia,23,Botetourt County,43,0,43
1,Alabama,51,Virginia,25,Brunswick County,0,5,-5
1,Alabama,51,Virginia,31,Campbell County,23,0,23
1,Alabama,51,Virginia,35,Carroll County,73,0,73
1,Alabama,51,Virginia,41,Chesterfield County,76,137,-61
1,Alabama,51,Virginia,43,Clarke County,34,0,34
1,Alabama,51,Virginia,59,Fairfax County,360,573,-213
1,Alabama,51,Virginia,61,Fauquier County,0,27,-27
1,Alabama,51,Virginia,69,Frederick County,104,0,104
1,Alabama,51,Virginia,73,Gloucester County,0,107,-107
1,Alabama,51,Virginia,79,Greene County,0,19,-19
1,Alabama,51,Virginia,85,Hanover County,7,63,-56
1,Alabama,51,Virginia,87,Henrico County,93,12,81
1,Alabama,51,Virginia,95,James City County,102,0,102
1,Alabama,51,Virginia,99,King George County,83,0,83
1,Alabama,51,Virginia,105,Lee County,12,21,-9
1,Alabama,51,Virginia,107,Loudoun County,111,45,66
1,Alabama,51,Virginia,109,Louisa County,0,7,-7
1,Alabama,51,Virginia,119,Middlesex County,15,0,15
1,Alabama,51,Virginia,121,Montgomery County,183,0,183
1,Alabama,51,Virginia,125,Nelson County,0,12,-12
1,Alabama,51,Virginia,137,Orange County,0,24,-24
1,Alabama,51,Virginia,147,Prince Edward County,18,2,16
1,Alabama,51,Virginia,149,Prince George County,22,0,22
1,Alabama,51,Virginia,153,Prince William County,295,341,-46
1,Alabama,51,Virginia,165,Rockingham County,21,0,21
1,Alabama,51,Virginia,171,Shenandoah County,0,23,-23
1,Alabama,51,Virginia,177,Spotsylvania County,28,50,-22
1,Alabama,51,Virginia,179,Stafford County,109,23,86
1,Alabama,51,Virginia,185,Tazewell County,102,18,84
1,Alabama,51,Virginia,187,Warren County,0,10,-10
1,Alabama,51,Virginia,199,York County,273,262,11
1,Alabama,51,Virginia,510,Alexandria city,78,103,-25
1,Alabama,51,Virginia,520,Bristol city,0,15,-15
1,Alabama,51,Virginia,540,Charlottesville city,27,45,-18
1,Alabama,51,Virginia,550,Chesapeake city,345,60,285
1,Alabama,51,Virginia,570,Colonial Heights city,99,0,99
1,Alabama,51,Virginia,590,Danville city,13,62,-49
1,Alabama,51,Virginia,610,Falls Church city,61,0,61
1,Alabama,51,Virginia,630,Fredericksburg city,0,13,-13
1,Alabama,51,Virginia,650,Hampton city,24,178,-154
1,Alabama,51,Virginia,678,Lexington city,0,1,-1
1,Alabama,51,Virginia,680,Lynchburg city,164,19,145
1,Alabama,51,Virginia,683,Manassas city,38,0,38
1,Alabama,51,Virginia,685,Manassas Park city,56,0,56
1,Alabama,51,Virginia,700,Newport News city,26,138,-112
1,Alabama,51,Virginia,710,Norfolk city,15,194,-179
1,Alabama,51,Virginia,720,Norton city,0,21,-21
1,Alabama,51,Virginia,730,Petersburg city,0,15,-15
1,Alabama,51,Virginia,740,Portsmouth city,0,41,-41
1,Alabama,51,Virginia,760,Richmond city,53,14,39
1,Alabama,51,Virginia,770,Roanoke city,0,18,-18
1,Alabama,51,Virginia,775,Salem city,28,0,28
1,Alabama,51,Virginia,800,Suffolk city,21,0,21
1,Alabama,51,Virginia,810,Virginia Beach city,82,146,-64
1,Alabama,53,Washington,5,Benton County,10,36,-26
1,Alabama,53,Washington,9,Clallam County,11,0,11
1,Alabama,53,Washington,11,Clark County,0,74,-74
1,Alabama,53,Washington,17,Douglas County,0,25,-25
1,Alabama,53,Washington,27,Grays Harbor County,0,5,-5
1,Alabama,53,Washington,33,King County,255,230,25
1,Alabama,53,Washington,35,Kitsap County,43,24,19
1,Alabama,53,Washington,37,Kittitas County,0,13,-13
1,Alabama,53,Washington,39,Klickitat County,21,0,21
1,Alabama,53,Washington,41,Lewis County,0,30,-30
1,Alabama,53,Washington,53,Pierce County,238,301,-63
1,Alabama,53,Washington,55,San Juan County,0,2,-2
1,Alabama,53,Washington,57,Skagit County,0,23,-23
1,Alabama,53,Washington,61,Snohomish County,45,44,1
1,Alabama,53,Washington,63,Spokane County,0,120,-120
1,Alabama,53,Washington,67,Thurston County,35,141,-106
1,Alabama,53,Washington,71,Walla Walla County,0,9,-9
1,Alabama,53,Washington,73,Whatcom County,12,0,12
1,Alabama,53,Washington,75,Whitman County,39,0,39
1,Alabama,53,Washington,77,Yakima County,58,33,25
1,Alabama,54,West Virginia,1,Barbour County,0,10,-10
1,Alabama,54,West Virginia,3,Berkeley County,199,0,199
1,Alabama,54,West Virginia,11,Cabell County,18,8,10
1,Alabama,54,West Virginia,15,Clay County,60,0,60
1,Alabama,54,West Virginia,27,Hampshire County,6,0,6
1,Alabama,54,West Virginia,29,Hancock County,10,0,10
1,Alabama,54,West Virginia,33,Harrison County,19,22,-3
1,Alabama,54,West Virginia,35,Jackson County,4,0,4
1,Alabama,54,West Virginia,37,Jefferson County,0,21,-21
1,Alabama,54,West Virginia,39,Kanawha County,126,21,105
1,Alabama,54,West Virginia,41,Lewis County,2,4,-2
1,Alabama,54,West Virginia,45,Logan County,0,10,-10
1,Alabama,54,West Virginia,47,McDowell County,0,8,-8
1,Alabama,54,West Virginia,55,Mercer County,0,51,-51
1,Alabama,54,West Virginia,57,Mineral County,3,0,3
1,Alabama,54,West Virginia,61,Monongalia County,15,9,6
1,Alabama,54,West Virginia,69,Ohio County,0,6,-6
1,Alabama,54,West Virginia,71,Pendleton County,6,11,-5
1,Alabama,54,West Virginia,77,Preston County,12,9,3
1,Alabama,54,West Virginia,79,Putnam County,32,0,32
1,Alabama,54,West Virginia,89,Summers County,0,18,-18
1,Alabama,54,West Virginia,93,Tucker County,0,16,-16
1,Alabama,54,West Virginia,95,Tyler County,0,28,-28
1,Alabama,54,West Virginia,97,Upshur County,0,8,-8
1,Alabama,54,West Virginia,107,Wood County,73,8,65
1,Alabama,55,Wisconsin,7,Bayfield County,0,4,-4
1,Alabama,55,Wisconsin,9,Brown County,0,53,-53
1,Alabama,55,Wisconsin,13,Burnett County,7,0,7
1,Alabama,55,Wisconsin,15,Calumet County,0,18,-18
1,Alabama,55,Wisconsin,21,Columbia County,6,0,6
1,Alabama,55,Wisconsin,25,Dane County,68,93,-25
1,Alabama,55,Wisconsin,27,Dodge County,0,8,-8
1,Alabama,55,Wisconsin,29,Door County,0,3,-3
1,Alabama,55,Wisconsin,33,Dunn County,10,0,10
1,Alabama,55,Wisconsin,41,Forest County,0,2,-2
1,Alabama,55,Wisconsin,57,Juneau County,0,1,-1
1,Alabama,55,Wisconsin,59,Kenosha County,135,32,103
1,Alabama,55,Wisconsin,63,La Crosse County,0,2,-2
1,Alabama,55,Wisconsin,71,Manitowoc County,0,8,-8
1,Alabama,55,Wisconsin,73,Marathon County,15,3,12
1,Alabama,55,Wisconsin,75,Marinette County,0,17,-17
1,Alabama,55,Wisconsin,79,Milwaukee County,79,142,-63
1,Alabama,55,Wisconsin,81,Monroe County,0,6,-6
1,Alabama,55,Wisconsin,87,Outagamie County,40,0,40
1,Alabama,55,Wisconsin,95,Polk County,0,25,-25
1,Alabama,55,Wisconsin,101,Racine County,27,0,27
1,Alabama,55,Wisconsin,105,Rock County,23,47,-24
1,Alabama,55,Wisconsin,115,Shawano County,0,10,-10
1,Alabama,55,Wisconsin,117,Sheboygan County,0,11,-11
1,Alabama,55,Wisconsin,123,Vernon County,0,20,-20
1,Alabama,55,Wisconsin,127,Walworth County,1,0,1
1,Alabama,55,Wisconsin,133,Waukesha County,93,33,60
1,Alabama,55,Wisconsin,135,Waupaca County,59,0,59
1,Alabama,56,Wyoming,1,Albany County,20,3,17
1,Alabama,56,Wyoming,5,Campbell County,0,2,-2
1,Alabama,56,Wyoming,9,Converse County,0,33,-33
1,Alabama,56,Wyoming,11,Crook County,15,0,15
1,Alabama,56,Wyoming,13,Fremont County,0,27,-27
1,Alabama,56,Wyoming,21,Laramie County,26,54,-28
1,Alabama,56,Wyoming,23,Lincoln County,0,13,-13
1,Alabama,56,Wyoming,25,Natrona County,0,28,-28
1,Alabama,56,Wyoming,29,Park County,61,0,61
1,Alabama,56,Wyoming,33,Sheridan County,32,0,32
1,Alabama,56,Wyoming,37,Sweetwater County,37,0,37
1,Alabama,56,Wyoming,39,Teton County,26,10,16
1,Alabama,56,Wyoming,41,Uinta County,20,0,20
1,Alabama,56,Wyoming,43,Washakie County,0,7,-7
1,Alabama,6,California,1,Alameda County,173,116,57
1,Alabama,6,California,7,Butte County,59,0,59
1,Alabama,6,California,13,Contra Costa County,2,116,-114
1,Alabama,6,California,15,Del Norte County,25,0,25
1,Alabama,6,California,17,El Dorado County,24,0,24
1,Alabama,6,California,19,Fresno County,201,84,117
1,Alabama,6,California,25,Imperial County,0,2,-2
1,Alabama,6,California,27,Inyo County,19,13,6
1,Alabama,6,California,29,Kern County,54,250,-196
1,Alabama,6,California,31,Kings County,157,33,124
1,Alabama,6,California,35,Lassen County,0,4,-4
1,Alabama,6,California,37,Los Angeles County,1002,567,435
1,Alabama,6,California,41,Marin County,26,43,-17
1,Alabama,6,California,47,Merced County,121,9,112
1,Alabama,6,California,49,Modoc County,0,17,-17
1,Alabama,6,California,53,Monterey County,38,63,-25
1,Alabama,6,California,57,Nevada County,41,3,38
1,Alabama,6,California,59,Orange County,321,521,-200
1,Alabama,6,California,61,Placer County,0,32,-32
1,Alabama,6,California,63,Plumas County,0,29,-29
1,Alabama,6,California,65,Riverside County,304,327,-23
1,Alabama,6,California,67,Sacramento County,94,94,0
1,Alabama,6,California,71,San Bernardino County,343,193,150
1,Alabama,6,California,73,San Diego County,360,975,-615
1,Alabama,6,California,75,San Francisco County,116,73,43
1,Alabama,6,California,77,San Joaquin County,94,103,-9
1,Alabama,6,California,79,San Luis Obispo County,84,10,74
1,Alabama,6,California,81,San Mateo County,43,7,36
1,Alabama,6,California,83,Santa Barbara County,0,248,-248
1,Alabama,6,California,85,Santa Clara County,442,103,339
1,Alabama,6,California,95,Solano County,11,256,-245
1,Alabama,6,California,97,Sonoma County,8,33,-25
1,Alabama,6,California,99,Stanislaus County,0,569,-569
1,Alabama,6,California,107,Tulare County,31,29,2
1,Alabama,6,California,109,Tuolumne County,0,11,-11
1,Alabama,6,California,111,Ventura County,189,61,128
1,Alabama,6,California,113,Yolo County,0,43,-43
1,Alabama,6,California,115,Yuba County,0,39,-39
1,Alabama,72,Puerto Rico,3,Aguada Municipio,13,0,13
1,Alabama,72,Puerto Rico,5,Aguadilla Municipio,10,50,-40
1,Alabama,72,Puerto Rico,9,Aibonito Municipio,9,0,9
1,Alabama,72,Puerto Rico,29,Canóvanas Municipio,0,33,-33
1,Alabama,72,Puerto Rico,31,Carolina Municipio,0,13,-13
1,Alabama,72,Puerto Rico,35,Cayey Municipio,14,0,14
1,Alabama,72,Puerto Rico,41,Cidra Municipio,10,0,10
1,Alabama,72,Puerto Rico,43,Coamo Municipio,0,185,-185
1,Alabama,72,Puerto Rico,63,Gurabo Municipio,28,0,28
1,Alabama,72,Puerto Rico,69,Humacao Municipio,25,0,25
1,Alabama,72,Puerto Rico,87,Loíza Municipio,40,0,40
1,Alabama,72,Puerto Rico,103,Naguabo Municipio,10,0,10
1,Alabama,72,Puerto Rico,111,Peñuelas Municipio,0,23,-23
1,Alabama,72,Puerto Rico,113,Ponce Municipio,72,0,72
1,Alabama,72,Puerto Rico,127,San Juan Municipio,47,0,47
1,Alabama,72,Puerto Rico,131,San Sebastián Municipio,13,0,13
1,Alabama,72,Puerto Rico,145,Vega Baja Municipio,9,0,9
1,Alabama,72,Puerto Rico,149,Villalba Municipio,0,14,-14
1,Alabama,8,Colorado,1,Adams County,81,3,78
1,Alabama,8,Colorado,5,Arapahoe County,122,162,-40
1,Alabama,8,Colorado,13,Boulder County,67,138,-71
1,Alabama,8,Colorado,14,Broomfield County,46,0,46
1,Alabama,8,Colorado,29,Delta County,19,0,19
1,Alabama,8,Colorado,31,Denver County,55,99,-44
1,Alabama,8,Colorado,35,Douglas County,31,2,29
1,Alabama,8,Colorado,37,Eagle County,36,0,36
1,Alabama,8,Colorado,41,El Paso County,679,956,-277
1,Alabama,8,Colorado,43,Fremont County,0,1,-1
1,Alabama,8,Colorado,45,Garfield County,0,19,-19
1,Alabama,8,Colorado,51,Gunnison County,74,16,58
1,Alabama,8,Colorado,59,Jefferson County,106,187,-81
1,Alabama,8,Colorado,61,Kiowa County,0,2,-2
1,Alabama,8,Colorado,63,Kit Carson County,0,15,-15
1,Alabama,8,Colorado,67,La Plata County,4,27,-23
1,Alabama,8,Colorado,69,Larimer County,182,380,-198
1,Alabama,8,Colorado,77,Mesa County,29,3,26
1,Alabama,8,Colorado,85,Montrose County,0,27,-27
1,Alabama,8,Colorado,89,Otero County,0,91,-91
1,Alabama,8,Colorado,101,Pueblo County,55,76,-21
1,Alabama,8,Colorado,103,Rio Blanco County,3,6,-3
1,Alabama,8,Colorado,107,Routt County,0,23,-23
1,Alabama,8,Colorado,115,Sedgwick County,0,2,-2
1,Alabama,8,Colorado,117,Summit County,0,10,-10
1,Alabama,8,Colorado,121,Washington County,33,0,33
1,Alabama,8,Colorado,123,Weld County,39,96,-57
1,Alabama,9,Connecticut,1,Fairfield County,128,15,113
1,Alabama,9,Connecticut,3,Hartford County,361,89,272
1,Alabama,9,Connecticut,5,Litchfield County,0,76,-76
1,Alabama,9,Connecticut,9,New Haven County,123,122,1
1,Alabama,9,Connecticut,11,New London County,0,106,-106
1,Alabama,9,Connecticut,13,Tolland County,38,0,38
1,Alabama,AFR,Africa,,-,601,0,0
1,Alabama,ASI,Asia,,-,6236,0,0
1,Alabama,CAM,Central America,,-,1429,0,0
1,Alabama,CAR,Caribbean,,-,1214,0,0
1,Alabama,EUR,Europe,,-,2728,0,0
1,Alabama,ISL,U.S. Island Areas,,-,176,0,0
1,Alabama,NAM,Northern America,,-,424,0,0
1,Alabama,OCE,Oceania and At Sea,,-,288,0,0
1,Alabama,SAM,South America,,-,881,0,0
2,Alaska,1,Alabama,15,Calhoun County,0,72,-72
2,Alaska,1,Alabama,31,Coffee County,118,125,-7
2,Alaska,1,Alabama,45,Dale County,184,45,139
2,Alaska,1,Alabama,47,Dallas County,0,34,-34
2,Alaska,1,Alabama,55,Etowah County,17,25,-8
2,Alaska,1,Alabama,59,Franklin County,0,14,-14
2,Alaska,1,Alabama,69,Houston County,22,7,15
2,Alaska,1,Alabama,71,Jackson County,20,0,20
2,Alaska,1,Alabama,73,Jefferson County,24,15,9
2,Alaska,1,Alabama,81,Lee County,26,65,-39
2,Alaska,1,Alabama,85,Lowndes County,0,13,-13
2,Alaska,1,Alabama,89,Madison County,10,0,10
2,Alaska,1,Alabama,95,Marshall County,0,4,-4
2,Alaska,1,Alabama,97,Mobile County,167,66,101
2,Alaska,1,Alabama,99,Monroe County,0,25,-25
2,Alaska,1,Alabama,101,Montgomery County,0,21,-21
2,Alaska,1,Alabama,103,Morgan County,5,42,-37
2,Alaska,1,Alabama,113,Russell County,39,66,-27
2,Alaska,1,Alabama,125,Tuscaloosa County,0,133,-133
2,Alaska,10,Delaware,1,Kent County,35,46,-11
2,Alaska,10,Delaware,3,New Castle County,0,175,-175
2,Alaska,10,Delaware,5,Sussex County,0,11,-11
2,Alaska,11,District of Columbia,1,District of Columbia,0,182,-182
2,Alaska,12,Florida,1,Alachua County,0,11,-11
2,Alaska,12,Florida,3,Baker County,0,47,-47
2,Alaska,12,Florida,5,Bay County,35,225,-190
2,Alaska,12,Florida,9,Brevard County,0,198,-198
2,Alaska,12,Florida,11,Broward County,144,101,43
2,Alaska,12,Florida,17,Citrus County,97,40,57
2,Alaska,12,Florida,19,Clay County,41,78,-37
2,Alaska,12,Florida,21,Collier County,0,191,-191
2,Alaska,12,Florida,23,Columbia County,0,11,-11
2,Alaska,12,Florida,31,Duval County,8,498,-490
2,Alaska,12,Florida,33,Escambia County,26,94,-68
2,Alaska,12,Florida,35,Flagler County,0,52,-52
2,Alaska,12,Florida,39,Gadsden County,0,45,-45
2,Alaska,12,Florida,53,Hernando County,0,22,-22
2,Alaska,12,Florida,57,Hillsborough County,79,319,-240
2,Alaska,12,Florida,61,Indian River County,7,84,-77
2,Alaska,12,Florida,63,Jackson County,29,0,29
2,Alaska,12,Florida,69,Lake County,173,97,76
2,Alaska,12,Florida,71,Lee County,6,172,-166
2,Alaska,12,Florida,73,Leon County,39,23,16
2,Alaska,12,Florida,81,Manatee County,0,14,-14
2,Alaska,12,Florida,83,Marion County,10,0,10
2,Alaska,12,Florida,85,Martin County,0,69,-69
2,Alaska,12,Florida,86,Miami-Dade County,56,257,-201
2,Alaska,12,Florida,87,Monroe County,188,22,166
2,Alaska,12,Florida,89,Nassau County,42,0,42
2,Alaska,12,Florida,91,Okaloosa County,23,123,-100
2,Alaska,12,Florida,95,Orange County,192,252,-60
2,Alaska,12,Florida,97,Osceola County,6,0,6
2,Alaska,12,Florida,99,Palm Beach County,101,422,-321
2,Alaska,12,Florida,101,Pasco County,12,0,12
2,Alaska,12,Florida,103,Pinellas County,38,794,-756
2,Alaska,12,Florida,105,Polk County,92,0,92
2,Alaska,12,Florida,107,Putnam County,0,28,-28
2,Alaska,12,Florida,109,St. Johns County,30,96,-66
2,Alaska,12,Florida,111,St. Lucie County,0,41,-41
2,Alaska,12,Florida,113,Santa Rosa County,50,206,-156
2,Alaska,12,Florida,115,Sarasota County,0,5,-5
2,Alaska,12,Florida,117,Seminole County,0,9,-9
2,Alaska,12,Florida,127,Volusia County,37,67,-30
2,Alaska,13,Georgia,29,Bryan County,16,0,16
2,Alaska,13,Georgia,39,Camden County,7,48,-41
2,Alaska,13,Georgia,43,Candler County,0,26,-26
2,Alaska,13,Georgia,47,Catoosa County,0,10,-10
2,Alaska,13,Georgia,51,Chatham County,0,54,-54
2,Alaska,13,Georgia,53,Chattahoochee County,122,112,10
2,Alaska,13,Georgia,59,Clarke County,7,0,7
2,Alaska,13,Georgia,63,Clayton County,0,46,-46
2,Alaska,13,Georgia,67,Cobb County,0,16,-16
2,Alaska,13,Georgia,69,Coffee County,0,7,-7
2,Alaska,13,Georgia,73,Columbia County,38,134,-96
2,Alaska,13,Georgia,77,Coweta County,13,0,13
2,Alaska,13,Georgia,79,Crawford County,0,7,-7
2,Alaska,13,Georgia,85,Dawson County,0,11,-11
2,Alaska,13,Georgia,89,DeKalb County,0,207,-207
2,Alaska,13,Georgia,91,Dodge County,8,6,2
2,Alaska,13,Georgia,95,Dougherty County,23,0,23
2,Alaska,13,Georgia,113,Fayette County,0,22,-22
2,Alaska,13,Georgia,117,Forsyth County,0,34,-34
2,Alaska,13,Georgia,121,Fulton County,21,127,-106
2,Alaska,13,Georgia,127,Glynn County,0,5,-5
2,Alaska,13,Georgia,135,Gwinnett County,19,0,19
2,Alaska,13,Georgia,139,Hall County,10,0,10
2,Alaska,13,Georgia,151,Henry County,51,0,51
2,Alaska,13,Georgia,153,Houston County,18,102,-84
2,Alaska,13,Georgia,171,Lamar County,9,0,9
2,Alaska,13,Georgia,173,Lanier County,6,48,-42
2,Alaska,13,Georgia,179,Liberty County,54,35,19
2,Alaska,13,Georgia,183,Long County,20,15,5
2,Alaska,13,Georgia,185,Lowndes County,45,62,-17
2,Alaska,13,Georgia,207,Monroe County,0,272,-272
2,Alaska,13,Georgia,215,Muscogee County,417,221,196
2,Alaska,13,Georgia,221,Oglethorpe County,0,15,-15
2,Alaska,13,Georgia,223,Paulding County,10,37,-27
2,Alaska,13,Georgia,231,Pike County,0,11,-11
2,Alaska,13,Georgia,245,Richmond County,39,64,-25
2,Alaska,13,Georgia,251,Screven County,125,0,125
2,Alaska,13,Georgia,257,Stephens County,38,0,38
2,Alaska,13,Georgia,275,Thomas County,0,38,-38
2,Alaska,13,Georgia,277,Tift County,0,77,-77
2,Alaska,13,Georgia,279,Toombs County,0,45,-45
2,Alaska,13,Georgia,293,Upson County,0,67,-67
2,Alaska,13,Georgia,297,Walton County,10,0,10
2,Alaska,13,Georgia,313,Whitfield County,0,12,-12
2,Alaska,15,Hawaii,1,Hawaii County,111,105,6
2,Alaska,15,Hawaii,3,Honolulu County,440,575,-135
2,Alaska,15,Hawaii,5,Kalawao County,0,2,-2
2,Alaska,15,Hawaii,7,Kauai County,0,15,-15
2,Alaska,15,Hawaii,9,Maui County,20,27,-7
2,Alaska,16,Idaho,1,Ada County,151,375,-224
2,Alaska,16,Idaho,5,Bannock County,0,45,-45
2,Alaska,16,Idaho,9,Benewah County,7,21,-14
2,Alaska,16,Idaho,11,Bingham County,12,0,12
2,Alaska,16,Idaho,13,Blaine County,3,154,-151
2,Alaska,16,Idaho,17,Bonner County,71,16,55
2,Alaska,16,Idaho,19,Bonneville County,38,32,6
2,Alaska,16,Idaho,23,Butte County,0,9,-9
2,Alaska,16,Idaho,25,Camas County,0,37,-37
2,Alaska,16,Idaho,27,Canyon County,26,449,-423
2,Alaska,16,Idaho,31,Cassia County,8,0,8
2,Alaska,16,Idaho,35,Clearwater County,0,26,-26
2,Alaska,16,Idaho,37,Custer County,0,2,-2
2,Alaska,16,Idaho,39,Elmore County,15,124,-109
2,Alaska,16,Idaho,41,Franklin County,0,1,-1
2,Alaska,16,Idaho,45,Gem County,0,38,-38
2,Alaska,16,Idaho,49,Idaho County,77,31,46
2,Alaska,16,Idaho,53,Jerome County,10,0,10
2,Alaska,16,Idaho,55,Kootenai County,2,140,-138
2,Alaska,16,Idaho,57,Latah County,50,27,23
2,Alaska,16,Idaho,63,Lincoln County,0,45,-45
2,Alaska,16,Idaho,65,Madison County,6,167,-161
2,Alaska,16,Idaho,69,Nez Perce County,2,24,-22
2,Alaska,16,Idaho,79,Shoshone County,2,11,-9
2,Alaska,16,Idaho,85,Valley County,0,23,-23
2,Alaska,16,Idaho,87,Washington County,8,0,8
2,Alaska,17,Illinois,13,Calhoun County,0,2,-2
2,Alaska,17,Illinois,19,Champaign County,8,186,-178
2,Alaska,17,Illinois,27,Clinton County,10,0,10
2,Alaska,17,Illinois,31,Cook County,281,409,-128
2,Alaska,17,Illinois,37,DeKalb County,6,0,6
2,Alaska,17,Illinois,43,DuPage County,12,52,-40
2,Alaska,17,Illinois,67,Hancock County,29,0,29
2,Alaska,17,Illinois,77,Jackson County,0,12,-12
2,Alaska,17,Illinois,89,Kane County,33,18,15
2,Alaska,17,Illinois,93,Kendall County,113,216,-103
2,Alaska,17,Illinois,97,Lake County,0,121,-121
2,Alaska,17,Illinois,99,LaSalle County,79,22,57
2,Alaska,17,Illinois,105,Livingston County,0,7,-7
2,Alaska,17,Illinois,111,McHenry County,23,0,23
2,Alaska,17,Illinois,113,McLean County,16,0,16
2,Alaska,17,Illinois,115,Macon County,0,1,-1
2,Alaska,17,Illinois,137,Morgan County,2,0,2
2,Alaska,17,Illinois,143,Peoria County,0,124,-124
2,Alaska,17,Illinois,161,Rock Island County,79,0,79
2,Alaska,17,Illinois,163,St. Clair County,40,233,-193
2,Alaska,17,Illinois,165,Saline County,65,0,65
2,Alaska,17,Illinois,179,Tazewell County,11,0,11
2,Alaska,17,Illinois,195,Whiteside County,8,0,8
2,Alaska,17,Illinois,197,Will County,22,26,-4
2,Alaska,18,Indiana,1,Adams County,0,25,-25
2,Alaska,18,Indiana,3,Allen County,0,21,-21
2,Alaska,18,Indiana,17,Cass County,26,0,26
2,Alaska,18,Indiana,19,Clark County,13,0,13
2,Alaska,18,Indiana,37,Dubois County,0,7,-7
2,Alaska,18,Indiana,43,Floyd County,0,8,-8
2,Alaska,18,Indiana,45,Fountain County,0,16,-16
2,Alaska,18,Indiana,55,Greene County,0,64,-64
2,Alaska,18,Indiana,63,Hendricks County,19,0,19
2,Alaska,18,Indiana,77,Jefferson County,0,2,-2
2,Alaska,18,Indiana,81,Johnson County,5,0,5
2,Alaska,18,Indiana,95,Madison County,34,0,34
2,Alaska,18,Indiana,97,Marion County,44,82,-38
2,Alaska,18,Indiana,105,Monroe County,3,0,3
2,Alaska,18,Indiana,157,Tippecanoe County,4,14,-10
2,Alaska,18,Indiana,163,Vanderburgh County,0,66,-66
2,Alaska,18,Indiana,167,Vigo County,3,0,3
2,Alaska,18,Indiana,177,Wayne County,0,9,-9
2,Alaska,18,Indiana,179,Wells County,103,0,103
2,Alaska,19,Iowa,13,Black Hawk County,0,106,-106
2,Alaska,19,Iowa,15,Boone County,0,20,-20
2,Alaska,19,Iowa,19,Buchanan County,0,6,-6
2,Alaska,19,Iowa,27,Carroll County,0,28,-28
2,Alaska,19,Iowa,29,Cass County,0,59,-59
2,Alaska,19,Iowa,31,Cedar County,0,3,-3
2,Alaska,19,Iowa,35,Cherokee County,0,13,-13
2,Alaska,19,Iowa,41,Clay County,0,101,-101
2,Alaska,19,Iowa,49,Dallas County,0,42,-42
2,Alaska,19,Iowa,53,Decatur County,0,4,-4
2,Alaska,19,Iowa,57,Des Moines County,7,107,-100
2,Alaska,19,Iowa,93,Ida County,13,0,13
2,Alaska,19,Iowa,97,Jackson County,0,6,-6
2,Alaska,19,Iowa,103,Johnson County,90,3,87
2,Alaska,19,Iowa,105,Jones County,33,0,33
2,Alaska,19,Iowa,113,Linn County,3,5,-2
2,Alaska,19,Iowa,153,Polk County,0,111,-111
2,Alaska,19,Iowa,155,Pottawattamie County,0,53,-53
2,Alaska,19,Iowa,163,Scott County,9,172,-163
2,Alaska,19,Iowa,169,Story County,0,5,-5
2,Alaska,19,Iowa,181,Warren County,11,47,-36
2,Alaska,2,Alaska,13,Aleutians East Borough,613,131,482
2,Alaska,2,Alaska,16,Aleutians West Census Area,128,117,11
2,Alaska,2,Alaska,20,Anchorage Municipality,5769,5503,266
2,Alaska,2,Alaska,50,Bethel Census Area,654,502,152
2,Alaska,2,Alaska,60,Bristol Bay Borough,21,66,-45
2,Alaska,2,Alaska,68,Denali Borough,81,118,-37
2,Alaska,2,Alaska,70,Dillingham Census Area,160,174,-14
2,Alaska,2,Alaska,90,Fairbanks North Star Borough,2007,1862,145
2,Alaska,2,Alaska,100,Haines Borough,70,118,-48
2,Alaska,2,Alaska,105,Hoonah-Angoon Census Area,145,96,49
2,Alaska,2,Alaska,110,Juneau City and Borough,933,580,353
2,Alaska,2,Alaska,122,Kenai Peninsula Borough,1370,1740,-370
2,Alaska,2,Alaska,130,Ketchikan Gateway Borough,273,336,-63
2,Alaska,2,Alaska,150,Kodiak Island Borough,344,450,-106
2,Alaska,2,Alaska,158,Kusilvak Census Area,498,219,279
2,Alaska,2,Alaska,164,Lake and Peninsula Borough,82,54,28
2,Alaska,2,Alaska,170,Matanuska-Susitna Borough,2396,3992,-1596
2,Alaska,2,Alaska,180,Nome Census Area,550,309,241
2,Alaska,2,Alaska,185,North Slope Borough,229,428,-199
2,Alaska,2,Alaska,188,Northwest Arctic Borough,197,123,74
2,Alaska,2,Alaska,195,Petersburg Borough,48,75,-27
2,Alaska,2,Alaska,198,Prince of Wales-Hyder Census Area,323,121,202
2,Alaska,2,Alaska,220,Sitka City and Borough,124,471,-347
2,Alaska,2,Alaska,230,Skagway Municipality,37,62,-25
2,Alaska,2,Alaska,240,Southeast Fairbanks Census Area,287,432,-145
2,Alaska,2,Alaska,261,Valdez-Cordova Census Area,743,417,326
2,Alaska,2,Alaska,275,Wrangell City and Borough,70,46,24
2,Alaska,2,Alaska,282,Yakutat City and Borough,29,22,7
2,Alaska,2,Alaska,290,Yukon-Koyukuk Census Area,560,177,383
2,Alaska,20,Kansas,1,Allen County,0,23,-23
2,Alaska,20,Kansas,27,Clay County,0,4,-4
2,Alaska,20,Kansas,35,Cowley County,0,5,-5
2,Alaska,20,Kansas,41,Dickinson County,0,18,-18
2,Alaska,20,Kansas,45,Douglas County,11,20,-9
2,Alaska,20,Kansas,59,Franklin County,0,15,-15
2,Alaska,20,Kansas,61,Geary County,31,80,-49
2,Alaska,20,Kansas,87,Jefferson County,21,0,21
2,Alaska,20,Kansas,91,Johnson County,109,101,8
2,Alaska,20,Kansas,99,Labette County,0,13,-13
2,Alaska,20,Kansas,103,Leavenworth County,143,0,143
2,Alaska,20,Kansas,113,McPherson County,16,7,9
2,Alaska,20,Kansas,115,Marion County,0,3,-3
2,Alaska,20,Kansas,125,Montgomery County,0,6,-6
2,Alaska,20,Kansas,139,Osage County,14,8,6
2,Alaska,20,Kansas,145,Pawnee County,8,0,8
2,Alaska,20,Kansas,149,Pottawatomie County,0,177,-177
2,Alaska,20,Kansas,161,Riley County,88,49,39
2,Alaska,20,Kansas,173,Sedgwick County,95,0,95
2,Alaska,20,Kansas,175,Seward County,0,27,-27
2,Alaska,20,Kansas,177,Shawnee County,8,10,-2
2,Alaska,20,Kansas,209,Wyandotte County,157,29,128
2,Alaska,21,Kentucky,1,Adair County,0,9,-9
2,Alaska,21,Kentucky,15,Boone County,9,0,9
2,Alaska,21,Kentucky,17,Bourbon County,0,9,-9
2,Alaska,21,Kentucky,21,Boyle County,0,19,-19
2,Alaska,21,Kentucky,33,Caldwell County,20,0,20
2,Alaska,21,Kentucky,35,Calloway County,0,20,-20
2,Alaska,21,Kentucky,37,Campbell County,33,0,33
2,Alaska,21,Kentucky,47,Christian County,69,100,-31
2,Alaska,21,Kentucky,57,Cumberland County,0,91,-91
2,Alaska,21,Kentucky,67,Fayette County,46,89,-43
2,Alaska,21,Kentucky,69,Fleming County,0,6,-6
2,Alaska,21,Kentucky,73,Franklin County,0,28,-28
2,Alaska,21,Kentucky,75,Fulton County,0,1,-1
2,Alaska,21,Kentucky,93,Hardin County,147,43,104
2,Alaska,21,Kentucky,99,Hart County,0,38,-38
2,Alaska,21,Kentucky,109,Jackson County,0,10,-10
2,Alaska,21,Kentucky,111,Jefferson County,133,80,53
2,Alaska,21,Kentucky,115,Johnson County,0,19,-19
2,Alaska,21,Kentucky,117,Kenton County,0,18,-18
2,Alaska,21,Kentucky,125,Laurel County,41,0,41
2,Alaska,21,Kentucky,163,Meade County,13,0,13
2,Alaska,21,Kentucky,185,Oldham County,12,0,12
2,Alaska,21,Kentucky,199,Pulaski County,10,0,10
2,Alaska,21,Kentucky,221,Trigg County,20,0,20
2,Alaska,21,Kentucky,229,Washington County,0,7,-7
2,Alaska,22,Louisiana,1,Acadia Parish,5,0,5
2,Alaska,22,Louisiana,5,Ascension Parish,42,0,42
2,Alaska,22,Louisiana,7,Assumption Parish,0,47,-47
2,Alaska,22,Louisiana,11,Beauregard Parish,0,18,-18
2,Alaska,22,Louisiana,15,Bossier Parish,14,0,14
2,Alaska,22,Louisiana,17,Caddo Parish,11,0,11
2,Alaska,22,Louisiana,19,Calcasieu Parish,10,0,10
2,Alaska,22,Louisiana,21,Caldwell Parish,8,0,8
2,Alaska,22,Louisiana,27,Claiborne Parish,1,0,1
2,Alaska,22,Louisiana,33,East Baton Rouge Parish,0,16,-16
2,Alaska,22,Louisiana,41,Franklin Parish,10,0,10
2,Alaska,22,Louisiana,49,Jackson Parish,3,0,3
2,Alaska,22,Louisiana,51,Jefferson Parish,0,39,-39
2,Alaska,22,Louisiana,53,Jefferson Davis Parish,0,72,-72
2,Alaska,22,Louisiana,55,Lafayette Parish,6,103,-97
2,Alaska,22,Louisiana,59,LaSalle Parish,0,7,-7
2,Alaska,22,Louisiana,61,Lincoln Parish,0,3,-3
2,Alaska,22,Louisiana,63,Livingston Parish,18,0,18
2,Alaska,22,Louisiana,71,Orleans Parish,16,18,-2
2,Alaska,22,Louisiana,73,Ouachita Parish,15,0,15
2,Alaska,22,Louisiana,79,Rapides Parish,0,2,-2
2,Alaska,22,Louisiana,99,St. Martin Parish,4,0,4
2,Alaska,22,Louisiana,101,St. Mary Parish,0,29,-29
2,Alaska,22,Louisiana,103,St. Tammany Parish,10,78,-68
2,Alaska,22,Louisiana,105,Tangipahoa Parish,0,11,-11
2,Alaska,22,Louisiana,109,Terrebonne Parish,8,48,-40
2,Alaska,22,Louisiana,115,Vernon Parish,211,142,69
2,Alaska,22,Louisiana,127,Winn Parish,29,0,29
2,Alaska,23,Maine,1,Androscoggin County,14,8,6
2,Alaska,23,Maine,3,Aroostook County,10,0,10
2,Alaska,23,Maine,5,Cumberland County,44,6,38
2,Alaska,23,Maine,9,Hancock County,0,11,-11
2,Alaska,23,Maine,11,Kennebec County,4,19,-15
2,Alaska,23,Maine,15,Lincoln County,1,0,1
2,Alaska,23,Maine,17,Oxford County,0,2,-2
2,Alaska,23,Maine,19,Penobscot County,5,42,-37
2,Alaska,23,Maine,23,Sagadahoc County,4,34,-30
2,Alaska,23,Maine,27,Waldo County,5,7,-2
2,Alaska,23,Maine,29,Washington County,0,32,-32
2,Alaska,23,Maine,31,York County,5,63,-58
2,Alaska,24,Maryland,1,Allegany County,12,0,12
2,Alaska,24,Maryland,3,Anne Arundel County,69,285,-216
2,Alaska,24,Maryland,5,Baltimore County,0,13,-13
2,Alaska,24,Maryland,9,Calvert County,0,24,-24
2,Alaska,24,Maryland,15,Cecil County,5,0,5
2,Alaska,24,Maryland,17,Charles County,0,52,-52
2,Alaska,24,Maryland,21,Frederick County,0,22,-22
2,Alaska,24,Maryland,25,Harford County,65,0,65
2,Alaska,24,Maryland,27,Howard County,14,16,-2
2,Alaska,24,Maryland,31,Montgomery County,63,55,8
2,Alaska,24,Maryland,33,Prince George's County,7,244,-237
2,Alaska,24,Maryland,37,St. Mary's County,0,95,-95
2,Alaska,24,Maryland,39,Somerset County,12,0,12
2,Alaska,24,Maryland,43,Washington County,0,10,-10
2,Alaska,24,Maryland,47,Worcester County,7,0,7
2,Alaska,24,Maryland,510,Baltimore city,57,0,57
2,Alaska,25,Massachusetts,1,Barnstable County,0,95,-95
2,Alaska,25,Massachusetts,5,Bristol County,4,0,4
2,Alaska,25,Massachusetts,7,Dukes County,4,0,4
2,Alaska,25,Massachusetts,9,Essex County,56,9,47
2,Alaska,25,Massachusetts,13,Hampden County,0,65,-65
2,Alaska,25,Massachusetts,15,Hampshire County,5,15,-10
2,Alaska,25,Massachusetts,17,Middlesex County,18,245,-227
2,Alaska,25,Massachusetts,21,Norfolk County,14,80,-66
2,Alaska,25,Massachusetts,23,Plymouth County,0,56,-56
2,Alaska,25,Massachusetts,25,Suffolk County,59,77,-18
2,Alaska,25,Massachusetts,27,Worcester County,58,261,-203
2,Alaska,26,Michigan,5,Allegan County,13,24,-11
2,Alaska,26,Michigan,9,Antrim County,6,0,6
2,Alaska,26,Michigan,13,Baraga County,0,6,-6
2,Alaska,26,Michigan,17,Bay County,17,0,17
2,Alaska,26,Michigan,23,Branch County,6,0,6
2,Alaska,26,Michigan,27,Cass County,0,3,-3
2,Alaska,26,Michigan,29,Charlevoix County,3,7,-4
2,Alaska,26,Michigan,31,Cheboygan County,0,11,-11
2,Alaska,26,Michigan,33,Chippewa County,0,41,-41
2,Alaska,26,Michigan,35,Clare County,0,5,-5
2,Alaska,26,Michigan,37,Clinton County,0,24,-24
2,Alaska,26,Michigan,41,Delta County,0,22,-22
2,Alaska,26,Michigan,45,Eaton County,26,29,-3
2,Alaska,26,Michigan,47,Emmet County,6,0,6
2,Alaska,26,Michigan,49,Genesee County,3,132,-129
2,Alaska,26,Michigan,55,Grand Traverse County,0,39,-39
2,Alaska,26,Michigan,57,Gratiot County,4,3,1
2,Alaska,26,Michigan,59,Hillsdale County,0,18,-18
2,Alaska,26,Michigan,61,Houghton County,0,58,-58
2,Alaska,26,Michigan,63,Huron County,0,10,-10
2,Alaska,26,Michigan,65,Ingham County,0,59,-59
2,Alaska,26,Michigan,67,Ionia County,21,0,21
2,Alaska,26,Michigan,71,Iron County,0,29,-29
2,Alaska,26,Michigan,77,Kalamazoo County,0,3,-3
2,Alaska,26,Michigan,81,Kent County,30,65,-35
2,Alaska,26,Michigan,87,Lapeer County,0,2,-2
2,Alaska,26,Michigan,89,Leelanau County,0,16,-16
2,Alaska,26,Michigan,93,Livingston County,13,13,0
2,Alaska,26,Michigan,97,Mackinac County,18,0,18
2,Alaska,26,Michigan,99,Macomb County,5,54,-49
2,Alaska,26,Michigan,103,Marquette County,0,33,-33
2,Alaska,26,Michigan,107,Mecosta County,12,0,12
2,Alaska,26,Michigan,109,Menominee County,0,2,-2
2,Alaska,26,Michigan,111,Midland County,0,22,-22
2,Alaska,26,Michigan,117,Montcalm County,5,2,3
2,Alaska,26,Michigan,121,Muskegon County,26,0,26
2,Alaska,26,Michigan,123,Newaygo County,0,10,-10
2,Alaska,26,Michigan,125,Oakland County,0,71,-71
2,Alaska,26,Michigan,129,Ogemaw County,3,0,3
2,Alaska,26,Michigan,133,Osceola County,0,9,-9
2,Alaska,26,Michigan,135,Oscoda County,0,13,-13
2,Alaska,26,Michigan,141,Presque Isle County,0,3,-3
2,Alaska,26,Michigan,145,Saginaw County,0,175,-175
2,Alaska,26,Michigan,149,St. Joseph County,0,21,-21
2,Alaska,26,Michigan,151,Sanilac County,0,13,-13
2,Alaska,26,Michigan,153,Schoolcraft County,0,60,-60
2,Alaska,26,Michigan,155,Shiawassee County,0,9,-9
2,Alaska,26,Michigan,159,Van Buren County,103,0,103
2,Alaska,26,Michigan,161,Washtenaw County,66,273,-207
2,Alaska,26,Michigan,163,Wayne County,83,443,-360
2,Alaska,27,Minnesota,3,Anoka County,25,0,25
2,Alaska,27,Minnesota,7,Beltrami County,0,6,-6
2,Alaska,27,Minnesota,13,Blue Earth County,3,0,3
2,Alaska,27,Minnesota,15,Brown County,0,25,-25
2,Alaska,27,Minnesota,17,Carlton County,9,0,9
2,Alaska,27,Minnesota,21,Cass County,0,1,-1
2,Alaska,27,Minnesota,25,Chisago County,29,0,29
2,Alaska,27,Minnesota,35,Crow Wing County,0,75,-75
2,Alaska,27,Minnesota,37,Dakota County,0,30,-30
2,Alaska,27,Minnesota,39,Dodge County,0,4,-4
2,Alaska,27,Minnesota,47,Freeborn County,17,0,17
2,Alaska,27,Minnesota,53,Hennepin County,24,116,-92
2,Alaska,27,Minnesota,57,Hubbard County,8,8,0
2,Alaska,27,Minnesota,59,Isanti County,0,11,-11
2,Alaska,27,Minnesota,65,Kanabec County,0,9,-9
2,Alaska,27,Minnesota,71,Koochiching County,0,6,-6
2,Alaska,27,Minnesota,73,Lac qui Parle County,0,2,-2
2,Alaska,27,Minnesota,79,Le Sueur County,3,0,3
2,Alaska,27,Minnesota,81,Lincoln County,0,2,-2
2,Alaska,27,Minnesota,83,Lyon County,30,0,30
2,Alaska,27,Minnesota,85,McLeod County,10,6,4
2,Alaska,27,Minnesota,95,Mille Lacs County,5,0,5
2,Alaska,27,Minnesota,101,Murray County,0,2,-2
2,Alaska,27,Minnesota,103,Nicollet County,3,15,-12
2,Alaska,27,Minnesota,105,Nobles County,0,4,-4
2,Alaska,27,Minnesota,109,Olmsted County,0,30,-30
2,Alaska,27,Minnesota,111,Otter Tail County,2,14,-12
2,Alaska,27,Minnesota,115,Pine County,0,31,-31
2,Alaska,27,Minnesota,123,Ramsey County,126,149,-23
2,Alaska,27,Minnesota,131,Rice County,3,23,-20
2,Alaska,27,Minnesota,137,St. Louis County,9,65,-56
2,Alaska,27,Minnesota,139,Scott County,1,1,0
2,Alaska,27,Minnesota,145,Stearns County,166,5,161
2,Alaska,27,Minnesota,147,Steele County,0,5,-5
2,Alaska,27,Minnesota,163,Washington County,17,20,-3
2,Alaska,27,Minnesota,171,Wright County,3,69,-66
2,Alaska,28,Mississippi,3,Alcorn County,12,0,12
2,Alaska,28,Mississippi,29,Copiah County,0,6,-6
2,Alaska,28,Mississippi,33,DeSoto County,10,8,2
2,Alaska,28,Mississippi,43,Grenada County,17,0,17
2,Alaska,28,Mississippi,47,Harrison County,42,114,-72
2,Alaska,28,Mississippi,59,Jackson County,5,18,-13
2,Alaska,28,Mississippi,77,Lawrence County,13,0,13
2,Alaska,28,Mississippi,79,Leake County,7,0,7
2,Alaska,28,Mississippi,87,Lowndes County,2,0,2
2,Alaska,28,Mississippi,89,Madison County,0,16,-16
2,Alaska,28,Mississippi,101,Newton County,30,0,30
2,Alaska,28,Mississippi,123,Scott County,2,0,2
2,Alaska,28,Mississippi,145,Union County,0,15,-15
2,Alaska,28,Mississippi,159,Winston County,0,7,-7
2,Alaska,29,Missouri,7,Audrain County,31,0,31
2,Alaska,29,Missouri,19,Boone County,102,91,11
2,Alaska,29,Missouri,21,Buchanan County,0,24,-24
2,Alaska,29,Missouri,23,Butler County,0,44,-44
2,Alaska,29,Missouri,27,Callaway County,9,0,9
2,Alaska,29,Missouri,47,Clay County,52,40,12
2,Alaska,29,Missouri,61,Daviess County,0,2,-2
2,Alaska,29,Missouri,71,Franklin County,8,72,-64
2,Alaska,29,Missouri,77,Greene County,0,263,-263
2,Alaska,29,Missouri,95,Jackson County,15,20,-5
2,Alaska,29,Missouri,97,Jasper County,8,2,6
2,Alaska,29,Missouri,101,Johnson County,15,86,-71
2,Alaska,29,Missouri,107,Lafayette County,9,3,6
2,Alaska,29,Missouri,117,Livingston County,11,0,11
2,Alaska,29,Missouri,123,Madison County,7,0,7
2,Alaska,29,Missouri,157,Perry County,0,8,-8
2,Alaska,29,Missouri,161,Phelps County,0,22,-22
2,Alaska,29,Missouri,163,Pike County,0,11,-11
2,Alaska,29,Missouri,165,Platte County,71,0,71
2,Alaska,29,Missouri,167,Polk County,0,5,-5
2,Alaska,29,Missouri,169,Pulaski County,345,198,147
2,Alaska,29,Missouri,177,Ray County,8,0,8
2,Alaska,29,Missouri,183,St. Charles County,55,0,55
2,Alaska,29,Missouri,187,St. Francois County,11,0,11
2,Alaska,29,Missouri,195,Saline County,0,8,-8
2,Alaska,29,Missouri,199,Scotland County,25,0,25
2,Alaska,29,Missouri,201,Scott County,0,114,-114
2,Alaska,29,Missouri,207,Stoddard County,5,0,5
2,Alaska,29,Missouri,215,Texas County,23,0,23
2,Alaska,29,Missouri,217,Vernon County,0,6,-6
2,Alaska,29,Missouri,219,Warren County,0,11,-11
2,Alaska,29,Missouri,225,Webster County,0,1,-1
2,Alaska,29,Missouri,510,St. Louis city,19,34,-15
2,Alaska,30,Montana,13,Cascade County,8,48,-40
2,Alaska,30,Montana,15,Chouteau County,0,3,-3
2,Alaska,30,Montana,17,Custer County,0,28,-28
2,Alaska,30,Montana,23,Deer Lodge County,5,3,2
2,Alaska,30,Montana,27,Fergus County,6,0,6
2,Alaska,30,Montana,29,Flathead County,102,135,-33
2,Alaska,30,Montana,31,Gallatin County,67,125,-58
2,Alaska,30,Montana,43,Jefferson County,0,16,-16
2,Alaska,30,Montana,47,Lake County,0,66,-66
2,Alaska,30,Montana,49,Lewis and Clark County,0,95,-95
2,Alaska,30,Montana,57,Madison County,0,3,-3
2,Alaska,30,Montana,59,Meagher County,5,0,5
2,Alaska,30,Montana,63,Missoula County,36,13,23
2,Alaska,30,Montana,65,Musselshell County,7,16,-9
2,Alaska,30,Montana,67,Park County,11,0,11
2,Alaska,30,Montana,71,Phillips County,0,33,-33
2,Alaska,30,Montana,77,Powell County,0,2,-2
2,Alaska,30,Montana,83,Richland County,6,0,6
2,Alaska,30,Montana,85,Roosevelt County,0,30,-30
2,Alaska,30,Montana,89,Sanders County,5,172,-167
2,Alaska,30,Montana,91,Sheridan County,0,1,-1
2,Alaska,30,Montana,93,Silver Bow County,100,16,84
2,Alaska,30,Montana,97,Sweet Grass County,16,0,16
2,Alaska,30,Montana,101,Toole County,1,0,1
2,Alaska,30,Montana,111,Yellowstone County,104,19,85
2,Alaska,31,Nebraska,21,Burt County,0,10,-10
2,Alaska,31,Nebraska,47,Dawson County,7,0,7
2,Alaska,31,Nebraska,53,Dodge County,3,8,-5
2,Alaska,31,Nebraska,55,Douglas County,3,21,-18
2,Alaska,31,Nebraska,67,Gage County,0,16,-16
2,Alaska,31,Nebraska,101,Keith County,0,1,-1
2,Alaska,31,Nebraska,109,Lancaster County,16,112,-96
2,Alaska,31,Nebraska,113,Logan County,0,11,-11
2,Alaska,31,Nebraska,153,Sarpy County,99,192,-93
2,Alaska,31,Nebraska,155,Saunders County,0,6,-6
2,Alaska,31,Nebraska,157,Scotts Bluff County,0,16,-16
2,Alaska,31,Nebraska,173,Thurston County,0,3,-3
2,Alaska,31,Nebraska,179,Wayne County,0,17,-17
2,Alaska,31,Nebraska,185,York County,0,2,-2
2,Alaska,32,Nevada,1,Churchill County,4,0,4
2,Alaska,32,Nevada,3,Clark County,596,957,-361
2,Alaska,32,Nevada,5,Douglas County,0,73,-73
2,Alaska,32,Nevada,7,Elko County,4,0,4
2,Alaska,32,Nevada,11,Eureka County,15,0,15
2,Alaska,32,Nevada,15,Lander County,4,0,4
2,Alaska,32,Nevada,19,Lyon County,14,16,-2
2,Alaska,32,Nevada,23,Nye County,37,0,37
2,Alaska,32,Nevada,31,Washoe County,102,287,-185
2,Alaska,32,Nevada,33,White Pine County,1,0,1
2,Alaska,32,Nevada,510,Carson City,17,28,-11
2,Alaska,33,New Hampshire,1,Belknap County,0,15,-15
2,Alaska,33,New Hampshire,5,Cheshire County,0,125,-125
2,Alaska,33,New Hampshire,9,Grafton County,87,0,87
2,Alaska,33,New Hampshire,11,Hillsborough County,14,0,14
2,Alaska,33,New Hampshire,15,Rockingham County,0,100,-100
2,Alaska,33,New Hampshire,17,Strafford County,10,46,-36
2,Alaska,34,New Jersey,1,Atlantic County,8,42,-34
2,Alaska,34,New Jersey,3,Bergen County,2,0,2
2,Alaska,34,New Jersey,5,Burlington County,84,61,23
2,Alaska,34,New Jersey,7,Camden County,22,22,0
2,Alaska,34,New Jersey,9,Cape May County,7,14,-7
2,Alaska,34,New Jersey,11,Cumberland County,30,16,14
2,Alaska,34,New Jersey,13,Essex County,24,8,16
2,Alaska,34,New Jersey,15,Gloucester County,0,78,-78
2,Alaska,34,New Jersey,17,Hudson County,0,40,-40
2,Alaska,34,New Jersey,21,Mercer County,0,62,-62
2,Alaska,34,New Jersey,23,Middlesex County,17,19,-2
2,Alaska,34,New Jersey,25,Monmouth County,0,12,-12
2,Alaska,34,New Jersey,27,Morris County,4,0,4
2,Alaska,34,New Jersey,29,Ocean County,25,158,-133
2,Alaska,34,New Jersey,31,Passaic County,0,43,-43
2,Alaska,35,New Mexico,1,Bernalillo County,106,374,-268
2,Alaska,35,New Mexico,9,Curry County,93,87,6
2,Alaska,35,New Mexico,13,Doña Ana County,1,12,-11
2,Alaska,35,New Mexico,17,Grant County,16,0,16
2,Alaska,35,New Mexico,25,Lea County,0,18,-18
2,Alaska,35,New Mexico,31,McKinley County,4,0,4
2,Alaska,35,New Mexico,35,Otero County,72,161,-89
2,Alaska,35,New Mexico,41,Roosevelt County,0,22,-22
2,Alaska,35,New Mexico,43,Sandoval County,16,12,4
2,Alaska,35,New Mexico,45,San Juan County,38,9,29
2,Alaska,35,New Mexico,47,San Miguel County,0,43,-43
2,Alaska,35,New Mexico,49,Santa Fe County,9,76,-67
2,Alaska,35,New Mexico,55,Taos County,11,0,11
2,Alaska,35,New Mexico,57,Torrance County,0,109,-109
2,Alaska,35,New Mexico,61,Valencia County,0,25,-25
2,Alaska,36,New York,1,Albany County,5,0,5
2,Alaska,36,New York,5,Bronx County,0,17,-17
2,Alaska,36,New York,9,Cattaraugus County,0,3,-3
2,Alaska,36,New York,13,Chautauqua County,0,16,-16
2,Alaska,36,New York,15,Chemung County,17,12,5
2,Alaska,36,New York,19,Clinton County,15,0,15
2,Alaska,36,New York,23,Cortland County,0,9,-9
2,Alaska,36,New York,27,Dutchess County,31,44,-13
2,Alaska,36,New York,29,Erie County,5,78,-73
2,Alaska,36,New York,45,Jefferson County,207,229,-22
2,Alaska,36,New York,47,Kings County,4,383,-379
2,Alaska,36,New York,49,Lewis County,0,8,-8
2,Alaska,36,New York,51,Livingston County,0,11,-11
2,Alaska,36,New York,55,Monroe County,42,42,0
2,Alaska,36,New York,59,Nassau County,19,187,-168
2,Alaska,36,New York,61,New York County,68,238,-170
2,Alaska,36,New York,63,Niagara County,0,89,-89
2,Alaska,36,New York,65,Oneida County,76,0,76
2,Alaska,36,New York,67,Onondaga County,25,0,25
2,Alaska,36,New York,71,Orange County,21,117,-96
2,Alaska,36,New York,75,Oswego County,0,3,-3
2,Alaska,36,New York,81,Queens County,25,258,-233
2,Alaska,36,New York,89,St. Lawrence County,23,21,2
2,Alaska,36,New York,93,Schenectady County,0,24,-24
2,Alaska,36,New York,97,Schuyler County,0,5,-5
2,Alaska,36,New York,103,Suffolk County,14,400,-386
2,Alaska,36,New York,105,Sullivan County,9,0,9
2,Alaska,36,New York,107,Tioga County,0,13,-13
2,Alaska,36,New York,109,Tompkins County,77,33,44
2,Alaska,36,New York,111,Ulster County,41,24,17
2,Alaska,36,New York,119,Westchester County,28,167,-139
2,Alaska,36,New York,121,Wyoming County,0,31,-31
2,Alaska,36,New York,123,Yates County,0,35,-35
2,Alaska,37,North Carolina,15,Bertie County,15,0,15
2,Alaska,37,North Carolina,19,Brunswick County,18,28,-10
2,Alaska,37,North Carolina,21,Buncombe County,13,0,13
2,Alaska,37,North Carolina,29,Camden County,0,14,-14
2,Alaska,37,North Carolina,31,Carteret County,31,14,17
2,Alaska,37,North Carolina,35,Catawba County,0,4,-4
2,Alaska,37,North Carolina,39,Cherokee County,6,0,6
2,Alaska,37,North Carolina,45,Cleveland County,62,0,62
2,Alaska,37,North Carolina,49,Craven County,82,0,82
2,Alaska,37,North Carolina,51,Cumberland County,357,477,-120
2,Alaska,37,North Carolina,53,Currituck County,28,0,28
2,Alaska,37,North Carolina,63,Durham County,11,17,-6
2,Alaska,37,North Carolina,67,Forsyth County,0,145,-145
2,Alaska,37,North Carolina,81,Guilford County,0,13,-13
2,Alaska,37,North Carolina,85,Harnett County,265,150,115
2,Alaska,37,North Carolina,87,Haywood County,44,64,-20
2,Alaska,37,North Carolina,89,Henderson County,8,35,-27
2,Alaska,37,North Carolina,93,Hoke County,24,111,-87
2,Alaska,37,North Carolina,97,Iredell County,0,32,-32
2,Alaska,37,North Carolina,101,Johnston County,14,0,14
2,Alaska,37,North Carolina,105,Lee County,100,61,39
2,Alaska,37,North Carolina,119,Mecklenburg County,12,127,-115
2,Alaska,37,North Carolina,125,Moore County,83,113,-30
2,Alaska,37,North Carolina,127,Nash County,0,6,-6
2,Alaska,37,North Carolina,129,New Hanover County,8,62,-54
2,Alaska,37,North Carolina,133,Onslow County,9,7,2
2,Alaska,37,North Carolina,135,Orange County,34,4,30
2,Alaska,37,North Carolina,139,Pasquotank County,0,36,-36
2,Alaska,37,North Carolina,143,Perquimans County,0,7,-7
2,Alaska,37,North Carolina,145,Person County,3,0,3
2,Alaska,37,North Carolina,147,Pitt County,3,0,3
2,Alaska,37,North Carolina,151,Randolph County,0,16,-16
2,Alaska,37,North Carolina,155,Robeson County,0,9,-9
2,Alaska,37,North Carolina,159,Rowan County,0,76,-76
2,Alaska,37,North Carolina,161,Rutherford County,11,0,11
2,Alaska,37,North Carolina,165,Scotland County,0,9,-9
2,Alaska,37,North Carolina,169,Stokes County,5,0,5
2,Alaska,37,North Carolina,175,Transylvania County,1,0,1
2,Alaska,37,North Carolina,179,Union County,0,222,-222
2,Alaska,37,North Carolina,183,Wake County,13,259,-246
2,Alaska,37,North Carolina,191,Wayne County,6,152,-146
2,Alaska,38,North Dakota,17,Cass County,0,13,-13
2,Alaska,38,North Dakota,25,Dunn County,0,22,-22
2,Alaska,38,North Dakota,35,Grand Forks County,20,25,-5
2,Alaska,38,North Dakota,55,McLean County,0,37,-37
2,Alaska,38,North Dakota,57,Mercer County,0,12,-12
2,Alaska,38,North Dakota,59,Morton County,0,19,-19
2,Alaska,38,North Dakota,61,Mountrail County,6,0,6
2,Alaska,38,North Dakota,63,Nelson County,0,8,-8
2,Alaska,38,North Dakota,65,Oliver County,2,0,2
2,Alaska,38,North Dakota,101,Ward County,13,18,-5
2,Alaska,38,North Dakota,105,Williams County,36,57,-21
2,Alaska,39,Ohio,3,Allen County,68,0,68
2,Alaska,39,Ohio,7,Ashtabula County,9,13,-4
2,Alaska,39,Ohio,11,Auglaize County,0,10,-10
2,Alaska,39,Ohio,17,Butler County,0,86,-86
2,Alaska,39,Ohio,21,Champaign County,5,0,5
2,Alaska,39,Ohio,25,Clermont County,0,53,-53
2,Alaska,39,Ohio,29,Columbiana County,24,0,24
2,Alaska,39,Ohio,33,Crawford County,39,0,39
2,Alaska,39,Ohio,35,Cuyahoga County,43,0,43
2,Alaska,39,Ohio,41,Delaware County,0,31,-31
2,Alaska,39,Ohio,47,Fayette County,0,43,-43
2,Alaska,39,Ohio,49,Franklin County,7,60,-53
2,Alaska,39,Ohio,51,Fulton County,6,0,6
2,Alaska,39,Ohio,55,Geauga County,0,17,-17
2,Alaska,39,Ohio,57,Greene County,14,16,-2
2,Alaska,39,Ohio,61,Hamilton County,19,69,-50
2,Alaska,39,Ohio,63,Hancock County,0,5,-5
2,Alaska,39,Ohio,69,Henry County,8,0,8
2,Alaska,39,Ohio,81,Jefferson County,0,11,-11
2,Alaska,39,Ohio,85,Lake County,0,5,-5
2,Alaska,39,Ohio,95,Lucas County,24,0,24
2,Alaska,39,Ohio,97,Madison County,0,11,-11
2,Alaska,39,Ohio,99,Mahoning County,0,2,-2
2,Alaska,39,Ohio,101,Marion County,0,58,-58
2,Alaska,39,Ohio,113,Montgomery County,148,116,32
2,Alaska,39,Ohio,115,Morgan County,0,5,-5
2,Alaska,39,Ohio,129,Pickaway County,1,0,1
2,Alaska,39,Ohio,153,Summit County,0,36,-36
2,Alaska,39,Ohio,155,Trumbull County,36,0,36
2,Alaska,39,Ohio,175,Wyandot County,25,0,25
2,Alaska,4,Arizona,3,Cochise County,158,206,-48
2,Alaska,4,Arizona,5,Coconino County,143,219,-76
2,Alaska,4,Arizona,7,Gila County,230,0,230
2,Alaska,4,Arizona,9,Graham County,0,28,-28
2,Alaska,4,Arizona,13,Maricopa County,371,1141,-770
2,Alaska,4,Arizona,15,Mohave County,58,112,-54
2,Alaska,4,Arizona,17,Navajo County,0,134,-134
2,Alaska,4,Arizona,19,Pima County,189,322,-133
2,Alaska,4,Arizona,21,Pinal County,24,143,-119
2,Alaska,4,Arizona,23,Santa Cruz County,8,16,-8
2,Alaska,4,Arizona,25,Yavapai County,16,323,-307
2,Alaska,4,Arizona,27,Yuma County,1,92,-91
2,Alaska,40,Oklahoma,3,Alfalfa County,0,8,-8
2,Alaska,40,Oklahoma,13,Bryan County,0,13,-13
2,Alaska,40,Oklahoma,15,Caddo County,0,7,-7
2,Alaska,40,Oklahoma,17,Canadian County,15,0,15
2,Alaska,40,Oklahoma,19,Carter County,37,138,-101
2,Alaska,40,Oklahoma,21,Cherokee County,14,0,14
2,Alaska,40,Oklahoma,27,Cleveland County,0,33,-33
2,Alaska,40,Oklahoma,31,Comanche County,270,144,126
2,Alaska,40,Oklahoma,39,Custer County,0,4,-4
2,Alaska,40,Oklahoma,41,Delaware County,4,0,4
2,Alaska,40,Oklahoma,47,Garfield County,0,17,-17
2,Alaska,40,Oklahoma,51,Grady County,0,19,-19
2,Alaska,40,Oklahoma,55,Greer County,0,35,-35
2,Alaska,40,Oklahoma,59,Harper County,0,59,-59
2,Alaska,40,Oklahoma,65,Jackson County,6,64,-58
2,Alaska,40,Oklahoma,71,Kay County,0,19,-19
2,Alaska,40,Oklahoma,77,Latimer County,0,4,-4
2,Alaska,40,Oklahoma,79,Le Flore County,0,34,-34
2,Alaska,40,Oklahoma,83,Logan County,11,0,11
2,Alaska,40,Oklahoma,95,Marshall County,0,59,-59
2,Alaska,40,Oklahoma,97,Mayes County,0,3,-3
2,Alaska,40,Oklahoma,101,Muskogee County,0,8,-8
2,Alaska,40,Oklahoma,109,Oklahoma County,169,103,66
2,Alaska,40,Oklahoma,111,Okmulgee County,0,28,-28
2,Alaska,40,Oklahoma,119,Payne County,0,25,-25
2,Alaska,40,Oklahoma,125,Pottawatomie County,5,11,-6
2,Alaska,40,Oklahoma,129,Roger Mills County,0,5,-5
2,Alaska,40,Oklahoma,135,Sequoyah County,0,17,-17
2,Alaska,40,Oklahoma,143,Tulsa County,40,115,-75
2,Alaska,40,Oklahoma,147,Washington County,2,0,2
2,Alaska,41,Oregon,1,Baker County,45,26,19
2,Alaska,41,Oregon,3,Benton County,47,59,-12
2,Alaska,41,Oregon,5,Clackamas County,35,150,-115
2,Alaska,41,Oregon,7,Clatsop County,130,126,4
2,Alaska,41,Oregon,9,Columbia County,15,8,7
2,Alaska,41,Oregon,11,Coos County,14,14,0
2,Alaska,41,Oregon,13,Crook County,25,0,25
2,Alaska,41,Oregon,15,Curry County,0,66,-66
2,Alaska,41,Oregon,17,Deschutes County,31,359,-328
2,Alaska,41,Oregon,19,Douglas County,30,12,18
2,Alaska,41,Oregon,23,Grant County,0,5,-5
2,Alaska,41,Oregon,27,Hood River County,8,0,8
2,Alaska,41,Oregon,29,Jackson County,226,89,137
2,Alaska,41,Oregon,31,Jefferson County,0,9,-9
2,Alaska,41,Oregon,33,Josephine County,8,109,-101
2,Alaska,41,Oregon,35,Klamath County,15,42,-27
2,Alaska,41,Oregon,37,Lake County,15,0,15
2,Alaska,41,Oregon,39,Lane County,97,398,-301
2,Alaska,41,Oregon,41,Lincoln County,39,3,36
2,Alaska,41,Oregon,43,Linn County,2,0,2
2,Alaska,41,Oregon,45,Malheur County,5,4,1
2,Alaska,41,Oregon,47,Marion County,85,52,33
2,Alaska,41,Oregon,51,Multnomah County,349,455,-106
2,Alaska,41,Oregon,53,Polk County,3,0,3
2,Alaska,41,Oregon,57,Tillamook County,45,11,34
2,Alaska,41,Oregon,59,Umatilla County,0,148,-148
2,Alaska,41,Oregon,61,Union County,0,10,-10
2,Alaska,41,Oregon,63,Wallowa County,15,0,15
2,Alaska,41,Oregon,67,Washington County,103,297,-194
2,Alaska,41,Oregon,71,Yamhill County,62,107,-45
2,Alaska,42,Pennsylvania,3,Allegheny County,102,16,86
2,Alaska,42,Pennsylvania,7,Beaver County,18,18,0
2,Alaska,42,Pennsylvania,15,Bradford County,0,17,-17
2,Alaska,42,Pennsylvania,19,Butler County,0,8,-8
2,Alaska,42,Pennsylvania,21,Cambria County,0,1,-1
2,Alaska,42,Pennsylvania,27,Centre County,0,67,-67
2,Alaska,42,Pennsylvania,29,Chester County,0,58,-58
2,Alaska,42,Pennsylvania,33,Clearfield County,10,2,8
2,Alaska,42,Pennsylvania,35,Clinton County,1,0,1
2,Alaska,42,Pennsylvania,41,Cumberland County,0,16,-16
2,Alaska,42,Pennsylvania,43,Dauphin County,34,19,15
2,Alaska,42,Pennsylvania,45,Delaware County,5,0,5
2,Alaska,42,Pennsylvania,49,Erie County,0,111,-111
2,Alaska,42,Pennsylvania,53,Forest County,0,9,-9
2,Alaska,42,Pennsylvania,59,Greene County,4,0,4
2,Alaska,42,Pennsylvania,63,Indiana County,18,0,18
2,Alaska,42,Pennsylvania,67,Juniata County,0,11,-11
2,Alaska,42,Pennsylvania,69,Lackawanna County,0,16,-16
2,Alaska,42,Pennsylvania,71,Lancaster County,17,0,17
2,Alaska,42,Pennsylvania,73,Lawrence County,3,14,-11
2,Alaska,42,Pennsylvania,75,Lebanon County,92,0,92
2,Alaska,42,Pennsylvania,77,Lehigh County,5,0,5
2,Alaska,42,Pennsylvania,79,Luzerne County,0,72,-72
2,Alaska,42,Pennsylvania,85,Mercer County,0,32,-32
2,Alaska,42,Pennsylvania,89,Monroe County,0,17,-17
2,Alaska,42,Pennsylvania,91,Montgomery County,25,60,-35
2,Alaska,42,Pennsylvania,93,Montour County,0,16,-16
2,Alaska,42,Pennsylvania,95,Northampton County,0,15,-15
2,Alaska,42,Pennsylvania,97,Northumberland County,0,13,-13
2,Alaska,42,Pennsylvania,101,Philadelphia County,146,207,-61
2,Alaska,42,Pennsylvania,103,Pike County,0,20,-20
2,Alaska,42,Pennsylvania,119,Union County,0,23,-23
2,Alaska,42,Pennsylvania,121,Venango County,0,2,-2
2,Alaska,42,Pennsylvania,127,Wayne County,4,0,4
2,Alaska,42,Pennsylvania,129,Westmoreland County,2,0,2
2,Alaska,42,Pennsylvania,131,Wyoming County,0,5,-5
2,Alaska,42,Pennsylvania,133,York County,11,11,0
2,Alaska,44,Rhode Island,3,Kent County,32,24,8
2,Alaska,44,Rhode Island,5,Newport County,17,8,9
2,Alaska,44,Rhode Island,7,Providence County,0,28,-28
2,Alaska,45,South Carolina,3,Aiken County,1,0,1
2,Alaska,45,South Carolina,15,Berkeley County,12,12,0
2,Alaska,45,South Carolina,19,Charleston County,33,122,-89
2,Alaska,45,South Carolina,35,Dorchester County,57,83,-26
2,Alaska,45,South Carolina,41,Florence County,0,8,-8
2,Alaska,45,South Carolina,43,Georgetown County,9,0,9
2,Alaska,45,South Carolina,45,Greenville County,4,52,-48
2,Alaska,45,South Carolina,49,Hampton County,110,0,110
2,Alaska,45,South Carolina,51,Horry County,0,34,-34
2,Alaska,45,South Carolina,63,Lexington County,16,41,-25
2,Alaska,45,South Carolina,67,Marion County,0,137,-137
2,Alaska,45,South Carolina,71,Newberry County,5,0,5
2,Alaska,45,South Carolina,73,Oconee County,6,0,6
2,Alaska,45,South Carolina,79,Richland County,118,97,21
2,Alaska,45,South Carolina,83,Spartanburg County,39,5,34
2,Alaska,45,South Carolina,85,Sumter County,66,27,39
2,Alaska,45,South Carolina,91,York County,9,0,9
2,Alaska,46,South Dakota,11,Brookings County,0,13,-13
2,Alaska,46,South Dakota,13,Brown County,0,4,-4
2,Alaska,46,South Dakota,19,Butte County,24,0,24
2,Alaska,46,South Dakota,33,Custer County,0,20,-20
2,Alaska,46,South Dakota,41,Dewey County,9,0,9
2,Alaska,46,South Dakota,55,Haakon County,0,16,-16
2,Alaska,46,South Dakota,79,Lake County,0,14,-14
2,Alaska,46,South Dakota,83,Lincoln County,1,58,-57
2,Alaska,46,South Dakota,93,Meade County,59,54,5
2,Alaska,46,South Dakota,99,Minnehaha County,12,38,-26
2,Alaska,46,South Dakota,103,Pennington County,59,27,32
2,Alaska,46,South Dakota,105,Perkins County,0,3,-3
2,Alaska,46,South Dakota,109,Roberts County,0,19,-19
2,Alaska,46,South Dakota,121,Todd County,10,0,10
2,Alaska,46,South Dakota,137,Ziebach County,18,0,18
2,Alaska,47,Tennessee,11,Bradley County,31,95,-64
2,Alaska,47,Tennessee,35,Cumberland County,0,72,-72
2,Alaska,47,Tennessee,37,Davidson County,14,70,-56
2,Alaska,47,Tennessee,43,Dickson County,28,0,28
2,Alaska,47,Tennessee,55,Giles County,0,29,-29
2,Alaska,47,Tennessee,65,Hamilton County,42,69,-27
2,Alaska,47,Tennessee,89,Jefferson County,0,3,-3
2,Alaska,47,Tennessee,93,Knox County,36,128,-92
2,Alaska,47,Tennessee,99,Lawrence County,4,0,4
2,Alaska,47,Tennessee,103,Lincoln County,26,0,26
2,Alaska,47,Tennessee,107,McMinn County,0,32,-32
2,Alaska,47,Tennessee,109,McNairy County,1,5,-4
2,Alaska,47,Tennessee,111,Macon County,0,8,-8
2,Alaska,47,Tennessee,123,Monroe County,0,29,-29
2,Alaska,47,Tennessee,125,Montgomery County,154,101,53
2,Alaska,47,Tennessee,127,Moore County,0,16,-16
2,Alaska,47,Tennessee,145,Roane County,0,22,-22
2,Alaska,47,Tennessee,147,Robertson County,0,10,-10
2,Alaska,47,Tennessee,149,Rutherford County,8,0,8
2,Alaska,47,Tennessee,157,Shelby County,20,271,-251
2,Alaska,47,Tennessee,159,Smith County,0,27,-27
2,Alaska,47,Tennessee,179,Washington County,0,55,-55
2,Alaska,47,Tennessee,181,Wayne County,2,0,2
2,Alaska,47,Tennessee,183,Weakley County,0,21,-21
2,Alaska,47,Tennessee,187,Williamson County,19,0,19
2,Alaska,48,Texas,5,Angelina County,32,0,32
2,Alaska,48,Texas,13,Atascosa County,41,0,41
2,Alaska,48,Texas,21,Bastrop County,2,0,2
2,Alaska,48,Texas,27,Bell County,53,268,-215
2,Alaska,48,Texas,29,Bexar County,635,378,257
2,Alaska,48,Texas,37,Bowie County,0,1,-1
2,Alaska,48,Texas,39,Brazoria County,0,17,-17
2,Alaska,48,Texas,49,Brown County,0,59,-59
2,Alaska,48,Texas,59,Callahan County,0,15,-15
2,Alaska,48,Texas,61,Cameron County,0,19,-19
2,Alaska,48,Texas,65,Carson County,9,0,9
2,Alaska,48,Texas,67,Cass County,0,8,-8
2,Alaska,48,Texas,85,Collin County,58,107,-49
2,Alaska,48,Texas,99,Coryell County,113,124,-11
2,Alaska,48,Texas,113,Dallas County,64,131,-67
2,Alaska,48,Texas,121,Denton County,24,126,-102
2,Alaska,48,Texas,133,Eastland County,8,7,1
2,Alaska,48,Texas,135,Ector County,35,0,35
2,Alaska,48,Texas,139,Ellis County,0,15,-15
2,Alaska,48,Texas,141,El Paso County,430,462,-32
2,Alaska,48,Texas,147,Fannin County,0,5,-5
2,Alaska,48,Texas,157,Fort Bend County,3,151,-148
2,Alaska,48,Texas,167,Galveston County,13,0,13
2,Alaska,48,Texas,179,Gray County,0,38,-38
2,Alaska,48,Texas,187,Guadalupe County,13,26,-13
2,Alaska,48,Texas,201,Harris County,141,481,-340
2,Alaska,48,Texas,203,Harrison County,0,95,-95
2,Alaska,48,Texas,209,Hays County,1,23,-22
2,Alaska,48,Texas,213,Henderson County,13,21,-8
2,Alaska,48,Texas,215,Hidalgo County,15,0,15
2,Alaska,48,Texas,217,Hill County,0,46,-46
2,Alaska,48,Texas,221,Hood County,6,15,-9
2,Alaska,48,Texas,227,Howard County,2,0,2
2,Alaska,48,Texas,231,Hunt County,10,0,10
2,Alaska,48,Texas,233,Hutchinson County,9,0,9
2,Alaska,48,Texas,245,Jefferson County,2,250,-248
2,Alaska,48,Texas,259,Kendall County,0,109,-109
2,Alaska,48,Texas,273,Kleberg County,0,52,-52
2,Alaska,48,Texas,277,Lamar County,14,0,14
2,Alaska,48,Texas,279,Lamb County,0,7,-7
2,Alaska,48,Texas,301,Loving County,0,2,-2
2,Alaska,48,Texas,303,Lubbock County,66,0,66
2,Alaska,48,Texas,309,McLennan County,142,23,119
2,Alaska,48,Texas,329,Midland County,0,42,-42
2,Alaska,48,Texas,339,Montgomery County,126,45,81
2,Alaska,48,Texas,347,Nacogdoches County,0,8,-8
2,Alaska,48,Texas,355,Nueces County,13,123,-110
2,Alaska,48,Texas,361,Orange County,0,289,-289
2,Alaska,48,Texas,367,Parker County,39,16,23
2,Alaska,48,Texas,373,Polk County,20,0,20
2,Alaska,48,Texas,375,Potter County,11,0,11
2,Alaska,48,Texas,379,Rains County,0,6,-6
2,Alaska,48,Texas,381,Randall County,37,0,37
2,Alaska,48,Texas,409,San Patricio County,14,247,-233
2,Alaska,48,Texas,417,Shackelford County,0,1,-1
2,Alaska,48,Texas,419,Shelby County,20,0,20
2,Alaska,48,Texas,435,Sutton County,0,1,-1
2,Alaska,48,Texas,439,Tarrant County,81,370,-289
2,Alaska,48,Texas,441,Taylor County,95,34,61
2,Alaska,48,Texas,451,Tom Green County,17,0,17
2,Alaska,48,Texas,453,Travis County,25,462,-437
2,Alaska,48,Texas,463,Uvalde County,0,7,-7
2,Alaska,48,Texas,465,Val Verde County,5,0,5
2,Alaska,48,Texas,467,Van Zandt County,0,83,-83
2,Alaska,48,Texas,469,Victoria County,16,17,-1
2,Alaska,48,Texas,471,Walker County,0,1,-1
2,Alaska,48,Texas,479,Webb County,12,26,-14
2,Alaska,48,Texas,485,Wichita County,61,97,-36
2,Alaska,48,Texas,491,Williamson County,85,69,16
2,Alaska,48,Texas,497,Wise County,9,0,9
2,Alaska,49,Utah,3,Box Elder County,10,0,10
2,Alaska,49,Utah,5,Cache County,24,36,-12
2,Alaska,49,Utah,7,Carbon County,0,3,-3
2,Alaska,49,Utah,11,Davis County,222,182,40
2,Alaska,49,Utah,21,Iron County,74,7,67
2,Alaska,49,Utah,23,Juab County,0,26,-26
2,Alaska,49,Utah,25,Kane County,0,1,-1
2,Alaska,49,Utah,35,Salt Lake County,123,790,-667
2,Alaska,49,Utah,37,San Juan County,7,3,4
2,Alaska,49,Utah,43,Summit County,4,0,4
2,Alaska,49,Utah,45,Tooele County,22,0,22
2,Alaska,49,Utah,49,Utah County,37,322,-285
2,Alaska,49,Utah,51,Wasatch County,39,0,39
2,Alaska,49,Utah,53,Washington County,58,83,-25
2,Alaska,49,Utah,57,Weber County,149,24,125
2,Alaska,5,Arkansas,3,Ashley County,4,0,4
2,Alaska,5,Arkansas,7,Benton County,0,37,-37
2,Alaska,5,Arkansas,15,Carroll County,0,14,-14
2,Alaska,5,Arkansas,17,Chicot County,12,0,12
2,Alaska,5,Arkansas,19,Clark County,6,0,6
2,Alaska,5,Arkansas,23,Cleburne County,0,178,-178
2,Alaska,5,Arkansas,49,Fulton County,0,15,-15
2,Alaska,5,Arkansas,51,Garland County,0,3,-3
2,Alaska,5,Arkansas,63,Independence County,0,27,-27
2,Alaska,5,Arkansas,71,Johnson County,0,15,-15
2,Alaska,5,Arkansas,85,Lonoke County,12,0,12
2,Alaska,5,Arkansas,89,Marion County,0,23,-23
2,Alaska,5,Arkansas,93,Mississippi County,2,0,2
2,Alaska,5,Arkansas,97,Montgomery County,0,13,-13
2,Alaska,5,Arkansas,119,Pulaski County,47,21,26
2,Alaska,5,Arkansas,121,Randolph County,44,5,39
2,Alaska,5,Arkansas,125,Saline County,0,11,-11
2,Alaska,5,Arkansas,131,Sebastian County,18,0,18
2,Alaska,5,Arkansas,139,Union County,5,0,5
2,Alaska,5,Arkansas,143,Washington County,14,0,14
2,Alaska,5,Arkansas,145,White County,0,10,-10
2,Alaska,50,Vermont,1,Addison County,7,0,7
2,Alaska,50,Vermont,3,Bennington County,0,24,-24
2,Alaska,50,Vermont,7,Chittenden County,12,0,12
2,Alaska,50,Vermont,15,Lamoille County,0,8,-8
2,Alaska,50,Vermont,17,Orange County,0,24,-24
2,Alaska,50,Vermont,21,Rutland County,25,0,25
2,Alaska,50,Vermont,23,Washington County,0,5,-5
2,Alaska,50,Vermont,25,Windham County,0,8,-8
2,Alaska,50,Vermont,27,Windsor County,18,0,18
2,Alaska,51,Virginia,1,Accomack County,7,0,7
2,Alaska,51,Virginia,11,Appomattox County,20,0,20
2,Alaska,51,Virginia,13,Arlington County,0,85,-85
2,Alaska,51,Virginia,15,Augusta County,0,9,-9
2,Alaska,51,Virginia,19,Bedford County,25,0,25
2,Alaska,51,Virginia,41,Chesterfield County,32,53,-21
2,Alaska,51,Virginia,59,Fairfax County,110,214,-104
2,Alaska,51,Virginia,61,Fauquier County,21,30,-9
2,Alaska,51,Virginia,63,Floyd County,0,1,-1
2,Alaska,51,Virginia,73,Gloucester County,5,0,5
2,Alaska,51,Virginia,95,James City County,5,0,5
2,Alaska,51,Virginia,105,Lee County,0,20,-20
2,Alaska,51,Virginia,107,Loudoun County,7,32,-25
2,Alaska,51,Virginia,121,Montgomery County,0,73,-73
2,Alaska,51,Virginia,127,New Kent County,0,1,-1
2,Alaska,51,Virginia,143,Pittsylvania County,0,20,-20
2,Alaska,51,Virginia,149,Prince George County,58,70,-12
2,Alaska,51,Virginia,153,Prince William County,9,122,-113
2,Alaska,51,Virginia,175,Southampton County,0,12,-12
2,Alaska,51,Virginia,179,Stafford County,36,18,18
2,Alaska,51,Virginia,181,Surry County,15,0,15
2,Alaska,51,Virginia,199,York County,14,102,-88
2,Alaska,51,Virginia,510,Alexandria city,0,54,-54
2,Alaska,51,Virginia,540,Charlottesville city,6,35,-29
2,Alaska,51,Virginia,550,Chesapeake city,18,68,-50
2,Alaska,51,Virginia,590,Danville city,0,286,-286
2,Alaska,51,Virginia,650,Hampton city,6,32,-26
2,Alaska,51,Virginia,700,Newport News city,60,41,19
2,Alaska,51,Virginia,710,Norfolk city,22,215,-193
2,Alaska,51,Virginia,730,Petersburg city,0,77,-77
2,Alaska,51,Virginia,735,Poquoson city,17,0,17
2,Alaska,51,Virginia,740,Portsmouth city,7,11,-4
2,Alaska,51,Virginia,760,Richmond city,9,3,6
2,Alaska,51,Virginia,790,Staunton city,0,67,-67
2,Alaska,51,Virginia,800,Suffolk city,5,0,5
2,Alaska,51,Virginia,810,Virginia Beach city,9,19,-10
2,Alaska,53,Washington,1,Adams County,7,0,7
2,Alaska,53,Washington,3,Asotin County,0,13,-13
2,Alaska,53,Washington,5,Benton County,10,30,-20
2,Alaska,53,Washington,7,Chelan County,12,49,-37
2,Alaska,53,Washington,9,Clallam County,51,98,-47
2,Alaska,53,Washington,11,Clark County,125,165,-40
2,Alaska,53,Washington,15,Cowlitz County,54,263,-209
2,Alaska,53,Washington,17,Douglas County,7,123,-116
2,Alaska,53,Washington,21,Franklin County,2,0,2
2,Alaska,53,Washington,25,Grant County,36,52,-16
2,Alaska,53,Washington,27,Grays Harbor County,30,28,2
2,Alaska,53,Washington,29,Island County,28,71,-43
2,Alaska,53,Washington,31,Jefferson County,0,29,-29
2,Alaska,53,Washington,33,King County,968,1046,-78
2,Alaska,53,Washington,35,Kitsap County,83,202,-119
2,Alaska,53,Washington,37,Kittitas County,0,27,-27
2,Alaska,53,Washington,39,Klickitat County,6,22,-16
2,Alaska,53,Washington,41,Lewis County,30,35,-5
2,Alaska,53,Washington,43,Lincoln County,0,12,-12
2,Alaska,53,Washington,45,Mason County,0,69,-69
2,Alaska,53,Washington,47,Okanogan County,10,17,-7
2,Alaska,53,Washington,49,Pacific County,82,19,63
2,Alaska,53,Washington,51,Pend Oreille County,0,61,-61
2,Alaska,53,Washington,53,Pierce County,880,657,223
2,Alaska,53,Washington,55,San Juan County,6,3,3
2,Alaska,53,Washington,57,Skagit County,37,172,-135
2,Alaska,53,Washington,61,Snohomish County,325,637,-312
2,Alaska,53,Washington,63,Spokane County,256,260,-4
2,Alaska,53,Washington,65,Stevens County,6,24,-18
2,Alaska,53,Washington,67,Thurston County,181,445,-264
2,Alaska,53,Washington,69,Wahkiakum County,13,0,13
2,Alaska,53,Washington,71,Walla Walla County,7,70,-63
2,Alaska,53,Washington,73,Whatcom County,337,377,-40
2,Alaska,53,Washington,75,Whitman County,4,124,-120
2,Alaska,53,Washington,77,Yakima County,76,64,12
2,Alaska,54,West Virginia,1,Barbour County,0,2,-2
2,Alaska,54,West Virginia,3,Berkeley County,0,67,-67
2,Alaska,54,West Virginia,5,Boone County,0,9,-9
2,Alaska,54,West Virginia,25,Greenbrier County,18,0,18
2,Alaska,54,West Virginia,37,Jefferson County,8,0,8
2,Alaska,54,West Virginia,39,Kanawha County,0,4,-4
2,Alaska,54,West Virginia,55,Mercer County,0,138,-138
2,Alaska,54,West Virginia,59,Mingo County,0,19,-19
2,Alaska,54,West Virginia,61,Monongalia County,23,0,23
2,Alaska,54,West Virginia,81,Raleigh County,0,26,-26
2,Alaska,54,West Virginia,85,Ritchie County,0,7,-7
2,Alaska,54,West Virginia,107,Wood County,0,350,-350
2,Alaska,55,Wisconsin,1,Adams County,0,26,-26
2,Alaska,55,Wisconsin,5,Barron County,33,0,33
2,Alaska,55,Wisconsin,9,Brown County,8,11,-3
2,Alaska,55,Wisconsin,11,Buffalo County,0,3,-3
2,Alaska,55,Wisconsin,13,Burnett County,0,1,-1
2,Alaska,55,Wisconsin,19,Clark County,0,4,-4
2,Alaska,55,Wisconsin,23,Crawford County,0,3,-3
2,Alaska,55,Wisconsin,25,Dane County,4,0,4
2,Alaska,55,Wisconsin,29,Door County,1,0,1
2,Alaska,55,Wisconsin,31,Douglas County,0,58,-58
2,Alaska,55,Wisconsin,33,Dunn County,44,12,32
2,Alaska,55,Wisconsin,35,Eau Claire County,0,7,-7
2,Alaska,55,Wisconsin,39,Fond du Lac County,0,2,-2
2,Alaska,55,Wisconsin,41,Forest County,0,4,-4
2,Alaska,55,Wisconsin,47,Green Lake County,0,7,-7
2,Alaska,55,Wisconsin,55,Jefferson County,3,0,3
2,Alaska,55,Wisconsin,59,Kenosha County,0,35,-35
2,Alaska,55,Wisconsin,63,La Crosse County,10,0,10
2,Alaska,55,Wisconsin,69,Lincoln County,0,5,-5
2,Alaska,55,Wisconsin,71,Manitowoc County,0,8,-8
2,Alaska,55,Wisconsin,73,Marathon County,257,0,257
2,Alaska,55,Wisconsin,75,Marinette County,0,2,-2
2,Alaska,55,Wisconsin,79,Milwaukee County,11,177,-166
2,Alaska,55,Wisconsin,83,Oconto County,14,13,1
2,Alaska,55,Wisconsin,87,Outagamie County,53,0,53
2,Alaska,55,Wisconsin,91,Pepin County,0,5,-5
2,Alaska,55,Wisconsin,99,Price County,0,4,-4
2,Alaska,55,Wisconsin,105,Rock County,2,49,-47
2,Alaska,55,Wisconsin,109,St. Croix County,58,33,25
2,Alaska,55,Wisconsin,115,Shawano County,1,10,-9
2,Alaska,55,Wisconsin,117,Sheboygan County,18,0,18
2,Alaska,55,Wisconsin,125,Vilas County,10,0,10
2,Alaska,55,Wisconsin,129,Washburn County,0,7,-7
2,Alaska,55,Wisconsin,139,Winnebago County,21,0,21
2,Alaska,55,Wisconsin,141,Wood County,0,3,-3
2,Alaska,56,Wyoming,1,Albany County,34,0,34
2,Alaska,56,Wyoming,5,Campbell County,0,136,-136
2,Alaska,56,Wyoming,7,Carbon County,36,0,36
2,Alaska,56,Wyoming,9,Converse County,0,15,-15
2,Alaska,56,Wyoming,13,Fremont County,4,24,-20
2,Alaska,56,Wyoming,19,Johnson County,0,11,-11
2,Alaska,56,Wyoming,21,Laramie County,33,8,25
2,Alaska,56,Wyoming,25,Natrona County,30,0,30
2,Alaska,56,Wyoming,29,Park County,9,21,-12
2,Alaska,56,Wyoming,33,Sheridan County,0,3,-3
2,Alaska,56,Wyoming,41,Uinta County,5,13,-8
2,Alaska,6,California,1,Alameda County,142,241,-99
2,Alaska,6,California,7,Butte County,7,31,-24
2,Alaska,6,California,13,Contra Costa County,0,451,-451
2,Alaska,6,California,15,Del Norte County,0,74,-74
2,Alaska,6,California,17,El Dorado County,55,0,55
2,Alaska,6,California,19,Fresno County,95,77,18
2,Alaska,6,California,21,Glenn County,6,0,6
2,Alaska,6,California,23,Humboldt County,7,79,-72
2,Alaska,6,California,25,Imperial County,44,7,37
2,Alaska,6,California,27,Inyo County,0,2,-2
2,Alaska,6,California,29,Kern County,86,177,-91
2,Alaska,6,California,31,Kings County,9,26,-17
2,Alaska,6,California,33,Lake County,0,117,-117
2,Alaska,6,California,35,Lassen County,6,13,-7
2,Alaska,6,California,37,Los Angeles County,462,782,-320
2,Alaska,6,California,39,Madera County,8,70,-62
2,Alaska,6,California,41,Marin County,23,9,14
2,Alaska,6,California,43,Mariposa County,13,10,3
2,Alaska,6,California,45,Mendocino County,51,0,51
2,Alaska,6,California,49,Modoc County,0,17,-17
2,Alaska,6,California,53,Monterey County,77,41,36
2,Alaska,6,California,55,Napa County,0,49,-49
2,Alaska,6,California,57,Nevada County,0,21,-21
2,Alaska,6,California,59,Orange County,91,306,-215
2,Alaska,6,California,61,Placer County,68,118,-50
2,Alaska,6,California,65,Riverside County,222,388,-166
2,Alaska,6,California,67,Sacramento County,185,347,-162
2,Alaska,6,California,69,San Benito County,4,0,4
2,Alaska,6,California,71,San Bernardino County,240,451,-211
2,Alaska,6,California,73,San Diego County,398,405,-7
2,Alaska,6,California,75,San Francisco County,13,11,2
2,Alaska,6,California,77,San Joaquin County,93,59,34
2,Alaska,6,California,79,San Luis Obispo County,10,131,-121
2,Alaska,6,California,81,San Mateo County,12,0,12
2,Alaska,6,California,83,Santa Barbara County,49,50,-1
2,Alaska,6,California,85,Santa Clara County,0,200,-200
2,Alaska,6,California,87,Santa Cruz County,29,84,-55
2,Alaska,6,California,89,Shasta County,5,28,-23
2,Alaska,6,California,93,Siskiyou County,5,0,5
2,Alaska,6,California,95,Solano County,170,216,-46
2,Alaska,6,California,97,Sonoma County,0,243,-243
2,Alaska,6,California,99,Stanislaus County,62,37,25
2,Alaska,6,California,101,Sutter County,17,17,0
2,Alaska,6,California,103,Tehama County,6,0,6
2,Alaska,6,California,105,Trinity County,0,40,-40
2,Alaska,6,California,107,Tulare County,30,42,-12
2,Alaska,6,California,111,Ventura County,89,183,-94
2,Alaska,6,California,113,Yolo County,17,36,-19
2,Alaska,6,California,115,Yuba County,59,22,37
2,Alaska,72,Puerto Rico,21,Bayamón Municipio,21,0,21
2,Alaska,72,Puerto Rico,23,Cabo Rojo Municipio,3,0,3
2,Alaska,72,Puerto Rico,29,Canóvanas Municipio,4,0,4
2,Alaska,72,Puerto Rico,31,Carolina Municipio,6,0,6
2,Alaska,72,Puerto Rico,33,Cataño Municipio,5,0,5
2,Alaska,72,Puerto Rico,35,Cayey Municipio,5,0,5
2,Alaska,72,Puerto Rico,41,Cidra Municipio,11,0,11
2,Alaska,72,Puerto Rico,65,Hatillo Municipio,147,0,147
2,Alaska,72,Puerto Rico,75,Juana Díaz Municipio,0,1,-1
2,Alaska,72,Puerto Rico,77,Juncos Municipio,11,0,11
2,Alaska,72,Puerto Rico,127,San Juan Municipio,26,11,15
2,Alaska,72,Puerto Rico,133,Santa Isabel Municipio,0,20,-20
2,Alaska,72,Puerto Rico,137,Toa Baja Municipio,0,9,-9
2,Alaska,8,Colorado,1,Adams County,103,16,87
2,Alaska,8,Colorado,5,Arapahoe County,36,192,-156
2,Alaska,8,Colorado,7,Archuleta County,5,0,5
2,Alaska,8,Colorado,13,Boulder County,27,78,-51
2,Alaska,8,Colorado,19,Clear Creek County,0,2,-2
2,Alaska,8,Colorado,29,Delta County,10,6,4
2,Alaska,8,Colorado,31,Denver County,142,237,-95
2,Alaska,8,Colorado,35,Douglas County,5,78,-73
2,Alaska,8,Colorado,37,Eagle County,34,0,34
2,Alaska,8,Colorado,39,Elbert County,4,0,4
2,Alaska,8,Colorado,41,El Paso County,680,256,424
2,Alaska,8,Colorado,43,Fremont County,210,62,148
2,Alaska,8,Colorado,45,Garfield County,1,22,-21
2,Alaska,8,Colorado,49,Grand County,39,35,4
2,Alaska,8,Colorado,51,Gunnison County,13,0,13
2,Alaska,8,Colorado,55,Huerfano County,14,0,14
2,Alaska,8,Colorado,59,Jefferson County,38,223,-185
2,Alaska,8,Colorado,63,Kit Carson County,0,1,-1
2,Alaska,8,Colorado,65,Lake County,0,17,-17
2,Alaska,8,Colorado,67,La Plata County,8,34,-26
2,Alaska,8,Colorado,69,Larimer County,158,24,134
2,Alaska,8,Colorado,77,Mesa County,9,148,-139
2,Alaska,8,Colorado,83,Montezuma County,6,50,-44
2,Alaska,8,Colorado,85,Montrose County,23,0,23
2,Alaska,8,Colorado,87,Morgan County,18,19,-1
2,Alaska,8,Colorado,89,Otero County,15,0,15
2,Alaska,8,Colorado,91,Ouray County,0,12,-12
2,Alaska,8,Colorado,93,Park County,0,4,-4
2,Alaska,8,Colorado,97,Pitkin County,21,1,20
2,Alaska,8,Colorado,101,Pueblo County,0,53,-53
2,Alaska,8,Colorado,105,Rio Grande County,0,3,-3
2,Alaska,8,Colorado,107,Routt County,25,24,1
2,Alaska,8,Colorado,113,San Miguel County,1,4,-3
2,Alaska,8,Colorado,115,Sedgwick County,0,15,-15
2,Alaska,8,Colorado,117,Summit County,6,0,6
2,Alaska,8,Colorado,119,Teller County,11,31,-20
2,Alaska,8,Colorado,123,Weld County,113,131,-18
2,Alaska,9,Connecticut,1,Fairfield County,0,100,-100
2,Alaska,9,Connecticut,3,Hartford County,44,67,-23
2,Alaska,9,Connecticut,9,New Haven County,10,642,-632
2,Alaska,9,Connecticut,11,New London County,12,65,-53
2,Alaska,AFR,Africa,,-,73,0,0
2,Alaska,ASI,Asia,,-,2940,0,0
2,Alaska,CAM,Central America,,-,457,0,0
2,Alaska,CAR,Caribbean,,-,195,0,0
2,Alaska,EUR,Europe,,-,1058,0,0
2,Alaska,ISL,U.S. Island Areas,,-,275,0,0
2,Alaska,NAM,Northern America,,-,253,0,0
2,Alaska,OCE,Oceania and At Sea,,-,291,0,0
2,Alaska,SAM,South America,,-,279,0,0
4,Arizona,1,Alabama,1,Autauga County,34,0,34
4,Arizona,1,Alabama,3,Baldwin County,61,79,-18
4,Arizona,1,Alabama,9,Blount County,5,0,5
4,Arizona,1,Alabama,15,Calhoun County,78,10,68
4,Arizona,1,Alabama,17,Chambers County,0,72,-72
4,Arizona,1,Alabama,31,Coffee County,0,26,-26
4,Arizona,1,Alabama,35,Conecuh County,9,0,9
4,Arizona,1,Alabama,39,Covington County,0,22,-22
4,Arizona,1,Alabama,41,Crenshaw County,0,47,-47
4,Arizona,1,Alabama,43,Cullman County,13,0,13
4,Arizona,1,Alabama,45,Dale County,95,21,74
4,Arizona,1,Alabama,53,Escambia County,0,15,-15
4,Arizona,1,Alabama,55,Etowah County,13,0,13
4,Arizona,1,Alabama,57,Fayette County,0,8,-8
4,Arizona,1,Alabama,61,Geneva County,0,46,-46
4,Arizona,1,Alabama,69,Houston County,0,5,-5
4,Arizona,1,Alabama,73,Jefferson County,200,201,-1
4,Arizona,1,Alabama,75,Lamar County,0,18,-18
4,Arizona,1,Alabama,77,Lauderdale County,22,43,-21
4,Arizona,1,Alabama,81,Lee County,78,1,77
4,Arizona,1,Alabama,83,Limestone County,97,147,-50
4,Arizona,1,Alabama,89,Madison County,113,143,-30
4,Arizona,1,Alabama,95,Marshall County,0,1,-1
4,Arizona,1,Alabama,97,Mobile County,84,110,-26
4,Arizona,1,Alabama,101,Montgomery County,80,90,-10
4,Arizona,1,Alabama,103,Morgan County,9,11,-2
4,Arizona,1,Alabama,107,Pickens County,24,9,15
4,Arizona,1,Alabama,109,Pike County,29,0,29
4,Arizona,1,Alabama,113,Russell County,2,0,2
4,Arizona,1,Alabama,115,St. Clair County,4,0,4
4,Arizona,1,Alabama,117,Shelby County,0,26,-26
4,Arizona,1,Alabama,121,Talladega County,0,23,-23
4,Arizona,1,Alabama,125,Tuscaloosa County,14,45,-31
4,Arizona,1,Alabama,127,Walker County,0,7,-7
4,Arizona,1,Alabama,133,Winston County,0,10,-10
4,Arizona,10,Delaware,1,Kent County,34,9,25
4,Arizona,10,Delaware,3,New Castle County,486,115,371
4,Arizona,10,Delaware,5,Sussex County,93,17,76
4,Arizona,11,District of Columbia,1,District of Columbia,257,326,-69
4,Arizona,12,Florida,1,Alachua County,143,131,12
4,Arizona,12,Florida,3,Baker County,0,4,-4
4,Arizona,12,Florida,5,Bay County,79,147,-68
4,Arizona,12,Florida,9,Brevard County,256,376,-120
4,Arizona,12,Florida,11,Broward County,395,889,-494
4,Arizona,12,Florida,15,Charlotte County,0,10,-10
4,Arizona,12,Florida,17,Citrus County,61,85,-24
4,Arizona,12,Florida,19,Clay County,4,47,-43
4,Arizona,12,Florida,21,Collier County,213,365,-152
4,Arizona,12,Florida,29,Dixie County,64,0,64
4,Arizona,12,Florida,31,Duval County,442,177,265
4,Arizona,12,Florida,33,Escambia County,186,233,-47
4,Arizona,12,Florida,35,Flagler County,36,40,-4
4,Arizona,12,Florida,41,Gilchrist County,0,2,-2
4,Arizona,12,Florida,49,Hardee County,15,0,15
4,Arizona,12,Florida,53,Hernando County,102,33,69
4,Arizona,12,Florida,55,Highlands County,141,124,17
4,Arizona,12,Florida,57,Hillsborough County,763,679,84
4,Arizona,12,Florida,61,Indian River County,254,113,141
4,Arizona,12,Florida,69,Lake County,239,30,209
4,Arizona,12,Florida,71,Lee County,427,401,26
4,Arizona,12,Florida,73,Leon County,92,64,28
4,Arizona,12,Florida,75,Levy County,0,4,-4
4,Arizona,12,Florida,81,Manatee County,155,192,-37
4,Arizona,12,Florida,83,Marion County,117,84,33
4,Arizona,12,Florida,85,Martin County,0,188,-188
4,Arizona,12,Florida,86,Miami-Dade County,596,438,158
4,Arizona,12,Florida,87,Monroe County,48,0,48
4,Arizona,12,Florida,89,Nassau County,0,29,-29
4,Arizona,12,Florida,91,Okaloosa County,412,274,138
4,Arizona,12,Florida,95,Orange County,613,590,23
4,Arizona,12,Florida,97,Osceola County,218,35,183
4,Arizona,12,Florida,99,Palm Beach County,446,410,36
4,Arizona,12,Florida,101,Pasco County,126,93,33
4,Arizona,12,Florida,103,Pinellas County,275,413,-138
4,Arizona,12,Florida,105,Polk County,338,77,261
4,Arizona,12,Florida,109,St. Johns County,92,69,23
4,Arizona,12,Florida,111,St. Lucie County,92,94,-2
4,Arizona,12,Florida,113,Santa Rosa County,50,6,44
4,Arizona,12,Florida,115,Sarasota County,0,270,-270
4,Arizona,12,Florida,117,Seminole County,84,125,-41
4,Arizona,12,Florida,119,Sumter County,38,103,-65
4,Arizona,12,Florida,121,Suwannee County,23,0,23
4,Arizona,12,Florida,123,Taylor County,0,56,-56
4,Arizona,12,Florida,125,Union County,0,3,-3
4,Arizona,12,Florida,127,Volusia County,654,235,419
4,Arizona,12,Florida,129,Wakulla County,0,16,-16
4,Arizona,12,Florida,131,Walton County,26,72,-46
4,Arizona,13,Georgia,9,Baldwin County,0,15,-15
4,Arizona,13,Georgia,11,Banks County,0,23,-23
4,Arizona,13,Georgia,15,Bartow County,14,12,2
4,Arizona,13,Georgia,21,Bibb County,132,20,112
4,Arizona,13,Georgia,29,Bryan County,25,0,25
4,Arizona,13,Georgia,31,Bulloch County,54,31,23
4,Arizona,13,Georgia,39,Camden County,0,118,-118
4,Arizona,13,Georgia,45,Carroll County,0,13,-13
4,Arizona,13,Georgia,49,Charlton County,0,34,-34
4,Arizona,13,Georgia,51,Chatham County,130,88,42
4,Arizona,13,Georgia,53,Chattahoochee County,0,131,-131
4,Arizona,13,Georgia,55,Chattooga County,20,0,20
4,Arizona,13,Georgia,57,Cherokee County,169,6,163
4,Arizona,13,Georgia,59,Clarke County,25,28,-3
4,Arizona,13,Georgia,63,Clayton County,177,85,92
4,Arizona,13,Georgia,65,Clinch County,0,4,-4
4,Arizona,13,Georgia,67,Cobb County,318,394,-76
4,Arizona,13,Georgia,73,Columbia County,128,83,45
4,Arizona,13,Georgia,77,Coweta County,35,12,23
4,Arizona,13,Georgia,79,Crawford County,2,0,2
4,Arizona,13,Georgia,85,Dawson County,7,13,-6
4,Arizona,13,Georgia,89,DeKalb County,168,102,66
4,Arizona,13,Georgia,97,Douglas County,18,151,-133
4,Arizona,13,Georgia,111,Fannin County,12,0,12
4,Arizona,13,Georgia,113,Fayette County,29,8,21
4,Arizona,13,Georgia,115,Floyd County,0,3,-3
4,Arizona,13,Georgia,117,Forsyth County,15,138,-123
4,Arizona,13,Georgia,121,Fulton County,761,594,167
4,Arizona,13,Georgia,123,Gilmer County,0,6,-6
4,Arizona,13,Georgia,127,Glynn County,56,27,29
4,Arizona,13,Georgia,129,Gordon County,28,0,28
4,Arizona,13,Georgia,133,Greene County,0,8,-8
4,Arizona,13,Georgia,135,Gwinnett County,292,495,-203
4,Arizona,13,Georgia,137,Habersham County,0,5,-5
4,Arizona,13,Georgia,139,Hall County,95,29,66
4,Arizona,13,Georgia,151,Henry County,111,0,111
4,Arizona,13,Georgia,153,Houston County,12,588,-576
4,Arizona,13,Georgia,169,Jones County,0,37,-37
4,Arizona,13,Georgia,179,Liberty County,247,110,137
4,Arizona,13,Georgia,185,Lowndes County,130,74,56
4,Arizona,13,Georgia,187,Lumpkin County,127,0,127
4,Arizona,13,Georgia,211,Morgan County,0,59,-59
4,Arizona,13,Georgia,215,Muscogee County,0,149,-149
4,Arizona,13,Georgia,217,Newton County,85,11,74
4,Arizona,13,Georgia,221,Oglethorpe County,0,5,-5
4,Arizona,13,Georgia,223,Paulding County,0,129,-129
4,Arizona,13,Georgia,237,Putnam County,22,0,22
4,Arizona,13,Georgia,245,Richmond County,150,457,-307
4,Arizona,13,Georgia,247,Rockdale County,67,0,67
4,Arizona,13,Georgia,257,Stephens County,20,14,6
4,Arizona,13,Georgia,259,Stewart County,0,9,-9
4,Arizona,13,Georgia,275,Thomas County,16,0,16
4,Arizona,13,Georgia,277,Tift County,12,0,12
4,Arizona,13,Georgia,285,Troup County,0,60,-60
4,Arizona,13,Georgia,291,Union County,42,0,42
4,Arizona,13,Georgia,293,Upson County,14,0,14
4,Arizona,13,Georgia,297,Walton County,0,32,-32
4,Arizona,13,Georgia,299,Ware County,0,15,-15
4,Arizona,13,Georgia,313,Whitfield County,27,0,27
4,Arizona,15,Hawaii,1,Hawaii County,129,272,-143
4,Arizona,15,Hawaii,3,Honolulu County,1921,1603,318
4,Arizona,15,Hawaii,7,Kauai County,106,59,47
4,Arizona,15,Hawaii,9,Maui County,212,89,123
4,Arizona,16,Idaho,1,Ada County,580,713,-133
4,Arizona,16,Idaho,5,Bannock County,367,27,340
4,Arizona,16,Idaho,7,Bear Lake County,48,18,30
4,Arizona,16,Idaho,9,Benewah County,20,36,-16
4,Arizona,16,Idaho,11,Bingham County,0,9,-9
4,Arizona,16,Idaho,13,Blaine County,97,26,71
4,Arizona,16,Idaho,15,Boise County,0,16,-16
4,Arizona,16,Idaho,17,Bonner County,82,45,37
4,Arizona,16,Idaho,19,Bonneville County,21,410,-389
4,Arizona,16,Idaho,23,Butte County,0,3,-3
4,Arizona,16,Idaho,27,Canyon County,419,148,271
4,Arizona,16,Idaho,31,Cassia County,185,4,181
4,Arizona,16,Idaho,37,Custer County,24,0,24
4,Arizona,16,Idaho,39,Elmore County,101,46,55
4,Arizona,16,Idaho,41,Franklin County,39,0,39
4,Arizona,16,Idaho,43,Fremont County,9,0,9
4,Arizona,16,Idaho,45,Gem County,55,14,41
4,Arizona,16,Idaho,47,Gooding County,0,32,-32
4,Arizona,16,Idaho,49,Idaho County,144,17,127
4,Arizona,16,Idaho,51,Jefferson County,0,30,-30
4,Arizona,16,Idaho,53,Jerome County,76,47,29
4,Arizona,16,Idaho,55,Kootenai County,299,215,84
4,Arizona,16,Idaho,57,Latah County,28,106,-78
4,Arizona,16,Idaho,59,Lemhi County,0,1,-1
4,Arizona,16,Idaho,63,Lincoln County,0,3,-3
4,Arizona,16,Idaho,65,Madison County,347,510,-163
4,Arizona,16,Idaho,67,Minidoka County,0,53,-53
4,Arizona,16,Idaho,69,Nez Perce County,52,0,52
4,Arizona,16,Idaho,71,Oneida County,42,0,42
4,Arizona,16,Idaho,73,Owyhee County,0,2,-2
4,Arizona,16,Idaho,75,Payette County,0,187,-187
4,Arizona,16,Idaho,77,Power County,77,2,75
4,Arizona,16,Idaho,79,Shoshone County,0,2,-2
4,Arizona,16,Idaho,81,Teton County,0,26,-26
4,Arizona,16,Idaho,83,Twin Falls County,122,180,-58
4,Arizona,16,Idaho,85,Valley County,101,15,86
4,Arizona,16,Idaho,87,Washington County,21,0,21
4,Arizona,17,Illinois,1,Adams County,29,4,25
4,Arizona,17,Illinois,5,Bond County,0,6,-6
4,Arizona,17,Illinois,7,Boone County,202,13,189
4,Arizona,17,Illinois,11,Bureau County,8,12,-4
4,Arizona,17,Illinois,15,Carroll County,21,31,-10
4,Arizona,17,Illinois,19,Champaign County,376,29,347
4,Arizona,17,Illinois,21,Christian County,0,12,-12
4,Arizona,17,Illinois,23,Clark County,0,9,-9
4,Arizona,17,Illinois,27,Clinton County,47,23,24
4,Arizona,17,Illinois,29,Coles County,0,14,-14
4,Arizona,17,Illinois,31,Cook County,3785,1984,1801
4,Arizona,17,Illinois,33,Crawford County,15,0,15
4,Arizona,17,Illinois,37,DeKalb County,157,18,139
4,Arizona,17,Illinois,39,De Witt County,10,0,10
4,Arizona,17,Illinois,43,DuPage County,948,455,493
4,Arizona,17,Illinois,45,Edgar County,0,9,-9
4,Arizona,17,Illinois,47,Edwards County,0,9,-9
4,Arizona,17,Illinois,55,Franklin County,0,50,-50
4,Arizona,17,Illinois,57,Fulton County,186,22,164
4,Arizona,17,Illinois,59,Gallatin County,0,5,-5
4,Arizona,17,Illinois,63,Grundy County,23,7,16
4,Arizona,17,Illinois,67,Hancock County,40,4,36
4,Arizona,17,Illinois,73,Henry County,125,16,109
4,Arizona,17,Illinois,75,Iroquois County,16,10,6
4,Arizona,17,Illinois,77,Jackson County,19,0,19
4,Arizona,17,Illinois,81,Jefferson County,0,2,-2
4,Arizona,17,Illinois,85,Jo Daviess County,0,10,-10
4,Arizona,17,Illinois,89,Kane County,581,273,308
4,Arizona,17,Illinois,91,Kankakee County,62,19,43
4,Arizona,17,Illinois,93,Kendall County,270,0,270
4,Arizona,17,Illinois,95,Knox County,0,29,-29
4,Arizona,17,Illinois,97,Lake County,991,325,666
4,Arizona,17,Illinois,99,LaSalle County,24,96,-72
4,Arizona,17,Illinois,103,Lee County,9,27,-18
4,Arizona,17,Illinois,105,Livingston County,0,11,-11
4,Arizona,17,Illinois,107,Logan County,0,12,-12
4,Arizona,17,Illinois,109,McDonough County,6,0,6
4,Arizona,17,Illinois,111,McHenry County,314,112,202
4,Arizona,17,Illinois,113,McLean County,486,65,421
4,Arizona,17,Illinois,115,Macon County,15,24,-9
4,Arizona,17,Illinois,117,Macoupin County,0,1,-1
4,Arizona,17,Illinois,119,Madison County,85,6,79
4,Arizona,17,Illinois,121,Marion County,21,13,8
4,Arizona,17,Illinois,125,Mason County,0,3,-3
4,Arizona,17,Illinois,129,Menard County,24,0,24
4,Arizona,17,Illinois,133,Monroe County,32,0,32
4,Arizona,17,Illinois,135,Montgomery County,8,3,5
4,Arizona,17,Illinois,137,Morgan County,0,11,-11
4,Arizona,17,Illinois,141,Ogle County,21,7,14
4,Arizona,17,Illinois,143,Peoria County,55,103,-48
4,Arizona,17,Illinois,145,Perry County,53,0,53
4,Arizona,17,Illinois,147,Piatt County,0,2,-2
4,Arizona,17,Illinois,157,Randolph County,12,15,-3
4,Arizona,17,Illinois,159,Richland County,0,8,-8
4,Arizona,17,Illinois,161,Rock Island County,59,21,38
4,Arizona,17,Illinois,163,St. Clair County,44,57,-13
4,Arizona,17,Illinois,167,Sangamon County,208,98,110
4,Arizona,17,Illinois,169,Schuyler County,34,0,34
4,Arizona,17,Illinois,175,Stark County,0,7,-7
4,Arizona,17,Illinois,177,Stephenson County,16,0,16
4,Arizona,17,Illinois,179,Tazewell County,181,129,52
4,Arizona,17,Illinois,183,Vermilion County,55,28,27
4,Arizona,17,Illinois,189,Washington County,54,0,54
4,Arizona,17,Illinois,193,White County,0,3,-3
4,Arizona,17,Illinois,195,Whiteside County,0,57,-57
4,Arizona,17,Illinois,197,Will County,567,206,361
4,Arizona,17,Illinois,199,Williamson County,26,61,-35
4,Arizona,17,Illinois,201,Winnebago County,482,121,361
4,Arizona,17,Illinois,203,Woodford County,35,18,17
4,Arizona,18,Indiana,1,Adams County,41,0,41
4,Arizona,18,Indiana,3,Allen County,155,61,94
4,Arizona,18,Indiana,5,Bartholomew County,0,1,-1
4,Arizona,18,Indiana,9,Blackford County,0,13,-13
4,Arizona,18,Indiana,11,Boone County,35,28,7
4,Arizona,18,Indiana,17,Cass County,0,2,-2
4,Arizona,18,Indiana,19,Clark County,109,38,71
4,Arizona,18,Indiana,21,Clay County,0,21,-21
4,Arizona,18,Indiana,23,Clinton County,0,15,-15
4,Arizona,18,Indiana,29,Dearborn County,34,40,-6
4,Arizona,18,Indiana,31,Decatur County,60,0,60
4,Arizona,18,Indiana,33,DeKalb County,8,0,8
4,Arizona,18,Indiana,35,Delaware County,38,38,0
4,Arizona,18,Indiana,39,Elkhart County,68,4,64
4,Arizona,18,Indiana,41,Fayette County,0,8,-8
4,Arizona,18,Indiana,43,Floyd County,7,64,-57
4,Arizona,18,Indiana,45,Fountain County,44,0,44
4,Arizona,18,Indiana,49,Fulton County,0,2,-2
4,Arizona,18,Indiana,53,Grant County,0,40,-40
4,Arizona,18,Indiana,57,Hamilton County,413,118,295
4,Arizona,18,Indiana,59,Hancock County,73,29,44
4,Arizona,18,Indiana,63,Hendricks County,75,103,-28
4,Arizona,18,Indiana,65,Henry County,17,6,11
4,Arizona,18,Indiana,67,Howard County,0,25,-25
4,Arizona,18,Indiana,69,Huntington County,68,0,68
4,Arizona,18,Indiana,73,Jasper County,4,5,-1
4,Arizona,18,Indiana,81,Johnson County,165,54,111
4,Arizona,18,Indiana,83,Knox County,0,11,-11
4,Arizona,18,Indiana,87,LaGrange County,0,5,-5
4,Arizona,18,Indiana,89,Lake County,338,189,149
4,Arizona,18,Indiana,91,LaPorte County,140,250,-110
4,Arizona,18,Indiana,93,Lawrence County,45,14,31
4,Arizona,18,Indiana,95,Madison County,48,0,48
4,Arizona,18,Indiana,97,Marion County,873,330,543
4,Arizona,18,Indiana,103,Miami County,72,0,72
4,Arizona,18,Indiana,105,Monroe County,164,208,-44
4,Arizona,18,Indiana,107,Montgomery County,0,10,-10
4,Arizona,18,Indiana,113,Noble County,28,11,17
4,Arizona,18,Indiana,123,Perry County,0,6,-6
4,Arizona,18,Indiana,127,Porter County,166,43,123
4,Arizona,18,Indiana,133,Putnam County,0,22,-22
4,Arizona,18,Indiana,135,Randolph County,0,24,-24
4,Arizona,18,Indiana,137,Ripley County,0,4,-4
4,Arizona,18,Indiana,139,Rush County,0,4,-4
4,Arizona,18,Indiana,141,St. Joseph County,140,152,-12
4,Arizona,18,Indiana,149,Starke County,15,0,15
4,Arizona,18,Indiana,151,Steuben County,0,13,-13
4,Arizona,18,Indiana,153,Sullivan County,0,35,-35
4,Arizona,18,Indiana,157,Tippecanoe County,217,88,129
4,Arizona,18,Indiana,163,Vanderburgh County,34,95,-61
4,Arizona,18,Indiana,167,Vigo County,29,74,-45
4,Arizona,18,Indiana,169,Wabash County,15,3,12
4,Arizona,18,Indiana,173,Warrick County,0,31,-31
4,Arizona,18,Indiana,177,Wayne County,0,2,-2
4,Arizona,18,Indiana,179,Wells County,37,5,32
4,Arizona,18,Indiana,183,Whitley County,0,27,-27
4,Arizona,19,Iowa,1,Adair County,0,10,-10
4,Arizona,19,Iowa,13,Black Hawk County,43,45,-2
4,Arizona,19,Iowa,15,Boone County,18,20,-2
4,Arizona,19,Iowa,19,Buchanan County,31,11,20
4,Arizona,19,Iowa,21,Buena Vista County,16,13,3
4,Arizona,19,Iowa,23,Butler County,20,0,20
4,Arizona,19,Iowa,27,Carroll County,0,15,-15
4,Arizona,19,Iowa,33,Cerro Gordo County,10,0,10
4,Arizona,19,Iowa,35,Cherokee County,10,39,-29
4,Arizona,19,Iowa,37,Chickasaw County,28,4,24
4,Arizona,19,Iowa,41,Clay County,0,4,-4
4,Arizona,19,Iowa,43,Clayton County,0,6,-6
4,Arizona,19,Iowa,45,Clinton County,19,99,-80
4,Arizona,19,Iowa,47,Crawford County,25,9,16
4,Arizona,19,Iowa,49,Dallas County,58,304,-246
4,Arizona,19,Iowa,53,Decatur County,69,0,69
4,Arizona,19,Iowa,55,Delaware County,25,2,23
4,Arizona,19,Iowa,57,Des Moines County,339,0,339
4,Arizona,19,Iowa,59,Dickinson County,33,4,29
4,Arizona,19,Iowa,61,Dubuque County,64,25,39
4,Arizona,19,Iowa,65,Fayette County,7,0,7
4,Arizona,19,Iowa,71,Fremont County,0,3,-3
4,Arizona,19,Iowa,75,Grundy County,14,2,12
4,Arizona,19,Iowa,81,Hancock County,29,9,20
4,Arizona,19,Iowa,83,Hardin County,0,3,-3
4,Arizona,19,Iowa,87,Henry County,0,136,-136
4,Arizona,19,Iowa,91,Humboldt County,14,6,8
4,Arizona,19,Iowa,93,Ida County,0,2,-2
4,Arizona,19,Iowa,97,Jackson County,15,0,15
4,Arizona,19,Iowa,99,Jasper County,27,0,27
4,Arizona,19,Iowa,101,Jefferson County,0,6,-6
4,Arizona,19,Iowa,103,Johnson County,278,52,226
4,Arizona,19,Iowa,105,Jones County,0,4,-4
4,Arizona,19,Iowa,109,Kossuth County,45,4,41
4,Arizona,19,Iowa,113,Linn County,98,145,-47
4,Arizona,19,Iowa,117,Lucas County,0,29,-29
4,Arizona,19,Iowa,123,Mahaska County,0,20,-20
4,Arizona,19,Iowa,125,Marion County,19,16,3
4,Arizona,19,Iowa,131,Mitchell County,0,8,-8
4,Arizona,19,Iowa,139,Muscatine County,121,0,121
4,Arizona,19,Iowa,141,O'Brien County,0,2,-2
4,Arizona,19,Iowa,147,Palo Alto County,0,2,-2
4,Arizona,19,Iowa,149,Plymouth County,13,2,11
4,Arizona,19,Iowa,151,Pocahontas County,37,0,37
4,Arizona,19,Iowa,153,Polk County,729,291,438
4,Arizona,19,Iowa,155,Pottawattamie County,88,50,38
4,Arizona,19,Iowa,157,Poweshiek County,29,12,17
4,Arizona,19,Iowa,161,Sac County,56,4,52
4,Arizona,19,Iowa,163,Scott County,125,178,-53
4,Arizona,19,Iowa,167,Sioux County,42,18,24
4,Arizona,19,Iowa,169,Story County,248,133,115
4,Arizona,19,Iowa,171,Tama County,31,0,31
4,Arizona,19,Iowa,173,Taylor County,15,8,7
4,Arizona,19,Iowa,177,Van Buren County,28,0,28
4,Arizona,19,Iowa,179,Wapello County,0,44,-44
4,Arizona,19,Iowa,181,Warren County,56,0,56
4,Arizona,19,Iowa,183,Washington County,0,101,-101
4,Arizona,19,Iowa,187,Webster County,17,4,13
4,Arizona,19,Iowa,189,Winnebago County,0,47,-47
4,Arizona,19,Iowa,191,Winneshiek County,40,8,32
4,Arizona,19,Iowa,193,Woodbury County,69,68,1
4,Arizona,19,Iowa,197,Wright County,0,6,-6
4,Arizona,2,Alaska,16,Aleutians West Census Area,0,1,-1
4,Arizona,2,Alaska,20,Anchorage Municipality,1012,552,460
4,Arizona,2,Alaska,50,Bethel Census Area,79,2,77
4,Arizona,2,Alaska,60,Bristol Bay Borough,18,0,18
4,Arizona,2,Alaska,70,Dillingham Census Area,0,7,-7
4,Arizona,2,Alaska,90,Fairbanks North Star Borough,526,290,236
4,Arizona,2,Alaska,105,Hoonah-Angoon Census Area,0,2,-2
4,Arizona,2,Alaska,110,Juneau City and Borough,56,51,5
4,Arizona,2,Alaska,122,Kenai Peninsula Borough,308,74,234
4,Arizona,2,Alaska,130,Ketchikan Gateway Borough,19,23,-4
4,Arizona,2,Alaska,150,Kodiak Island Borough,0,7,-7
4,Arizona,2,Alaska,170,Matanuska-Susitna Borough,493,140,353
4,Arizona,2,Alaska,180,Nome Census Area,155,7,148
4,Arizona,2,Alaska,185,North Slope Borough,35,5,30
4,Arizona,2,Alaska,188,Northwest Arctic Borough,0,8,-8
4,Arizona,2,Alaska,198,Prince of Wales-Hyder Census Area,35,9,26
4,Arizona,2,Alaska,220,Sitka City and Borough,0,10,-10
4,Arizona,2,Alaska,261,Valdez-Cordova Census Area,0,6,-6
4,Arizona,2,Alaska,282,Yakutat City and Borough,0,4,-4
4,Arizona,20,Kansas,3,Anderson County,0,94,-94
4,Arizona,20,Kansas,5,Atchison County,0,15,-15
4,Arizona,20,Kansas,11,Bourbon County,25,3,22
4,Arizona,20,Kansas,13,Brown County,0,1,-1
4,Arizona,20,Kansas,15,Butler County,55,36,19
4,Arizona,20,Kansas,21,Cherokee County,20,0,20
4,Arizona,20,Kansas,27,Clay County,0,8,-8
4,Arizona,20,Kansas,29,Cloud County,35,13,22
4,Arizona,20,Kansas,31,Coffey County,0,1,-1
4,Arizona,20,Kansas,35,Cowley County,34,62,-28
4,Arizona,20,Kansas,37,Crawford County,0,27,-27
4,Arizona,20,Kansas,41,Dickinson County,20,5,15
4,Arizona,20,Kansas,45,Douglas County,144,87,57
4,Arizona,20,Kansas,55,Finney County,19,10,9
4,Arizona,20,Kansas,57,Ford County,0,5,-5
4,Arizona,20,Kansas,59,Franklin County,3,59,-56
4,Arizona,20,Kansas,61,Geary County,302,112,190
4,Arizona,20,Kansas,65,Graham County,0,9,-9
4,Arizona,20,Kansas,67,Grant County,0,2,-2
4,Arizona,20,Kansas,73,Greenwood County,42,0,42
4,Arizona,20,Kansas,75,Hamilton County,19,0,19
4,Arizona,20,Kansas,79,Harvey County,39,29,10
4,Arizona,20,Kansas,87,Jefferson County,13,0,13
4,Arizona,20,Kansas,91,Johnson County,595,502,93
4,Arizona,20,Kansas,95,Kingman County,0,14,-14
4,Arizona,20,Kansas,97,Kiowa County,0,2,-2
4,Arizona,20,Kansas,99,Labette County,0,7,-7
4,Arizona,20,Kansas,103,Leavenworth County,93,211,-118
4,Arizona,20,Kansas,109,Logan County,0,4,-4
4,Arizona,20,Kansas,111,Lyon County,20,0,20
4,Arizona,20,Kansas,113,McPherson County,0,25,-25
4,Arizona,20,Kansas,117,Marshall County,0,2,-2
4,Arizona,20,Kansas,121,Miami County,34,36,-2
4,Arizona,20,Kansas,123,Mitchell County,0,8,-8
4,Arizona,20,Kansas,125,Montgomery County,9,0,9
4,Arizona,20,Kansas,131,Nemaha County,19,0,19
4,Arizona,20,Kansas,133,Neosho County,0,10,-10
4,Arizona,20,Kansas,139,Osage County,0,11,-11
4,Arizona,20,Kansas,149,Pottawatomie County,140,0,140
4,Arizona,20,Kansas,153,Rawlins County,0,1,-1
4,Arizona,20,Kansas,155,Reno County,71,0,71
4,Arizona,20,Kansas,157,Republic County,0,7,-7
4,Arizona,20,Kansas,161,Riley County,248,88,160
4,Arizona,20,Kansas,165,Rush County,0,5,-5
4,Arizona,20,Kansas,169,Saline County,28,38,-10
4,Arizona,20,Kansas,173,Sedgwick County,231,287,-56
4,Arizona,20,Kansas,175,Seward County,32,0,32
4,Arizona,20,Kansas,177,Shawnee County,67,51,16
4,Arizona,20,Kansas,181,Sherman County,0,2,-2
4,Arizona,20,Kansas,189,Stevens County,58,0,58
4,Arizona,20,Kansas,201,Washington County,0,7,-7
4,Arizona,20,Kansas,207,Woodson County,0,15,-15
4,Arizona,20,Kansas,209,Wyandotte County,13,85,-72
4,Arizona,21,Kentucky,13,Bell County,17,0,17
4,Arizona,21,Kentucky,15,Boone County,266,44,222
4,Arizona,21,Kentucky,19,Boyd County,41,14,27
4,Arizona,21,Kentucky,21,Boyle County,0,8,-8
4,Arizona,21,Kentucky,35,Calloway County,39,0,39
4,Arizona,21,Kentucky,37,Campbell County,0,3,-3
4,Arizona,21,Kentucky,43,Carter County,0,5,-5
4,Arizona,21,Kentucky,47,Christian County,293,90,203
4,Arizona,21,Kentucky,49,Clark County,0,60,-60
4,Arizona,21,Kentucky,55,Crittenden County,0,3,-3
4,Arizona,21,Kentucky,59,Daviess County,0,117,-117
4,Arizona,21,Kentucky,67,Fayette County,166,114,52
4,Arizona,21,Kentucky,73,Franklin County,0,17,-17
4,Arizona,21,Kentucky,93,Hardin County,134,14,120
4,Arizona,21,Kentucky,103,Henry County,27,0,27
4,Arizona,21,Kentucky,105,Hickman County,0,31,-31
4,Arizona,21,Kentucky,107,Hopkins County,5,0,5
4,Arizona,21,Kentucky,109,Jackson County,58,0,58
4,Arizona,21,Kentucky,111,Jefferson County,379,57,322
4,Arizona,21,Kentucky,115,Johnson County,9,0,9
4,Arizona,21,Kentucky,117,Kenton County,8,11,-3
4,Arizona,21,Kentucky,121,Knox County,0,8,-8
4,Arizona,21,Kentucky,123,Larue County,11,0,11
4,Arizona,21,Kentucky,127,Lawrence County,0,7,-7
4,Arizona,21,Kentucky,141,Logan County,0,51,-51
4,Arizona,21,Kentucky,143,Lyon County,29,0,29
4,Arizona,21,Kentucky,145,McCracken County,0,6,-6
4,Arizona,21,Kentucky,151,Madison County,0,20,-20
4,Arizona,21,Kentucky,155,Marion County,14,0,14
4,Arizona,21,Kentucky,163,Meade County,17,0,17
4,Arizona,21,Kentucky,173,Montgomery County,0,17,-17
4,Arizona,21,Kentucky,177,Muhlenberg County,29,0,29
4,Arizona,21,Kentucky,181,Nicholas County,42,0,42
4,Arizona,21,Kentucky,185,Oldham County,0,27,-27
4,Arizona,21,Kentucky,199,Pulaski County,19,135,-116
4,Arizona,21,Kentucky,207,Russell County,0,8,-8
4,Arizona,21,Kentucky,209,Scott County,9,32,-23
4,Arizona,21,Kentucky,213,Simpson County,31,0,31
4,Arizona,21,Kentucky,219,Todd County,16,0,16
4,Arizona,21,Kentucky,221,Trigg County,46,0,46
4,Arizona,21,Kentucky,227,Warren County,66,78,-12
4,Arizona,21,Kentucky,239,Woodford County,0,36,-36
4,Arizona,22,Louisiana,5,Ascension Parish,8,20,-12
4,Arizona,22,Louisiana,7,Assumption Parish,0,77,-77
4,Arizona,22,Louisiana,13,Bienville Parish,0,8,-8
4,Arizona,22,Louisiana,15,Bossier Parish,87,80,7
4,Arizona,22,Louisiana,17,Caddo Parish,230,20,210
4,Arizona,22,Louisiana,19,Calcasieu Parish,24,15,9
4,Arizona,22,Louisiana,33,East Baton Rouge Parish,176,0,176
4,Arizona,22,Louisiana,37,East Feliciana Parish,9,2,7
4,Arizona,22,Louisiana,41,Franklin Parish,0,8,-8
4,Arizona,22,Louisiana,47,Iberville Parish,12,74,-62
4,Arizona,22,Louisiana,51,Jefferson Parish,121,57,64
4,Arizona,22,Louisiana,55,Lafayette Parish,128,7,121
4,Arizona,22,Louisiana,61,Lincoln Parish,13,9,4
4,Arizona,22,Louisiana,63,Livingston Parish,12,0,12
4,Arizona,22,Louisiana,69,Natchitoches Parish,29,0,29
4,Arizona,22,Louisiana,71,Orleans Parish,227,95,132
4,Arizona,22,Louisiana,73,Ouachita Parish,32,23,9
4,Arizona,22,Louisiana,79,Rapides Parish,13,0,13
4,Arizona,22,Louisiana,103,St. Tammany Parish,110,20,90
4,Arizona,22,Louisiana,105,Tangipahoa Parish,28,0,28
4,Arizona,22,Louisiana,109,Terrebonne Parish,54,0,54
4,Arizona,22,Louisiana,115,Vernon Parish,128,16,112
4,Arizona,22,Louisiana,121,West Baton Rouge Parish,0,40,-40
4,Arizona,23,Maine,1,Androscoggin County,14,37,-23
4,Arizona,23,Maine,3,Aroostook County,0,14,-14
4,Arizona,23,Maine,5,Cumberland County,241,104,137
4,Arizona,23,Maine,7,Franklin County,0,4,-4
4,Arizona,23,Maine,9,Hancock County,23,13,10
4,Arizona,23,Maine,11,Kennebec County,7,36,-29
4,Arizona,23,Maine,13,Knox County,37,0,37
4,Arizona,23,Maine,15,Lincoln County,15,2,13
4,Arizona,23,Maine,17,Oxford County,21,0,21
4,Arizona,23,Maine,19,Penobscot County,58,80,-22
4,Arizona,23,Maine,23,Sagadahoc County,16,8,8
4,Arizona,23,Maine,25,Somerset County,0,17,-17
4,Arizona,23,Maine,27,Waldo County,31,0,31
4,Arizona,23,Maine,29,Washington County,0,8,-8
4,Arizona,23,Maine,31,York County,116,47,69
4,Arizona,24,Maryland,1,Allegany County,0,14,-14
4,Arizona,24,Maryland,3,Anne Arundel County,425,540,-115
4,Arizona,24,Maryland,5,Baltimore County,209,75,134
4,Arizona,24,Maryland,9,Calvert County,34,38,-4
4,Arizona,24,Maryland,11,Caroline County,30,0,30
4,Arizona,24,Maryland,13,Carroll County,0,32,-32
4,Arizona,24,Maryland,15,Cecil County,0,26,-26
4,Arizona,24,Maryland,17,Charles County,66,22,44
4,Arizona,24,Maryland,21,Frederick County,34,23,11
4,Arizona,24,Maryland,23,Garrett County,0,6,-6
4,Arizona,24,Maryland,25,Harford County,56,9,47
4,Arizona,24,Maryland,27,Howard County,64,39,25
4,Arizona,24,Maryland,31,Montgomery County,378,524,-146
4,Arizona,24,Maryland,33,Prince George's County,174,197,-23
4,Arizona,24,Maryland,37,St. Mary's County,25,13,12
4,Arizona,24,Maryland,41,Talbot County,0,14,-14
4,Arizona,24,Maryland,43,Washington County,70,18,52
4,Arizona,24,Maryland,45,Wicomico County,31,0,31
4,Arizona,24,Maryland,510,Baltimore city,123,159,-36
4,Arizona,25,Massachusetts,1,Barnstable County,61,52,9
4,Arizona,25,Massachusetts,3,Berkshire County,0,55,-55
4,Arizona,25,Massachusetts,5,Bristol County,25,64,-39
4,Arizona,25,Massachusetts,9,Essex County,160,48,112
4,Arizona,25,Massachusetts,11,Franklin County,21,4,17
4,Arizona,25,Massachusetts,13,Hampden County,322,76,246
4,Arizona,25,Massachusetts,15,Hampshire County,20,76,-56
4,Arizona,25,Massachusetts,17,Middlesex County,620,478,142
4,Arizona,25,Massachusetts,21,Norfolk County,446,64,382
4,Arizona,25,Massachusetts,23,Plymouth County,89,297,-208
4,Arizona,25,Massachusetts,25,Suffolk County,332,283,49
4,Arizona,25,Massachusetts,27,Worcester County,488,154,334
4,Arizona,26,Michigan,1,Alcona County,18,8,10
4,Arizona,26,Michigan,5,Allegan County,78,0,78
4,Arizona,26,Michigan,7,Alpena County,1,54,-53
4,Arizona,26,Michigan,9,Antrim County,0,24,-24
4,Arizona,26,Michigan,13,Baraga County,0,34,-34
4,Arizona,26,Michigan,15,Barry County,21,20,1
4,Arizona,26,Michigan,17,Bay County,65,147,-82
4,Arizona,26,Michigan,19,Benzie County,11,0,11
4,Arizona,26,Michigan,21,Berrien County,118,63,55
4,Arizona,26,Michigan,23,Branch County,35,3,32
4,Arizona,26,Michigan,25,Calhoun County,86,0,86
4,Arizona,26,Michigan,27,Cass County,17,0,17
4,Arizona,26,Michigan,29,Charlevoix County,15,0,15
4,Arizona,26,Michigan,31,Cheboygan County,8,0,8
4,Arizona,26,Michigan,33,Chippewa County,0,49,-49
4,Arizona,26,Michigan,35,Clare County,34,0,34
4,Arizona,26,Michigan,37,Clinton County,43,75,-32
4,Arizona,26,Michigan,41,Delta County,28,0,28
4,Arizona,26,Michigan,43,Dickinson County,4,0,4
4,Arizona,26,Michigan,45,Eaton County,0,185,-185
4,Arizona,26,Michigan,47,Emmet County,89,10,79
4,Arizona,26,Michigan,49,Genesee County,327,285,42
4,Arizona,26,Michigan,53,Gogebic County,0,3,-3
4,Arizona,26,Michigan,55,Grand Traverse County,63,196,-133
4,Arizona,26,Michigan,57,Gratiot County,0,14,-14
4,Arizona,26,Michigan,59,Hillsdale County,26,3,23
4,Arizona,26,Michigan,61,Houghton County,120,18,102
4,Arizona,26,Michigan,63,Huron County,14,0,14
4,Arizona,26,Michigan,65,Ingham County,682,185,497
4,Arizona,26,Michigan,67,Ionia County,0,23,-23
4,Arizona,26,Michigan,69,Iosco County,30,69,-39
4,Arizona,26,Michigan,73,Isabella County,57,15,42
4,Arizona,26,Michigan,75,Jackson County,24,4,20
4,Arizona,26,Michigan,77,Kalamazoo County,501,217,284
4,Arizona,26,Michigan,79,Kalkaska County,0,15,-15
4,Arizona,26,Michigan,81,Kent County,339,287,52
4,Arizona,26,Michigan,85,Lake County,24,0,24
4,Arizona,26,Michigan,87,Lapeer County,48,19,29
4,Arizona,26,Michigan,89,Leelanau County,69,8,61
4,Arizona,26,Michigan,91,Lenawee County,63,12,51
4,Arizona,26,Michigan,93,Livingston County,98,70,28
4,Arizona,26,Michigan,97,Mackinac County,18,13,5
4,Arizona,26,Michigan,99,Macomb County,535,224,311
4,Arizona,26,Michigan,101,Manistee County,7,27,-20
4,Arizona,26,Michigan,103,Marquette County,53,21,32
4,Arizona,26,Michigan,105,Mason County,5,14,-9
4,Arizona,26,Michigan,107,Mecosta County,39,4,35
4,Arizona,26,Michigan,111,Midland County,83,14,69
4,Arizona,26,Michigan,113,Missaukee County,11,1,10
4,Arizona,26,Michigan,115,Monroe County,63,82,-19
4,Arizona,26,Michigan,117,Montcalm County,0,11,-11
4,Arizona,26,Michigan,121,Muskegon County,168,50,118
4,Arizona,26,Michigan,123,Newaygo County,67,12,55
4,Arizona,26,Michigan,125,Oakland County,1257,491,766
4,Arizona,26,Michigan,127,Oceana County,0,10,-10
4,Arizona,26,Michigan,129,Ogemaw County,20,4,16
4,Arizona,26,Michigan,131,Ontonagon County,0,5,-5
4,Arizona,26,Michigan,137,Otsego County,17,5,12
4,Arizona,26,Michigan,139,Ottawa County,124,98,26
4,Arizona,26,Michigan,143,Roscommon County,63,33,30
4,Arizona,26,Michigan,145,Saginaw County,67,56,11
4,Arizona,26,Michigan,147,St. Clair County,197,99,98
4,Arizona,26,Michigan,149,St. Joseph County,40,0,40
4,Arizona,26,Michigan,151,Sanilac County,11,21,-10
4,Arizona,26,Michigan,155,Shiawassee County,39,0,39
4,Arizona,26,Michigan,157,Tuscola County,26,0,26
4,Arizona,26,Michigan,159,Van Buren County,151,0,151
4,Arizona,26,Michigan,161,Washtenaw County,192,233,-41
4,Arizona,26,Michigan,163,Wayne County,1105,807,298
4,Arizona,26,Michigan,165,Wexford County,28,22,6
4,Arizona,27,Minnesota,1,Aitkin County,0,1,-1
4,Arizona,27,Minnesota,3,Anoka County,442,266,176
4,Arizona,27,Minnesota,5,Becker County,45,2,43
4,Arizona,27,Minnesota,7,Beltrami County,8,38,-30
4,Arizona,27,Minnesota,9,Benton County,0,154,-154
4,Arizona,27,Minnesota,11,Big Stone County,20,1,19
4,Arizona,27,Minnesota,13,Blue Earth County,107,43,64
4,Arizona,27,Minnesota,15,Brown County,0,5,-5
4,Arizona,27,Minnesota,17,Carlton County,98,0,98
4,Arizona,27,Minnesota,19,Carver County,148,18,130
4,Arizona,27,Minnesota,21,Cass County,16,1,15
4,Arizona,27,Minnesota,23,Chippewa County,0,20,-20
4,Arizona,27,Minnesota,25,Chisago County,72,25,47
4,Arizona,27,Minnesota,27,Clay County,140,0,140
4,Arizona,27,Minnesota,33,Cottonwood County,0,4,-4
4,Arizona,27,Minnesota,35,Crow Wing County,15,38,-23
4,Arizona,27,Minnesota,37,Dakota County,554,67,487
4,Arizona,27,Minnesota,39,Dodge County,0,7,-7
4,Arizona,27,Minnesota,41,Douglas County,65,3,62
4,Arizona,27,Minnesota,43,Faribault County,5,14,-9
4,Arizona,27,Minnesota,45,Fillmore County,0,3,-3
4,Arizona,27,Minnesota,47,Freeborn County,39,3,36
4,Arizona,27,Minnesota,49,Goodhue County,19,8,11
4,Arizona,27,Minnesota,51,Grant County,16,0,16
4,Arizona,27,Minnesota,53,Hennepin County,1312,1233,79
4,Arizona,27,Minnesota,57,Hubbard County,9,0,9
4,Arizona,27,Minnesota,59,Isanti County,15,34,-19
4,Arizona,27,Minnesota,61,Itasca County,4,0,4
4,Arizona,27,Minnesota,63,Jackson County,0,24,-24
4,Arizona,27,Minnesota,65,Kanabec County,0,22,-22
4,Arizona,27,Minnesota,67,Kandiyohi County,68,24,44
4,Arizona,27,Minnesota,69,Kittson County,0,4,-4
4,Arizona,27,Minnesota,71,Koochiching County,0,24,-24
4,Arizona,27,Minnesota,73,Lac qui Parle County,45,0,45
4,Arizona,27,Minnesota,75,Lake County,0,4,-4
4,Arizona,27,Minnesota,79,Le Sueur County,28,1,27
4,Arizona,27,Minnesota,83,Lyon County,32,46,-14
4,Arizona,27,Minnesota,85,McLeod County,39,5,34
4,Arizona,27,Minnesota,87,Mahnomen County,0,11,-11
4,Arizona,27,Minnesota,91,Martin County,5,3,2
4,Arizona,27,Minnesota,93,Meeker County,25,5,20
4,Arizona,27,Minnesota,95,Mille Lacs County,18,25,-7
4,Arizona,27,Minnesota,97,Morrison County,40,4,36
4,Arizona,27,Minnesota,101,Murray County,73,0,73
4,Arizona,27,Minnesota,103,Nicollet County,21,16,5
4,Arizona,27,Minnesota,109,Olmsted County,92,150,-58
4,Arizona,27,Minnesota,111,Otter Tail County,84,23,61
4,Arizona,27,Minnesota,113,Pennington County,0,7,-7
4,Arizona,27,Minnesota,115,Pine County,8,0,8
4,Arizona,27,Minnesota,119,Polk County,18,5,13
4,Arizona,27,Minnesota,121,Pope County,8,1,7
4,Arizona,27,Minnesota,123,Ramsey County,750,385,365
4,Arizona,27,Minnesota,127,Redwood County,0,7,-7
4,Arizona,27,Minnesota,131,Rice County,134,15,119
4,Arizona,27,Minnesota,135,Roseau County,117,1,116
4,Arizona,27,Minnesota,137,St. Louis County,323,127,196
4,Arizona,27,Minnesota,139,Scott County,125,142,-17
4,Arizona,27,Minnesota,141,Sherburne County,309,53,256
4,Arizona,27,Minnesota,143,Sibley County,0,13,-13
4,Arizona,27,Minnesota,145,Stearns County,58,132,-74
4,Arizona,27,Minnesota,147,Steele County,0,17,-17
4,Arizona,27,Minnesota,151,Swift County,37,12,25
4,Arizona,27,Minnesota,153,Todd County,0,7,-7
4,Arizona,27,Minnesota,157,Wabasha County,0,25,-25
4,Arizona,27,Minnesota,159,Wadena County,30,0,30
4,Arizona,27,Minnesota,161,Waseca County,10,3,7
4,Arizona,27,Minnesota,163,Washington County,427,43,384
4,Arizona,27,Minnesota,165,Watonwan County,25,0,25
4,Arizona,27,Minnesota,167,Wilkin County,21,0,21
4,Arizona,27,Minnesota,169,Winona County,112,0,112
4,Arizona,27,Minnesota,171,Wright County,8,0,8
4,Arizona,28,Mississippi,1,Adams County,32,0,32
4,Arizona,28,Mississippi,11,Bolivar County,9,0,9
4,Arizona,28,Mississippi,33,DeSoto County,56,129,-73
4,Arizona,28,Mississippi,45,Hancock County,4,0,4
4,Arizona,28,Mississippi,47,Harrison County,236,178,58
4,Arizona,28,Mississippi,49,Hinds County,0,22,-22
4,Arizona,28,Mississippi,59,Jackson County,36,18,18
4,Arizona,28,Mississippi,67,Jones County,0,7,-7
4,Arizona,28,Mississippi,71,Lafayette County,52,9,43
4,Arizona,28,Mississippi,73,Lamar County,25,0,25
4,Arizona,28,Mississippi,81,Lee County,0,16,-16
4,Arizona,28,Mississippi,87,Lowndes County,62,42,20
4,Arizona,28,Mississippi,89,Madison County,0,7,-7
4,Arizona,28,Mississippi,97,Montgomery County,0,36,-36
4,Arizona,28,Mississippi,121,Rankin County,114,39,75
4,Arizona,28,Mississippi,133,Sunflower County,10,0,10
4,Arizona,28,Mississippi,135,Tallahatchie County,64,225,-161
4,Arizona,28,Mississippi,137,Tate County,0,11,-11
4,Arizona,28,Mississippi,151,Washington County,0,1,-1
4,Arizona,29,Missouri,1,Adair County,0,56,-56
4,Arizona,29,Missouri,3,Andrew County,0,16,-16
4,Arizona,29,Missouri,7,Audrain County,0,14,-14
4,Arizona,29,Missouri,9,Barry County,61,0,61
4,Arizona,29,Missouri,17,Bollinger County,0,1,-1
4,Arizona,29,Missouri,19,Boone County,440,310,130
4,Arizona,29,Missouri,21,Buchanan County,16,103,-87
4,Arizona,29,Missouri,27,Callaway County,0,33,-33
4,Arizona,29,Missouri,29,Camden County,10,61,-51
4,Arizona,29,Missouri,31,Cape Girardeau County,25,0,25
4,Arizona,29,Missouri,37,Cass County,34,66,-32
4,Arizona,29,Missouri,39,Cedar County,0,53,-53
4,Arizona,29,Missouri,43,Christian County,69,30,39
4,Arizona,29,Missouri,45,Clark County,0,2,-2
4,Arizona,29,Missouri,47,Clay County,379,386,-7
4,Arizona,29,Missouri,51,Cole County,49,30,19
4,Arizona,29,Missouri,53,Cooper County,24,26,-2
4,Arizona,29,Missouri,57,Dade County,0,3,-3
4,Arizona,29,Missouri,59,Dallas County,0,54,-54
4,Arizona,29,Missouri,69,Dunklin County,0,6,-6
4,Arizona,29,Missouri,71,Franklin County,0,30,-30
4,Arizona,29,Missouri,75,Gentry County,0,3,-3
4,Arizona,29,Missouri,77,Greene County,106,111,-5
4,Arizona,29,Missouri,83,Henry County,80,7,73
4,Arizona,29,Missouri,89,Howard County,29,12,17
4,Arizona,29,Missouri,91,Howell County,50,0,50
4,Arizona,29,Missouri,95,Jackson County,505,455,50
4,Arizona,29,Missouri,97,Jasper County,104,7,97
4,Arizona,29,Missouri,99,Jefferson County,143,13,130
4,Arizona,29,Missouri,101,Johnson County,37,53,-16
4,Arizona,29,Missouri,105,Laclede County,11,0,11
4,Arizona,29,Missouri,107,Lafayette County,42,17,25
4,Arizona,29,Missouri,109,Lawrence County,6,0,6
4,Arizona,29,Missouri,113,Lincoln County,142,0,142
4,Arizona,29,Missouri,115,Linn County,101,10,91
4,Arizona,29,Missouri,117,Livingston County,11,0,11
4,Arizona,29,Missouri,119,McDonald County,34,0,34
4,Arizona,29,Missouri,121,Macon County,0,3,-3
4,Arizona,29,Missouri,125,Maries County,0,53,-53
4,Arizona,29,Missouri,127,Marion County,20,0,20
4,Arizona,29,Missouri,129,Mercer County,0,24,-24
4,Arizona,29,Missouri,131,Miller County,0,24,-24
4,Arizona,29,Missouri,139,Montgomery County,21,0,21
4,Arizona,29,Missouri,141,Morgan County,0,19,-19
4,Arizona,29,Missouri,145,Newton County,24,7,17
4,Arizona,29,Missouri,147,Nodaway County,0,19,-19
4,Arizona,29,Missouri,155,Pemiscot County,0,48,-48
4,Arizona,29,Missouri,157,Perry County,0,10,-10
4,Arizona,29,Missouri,159,Pettis County,11,0,11
4,Arizona,29,Missouri,161,Phelps County,46,0,46
4,Arizona,29,Missouri,163,Pike County,8,1,7
4,Arizona,29,Missouri,165,Platte County,0,126,-126
4,Arizona,29,Missouri,167,Polk County,29,107,-78
4,Arizona,29,Missouri,169,Pulaski County,15,265,-250
4,Arizona,29,Missouri,171,Putnam County,7,0,7
4,Arizona,29,Missouri,175,Randolph County,52,5,47
4,Arizona,29,Missouri,177,Ray County,0,2,-2
4,Arizona,29,Missouri,183,St. Charles County,287,97,190
4,Arizona,29,Missouri,187,St. Francois County,0,19,-19
4,Arizona,29,Missouri,189,St. Louis County,709,354,355
4,Arizona,29,Missouri,195,Saline County,13,0,13
4,Arizona,29,Missouri,201,Scott County,0,26,-26
4,Arizona,29,Missouri,209,Stone County,10,21,-11
4,Arizona,29,Missouri,213,Taney County,10,0,10
4,Arizona,29,Missouri,215,Texas County,0,160,-160
4,Arizona,29,Missouri,217,Vernon County,69,0,69
4,Arizona,29,Missouri,219,Warren County,13,17,-4
4,Arizona,29,Missouri,225,Webster County,0,45,-45
4,Arizona,29,Missouri,229,Wright County,5,0,5
4,Arizona,29,Missouri,510,St. Louis city,481,168,313
4,Arizona,30,Montana,1,Beaverhead County,0,15,-15
4,Arizona,30,Montana,3,Big Horn County,0,15,-15
4,Arizona,30,Montana,7,Broadwater County,23,0,23
4,Arizona,30,Montana,9,Carbon County,151,1,150
4,Arizona,30,Montana,11,Carter County,0,2,-2
4,Arizona,30,Montana,13,Cascade County,319,91,228
4,Arizona,30,Montana,15,Chouteau County,9,81,-72
4,Arizona,30,Montana,17,Custer County,10,13,-3
4,Arizona,30,Montana,19,Daniels County,18,0,18
4,Arizona,30,Montana,21,Dawson County,28,0,28
4,Arizona,30,Montana,23,Deer Lodge County,0,31,-31
4,Arizona,30,Montana,25,Fallon County,0,35,-35
4,Arizona,30,Montana,29,Flathead County,56,102,-46
4,Arizona,30,Montana,31,Gallatin County,133,31,102
4,Arizona,30,Montana,35,Glacier County,0,18,-18
4,Arizona,30,Montana,39,Granite County,0,14,-14
4,Arizona,30,Montana,41,Hill County,75,27,48
4,Arizona,30,Montana,43,Jefferson County,0,5,-5
4,Arizona,30,Montana,47,Lake County,34,39,-5
4,Arizona,30,Montana,49,Lewis and Clark County,256,119,137
4,Arizona,30,Montana,53,Lincoln County,0,53,-53
4,Arizona,30,Montana,57,Madison County,17,0,17
4,Arizona,30,Montana,61,Mineral County,0,12,-12
4,Arizona,30,Montana,63,Missoula County,415,29,386
4,Arizona,30,Montana,65,Musselshell County,0,5,-5
4,Arizona,30,Montana,67,Park County,89,4,85
4,Arizona,30,Montana,71,Phillips County,2,0,2
4,Arizona,30,Montana,73,Pondera County,9,8,1
4,Arizona,30,Montana,77,Powell County,0,3,-3
4,Arizona,30,Montana,81,Ravalli County,30,130,-100
4,Arizona,30,Montana,83,Richland County,32,0,32
4,Arizona,30,Montana,91,Sheridan County,0,2,-2
4,Arizona,30,Montana,93,Silver Bow County,0,74,-74
4,Arizona,30,Montana,95,Stillwater County,9,13,-4
4,Arizona,30,Montana,101,Toole County,0,21,-21
4,Arizona,30,Montana,103,Treasure County,0,9,-9
4,Arizona,30,Montana,105,Valley County,79,0,79
4,Arizona,30,Montana,109,Wibaux County,23,0,23
4,Arizona,30,Montana,111,Yellowstone County,216,185,31
4,Arizona,31,Nebraska,1,Adams County,174,12,162
4,Arizona,31,Nebraska,3,Antelope County,0,2,-2
4,Arizona,31,Nebraska,13,Box Butte County,4,34,-30
4,Arizona,31,Nebraska,19,Buffalo County,11,0,11
4,Arizona,31,Nebraska,25,Cass County,0,1,-1
4,Arizona,31,Nebraska,27,Cedar County,0,18,-18
4,Arizona,31,Nebraska,33,Cheyenne County,0,29,-29
4,Arizona,31,Nebraska,37,Colfax County,0,30,-30
4,Arizona,31,Nebraska,41,Custer County,0,91,-91
4,Arizona,31,Nebraska,43,Dakota County,0,1,-1
4,Arizona,31,Nebraska,45,Dawes County,17,5,12
4,Arizona,31,Nebraska,49,Deuel County,0,5,-5
4,Arizona,31,Nebraska,53,Dodge County,10,5,5
4,Arizona,31,Nebraska,55,Douglas County,934,389,545
4,Arizona,31,Nebraska,57,Dundy County,0,5,-5
4,Arizona,31,Nebraska,59,Fillmore County,0,4,-4
4,Arizona,31,Nebraska,63,Frontier County,20,0,20
4,Arizona,31,Nebraska,67,Gage County,11,0,11
4,Arizona,31,Nebraska,79,Hall County,43,2,41
4,Arizona,31,Nebraska,83,Harlan County,0,10,-10
4,Arizona,31,Nebraska,93,Howard County,10,0,10
4,Arizona,31,Nebraska,101,Keith County,46,0,46
4,Arizona,31,Nebraska,107,Knox County,0,12,-12
4,Arizona,31,Nebraska,109,Lancaster County,217,260,-43
4,Arizona,31,Nebraska,111,Lincoln County,0,31,-31
4,Arizona,31,Nebraska,119,Madison County,0,37,-37
4,Arizona,31,Nebraska,123,Morrill County,23,15,8
4,Arizona,31,Nebraska,125,Nance County,0,8,-8
4,Arizona,31,Nebraska,127,Nemaha County,9,0,9
4,Arizona,31,Nebraska,131,Otoe County,0,40,-40
4,Arizona,31,Nebraska,133,Pawnee County,0,3,-3
4,Arizona,31,Nebraska,139,Pierce County,0,12,-12
4,Arizona,31,Nebraska,141,Platte County,29,21,8
4,Arizona,31,Nebraska,145,Red Willow County,0,6,-6
4,Arizona,31,Nebraska,147,Richardson County,16,3,13
4,Arizona,31,Nebraska,153,Sarpy County,123,155,-32
4,Arizona,31,Nebraska,155,Saunders County,0,4,-4
4,Arizona,31,Nebraska,159,Seward County,0,5,-5
4,Arizona,31,Nebraska,161,Sheridan County,0,6,-6
4,Arizona,31,Nebraska,163,Sherman County,0,3,-3
4,Arizona,31,Nebraska,165,Sioux County,0,6,-6
4,Arizona,31,Nebraska,167,Stanton County,0,4,-4
4,Arizona,31,Nebraska,173,Thurston County,0,9,-9
4,Arizona,31,Nebraska,175,Valley County,0,2,-2
4,Arizona,31,Nebraska,177,Washington County,37,76,-39
4,Arizona,31,Nebraska,179,Wayne County,17,0,17
4,Arizona,32,Nevada,1,Churchill County,0,82,-82
4,Arizona,32,Nevada,3,Clark County,6013,4718,1295
4,Arizona,32,Nevada,5,Douglas County,128,26,102
4,Arizona,32,Nevada,7,Elko County,136,108,28
4,Arizona,32,Nevada,9,Esmeralda County,0,6,-6
4,Arizona,32,Nevada,11,Eureka County,11,0,11
4,Arizona,32,Nevada,13,Humboldt County,56,11,45
4,Arizona,32,Nevada,15,Lander County,49,1,48
4,Arizona,32,Nevada,17,Lincoln County,0,1,-1
4,Arizona,32,Nevada,19,Lyon County,28,295,-267
4,Arizona,32,Nevada,23,Nye County,298,24,274
4,Arizona,32,Nevada,29,Storey County,49,0,49
4,Arizona,32,Nevada,31,Washoe County,611,513,98
4,Arizona,32,Nevada,33,White Pine County,0,3,-3
4,Arizona,32,Nevada,510,Carson City,135,60,75
4,Arizona,33,New Hampshire,1,Belknap County,29,14,15
4,Arizona,33,New Hampshire,5,Cheshire County,233,5,228
4,Arizona,33,New Hampshire,7,Coos County,34,40,-6
4,Arizona,33,New Hampshire,9,Grafton County,7,126,-119
4,Arizona,33,New Hampshire,11,Hillsborough County,110,79,31
4,Arizona,33,New Hampshire,13,Merrimack County,93,19,74
4,Arizona,33,New Hampshire,15,Rockingham County,74,35,39
4,Arizona,33,New Hampshire,17,Strafford County,0,17,-17
4,Arizona,33,New Hampshire,19,Sullivan County,0,3,-3
4,Arizona,34,New Jersey,1,Atlantic County,16,0,16
4,Arizona,34,New Jersey,3,Bergen County,345,101,244
4,Arizona,34,New Jersey,5,Burlington County,104,88,16
4,Arizona,34,New Jersey,7,Camden County,96,74,22
4,Arizona,34,New Jersey,9,Cape May County,28,0,28
4,Arizona,34,New Jersey,11,Cumberland County,6,17,-11
4,Arizona,34,New Jersey,13,Essex County,247,14,233
4,Arizona,34,New Jersey,15,Gloucester County,85,27,58
4,Arizona,34,New Jersey,17,Hudson County,352,50,302
4,Arizona,34,New Jersey,19,Hunterdon County,38,0,38
4,Arizona,34,New Jersey,21,Mercer County,120,55,65
4,Arizona,34,New Jersey,23,Middlesex County,611,251,360
4,Arizona,34,New Jersey,25,Monmouth County,180,31,149
4,Arizona,34,New Jersey,27,Morris County,213,184,29
4,Arizona,34,New Jersey,29,Ocean County,129,44,85
4,Arizona,34,New Jersey,31,Passaic County,393,52,341
4,Arizona,34,New Jersey,35,Somerset County,76,37,39
4,Arizona,34,New Jersey,37,Sussex County,97,0,97
4,Arizona,34,New Jersey,39,Union County,288,57,231
4,Arizona,34,New Jersey,41,Warren County,13,0,13
4,Arizona,35,New Mexico,1,Bernalillo County,2075,1321,754
4,Arizona,35,New Mexico,3,Catron County,57,35,22
4,Arizona,35,New Mexico,5,Chaves County,117,148,-31
4,Arizona,35,New Mexico,6,Cibola County,293,119,174
4,Arizona,35,New Mexico,7,Colfax County,0,54,-54
4,Arizona,35,New Mexico,9,Curry County,97,215,-118
4,Arizona,35,New Mexico,13,Doña Ana County,666,1002,-336
4,Arizona,35,New Mexico,15,Eddy County,582,264,318
4,Arizona,35,New Mexico,17,Grant County,466,149,317
4,Arizona,35,New Mexico,19,Guadalupe County,0,9,-9
4,Arizona,35,New Mexico,23,Hidalgo County,42,88,-46
4,Arizona,35,New Mexico,25,Lea County,44,31,13
4,Arizona,35,New Mexico,27,Lincoln County,44,85,-41
4,Arizona,35,New Mexico,28,Los Alamos County,87,44,43
4,Arizona,35,New Mexico,29,Luna County,256,228,28
4,Arizona,35,New Mexico,31,McKinley County,751,540,211
4,Arizona,35,New Mexico,35,Otero County,58,343,-285
4,Arizona,35,New Mexico,37,Quay County,19,0,19
4,Arizona,35,New Mexico,39,Rio Arriba County,10,29,-19
4,Arizona,35,New Mexico,41,Roosevelt County,0,41,-41
4,Arizona,35,New Mexico,43,Sandoval County,932,465,467
4,Arizona,35,New Mexico,45,San Juan County,467,863,-396
4,Arizona,35,New Mexico,47,San Miguel County,43,25,18
4,Arizona,35,New Mexico,49,Santa Fe County,463,307,156
4,Arizona,35,New Mexico,51,Sierra County,0,14,-14
4,Arizona,35,New Mexico,53,Socorro County,142,0,142
4,Arizona,35,New Mexico,55,Taos County,0,30,-30
4,Arizona,35,New Mexico,57,Torrance County,37,39,-2
4,Arizona,35,New Mexico,61,Valencia County,180,49,131
4,Arizona,36,New York,1,Albany County,83,24,59
4,Arizona,36,New York,3,Allegany County,0,48,-48
4,Arizona,36,New York,5,Bronx County,93,135,-42
4,Arizona,36,New York,7,Broome County,41,0,41
4,Arizona,36,New York,9,Cattaraugus County,15,61,-46
4,Arizona,36,New York,11,Cayuga County,9,24,-15
4,Arizona,36,New York,13,Chautauqua County,51,37,14
4,Arizona,36,New York,15,Chemung County,61,0,61
4,Arizona,36,New York,19,Clinton County,32,4,28
4,Arizona,36,New York,21,Columbia County,17,0,17
4,Arizona,36,New York,23,Cortland County,0,2,-2
4,Arizona,36,New York,25,Delaware County,0,10,-10
4,Arizona,36,New York,27,Dutchess County,84,45,39
4,Arizona,36,New York,29,Erie County,303,245,58
4,Arizona,36,New York,33,Franklin County,0,23,-23
4,Arizona,36,New York,37,Genesee County,8,9,-1
4,Arizona,36,New York,43,Herkimer County,9,0,9
4,Arizona,36,New York,45,Jefferson County,32,186,-154
4,Arizona,36,New York,47,Kings County,615,297,318
4,Arizona,36,New York,49,Lewis County,7,0,7
4,Arizona,36,New York,51,Livingston County,31,0,31
4,Arizona,36,New York,53,Madison County,31,31,0
4,Arizona,36,New York,55,Monroe County,337,173,164
4,Arizona,36,New York,57,Montgomery County,0,18,-18
4,Arizona,36,New York,59,Nassau County,41,107,-66
4,Arizona,36,New York,61,New York County,945,1620,-675
4,Arizona,36,New York,63,Niagara County,236,95,141
4,Arizona,36,New York,65,Oneida County,0,101,-101
4,Arizona,36,New York,67,Onondaga County,63,178,-115
4,Arizona,36,New York,69,Ontario County,0,35,-35
4,Arizona,36,New York,71,Orange County,169,73,96
4,Arizona,36,New York,75,Oswego County,139,72,67
4,Arizona,36,New York,77,Otsego County,10,56,-46
4,Arizona,36,New York,79,Putnam County,5,83,-78
4,Arizona,36,New York,81,Queens County,562,182,380
4,Arizona,36,New York,83,Rensselaer County,44,26,18
4,Arizona,36,New York,85,Richmond County,208,9,199
4,Arizona,36,New York,87,Rockland County,76,39,37
4,Arizona,36,New York,89,St. Lawrence County,11,23,-12
4,Arizona,36,New York,91,Saratoga County,94,487,-393
4,Arizona,36,New York,93,Schenectady County,24,66,-42
4,Arizona,36,New York,97,Schuyler County,0,6,-6
4,Arizona,36,New York,101,Steuben County,111,0,111
4,Arizona,36,New York,103,Suffolk County,559,271,288
4,Arizona,36,New York,107,Tioga County,18,5,13
4,Arizona,36,New York,109,Tompkins County,58,17,41
4,Arizona,36,New York,111,Ulster County,35,37,-2
4,Arizona,36,New York,113,Warren County,8,7,1
4,Arizona,36,New York,115,Washington County,45,0,45
4,Arizona,36,New York,117,Wayne County,23,234,-211
4,Arizona,36,New York,119,Westchester County,259,55,204
4,Arizona,36,New York,123,Yates County,0,14,-14
4,Arizona,37,North Carolina,1,Alamance County,9,0,9
4,Arizona,37,North Carolina,21,Buncombe County,134,121,13
4,Arizona,37,North Carolina,25,Cabarrus County,74,0,74
4,Arizona,37,North Carolina,27,Caldwell County,0,19,-19
4,Arizona,37,North Carolina,31,Carteret County,125,0,125
4,Arizona,37,North Carolina,35,Catawba County,0,88,-88
4,Arizona,37,North Carolina,37,Chatham County,45,15,30
4,Arizona,37,North Carolina,41,Chowan County,0,34,-34
4,Arizona,37,North Carolina,49,Craven County,316,249,67
4,Arizona,37,North Carolina,51,Cumberland County,478,937,-459
4,Arizona,37,North Carolina,53,Currituck County,8,15,-7
4,Arizona,37,North Carolina,57,Davidson County,0,9,-9
4,Arizona,37,North Carolina,61,Duplin County,26,0,26
4,Arizona,37,North Carolina,63,Durham County,159,248,-89
4,Arizona,37,North Carolina,67,Forsyth County,132,7,125
4,Arizona,37,North Carolina,69,Franklin County,0,3,-3
4,Arizona,37,North Carolina,71,Gaston County,50,35,15
4,Arizona,37,North Carolina,75,Graham County,16,0,16
4,Arizona,37,North Carolina,81,Guilford County,110,297,-187
4,Arizona,37,North Carolina,83,Halifax County,11,0,11
4,Arizona,37,North Carolina,85,Harnett County,139,42,97
4,Arizona,37,North Carolina,89,Henderson County,94,63,31
4,Arizona,37,North Carolina,97,Iredell County,29,48,-19
4,Arizona,37,North Carolina,99,Jackson County,0,30,-30
4,Arizona,37,North Carolina,101,Johnston County,122,97,25
4,Arizona,37,North Carolina,113,Macon County,0,10,-10
4,Arizona,37,North Carolina,119,Mecklenburg County,527,643,-116
4,Arizona,37,North Carolina,125,Moore County,167,14,153
4,Arizona,37,North Carolina,127,Nash County,0,19,-19
4,Arizona,37,North Carolina,129,New Hanover County,60,5,55
4,Arizona,37,North Carolina,133,Onslow County,281,423,-142
4,Arizona,37,North Carolina,135,Orange County,60,25,35
4,Arizona,37,North Carolina,151,Randolph County,13,0,13
4,Arizona,37,North Carolina,159,Rowan County,0,59,-59
4,Arizona,37,North Carolina,161,Rutherford County,23,102,-79
4,Arizona,37,North Carolina,163,Sampson County,0,14,-14
4,Arizona,37,North Carolina,167,Stanly County,0,30,-30
4,Arizona,37,North Carolina,169,Stokes County,12,43,-31
4,Arizona,37,North Carolina,179,Union County,114,272,-158
4,Arizona,37,North Carolina,183,Wake County,290,520,-230
4,Arizona,37,North Carolina,189,Watauga County,97,0,97
4,Arizona,37,North Carolina,191,Wayne County,97,135,-38
4,Arizona,37,North Carolina,193,Wilkes County,0,11,-11
4,Arizona,37,North Carolina,197,Yadkin County,64,0,64
4,Arizona,38,North Dakota,3,Barnes County,9,0,9
4,Arizona,38,North Dakota,9,Bottineau County,38,0,38
4,Arizona,38,North Dakota,15,Burleigh County,126,19,107
4,Arizona,38,North Dakota,17,Cass County,461,65,396
4,Arizona,38,North Dakota,21,Dickey County,29,0,29
4,Arizona,38,North Dakota,35,Grand Forks County,128,160,-32
4,Arizona,38,North Dakota,39,Griggs County,0,11,-11
4,Arizona,38,North Dakota,43,Kidder County,0,6,-6
4,Arizona,38,North Dakota,49,McHenry County,0,2,-2
4,Arizona,38,North Dakota,55,McLean County,79,0,79
4,Arizona,38,North Dakota,57,Mercer County,7,0,7
4,Arizona,38,North Dakota,59,Morton County,17,15,2
4,Arizona,38,North Dakota,61,Mountrail County,0,36,-36
4,Arizona,38,North Dakota,63,Nelson County,0,11,-11
4,Arizona,38,North Dakota,67,Pembina County,0,3,-3
4,Arizona,38,North Dakota,73,Ransom County,0,5,-5
4,Arizona,38,North Dakota,75,Renville County,0,5,-5
4,Arizona,38,North Dakota,77,Richland County,23,0,23
4,Arizona,38,North Dakota,85,Sioux County,0,51,-51
4,Arizona,38,North Dakota,89,Stark County,52,117,-65
4,Arizona,38,North Dakota,93,Stutsman County,0,153,-153
4,Arizona,38,North Dakota,99,Walsh County,15,0,15
4,Arizona,38,North Dakota,101,Ward County,250,124,126
4,Arizona,38,North Dakota,103,Wells County,0,5,-5
4,Arizona,38,North Dakota,105,Williams County,306,127,179
4,Arizona,39,Ohio,1,Adams County,52,0,52
4,Arizona,39,Ohio,3,Allen County,0,16,-16
4,Arizona,39,Ohio,7,Ashtabula County,0,28,-28
4,Arizona,39,Ohio,9,Athens County,7,2,5
4,Arizona,39,Ohio,11,Auglaize County,8,0,8
4,Arizona,39,Ohio,13,Belmont County,0,28,-28
4,Arizona,39,Ohio,17,Butler County,45,27,18
4,Arizona,39,Ohio,19,Carroll County,35,0,35
4,Arizona,39,Ohio,21,Champaign County,93,0,93
4,Arizona,39,Ohio,23,Clark County,20,97,-77
4,Arizona,39,Ohio,25,Clermont County,138,0,138
4,Arizona,39,Ohio,29,Columbiana County,0,45,-45
4,Arizona,39,Ohio,31,Coshocton County,0,2,-2
4,Arizona,39,Ohio,33,Crawford County,20,3,17
4,Arizona,39,Ohio,35,Cuyahoga County,301,294,7
4,Arizona,39,Ohio,37,Darke County,17,0,17
4,Arizona,39,Ohio,41,Delaware County,205,70,135
4,Arizona,39,Ohio,43,Erie County,9,26,-17
4,Arizona,39,Ohio,45,Fairfield County,68,7,61
4,Arizona,39,Ohio,47,Fayette County,38,0,38
4,Arizona,39,Ohio,49,Franklin County,707,645,62
4,Arizona,39,Ohio,51,Fulton County,0,20,-20
4,Arizona,39,Ohio,55,Geauga County,64,16,48
4,Arizona,39,Ohio,57,Greene County,239,32,207
4,Arizona,39,Ohio,61,Hamilton County,287,121,166
4,Arizona,39,Ohio,63,Hancock County,0,8,-8
4,Arizona,39,Ohio,69,Henry County,0,35,-35
4,Arizona,39,Ohio,71,Highland County,20,0,20
4,Arizona,39,Ohio,75,Holmes County,0,45,-45
4,Arizona,39,Ohio,77,Huron County,0,2,-2
4,Arizona,39,Ohio,81,Jefferson County,26,47,-21
4,Arizona,39,Ohio,83,Knox County,0,92,-92
4,Arizona,39,Ohio,85,Lake County,188,60,128
4,Arizona,39,Ohio,87,Lawrence County,100,0,100
4,Arizona,39,Ohio,89,Licking County,143,63,80
4,Arizona,39,Ohio,91,Logan County,0,22,-22
4,Arizona,39,Ohio,93,Lorain County,241,64,177
4,Arizona,39,Ohio,95,Lucas County,96,57,39
4,Arizona,39,Ohio,99,Mahoning County,181,76,105
4,Arizona,39,Ohio,101,Marion County,0,28,-28
4,Arizona,39,Ohio,103,Medina County,172,0,172
4,Arizona,39,Ohio,109,Miami County,32,0,32
4,Arizona,39,Ohio,111,Monroe County,0,9,-9
4,Arizona,39,Ohio,113,Montgomery County,149,243,-94
4,Arizona,39,Ohio,117,Morrow County,26,0,26
4,Arizona,39,Ohio,119,Muskingum County,16,68,-52
4,Arizona,39,Ohio,127,Perry County,15,0,15
4,Arizona,39,Ohio,129,Pickaway County,29,7,22
4,Arizona,39,Ohio,133,Portage County,85,121,-36
4,Arizona,39,Ohio,135,Preble County,11,11,0
4,Arizona,39,Ohio,137,Putnam County,17,0,17
4,Arizona,39,Ohio,139,Richland County,26,98,-72
4,Arizona,39,Ohio,141,Ross County,27,0,27
4,Arizona,39,Ohio,143,Sandusky County,56,0,56
4,Arizona,39,Ohio,147,Seneca County,0,179,-179
4,Arizona,39,Ohio,151,Stark County,180,64,116
4,Arizona,39,Ohio,153,Summit County,125,30,95
4,Arizona,39,Ohio,155,Trumbull County,300,26,274
4,Arizona,39,Ohio,159,Union County,8,0,8
4,Arizona,39,Ohio,165,Warren County,29,90,-61
4,Arizona,39,Ohio,169,Wayne County,26,0,26
4,Arizona,39,Ohio,173,Wood County,106,34,72
4,Arizona,39,Ohio,175,Wyandot County,0,21,-21
4,Arizona,4,Arizona,1,Apache County,3246,1540,1706
4,Arizona,4,Arizona,3,Cochise County,4398,5222,-824
4,Arizona,4,Arizona,5,Coconino County,6793,9230,-2437
4,Arizona,4,Arizona,7,Gila County,3253,2684,569
4,Arizona,4,Arizona,9,Graham County,1718,2212,-494
4,Arizona,4,Arizona,11,Greenlee County,371,563,-192
4,Arizona,4,Arizona,12,La Paz County,372,371,1
4,Arizona,4,Arizona,13,Maricopa County,44893,37636,7257
4,Arizona,4,Arizona,15,Mohave County,5146,3140,2006
4,Arizona,4,Arizona,17,Navajo County,3510,5165,-1655
4,Arizona,4,Arizona,19,Pima County,16602,17304,-702
4,Arizona,4,Arizona,21,Pinal County,18759,22963,-4204
4,Arizona,4,Arizona,23,Santa Cruz County,2050,738,1312
4,Arizona,4,Arizona,25,Yavapai County,5065,8517,-3452
4,Arizona,4,Arizona,27,Yuma County,4315,3206,1109
4,Arizona,40,Oklahoma,5,Atoka County,0,11,-11
4,Arizona,40,Oklahoma,9,Beckham County,24,21,3
4,Arizona,40,Oklahoma,11,Blaine County,0,6,-6
4,Arizona,40,Oklahoma,13,Bryan County,0,20,-20
4,Arizona,40,Oklahoma,15,Caddo County,5,88,-83
4,Arizona,40,Oklahoma,17,Canadian County,302,116,186
4,Arizona,40,Oklahoma,19,Carter County,71,29,42
4,Arizona,40,Oklahoma,21,Cherokee County,0,67,-67
4,Arizona,40,Oklahoma,23,Choctaw County,0,1,-1
4,Arizona,40,Oklahoma,25,Cimarron County,18,0,18
4,Arizona,40,Oklahoma,27,Cleveland County,465,463,2
4,Arizona,40,Oklahoma,31,Comanche County,117,161,-44
4,Arizona,40,Oklahoma,39,Custer County,9,0,9
4,Arizona,40,Oklahoma,41,Delaware County,214,20,194
4,Arizona,40,Oklahoma,47,Garfield County,76,35,41
4,Arizona,40,Oklahoma,49,Garvin County,77,0,77
4,Arizona,40,Oklahoma,51,Grady County,277,36,241
4,Arizona,40,Oklahoma,61,Haskell County,0,3,-3
4,Arizona,40,Oklahoma,65,Jackson County,0,20,-20
4,Arizona,40,Oklahoma,67,Jefferson County,0,4,-4
4,Arizona,40,Oklahoma,69,Johnston County,0,1,-1
4,Arizona,40,Oklahoma,71,Kay County,33,8,25
4,Arizona,40,Oklahoma,75,Kiowa County,0,2,-2
4,Arizona,40,Oklahoma,79,Le Flore County,0,18,-18
4,Arizona,40,Oklahoma,83,Logan County,57,0,57
4,Arizona,40,Oklahoma,85,Love County,0,8,-8
4,Arizona,40,Oklahoma,87,McClain County,89,16,73
4,Arizona,40,Oklahoma,89,McCurtain County,0,20,-20
4,Arizona,40,Oklahoma,93,Major County,0,13,-13
4,Arizona,40,Oklahoma,97,Mayes County,18,23,-5
4,Arizona,40,Oklahoma,99,Murray County,12,0,12
4,Arizona,40,Oklahoma,101,Muskogee County,123,36,87
4,Arizona,40,Oklahoma,107,Okfuskee County,107,0,107
4,Arizona,40,Oklahoma,109,Oklahoma County,780,508,272
4,Arizona,40,Oklahoma,113,Osage County,0,87,-87
4,Arizona,40,Oklahoma,115,Ottawa County,0,3,-3
4,Arizona,40,Oklahoma,119,Payne County,12,31,-19
4,Arizona,40,Oklahoma,121,Pittsburg County,0,21,-21
4,Arizona,40,Oklahoma,123,Pontotoc County,16,30,-14
4,Arizona,40,Oklahoma,125,Pottawatomie County,67,10,57
4,Arizona,40,Oklahoma,127,Pushmataha County,0,2,-2
4,Arizona,40,Oklahoma,129,Roger Mills County,17,0,17
4,Arizona,40,Oklahoma,131,Rogers County,0,41,-41
4,Arizona,40,Oklahoma,133,Seminole County,11,0,11
4,Arizona,40,Oklahoma,135,Sequoyah County,71,34,37
4,Arizona,40,Oklahoma,137,Stephens County,0,14,-14
4,Arizona,40,Oklahoma,139,Texas County,58,0,58
4,Arizona,40,Oklahoma,141,Tillman County,31,0,31
4,Arizona,40,Oklahoma,143,Tulsa County,896,710,186
4,Arizona,40,Oklahoma,145,Wagoner County,103,0,103
4,Arizona,40,Oklahoma,147,Washington County,102,24,78
4,Arizona,41,Oregon,3,Benton County,159,249,-90
4,Arizona,41,Oregon,5,Clackamas County,583,685,-102
4,Arizona,41,Oregon,7,Clatsop County,175,0,175
4,Arizona,41,Oregon,9,Columbia County,22,14,8
4,Arizona,41,Oregon,11,Coos County,215,201,14
4,Arizona,41,Oregon,13,Crook County,28,29,-1
4,Arizona,41,Oregon,17,Deschutes County,611,832,-221
4,Arizona,41,Oregon,19,Douglas County,153,296,-143
4,Arizona,41,Oregon,23,Grant County,7,0,7
4,Arizona,41,Oregon,25,Harney County,69,0,69
4,Arizona,41,Oregon,27,Hood River County,10,0,10
4,Arizona,41,Oregon,29,Jackson County,651,336,315
4,Arizona,41,Oregon,31,Jefferson County,0,7,-7
4,Arizona,41,Oregon,33,Josephine County,132,153,-21
4,Arizona,41,Oregon,35,Klamath County,283,95,188
4,Arizona,41,Oregon,37,Lake County,0,2,-2
4,Arizona,41,Oregon,39,Lane County,705,391,314
4,Arizona,41,Oregon,41,Lincoln County,83,25,58
4,Arizona,41,Oregon,43,Linn County,339,88,251
4,Arizona,41,Oregon,45,Malheur County,0,4,-4
4,Arizona,41,Oregon,47,Marion County,379,452,-73
4,Arizona,41,Oregon,49,Morrow County,0,29,-29
4,Arizona,41,Oregon,51,Multnomah County,1870,1341,529
4,Arizona,41,Oregon,53,Polk County,299,295,4
4,Arizona,41,Oregon,57,Tillamook County,31,13,18
4,Arizona,41,Oregon,59,Umatilla County,237,79,158
4,Arizona,41,Oregon,61,Union County,33,11,22
4,Arizona,41,Oregon,63,Wallowa County,0,5,-5
4,Arizona,41,Oregon,65,Wasco County,128,19,109
4,Arizona,41,Oregon,67,Washington County,1295,1370,-75
4,Arizona,41,Oregon,71,Yamhill County,409,204,205
4,Arizona,42,Pennsylvania,1,Adams County,8,18,-10
4,Arizona,42,Pennsylvania,3,Allegheny County,335,207,128
4,Arizona,42,Pennsylvania,5,Armstrong County,0,107,-107
4,Arizona,42,Pennsylvania,7,Beaver County,18,64,-46
4,Arizona,42,Pennsylvania,11,Berks County,84,115,-31
4,Arizona,42,Pennsylvania,13,Blair County,65,4,61
4,Arizona,42,Pennsylvania,17,Bucks County,108,126,-18
4,Arizona,42,Pennsylvania,19,Butler County,238,86,152
4,Arizona,42,Pennsylvania,21,Cambria County,10,26,-16
4,Arizona,42,Pennsylvania,25,Carbon County,0,101,-101
4,Arizona,42,Pennsylvania,27,Centre County,17,0,17
4,Arizona,42,Pennsylvania,29,Chester County,554,154,400
4,Arizona,42,Pennsylvania,31,Clarion County,0,6,-6
4,Arizona,42,Pennsylvania,33,Clearfield County,19,6,13
4,Arizona,42,Pennsylvania,35,Clinton County,10,39,-29
4,Arizona,42,Pennsylvania,37,Columbia County,56,10,46
4,Arizona,42,Pennsylvania,39,Crawford County,102,3,99
4,Arizona,42,Pennsylvania,41,Cumberland County,44,27,17
4,Arizona,42,Pennsylvania,43,Dauphin County,123,85,38
4,Arizona,42,Pennsylvania,45,Delaware County,333,219,114
4,Arizona,42,Pennsylvania,49,Erie County,416,94,322
4,Arizona,42,Pennsylvania,51,Fayette County,91,25,66
4,Arizona,42,Pennsylvania,55,Franklin County,16,39,-23
4,Arizona,42,Pennsylvania,59,Greene County,0,6,-6
4,Arizona,42,Pennsylvania,61,Huntingdon County,0,8,-8
4,Arizona,42,Pennsylvania,65,Jefferson County,0,5,-5
4,Arizona,42,Pennsylvania,67,Juniata County,0,6,-6
4,Arizona,42,Pennsylvania,69,Lackawanna County,39,29,10
4,Arizona,42,Pennsylvania,71,Lancaster County,133,6,127
4,Arizona,42,Pennsylvania,73,Lawrence County,48,7,41
4,Arizona,42,Pennsylvania,75,Lebanon County,17,14,3
4,Arizona,42,Pennsylvania,77,Lehigh County,114,52,62
4,Arizona,42,Pennsylvania,79,Luzerne County,124,5,119
4,Arizona,42,Pennsylvania,81,Lycoming County,109,8,101
4,Arizona,42,Pennsylvania,83,McKean County,18,0,18
4,Arizona,42,Pennsylvania,85,Mercer County,122,15,107
4,Arizona,42,Pennsylvania,89,Monroe County,44,50,-6
4,Arizona,42,Pennsylvania,91,Montgomery County,339,198,141
4,Arizona,42,Pennsylvania,95,Northampton County,308,13,295
4,Arizona,42,Pennsylvania,97,Northumberland County,21,9,12
4,Arizona,42,Pennsylvania,99,Perry County,0,19,-19
4,Arizona,42,Pennsylvania,101,Philadelphia County,519,319,200
4,Arizona,42,Pennsylvania,103,Pike County,0,8,-8
4,Arizona,42,Pennsylvania,107,Schuylkill County,96,72,24
4,Arizona,42,Pennsylvania,111,Somerset County,49,4,45
4,Arizona,42,Pennsylvania,115,Susquehanna County,0,23,-23
4,Arizona,42,Pennsylvania,117,Tioga County,67,0,67
4,Arizona,42,Pennsylvania,119,Union County,18,40,-22
4,Arizona,42,Pennsylvania,123,Warren County,9,32,-23
4,Arizona,42,Pennsylvania,125,Washington County,25,2,23
4,Arizona,42,Pennsylvania,127,Wayne County,42,15,27
4,Arizona,42,Pennsylvania,129,Westmoreland County,203,6,197
4,Arizona,42,Pennsylvania,131,Wyoming County,0,18,-18
4,Arizona,42,Pennsylvania,133,York County,80,94,-14
4,Arizona,44,Rhode Island,1,Bristol County,0,5,-5
4,Arizona,44,Rhode Island,3,Kent County,527,91,436
4,Arizona,44,Rhode Island,5,Newport County,0,42,-42
4,Arizona,44,Rhode Island,7,Providence County,142,94,48
4,Arizona,44,Rhode Island,9,Washington County,2,0,2
4,Arizona,45,South Carolina,3,Aiken County,0,25,-25
4,Arizona,45,South Carolina,7,Anderson County,23,41,-18
4,Arizona,45,South Carolina,13,Beaufort County,131,308,-177
4,Arizona,45,South Carolina,15,Berkeley County,68,147,-79
4,Arizona,45,South Carolina,19,Charleston County,304,81,223
4,Arizona,45,South Carolina,23,Chester County,25,0,25
4,Arizona,45,South Carolina,25,Chesterfield County,0,16,-16
4,Arizona,45,South Carolina,27,Clarendon County,21,0,21
4,Arizona,45,South Carolina,35,Dorchester County,10,22,-12
4,Arizona,45,South Carolina,41,Florence County,12,0,12
4,Arizona,45,South Carolina,45,Greenville County,71,168,-97
4,Arizona,45,South Carolina,47,Greenwood County,8,0,8
4,Arizona,45,South Carolina,51,Horry County,24,67,-43
4,Arizona,45,South Carolina,53,Jasper County,23,0,23
4,Arizona,45,South Carolina,57,Lancaster County,0,39,-39
4,Arizona,45,South Carolina,59,Laurens County,0,40,-40
4,Arizona,45,South Carolina,63,Lexington County,14,64,-50
4,Arizona,45,South Carolina,71,Newberry County,55,0,55
4,Arizona,45,South Carolina,73,Oconee County,0,21,-21
4,Arizona,45,South Carolina,75,Orangeburg County,0,1,-1
4,Arizona,45,South Carolina,77,Pickens County,0,65,-65
4,Arizona,45,South Carolina,79,Richland County,260,427,-167
4,Arizona,45,South Carolina,83,Spartanburg County,129,137,-8
4,Arizona,45,South Carolina,85,Sumter County,45,148,-103
4,Arizona,45,South Carolina,91,York County,40,70,-30
4,Arizona,46,South Dakota,3,Aurora County,0,3,-3
4,Arizona,46,South Dakota,5,Beadle County,40,17,23
4,Arizona,46,South Dakota,11,Brookings County,59,0,59
4,Arizona,46,South Dakota,13,Brown County,10,10,0
4,Arizona,46,South Dakota,19,Butte County,6,0,6
4,Arizona,46,South Dakota,25,Clark County,0,31,-31
4,Arizona,46,South Dakota,27,Clay County,0,5,-5
4,Arizona,46,South Dakota,29,Codington County,123,14,109
4,Arizona,46,South Dakota,31,Corson County,22,0,22
4,Arizona,46,South Dakota,33,Custer County,36,0,36
4,Arizona,46,South Dakota,35,Davison County,93,60,33
4,Arizona,46,South Dakota,37,Day County,0,11,-11
4,Arizona,46,South Dakota,47,Fall River County,17,22,-5
4,Arizona,46,South Dakota,49,Faulk County,0,23,-23
4,Arizona,46,South Dakota,61,Hanson County,0,33,-33
4,Arizona,46,South Dakota,65,Hughes County,174,27,147
4,Arizona,46,South Dakota,67,Hutchinson County,0,46,-46
4,Arizona,46,South Dakota,71,Jackson County,0,11,-11
4,Arizona,46,South Dakota,79,Lake County,15,0,15
4,Arizona,46,South Dakota,81,Lawrence County,0,53,-53
4,Arizona,46,South Dakota,83,Lincoln County,40,11,29
4,Arizona,46,South Dakota,87,McCook County,0,25,-25
4,Arizona,46,South Dakota,89,McPherson County,0,7,-7
4,Arizona,46,South Dakota,91,Marshall County,17,0,17
4,Arizona,46,South Dakota,93,Meade County,60,130,-70
4,Arizona,46,South Dakota,99,Minnehaha County,562,161,401
4,Arizona,46,South Dakota,101,Moody County,0,13,-13
4,Arizona,46,South Dakota,103,Pennington County,446,292,154
4,Arizona,46,South Dakota,111,Sanborn County,0,9,-9
4,Arizona,46,South Dakota,115,Spink County,90,4,86
4,Arizona,46,South Dakota,121,Todd County,3,6,-3
4,Arizona,46,South Dakota,125,Turner County,0,2,-2
4,Arizona,46,South Dakota,127,Union County,21,5,16
4,Arizona,46,South Dakota,135,Yankton County,8,0,8
4,Arizona,46,South Dakota,137,Ziebach County,0,2,-2
4,Arizona,47,Tennessee,9,Blount County,68,45,23
4,Arizona,47,Tennessee,11,Bradley County,68,17,51
4,Arizona,47,Tennessee,23,Chester County,0,25,-25
4,Arizona,47,Tennessee,29,Cocke County,24,0,24
4,Arizona,47,Tennessee,33,Crockett County,0,10,-10
4,Arizona,47,Tennessee,35,Cumberland County,19,49,-30
4,Arizona,47,Tennessee,37,Davidson County,354,451,-97
4,Arizona,47,Tennessee,43,Dickson County,0,45,-45
4,Arizona,47,Tennessee,45,Dyer County,60,0,60
4,Arizona,47,Tennessee,47,Fayette County,35,0,35
4,Arizona,47,Tennessee,53,Gibson County,34,0,34
4,Arizona,47,Tennessee,65,Hamilton County,88,151,-63
4,Arizona,47,Tennessee,73,Hawkins County,37,18,19
4,Arizona,47,Tennessee,81,Hickman County,11,0,11
4,Arizona,47,Tennessee,85,Humphreys County,22,0,22
4,Arizona,47,Tennessee,89,Jefferson County,0,45,-45
4,Arizona,47,Tennessee,93,Knox County,133,149,-16
4,Arizona,47,Tennessee,97,Lauderdale County,0,5,-5
4,Arizona,47,Tennessee,99,Lawrence County,0,85,-85
4,Arizona,47,Tennessee,111,Macon County,11,0,11
4,Arizona,47,Tennessee,113,Madison County,0,17,-17
4,Arizona,47,Tennessee,115,Marion County,0,10,-10
4,Arizona,47,Tennessee,119,Maury County,47,0,47
4,Arizona,47,Tennessee,121,Meigs County,0,101,-101
4,Arizona,47,Tennessee,125,Montgomery County,577,102,475
4,Arizona,47,Tennessee,131,Obion County,12,0,12
4,Arizona,47,Tennessee,133,Overton County,27,0,27
4,Arizona,47,Tennessee,141,Putnam County,1,0,1
4,Arizona,47,Tennessee,143,Rhea County,0,48,-48
4,Arizona,47,Tennessee,145,Roane County,0,14,-14
4,Arizona,47,Tennessee,147,Robertson County,0,13,-13
4,Arizona,47,Tennessee,149,Rutherford County,189,328,-139
4,Arizona,47,Tennessee,155,Sevier County,48,75,-27
4,Arizona,47,Tennessee,157,Shelby County,345,312,33
4,Arizona,47,Tennessee,159,Smith County,17,0,17
4,Arizona,47,Tennessee,163,Sullivan County,10,0,10
4,Arizona,47,Tennessee,165,Sumner County,47,58,-11
4,Arizona,47,Tennessee,167,Tipton County,0,41,-41
4,Arizona,47,Tennessee,169,Trousdale County,9,0,9
4,Arizona,47,Tennessee,171,Unicoi County,0,11,-11
4,Arizona,47,Tennessee,177,Warren County,17,0,17
4,Arizona,47,Tennessee,187,Williamson County,158,299,-141
4,Arizona,47,Tennessee,189,Wilson County,0,30,-30
4,Arizona,48,Texas,5,Angelina County,12,127,-115
4,Arizona,48,Texas,13,Atascosa County,203,73,130
4,Arizona,48,Texas,15,Austin County,0,47,-47
4,Arizona,48,Texas,21,Bastrop County,23,65,-42
4,Arizona,48,Texas,25,Bee County,0,64,-64
4,Arizona,48,Texas,27,Bell County,404,978,-574
4,Arizona,48,Texas,29,Bexar County,832,1772,-940
4,Arizona,48,Texas,31,Blanco County,26,0,26
4,Arizona,48,Texas,39,Brazoria County,365,331,34
4,Arizona,48,Texas,41,Brazos County,257,405,-148
4,Arizona,48,Texas,43,Brewster County,0,1,-1
4,Arizona,48,Texas,47,Brooks County,0,7,-7
4,Arizona,48,Texas,49,Brown County,7,0,7
4,Arizona,48,Texas,53,Burnet County,22,61,-39
4,Arizona,48,Texas,55,Caldwell County,9,48,-39
4,Arizona,48,Texas,57,Calhoun County,0,10,-10
4,Arizona,48,Texas,59,Callahan County,8,8,0
4,Arizona,48,Texas,61,Cameron County,80,23,57
4,Arizona,48,Texas,63,Camp County,29,15,14
4,Arizona,48,Texas,65,Carson County,0,1,-1
4,Arizona,48,Texas,67,Cass County,8,0,8
4,Arizona,48,Texas,69,Castro County,0,16,-16
4,Arizona,48,Texas,73,Cherokee County,0,6,-6
4,Arizona,48,Texas,75,Childress County,0,27,-27
4,Arizona,48,Texas,77,Clay County,4,0,4
4,Arizona,48,Texas,85,Collin County,715,586,129
4,Arizona,48,Texas,91,Comal County,105,179,-74
4,Arizona,48,Texas,95,Concho County,7,0,7
4,Arizona,48,Texas,97,Cooke County,0,12,-12
4,Arizona,48,Texas,99,Coryell County,118,108,10
4,Arizona,48,Texas,101,Cottle County,0,4,-4
4,Arizona,48,Texas,107,Crosby County,81,4,77
4,Arizona,48,Texas,113,Dallas County,1166,1153,13
4,Arizona,48,Texas,121,Denton County,602,647,-45
4,Arizona,48,Texas,129,Donley County,0,22,-22
4,Arizona,48,Texas,133,Eastland County,0,15,-15
4,Arizona,48,Texas,135,Ector County,87,138,-51
4,Arizona,48,Texas,139,Ellis County,0,7,-7
4,Arizona,48,Texas,141,El Paso County,1716,1120,596
4,Arizona,48,Texas,143,Erath County,45,29,16
4,Arizona,48,Texas,157,Fort Bend County,134,531,-397
4,Arizona,48,Texas,163,Frio County,0,24,-24
4,Arizona,48,Texas,165,Gaines County,0,30,-30
4,Arizona,48,Texas,167,Galveston County,169,96,73
4,Arizona,48,Texas,169,Garza County,0,157,-157
4,Arizona,48,Texas,179,Gray County,6,0,6
4,Arizona,48,Texas,181,Grayson County,44,81,-37
4,Arizona,48,Texas,183,Gregg County,53,51,2
4,Arizona,48,Texas,187,Guadalupe County,126,161,-35
4,Arizona,48,Texas,189,Hale County,0,18,-18
4,Arizona,48,Texas,199,Hardin County,19,6,13
4,Arizona,48,Texas,201,Harris County,1813,2452,-639
4,Arizona,48,Texas,203,Harrison County,105,0,105
4,Arizona,48,Texas,205,Hartley County,13,0,13
4,Arizona,48,Texas,207,Haskell County,0,30,-30
4,Arizona,48,Texas,209,Hays County,57,246,-189
4,Arizona,48,Texas,213,Henderson County,8,18,-10
4,Arizona,48,Texas,215,Hidalgo County,235,110,125
4,Arizona,48,Texas,217,Hill County,33,0,33
4,Arizona,48,Texas,219,Hockley County,0,11,-11
4,Arizona,48,Texas,221,Hood County,86,17,69
4,Arizona,48,Texas,227,Howard County,11,35,-24
4,Arizona,48,Texas,231,Hunt County,58,0,58
4,Arizona,48,Texas,235,Irion County,8,0,8
4,Arizona,48,Texas,237,Jack County,21,0,21
4,Arizona,48,Texas,245,Jefferson County,38,30,8
4,Arizona,48,Texas,247,Jim Hogg County,0,1,-1
4,Arizona,48,Texas,249,Jim Wells County,74,0,74
4,Arizona,48,Texas,251,Johnson County,40,55,-15
4,Arizona,48,Texas,253,Jones County,0,1,-1
4,Arizona,48,Texas,257,Kaufman County,51,28,23
4,Arizona,48,Texas,259,Kendall County,74,0,74
4,Arizona,48,Texas,265,Kerr County,25,55,-30
4,Arizona,48,Texas,277,Lamar County,7,0,7
4,Arizona,48,Texas,281,Lampasas County,22,51,-29
4,Arizona,48,Texas,285,Lavaca County,0,6,-6
4,Arizona,48,Texas,289,Leon County,0,23,-23
4,Arizona,48,Texas,291,Liberty County,0,67,-67
4,Arizona,48,Texas,299,Llano County,16,0,16
4,Arizona,48,Texas,303,Lubbock County,33,163,-130
4,Arizona,48,Texas,307,McCulloch County,47,0,47
4,Arizona,48,Texas,309,McLennan County,32,409,-377
4,Arizona,48,Texas,321,Matagorda County,0,54,-54
4,Arizona,48,Texas,323,Maverick County,33,0,33
4,Arizona,48,Texas,329,Midland County,141,113,28
4,Arizona,48,Texas,331,Milam County,0,14,-14
4,Arizona,48,Texas,335,Mitchell County,4,21,-17
4,Arizona,48,Texas,337,Montague County,11,0,11
4,Arizona,48,Texas,339,Montgomery County,153,323,-170
4,Arizona,48,Texas,349,Navarro County,0,21,-21
4,Arizona,48,Texas,353,Nolan County,0,6,-6
4,Arizona,48,Texas,355,Nueces County,196,33,163
4,Arizona,48,Texas,359,Oldham County,0,9,-9
4,Arizona,48,Texas,361,Orange County,77,71,6
4,Arizona,48,Texas,365,Panola County,0,3,-3
4,Arizona,48,Texas,367,Parker County,53,102,-49
4,Arizona,48,Texas,369,Parmer County,0,26,-26
4,Arizona,48,Texas,373,Polk County,154,0,154
4,Arizona,48,Texas,375,Potter County,49,59,-10
4,Arizona,48,Texas,379,Rains County,0,2,-2
4,Arizona,48,Texas,381,Randall County,0,41,-41
4,Arizona,48,Texas,389,Reeves County,0,43,-43
4,Arizona,48,Texas,391,Refugio County,0,3,-3
4,Arizona,48,Texas,397,Rockwall County,0,4,-4
4,Arizona,48,Texas,403,Sabine County,0,12,-12
4,Arizona,48,Texas,409,San Patricio County,62,68,-6
4,Arizona,48,Texas,423,Smith County,37,31,6
4,Arizona,48,Texas,437,Swisher County,0,1,-1
4,Arizona,48,Texas,439,Tarrant County,672,1340,-668
4,Arizona,48,Texas,441,Taylor County,50,108,-58
4,Arizona,48,Texas,445,Terry County,0,11,-11
4,Arizona,48,Texas,449,Titus County,0,30,-30
4,Arizona,48,Texas,451,Tom Green County,383,53,330
4,Arizona,48,Texas,453,Travis County,1136,1532,-396
4,Arizona,48,Texas,455,Trinity County,0,8,-8
4,Arizona,48,Texas,457,Tyler County,0,17,-17
4,Arizona,48,Texas,461,Upton County,0,1,-1
4,Arizona,48,Texas,465,Val Verde County,79,11,68
4,Arizona,48,Texas,467,Van Zandt County,39,17,22
4,Arizona,48,Texas,469,Victoria County,3,26,-23
4,Arizona,48,Texas,471,Walker County,19,1,18
4,Arizona,48,Texas,475,Ward County,7,59,-52
4,Arizona,48,Texas,477,Washington County,0,12,-12
4,Arizona,48,Texas,479,Webb County,40,0,40
4,Arizona,48,Texas,481,Wharton County,0,4,-4
4,Arizona,48,Texas,485,Wichita County,207,170,37
4,Arizona,48,Texas,487,Wilbarger County,0,2,-2
4,Arizona,48,Texas,489,Willacy County,26,11,15
4,Arizona,48,Texas,491,Williamson County,248,433,-185
4,Arizona,48,Texas,493,Wilson County,0,9,-9
4,Arizona,48,Texas,495,Winkler County,0,64,-64
4,Arizona,48,Texas,497,Wise County,4,0,4
4,Arizona,48,Texas,499,Wood County,0,2,-2
4,Arizona,48,Texas,503,Young County,0,2,-2
4,Arizona,49,Utah,1,Beaver County,0,47,-47
4,Arizona,49,Utah,3,Box Elder County,193,74,119
4,Arizona,49,Utah,5,Cache County,375,338,37
4,Arizona,49,Utah,7,Carbon County,0,104,-104
4,Arizona,49,Utah,11,Davis County,913,226,687
4,Arizona,49,Utah,13,Duchesne County,0,23,-23
4,Arizona,49,Utah,15,Emery County,0,27,-27
4,Arizona,49,Utah,17,Garfield County,0,4,-4
4,Arizona,49,Utah,19,Grand County,78,98,-20
4,Arizona,49,Utah,21,Iron County,237,305,-68
4,Arizona,49,Utah,23,Juab County,0,122,-122
4,Arizona,49,Utah,25,Kane County,20,243,-223
4,Arizona,49,Utah,27,Millard County,31,37,-6
4,Arizona,49,Utah,33,Rich County,0,57,-57
4,Arizona,49,Utah,35,Salt Lake County,3002,1397,1605
4,Arizona,49,Utah,37,San Juan County,57,89,-32
4,Arizona,49,Utah,39,Sanpete County,47,186,-139
4,Arizona,49,Utah,41,Sevier County,0,6,-6
4,Arizona,49,Utah,43,Summit County,28,28,0
4,Arizona,49,Utah,45,Tooele County,289,40,249
4,Arizona,49,Utah,47,Uintah County,17,88,-71
4,Arizona,49,Utah,49,Utah County,1300,2634,-1334
4,Arizona,49,Utah,53,Washington County,1186,1102,84
4,Arizona,49,Utah,55,Wayne County,0,23,-23
4,Arizona,49,Utah,57,Weber County,615,375,240
4,Arizona,5,Arkansas,3,Ashley County,38,0,38
4,Arizona,5,Arkansas,5,Baxter County,37,38,-1
4,Arizona,5,Arkansas,7,Benton County,234,203,31
4,Arizona,5,Arkansas,9,Boone County,0,20,-20
4,Arizona,5,Arkansas,15,Carroll County,18,0,18
4,Arizona,5,Arkansas,27,Columbia County,0,5,-5
4,Arizona,5,Arkansas,33,Crawford County,29,9,20
4,Arizona,5,Arkansas,35,Crittenden County,11,0,11
4,Arizona,5,Arkansas,39,Dallas County,0,6,-6
4,Arizona,5,Arkansas,41,Desha County,4,0,4
4,Arizona,5,Arkansas,45,Faulkner County,22,14,8
4,Arizona,5,Arkansas,49,Fulton County,0,18,-18
4,Arizona,5,Arkansas,51,Garland County,0,9,-9
4,Arizona,5,Arkansas,53,Grant County,0,4,-4
4,Arizona,5,Arkansas,55,Greene County,2,2,0
4,Arizona,5,Arkansas,59,Hot Spring County,28,6,22
4,Arizona,5,Arkansas,61,Howard County,0,100,-100
4,Arizona,5,Arkansas,63,Independence County,14,0,14
4,Arizona,5,Arkansas,65,Izard County,16,33,-17
4,Arizona,5,Arkansas,69,Jefferson County,44,0,44
4,Arizona,5,Arkansas,85,Lonoke County,93,50,43
4,Arizona,5,Arkansas,89,Marion County,12,147,-135
4,Arizona,5,Arkansas,91,Miller County,0,27,-27
4,Arizona,5,Arkansas,113,Polk County,0,10,-10
4,Arizona,5,Arkansas,115,Pope County,0,11,-11
4,Arizona,5,Arkansas,119,Pulaski County,340,73,267
4,Arizona,5,Arkansas,129,Searcy County,0,8,-8
4,Arizona,5,Arkansas,131,Sebastian County,10,119,-109
4,Arizona,5,Arkansas,133,Sevier County,0,11,-11
4,Arizona,5,Arkansas,139,Union County,0,11,-11
4,Arizona,5,Arkansas,143,Washington County,71,63,8
4,Arizona,5,Arkansas,145,White County,4,35,-31
4,Arizona,5,Arkansas,149,Yell County,0,59,-59
4,Arizona,50,Vermont,1,Addison County,12,29,-17
4,Arizona,50,Vermont,3,Bennington County,14,0,14
4,Arizona,50,Vermont,5,Caledonia County,22,12,10
4,Arizona,50,Vermont,7,Chittenden County,156,63,93
4,Arizona,50,Vermont,11,Franklin County,93,5,88
4,Arizona,50,Vermont,19,Orleans County,6,2,4
4,Arizona,50,Vermont,21,Rutland County,40,0,40
4,Arizona,50,Vermont,23,Washington County,74,16,58
4,Arizona,50,Vermont,25,Windham County,0,6,-6
4,Arizona,50,Vermont,27,Windsor County,70,5,65
4,Arizona,51,Virginia,1,Accomack County,0,3,-3
4,Arizona,51,Virginia,3,Albemarle County,56,75,-19
4,Arizona,51,Virginia,9,Amherst County,50,0,50
4,Arizona,51,Virginia,13,Arlington County,90,128,-38
4,Arizona,51,Virginia,15,Augusta County,33,9,24
4,Arizona,51,Virginia,19,Bedford County,0,26,-26
4,Arizona,51,Virginia,33,Caroline County,38,26,12
4,Arizona,51,Virginia,41,Chesterfield County,5,14,-9
4,Arizona,51,Virginia,47,Culpeper County,0,72,-72
4,Arizona,51,Virginia,53,Dinwiddie County,0,3,-3
4,Arizona,51,Virginia,57,Essex County,0,11,-11
4,Arizona,51,Virginia,59,Fairfax County,540,532,8
4,Arizona,51,Virginia,61,Fauquier County,11,68,-57
4,Arizona,51,Virginia,69,Frederick County,20,8,12
4,Arizona,51,Virginia,73,Gloucester County,5,0,5
4,Arizona,51,Virginia,79,Greene County,107,0,107
4,Arizona,51,Virginia,85,Hanover County,26,18,8
4,Arizona,51,Virginia,87,Henrico County,0,12,-12
4,Arizona,51,Virginia,95,James City County,184,20,164
4,Arizona,51,Virginia,107,Loudoun County,885,220,665
4,Arizona,51,Virginia,117,Mecklenburg County,67,8,59
4,Arizona,51,Virginia,121,Montgomery County,0,36,-36
4,Arizona,51,Virginia,125,Nelson County,31,0,31
4,Arizona,51,Virginia,139,Page County,0,44,-44
4,Arizona,51,Virginia,147,Prince Edward County,20,0,20
4,Arizona,51,Virginia,149,Prince George County,127,37,90
4,Arizona,51,Virginia,153,Prince William County,342,143,199
4,Arizona,51,Virginia,161,Roanoke County,34,13,21
4,Arizona,51,Virginia,165,Rockingham County,0,21,-21
4,Arizona,51,Virginia,171,Shenandoah County,0,5,-5
4,Arizona,51,Virginia,177,Spotsylvania County,11,11,0
4,Arizona,51,Virginia,179,Stafford County,135,25,110
4,Arizona,51,Virginia,181,Surry County,0,26,-26
4,Arizona,51,Virginia,183,Sussex County,22,0,22
4,Arizona,51,Virginia,185,Tazewell County,0,16,-16
4,Arizona,51,Virginia,187,Warren County,0,33,-33
4,Arizona,51,Virginia,191,Washington County,74,0,74
4,Arizona,51,Virginia,199,York County,108,92,16
4,Arizona,51,Virginia,510,Alexandria city,67,66,1
4,Arizona,51,Virginia,530,Buena Vista city,0,46,-46
4,Arizona,51,Virginia,540,Charlottesville city,159,63,96
4,Arizona,51,Virginia,550,Chesapeake city,68,82,-14
4,Arizona,51,Virginia,590,Danville city,19,0,19
4,Arizona,51,Virginia,595,Emporia city,55,11,44
4,Arizona,51,Virginia,600,Fairfax city,11,0,11
4,Arizona,51,Virginia,610,Falls Church city,113,0,113
4,Arizona,51,Virginia,630,Fredericksburg city,53,0,53
4,Arizona,51,Virginia,650,Hampton city,76,68,8
4,Arizona,51,Virginia,678,Lexington city,0,7,-7
4,Arizona,51,Virginia,680,Lynchburg city,0,4,-4
4,Arizona,51,Virginia,685,Manassas Park city,78,9,69
4,Arizona,51,Virginia,690,Martinsville city,0,6,-6
4,Arizona,51,Virginia,700,Newport News city,71,51,20
4,Arizona,51,Virginia,710,Norfolk city,189,129,60
4,Arizona,51,Virginia,735,Poquoson city,0,130,-130
4,Arizona,51,Virginia,740,Portsmouth city,0,145,-145
4,Arizona,51,Virginia,760,Richmond city,208,5,203
4,Arizona,51,Virginia,770,Roanoke city,126,84,42
4,Arizona,51,Virginia,810,Virginia Beach city,189,346,-157
4,Arizona,51,Virginia,820,Waynesboro city,0,50,-50
4,Arizona,51,Virginia,830,Williamsburg city,0,7,-7
4,Arizona,51,Virginia,840,Winchester city,12,0,12
4,Arizona,53,Washington,1,Adams County,0,16,-16
4,Arizona,53,Washington,3,Asotin County,17,32,-15
4,Arizona,53,Washington,5,Benton County,279,293,-14
4,Arizona,53,Washington,7,Chelan County,47,12,35
4,Arizona,53,Washington,9,Clallam County,308,139,169
4,Arizona,53,Washington,11,Clark County,1375,728,647
4,Arizona,53,Washington,15,Cowlitz County,39,76,-37
4,Arizona,53,Washington,17,Douglas County,120,10,110
4,Arizona,53,Washington,19,Ferry County,38,0,38
4,Arizona,53,Washington,21,Franklin County,92,11,81
4,Arizona,53,Washington,23,Garfield County,12,0,12
4,Arizona,53,Washington,25,Grant County,86,21,65
4,Arizona,53,Washington,27,Grays Harbor County,169,108,61
4,Arizona,53,Washington,29,Island County,181,75,106
4,Arizona,53,Washington,31,Jefferson County,74,64,10
4,Arizona,53,Washington,33,King County,3885,3755,130
4,Arizona,53,Washington,35,Kitsap County,347,271,76
4,Arizona,53,Washington,37,Kittitas County,6,58,-52
4,Arizona,53,Washington,39,Klickitat County,13,0,13
4,Arizona,53,Washington,41,Lewis County,50,32,18
4,Arizona,53,Washington,45,Mason County,257,132,125
4,Arizona,53,Washington,47,Okanogan County,135,14,121
4,Arizona,53,Washington,49,Pacific County,65,9,56
4,Arizona,53,Washington,51,Pend Oreille County,21,0,21
4,Arizona,53,Washington,53,Pierce County,1706,1166,540
4,Arizona,53,Washington,55,San Juan County,85,40,45
4,Arizona,53,Washington,57,Skagit County,89,143,-54
4,Arizona,53,Washington,61,Snohomish County,1789,1346,443
4,Arizona,53,Washington,63,Spokane County,1094,1205,-111
4,Arizona,53,Washington,65,Stevens County,40,42,-2
4,Arizona,53,Washington,67,Thurston County,517,314,203
4,Arizona,53,Washington,71,Walla Walla County,100,8,92
4,Arizona,53,Washington,73,Whatcom County,490,223,267
4,Arizona,53,Washington,75,Whitman County,97,221,-124
4,Arizona,53,Washington,77,Yakima County,239,448,-209
4,Arizona,54,West Virginia,3,Berkeley County,20,0,20
4,Arizona,54,West Virginia,9,Brooke County,0,15,-15
4,Arizona,54,West Virginia,29,Hancock County,14,0,14
4,Arizona,54,West Virginia,37,Jefferson County,0,3,-3
4,Arizona,54,West Virginia,39,Kanawha County,62,64,-2
4,Arizona,54,West Virginia,49,Marion County,77,0,77
4,Arizona,54,West Virginia,51,Marshall County,0,14,-14
4,Arizona,54,West Virginia,53,Mason County,24,0,24
4,Arizona,54,West Virginia,55,Mercer County,25,0,25
4,Arizona,54,West Virginia,69,Ohio County,38,0,38
4,Arizona,54,West Virginia,71,Pendleton County,147,0,147
4,Arizona,54,West Virginia,81,Raleigh County,0,3,-3
4,Arizona,54,West Virginia,89,Summers County,0,11,-11
4,Arizona,55,Wisconsin,1,Adams County,0,14,-14
4,Arizona,55,Wisconsin,3,Ashland County,153,0,153
4,Arizona,55,Wisconsin,7,Bayfield County,0,4,-4
4,Arizona,55,Wisconsin,9,Brown County,199,115,84
4,Arizona,55,Wisconsin,11,Buffalo County,0,89,-89
4,Arizona,55,Wisconsin,13,Burnett County,7,2,5
4,Arizona,55,Wisconsin,15,Calumet County,14,0,14
4,Arizona,55,Wisconsin,17,Chippewa County,0,2,-2
4,Arizona,55,Wisconsin,19,Clark County,0,3,-3
4,Arizona,55,Wisconsin,21,Columbia County,22,20,2
4,Arizona,55,Wisconsin,25,Dane County,665,170,495
4,Arizona,55,Wisconsin,27,Dodge County,105,129,-24
4,Arizona,55,Wisconsin,29,Door County,22,13,9
4,Arizona,55,Wisconsin,31,Douglas County,65,21,44
4,Arizona,55,Wisconsin,33,Dunn County,64,4,60
4,Arizona,55,Wisconsin,35,Eau Claire County,52,49,3
4,Arizona,55,Wisconsin,39,Fond du Lac County,89,31,58
4,Arizona,55,Wisconsin,41,Forest County,0,2,-2
4,Arizona,55,Wisconsin,43,Grant County,30,26,4
4,Arizona,55,Wisconsin,47,Green Lake County,0,28,-28
4,Arizona,55,Wisconsin,49,Iowa County,0,11,-11
4,Arizona,55,Wisconsin,51,Iron County,0,8,-8
4,Arizona,55,Wisconsin,53,Jackson County,0,16,-16
4,Arizona,55,Wisconsin,55,Jefferson County,52,54,-2
4,Arizona,55,Wisconsin,57,Juneau County,0,2,-2
4,Arizona,55,Wisconsin,59,Kenosha County,279,81,198
4,Arizona,55,Wisconsin,63,La Crosse County,217,32,185
4,Arizona,55,Wisconsin,67,Langlade County,83,5,78
4,Arizona,55,Wisconsin,69,Lincoln County,24,0,24
4,Arizona,55,Wisconsin,71,Manitowoc County,118,20,98
4,Arizona,55,Wisconsin,73,Marathon County,70,227,-157
4,Arizona,55,Wisconsin,75,Marinette County,0,11,-11
4,Arizona,55,Wisconsin,77,Marquette County,0,3,-3
4,Arizona,55,Wisconsin,79,Milwaukee County,1209,466,743
4,Arizona,55,Wisconsin,81,Monroe County,0,38,-38
4,Arizona,55,Wisconsin,83,Oconto County,0,3,-3
4,Arizona,55,Wisconsin,85,Oneida County,61,0,61
4,Arizona,55,Wisconsin,87,Outagamie County,185,28,157
4,Arizona,55,Wisconsin,89,Ozaukee County,65,29,36
4,Arizona,55,Wisconsin,93,Pierce County,14,0,14
4,Arizona,55,Wisconsin,95,Polk County,0,23,-23
4,Arizona,55,Wisconsin,97,Portage County,0,3,-3
4,Arizona,55,Wisconsin,99,Price County,0,47,-47
4,Arizona,55,Wisconsin,101,Racine County,95,156,-61
4,Arizona,55,Wisconsin,105,Rock County,59,72,-13
4,Arizona,55,Wisconsin,107,Rusk County,60,0,60
4,Arizona,55,Wisconsin,109,St. Croix County,88,25,63
4,Arizona,55,Wisconsin,111,Sauk County,132,72,60
4,Arizona,55,Wisconsin,113,Sawyer County,7,4,3
4,Arizona,55,Wisconsin,115,Shawano County,26,16,10
4,Arizona,55,Wisconsin,117,Sheboygan County,82,9,73
4,Arizona,55,Wisconsin,119,Taylor County,0,6,-6
4,Arizona,55,Wisconsin,121,Trempealeau County,0,11,-11
4,Arizona,55,Wisconsin,125,Vilas County,18,4,14
4,Arizona,55,Wisconsin,127,Walworth County,108,33,75
4,Arizona,55,Wisconsin,129,Washburn County,13,0,13
4,Arizona,55,Wisconsin,131,Washington County,86,65,21
4,Arizona,55,Wisconsin,133,Waukesha County,620,117,503
4,Arizona,55,Wisconsin,135,Waupaca County,0,3,-3
4,Arizona,55,Wisconsin,137,Waushara County,0,2,-2
4,Arizona,55,Wisconsin,139,Winnebago County,294,197,97
4,Arizona,55,Wisconsin,141,Wood County,18,0,18
4,Arizona,56,Wyoming,1,Albany County,98,3,95
4,Arizona,56,Wyoming,3,Big Horn County,13,14,-1
4,Arizona,56,Wyoming,5,Campbell County,199,83,116
4,Arizona,56,Wyoming,7,Carbon County,0,4,-4
4,Arizona,56,Wyoming,9,Converse County,0,10,-10
4,Arizona,56,Wyoming,11,Crook County,24,0,24
4,Arizona,56,Wyoming,13,Fremont County,41,60,-19
4,Arizona,56,Wyoming,15,Goshen County,0,39,-39
4,Arizona,56,Wyoming,17,Hot Springs County,18,0,18
4,Arizona,56,Wyoming,19,Johnson County,0,1,-1
4,Arizona,56,Wyoming,21,Laramie County,622,148,474
4,Arizona,56,Wyoming,23,Lincoln County,95,100,-5
4,Arizona,56,Wyoming,25,Natrona County,208,139,69
4,Arizona,56,Wyoming,29,Park County,64,23,41
4,Arizona,56,Wyoming,31,Platte County,6,0,6
4,Arizona,56,Wyoming,33,Sheridan County,161,14,147
4,Arizona,56,Wyoming,35,Sublette County,0,12,-12
4,Arizona,56,Wyoming,37,Sweetwater County,200,6,194
4,Arizona,56,Wyoming,39,Teton County,55,114,-59
4,Arizona,56,Wyoming,41,Uinta County,0,17,-17
4,Arizona,56,Wyoming,45,Weston County,27,13,14
4,Arizona,6,California,1,Alameda County,1542,1089,453
4,Arizona,6,California,5,Amador County,0,10,-10
4,Arizona,6,California,7,Butte County,70,537,-467
4,Arizona,6,California,9,Calaveras County,94,27,67
4,Arizona,6,California,13,Contra Costa County,1208,810,398
4,Arizona,6,California,15,Del Norte County,30,7,23
4,Arizona,6,California,17,El Dorado County,173,328,-155
4,Arizona,6,California,19,Fresno County,594,354,240
4,Arizona,6,California,23,Humboldt County,63,520,-457
4,Arizona,6,California,25,Imperial County,652,408,244
4,Arizona,6,California,27,Inyo County,21,2,19
4,Arizona,6,California,29,Kern County,1837,1371,466
4,Arizona,6,California,31,Kings County,288,57,231
4,Arizona,6,California,33,Lake County,45,0,45
4,Arizona,6,California,35,Lassen County,34,114,-80
4,Arizona,6,California,37,Los Angeles County,11070,5155,5915
4,Arizona,6,California,39,Madera County,129,154,-25
4,Arizona,6,California,41,Marin County,179,255,-76
4,Arizona,6,California,43,Mariposa County,5,46,-41
4,Arizona,6,California,45,Mendocino County,6,18,-12
4,Arizona,6,California,47,Merced County,424,155,269
4,Arizona,6,California,51,Mono County,5,0,5
4,Arizona,6,California,53,Monterey County,687,466,221
4,Arizona,6,California,55,Napa County,198,70,128
4,Arizona,6,California,57,Nevada County,48,85,-37
4,Arizona,6,California,59,Orange County,7218,2850,4368
4,Arizona,6,California,61,Placer County,395,461,-66
4,Arizona,6,California,63,Plumas County,0,13,-13
4,Arizona,6,California,65,Riverside County,4514,2580,1934
4,Arizona,6,California,67,Sacramento County,1699,1171,528
4,Arizona,6,California,69,San Benito County,20,40,-20
4,Arizona,6,California,71,San Bernardino County,4409,2527,1882
4,Arizona,6,California,73,San Diego County,8508,4737,3771
4,Arizona,6,California,75,San Francisco County,586,416,170
4,Arizona,6,California,77,San Joaquin County,431,653,-222
4,Arizona,6,California,79,San Luis Obispo County,481,495,-14
4,Arizona,6,California,81,San Mateo County,754,362,392
4,Arizona,6,California,83,Santa Barbara County,748,431,317
4,Arizona,6,California,85,Santa Clara County,1830,1647,183
4,Arizona,6,California,87,Santa Cruz County,271,31,240
4,Arizona,6,California,89,Shasta County,220,281,-61
4,Arizona,6,California,93,Siskiyou County,65,58,7
4,Arizona,6,California,95,Solano County,666,378,288
4,Arizona,6,California,97,Sonoma County,590,398,192
4,Arizona,6,California,99,Stanislaus County,271,350,-79
4,Arizona,6,California,101,Sutter County,75,37,38
4,Arizona,6,California,103,Tehama County,29,24,5
4,Arizona,6,California,105,Trinity County,0,6,-6
4,Arizona,6,California,107,Tulare County,129,241,-112
4,Arizona,6,California,109,Tuolumne County,30,111,-81
4,Arizona,6,California,111,Ventura County,1749,578,1171
4,Arizona,6,California,113,Yolo County,267,142,125
4,Arizona,6,California,115,Yuba County,156,24,132
4,Arizona,72,Puerto Rico,3,Aguada Municipio,19,0,19
4,Arizona,72,Puerto Rico,11,Añasco Municipio,10,0,10
4,Arizona,72,Puerto Rico,13,Arecibo Municipio,0,1,-1
4,Arizona,72,Puerto Rico,21,Bayamón Municipio,0,12,-12
4,Arizona,72,Puerto Rico,25,Caguas Municipio,25,0,25
4,Arizona,72,Puerto Rico,31,Carolina Municipio,7,0,7
4,Arizona,72,Puerto Rico,61,Guaynabo Municipio,26,50,-24
4,Arizona,72,Puerto Rico,67,Hormigueros Municipio,69,0,69
4,Arizona,72,Puerto Rico,75,Juana Díaz Municipio,23,0,23
4,Arizona,72,Puerto Rico,91,Manatí Municipio,13,0,13
4,Arizona,72,Puerto Rico,111,Peñuelas Municipio,42,0,42
4,Arizona,72,Puerto Rico,113,Ponce Municipio,87,0,87
4,Arizona,72,Puerto Rico,127,San Juan Municipio,396,34,362
4,Arizona,72,Puerto Rico,137,Toa Baja Municipio,26,0,26
4,Arizona,72,Puerto Rico,139,Trujillo Alto Municipio,52,0,52
4,Arizona,72,Puerto Rico,151,Yabucoa Municipio,70,0,70
4,Arizona,8,Colorado,1,Adams County,537,471,66
4,Arizona,8,Colorado,3,Alamosa County,25,2,23
4,Arizona,8,Colorado,5,Arapahoe County,882,747,135
4,Arizona,8,Colorado,7,Archuleta County,25,66,-41
4,Arizona,8,Colorado,11,Bent County,11,0,11
4,Arizona,8,Colorado,13,Boulder County,479,541,-62
4,Arizona,8,Colorado,14,Broomfield County,479,100,379
4,Arizona,8,Colorado,15,Chaffee County,26,0,26
4,Arizona,8,Colorado,19,Clear Creek County,0,1,-1
4,Arizona,8,Colorado,23,Costilla County,53,0,53
4,Arizona,8,Colorado,25,Crowley County,0,7,-7
4,Arizona,8,Colorado,27,Custer County,97,3,94
4,Arizona,8,Colorado,29,Delta County,0,86,-86
4,Arizona,8,Colorado,31,Denver County,1258,1213,45
4,Arizona,8,Colorado,33,Dolores County,0,59,-59
4,Arizona,8,Colorado,35,Douglas County,1119,482,637
4,Arizona,8,Colorado,37,Eagle County,48,34,14
4,Arizona,8,Colorado,39,Elbert County,27,27,0
4,Arizona,8,Colorado,41,El Paso County,1622,1489,133
4,Arizona,8,Colorado,43,Fremont County,88,185,-97
4,Arizona,8,Colorado,45,Garfield County,40,156,-116
4,Arizona,8,Colorado,49,Grand County,65,9,56
4,Arizona,8,Colorado,51,Gunnison County,17,11,6
4,Arizona,8,Colorado,59,Jefferson County,1126,969,157
4,Arizona,8,Colorado,63,Kit Carson County,31,1,30
4,Arizona,8,Colorado,65,Lake County,0,34,-34
4,Arizona,8,Colorado,67,La Plata County,184,503,-319
4,Arizona,8,Colorado,69,Larimer County,936,669,267
4,Arizona,8,Colorado,71,Las Animas County,20,63,-43
4,Arizona,8,Colorado,75,Logan County,11,0,11
4,Arizona,8,Colorado,77,Mesa County,483,391,92
4,Arizona,8,Colorado,79,Mineral County,0,4,-4
4,Arizona,8,Colorado,81,Moffat County,33,0,33
4,Arizona,8,Colorado,83,Montezuma County,100,123,-23
4,Arizona,8,Colorado,85,Montrose County,205,170,35
4,Arizona,8,Colorado,87,Morgan County,0,39,-39
4,Arizona,8,Colorado,89,Otero County,33,97,-64
4,Arizona,8,Colorado,93,Park County,3,71,-68
4,Arizona,8,Colorado,97,Pitkin County,6,1,5
4,Arizona,8,Colorado,99,Prowers County,5,12,-7
4,Arizona,8,Colorado,101,Pueblo County,323,212,111
4,Arizona,8,Colorado,103,Rio Blanco County,0,112,-112
4,Arizona,8,Colorado,105,Rio Grande County,0,425,-425
4,Arizona,8,Colorado,107,Routt County,49,31,18
4,Arizona,8,Colorado,109,Saguache County,0,27,-27
4,Arizona,8,Colorado,111,San Juan County,9,0,9
4,Arizona,8,Colorado,113,San Miguel County,14,32,-18
4,Arizona,8,Colorado,115,Sedgwick County,0,2,-2
4,Arizona,8,Colorado,117,Summit County,13,0,13
4,Arizona,8,Colorado,119,Teller County,18,29,-11
4,Arizona,8,Colorado,121,Washington County,5,1,4
4,Arizona,8,Colorado,123,Weld County,495,477,18
4,Arizona,8,Colorado,125,Yuma County,0,4,-4
4,Arizona,9,Connecticut,1,Fairfield County,411,216,195
4,Arizona,9,Connecticut,3,Hartford County,142,185,-43
4,Arizona,9,Connecticut,5,Litchfield County,149,4,145
4,Arizona,9,Connecticut,7,Middlesex County,178,75,103
4,Arizona,9,Connecticut,9,New Haven County,345,30,315
4,Arizona,9,Connecticut,11,New London County,57,66,-9
4,Arizona,9,Connecticut,13,Tolland County,40,0,40
4,Arizona,9,Connecticut,15,Windham County,0,3,-3
4,Arizona,AFR,Africa,,-,1839,0,0
4,Arizona,ASI,Asia,,-,14908,0,0
4,Arizona,CAM,Central America,,-,13703,0,0
4,Arizona,CAR,Caribbean,,-,964,0,0
4,Arizona,EUR,Europe,,-,5242,0,0
4,Arizona,ISL,U.S. Island Areas,,-,212,0,0
4,Arizona,NAM,Northern America,,-,7899,0,0
4,Arizona,OCE,Oceania and At Sea,,-,597,0,0
4,Arizona,SAM,South America,,-,1766,0,0
5,Arkansas,1,Alabama,3,Baldwin County,114,0,114
5,Arkansas,1,Alabama,15,Calhoun County,57,13,44
5,Arkansas,1,Alabama,21,Chilton County,82,23,59
5,Arkansas,1,Alabama,25,Clarke County,0,29,-29
5,Arkansas,1,Alabama,31,Coffee County,0,9,-9
5,Arkansas,1,Alabama,33,Colbert County,0,34,-34
5,Arkansas,1,Alabama,43,Cullman County,45,14,31
5,Arkansas,1,Alabama,45,Dale County,0,243,-243
5,Arkansas,1,Alabama,49,DeKalb County,7,3,4
5,Arkansas,1,Alabama,51,Elmore County,0,16,-16
5,Arkansas,1,Alabama,55,Etowah County,9,21,-12
5,Arkansas,1,Alabama,59,Franklin County,8,0,8
5,Arkansas,1,Alabama,69,Houston County,0,24,-24
5,Arkansas,1,Alabama,71,Jackson County,0,40,-40
5,Arkansas,1,Alabama,73,Jefferson County,118,18,100
5,Arkansas,1,Alabama,77,Lauderdale County,35,12,23
5,Arkansas,1,Alabama,81,Lee County,13,36,-23
5,Arkansas,1,Alabama,83,Limestone County,105,9,96
5,Arkansas,1,Alabama,87,Macon County,6,0,6
5,Arkansas,1,Alabama,89,Madison County,268,195,73
5,Arkansas,1,Alabama,91,Marengo County,14,0,14
5,Arkansas,1,Alabama,95,Marshall County,0,5,-5
5,Arkansas,1,Alabama,97,Mobile County,89,42,47
5,Arkansas,1,Alabama,101,Montgomery County,3,96,-93
5,Arkansas,1,Alabama,103,Morgan County,0,37,-37
5,Arkansas,1,Alabama,115,St. Clair County,31,0,31
5,Arkansas,1,Alabama,117,Shelby County,43,33,10
5,Arkansas,1,Alabama,121,Talladega County,43,0,43
5,Arkansas,1,Alabama,125,Tuscaloosa County,22,121,-99
5,Arkansas,10,Delaware,3,New Castle County,5,0,5
5,Arkansas,11,District of Columbia,1,District of Columbia,156,86,70
5,Arkansas,12,Florida,1,Alachua County,27,113,-86
5,Arkansas,12,Florida,5,Bay County,73,22,51
5,Arkansas,12,Florida,9,Brevard County,89,108,-19
5,Arkansas,12,Florida,11,Broward County,105,315,-210
5,Arkansas,12,Florida,15,Charlotte County,13,0,13
5,Arkansas,12,Florida,17,Citrus County,56,0,56
5,Arkansas,12,Florida,19,Clay County,6,12,-6
5,Arkansas,12,Florida,21,Collier County,14,9,5
5,Arkansas,12,Florida,23,Columbia County,38,0,38
5,Arkansas,12,Florida,31,Duval County,25,237,-212
5,Arkansas,12,Florida,33,Escambia County,107,60,47
5,Arkansas,12,Florida,35,Flagler County,0,49,-49
5,Arkansas,12,Florida,37,Franklin County,0,8,-8
5,Arkansas,12,Florida,39,Gadsden County,8,0,8
5,Arkansas,12,Florida,45,Gulf County,0,23,-23
5,Arkansas,12,Florida,47,Hamilton County,0,5,-5
5,Arkansas,12,Florida,55,Highlands County,106,0,106
5,Arkansas,12,Florida,57,Hillsborough County,149,149,0
5,Arkansas,12,Florida,61,Indian River County,0,134,-134
5,Arkansas,12,Florida,69,Lake County,43,81,-38
5,Arkansas,12,Florida,71,Lee County,0,99,-99
5,Arkansas,12,Florida,73,Leon County,16,66,-50
5,Arkansas,12,Florida,81,Manatee County,13,201,-188
5,Arkansas,12,Florida,83,Marion County,17,8,9
5,Arkansas,12,Florida,85,Martin County,16,0,16
5,Arkansas,12,Florida,86,Miami-Dade County,133,43,90
5,Arkansas,12,Florida,87,Monroe County,7,1,6
5,Arkansas,12,Florida,89,Nassau County,44,0,44
5,Arkansas,12,Florida,91,Okaloosa County,300,170,130
5,Arkansas,12,Florida,93,Okeechobee County,11,0,11
5,Arkansas,12,Florida,95,Orange County,50,216,-166
5,Arkansas,12,Florida,99,Palm Beach County,41,128,-87
5,Arkansas,12,Florida,101,Pasco County,61,146,-85
5,Arkansas,12,Florida,103,Pinellas County,55,110,-55
5,Arkansas,12,Florida,105,Polk County,43,127,-84
5,Arkansas,12,Florida,109,St. Johns County,12,219,-207
5,Arkansas,12,Florida,111,St. Lucie County,58,198,-140
5,Arkansas,12,Florida,113,Santa Rosa County,0,234,-234
5,Arkansas,12,Florida,115,Sarasota County,62,32,30
5,Arkansas,12,Florida,117,Seminole County,5,0,5
5,Arkansas,12,Florida,119,Sumter County,0,25,-25
5,Arkansas,12,Florida,127,Volusia County,100,102,-2
5,Arkansas,12,Florida,131,Walton County,0,3,-3
5,Arkansas,13,Georgia,19,Berrien County,0,5,-5
5,Arkansas,13,Georgia,21,Bibb County,0,38,-38
5,Arkansas,13,Georgia,29,Bryan County,49,0,49
5,Arkansas,13,Georgia,39,Camden County,0,87,-87
5,Arkansas,13,Georgia,45,Carroll County,79,84,-5
5,Arkansas,13,Georgia,51,Chatham County,89,124,-35
5,Arkansas,13,Georgia,53,Chattahoochee County,0,57,-57
5,Arkansas,13,Georgia,55,Chattooga County,7,0,7
5,Arkansas,13,Georgia,57,Cherokee County,0,34,-34
5,Arkansas,13,Georgia,59,Clarke County,403,50,353
5,Arkansas,13,Georgia,63,Clayton County,135,48,87
5,Arkansas,13,Georgia,67,Cobb County,225,27,198
5,Arkansas,13,Georgia,71,Colquitt County,0,2,-2
5,Arkansas,13,Georgia,73,Columbia County,6,66,-60
5,Arkansas,13,Georgia,77,Coweta County,23,28,-5
5,Arkansas,13,Georgia,81,Crisp County,0,5,-5
5,Arkansas,13,Georgia,87,Decatur County,141,0,141
5,Arkansas,13,Georgia,89,DeKalb County,24,293,-269
5,Arkansas,13,Georgia,93,Dooly County,0,3,-3
5,Arkansas,13,Georgia,95,Dougherty County,0,29,-29
5,Arkansas,13,Georgia,113,Fayette County,46,71,-25
5,Arkansas,13,Georgia,115,Floyd County,10,19,-9
5,Arkansas,13,Georgia,117,Forsyth County,0,22,-22
5,Arkansas,13,Georgia,119,Franklin County,4,0,4
5,Arkansas,13,Georgia,121,Fulton County,513,251,262
5,Arkansas,13,Georgia,135,Gwinnett County,122,58,64
5,Arkansas,13,Georgia,139,Hall County,40,42,-2
5,Arkansas,13,Georgia,151,Henry County,99,35,64
5,Arkansas,13,Georgia,153,Houston County,67,0,67
5,Arkansas,13,Georgia,157,Jackson County,6,0,6
5,Arkansas,13,Georgia,161,Jeff Davis County,42,0,42
5,Arkansas,13,Georgia,169,Jones County,0,96,-96
5,Arkansas,13,Georgia,171,Lamar County,6,0,6
5,Arkansas,13,Georgia,175,Laurens County,2,0,2
5,Arkansas,13,Georgia,179,Liberty County,45,33,12
5,Arkansas,13,Georgia,185,Lowndes County,0,26,-26
5,Arkansas,13,Georgia,205,Mitchell County,6,0,6
5,Arkansas,13,Georgia,211,Morgan County,0,38,-38
5,Arkansas,13,Georgia,213,Murray County,0,5,-5
5,Arkansas,13,Georgia,215,Muscogee County,40,83,-43
5,Arkansas,13,Georgia,217,Newton County,13,0,13
5,Arkansas,13,Georgia,223,Paulding County,0,36,-36
5,Arkansas,13,Georgia,227,Pickens County,42,0,42
5,Arkansas,13,Georgia,233,Polk County,110,0,110
5,Arkansas,13,Georgia,245,Richmond County,8,45,-37
5,Arkansas,13,Georgia,247,Rockdale County,5,0,5
5,Arkansas,13,Georgia,255,Spalding County,62,0,62
5,Arkansas,13,Georgia,285,Troup County,0,12,-12
5,Arkansas,13,Georgia,305,Wayne County,0,11,-11
5,Arkansas,13,Georgia,313,Whitfield County,13,0,13
5,Arkansas,13,Georgia,317,Wilkes County,0,3,-3
5,Arkansas,15,Hawaii,3,Honolulu County,107,38,69
5,Arkansas,15,Hawaii,7,Kauai County,12,0,12
5,Arkansas,15,Hawaii,9,Maui County,9,34,-25
5,Arkansas,16,Idaho,1,Ada County,0,348,-348
5,Arkansas,16,Idaho,5,Bannock County,11,0,11
5,Arkansas,16,Idaho,21,Boundary County,26,19,7
5,Arkansas,16,Idaho,27,Canyon County,0,68,-68
5,Arkansas,16,Idaho,39,Elmore County,0,93,-93
5,Arkansas,16,Idaho,55,Kootenai County,0,53,-53
5,Arkansas,16,Idaho,61,Lewis County,0,3,-3
5,Arkansas,16,Idaho,65,Madison County,104,101,3
5,Arkansas,16,Idaho,75,Payette County,16,8,8
5,Arkansas,17,Illinois,1,Adams County,31,0,31
5,Arkansas,17,Illinois,5,Bond County,21,0,21
5,Arkansas,17,Illinois,7,Boone County,0,10,-10
5,Arkansas,17,Illinois,19,Champaign County,31,29,2
5,Arkansas,17,Illinois,21,Christian County,0,5,-5
5,Arkansas,17,Illinois,25,Clay County,0,7,-7
5,Arkansas,17,Illinois,27,Clinton County,0,6,-6
5,Arkansas,17,Illinois,29,Coles County,7,0,7
5,Arkansas,17,Illinois,31,Cook County,1169,380,789
5,Arkansas,17,Illinois,37,DeKalb County,14,0,14
5,Arkansas,17,Illinois,41,Douglas County,44,2,42
5,Arkansas,17,Illinois,43,DuPage County,83,141,-58
5,Arkansas,17,Illinois,49,Effingham County,0,3,-3
5,Arkansas,17,Illinois,51,Fayette County,100,0,100
5,Arkansas,17,Illinois,55,Franklin County,0,74,-74
5,Arkansas,17,Illinois,57,Fulton County,28,0,28
5,Arkansas,17,Illinois,61,Greene County,0,15,-15
5,Arkansas,17,Illinois,65,Hamilton County,1,0,1
5,Arkansas,17,Illinois,77,Jackson County,104,18,86
5,Arkansas,17,Illinois,81,Jefferson County,0,60,-60
5,Arkansas,17,Illinois,83,Jersey County,0,4,-4
5,Arkansas,17,Illinois,89,Kane County,29,8,21
5,Arkansas,17,Illinois,91,Kankakee County,0,58,-58
5,Arkansas,17,Illinois,93,Kendall County,12,310,-298
5,Arkansas,17,Illinois,95,Knox County,50,12,38
5,Arkansas,17,Illinois,97,Lake County,0,105,-105
5,Arkansas,17,Illinois,99,LaSalle County,14,8,6
5,Arkansas,17,Illinois,101,Lawrence County,0,6,-6
5,Arkansas,17,Illinois,103,Lee County,0,30,-30
5,Arkansas,17,Illinois,107,Logan County,0,27,-27
5,Arkansas,17,Illinois,109,McDonough County,0,4,-4
5,Arkansas,17,Illinois,111,McHenry County,4,23,-19
5,Arkansas,17,Illinois,113,McLean County,0,28,-28
5,Arkansas,17,Illinois,115,Macon County,0,6,-6
5,Arkansas,17,Illinois,119,Madison County,204,7,197
5,Arkansas,17,Illinois,121,Marion County,0,16,-16
5,Arkansas,17,Illinois,129,Menard County,13,5,8
5,Arkansas,17,Illinois,131,Mercer County,0,4,-4
5,Arkansas,17,Illinois,133,Monroe County,8,41,-33
5,Arkansas,17,Illinois,139,Moultrie County,8,10,-2
5,Arkansas,17,Illinois,141,Ogle County,18,0,18
5,Arkansas,17,Illinois,143,Peoria County,53,11,42
5,Arkansas,17,Illinois,145,Perry County,7,0,7
5,Arkansas,17,Illinois,151,Pope County,0,30,-30
5,Arkansas,17,Illinois,155,Putnam County,0,47,-47
5,Arkansas,17,Illinois,157,Randolph County,130,2,128
5,Arkansas,17,Illinois,161,Rock Island County,90,1,89
5,Arkansas,17,Illinois,163,St. Clair County,235,35,200
5,Arkansas,17,Illinois,165,Saline County,17,67,-50
5,Arkansas,17,Illinois,167,Sangamon County,81,0,81
5,Arkansas,17,Illinois,173,Shelby County,21,0,21
5,Arkansas,17,Illinois,177,Stephenson County,0,12,-12
5,Arkansas,17,Illinois,179,Tazewell County,48,0,48
5,Arkansas,17,Illinois,181,Union County,2,0,2
5,Arkansas,17,Illinois,183,Vermilion County,10,29,-19
5,Arkansas,17,Illinois,191,Wayne County,0,12,-12
5,Arkansas,17,Illinois,197,Will County,107,22,85
5,Arkansas,17,Illinois,201,Winnebago County,36,25,11
5,Arkansas,17,Illinois,203,Woodford County,16,34,-18
5,Arkansas,18,Indiana,3,Allen County,46,11,35
5,Arkansas,18,Indiana,5,Bartholomew County,0,5,-5
5,Arkansas,18,Indiana,17,Cass County,0,26,-26
5,Arkansas,18,Indiana,27,Daviess County,0,7,-7
5,Arkansas,18,Indiana,31,Decatur County,1,0,1
5,Arkansas,18,Indiana,35,Delaware County,20,46,-26
5,Arkansas,18,Indiana,39,Elkhart County,0,19,-19
5,Arkansas,18,Indiana,43,Floyd County,0,23,-23
5,Arkansas,18,Indiana,53,Grant County,0,3,-3
5,Arkansas,18,Indiana,57,Hamilton County,2,0,2
5,Arkansas,18,Indiana,61,Harrison County,0,1,-1
5,Arkansas,18,Indiana,63,Hendricks County,0,10,-10
5,Arkansas,18,Indiana,65,Henry County,0,32,-32
5,Arkansas,18,Indiana,67,Howard County,49,0,49
5,Arkansas,18,Indiana,71,Jackson County,35,0,35
5,Arkansas,18,Indiana,73,Jasper County,14,0,14
5,Arkansas,18,Indiana,77,Jefferson County,0,2,-2
5,Arkansas,18,Indiana,79,Jennings County,0,27,-27
5,Arkansas,18,Indiana,81,Johnson County,16,70,-54
5,Arkansas,18,Indiana,89,Lake County,117,38,79
5,Arkansas,18,Indiana,91,LaPorte County,32,6,26
5,Arkansas,18,Indiana,95,Madison County,28,1,27
5,Arkansas,18,Indiana,97,Marion County,272,141,131
5,Arkansas,18,Indiana,105,Monroe County,45,52,-7
5,Arkansas,18,Indiana,113,Noble County,0,22,-22
5,Arkansas,18,Indiana,127,Porter County,79,0,79
5,Arkansas,18,Indiana,141,St. Joseph County,17,45,-28
5,Arkansas,18,Indiana,147,Spencer County,0,34,-34
5,Arkansas,18,Indiana,157,Tippecanoe County,35,22,13
5,Arkansas,18,Indiana,161,Union County,53,0,53
5,Arkansas,18,Indiana,163,Vanderburgh County,0,36,-36
5,Arkansas,18,Indiana,167,Vigo County,0,156,-156
5,Arkansas,18,Indiana,173,Warrick County,0,41,-41
5,Arkansas,18,Indiana,179,Wells County,19,0,19
5,Arkansas,18,Indiana,181,White County,0,64,-64
5,Arkansas,18,Indiana,183,Whitley County,0,22,-22
5,Arkansas,19,Iowa,9,Audubon County,3,4,-1
5,Arkansas,19,Iowa,13,Black Hawk County,29,60,-31
5,Arkansas,19,Iowa,17,Bremer County,21,0,21
5,Arkansas,19,Iowa,25,Calhoun County,0,33,-33
5,Arkansas,19,Iowa,27,Carroll County,0,5,-5
5,Arkansas,19,Iowa,29,Cass County,0,6,-6
5,Arkansas,19,Iowa,31,Cedar County,31,0,31
5,Arkansas,19,Iowa,49,Dallas County,56,0,56
5,Arkansas,19,Iowa,51,Davis County,0,10,-10
5,Arkansas,19,Iowa,53,Decatur County,19,0,19
5,Arkansas,19,Iowa,57,Des Moines County,16,14,2
5,Arkansas,19,Iowa,61,Dubuque County,0,88,-88
5,Arkansas,19,Iowa,63,Emmet County,0,23,-23
5,Arkansas,19,Iowa,83,Hardin County,0,11,-11
5,Arkansas,19,Iowa,87,Henry County,35,0,35
5,Arkansas,19,Iowa,99,Jasper County,31,0,31
5,Arkansas,19,Iowa,101,Jefferson County,16,0,16
5,Arkansas,19,Iowa,103,Johnson County,18,0,18
5,Arkansas,19,Iowa,105,Jones County,24,0,24
5,Arkansas,19,Iowa,111,Lee County,5,0,5
5,Arkansas,19,Iowa,113,Linn County,12,181,-169
5,Arkansas,19,Iowa,123,Mahaska County,3,0,3
5,Arkansas,19,Iowa,127,Marshall County,0,23,-23
5,Arkansas,19,Iowa,133,Monona County,0,1,-1
5,Arkansas,19,Iowa,137,Montgomery County,0,11,-11
5,Arkansas,19,Iowa,139,Muscatine County,0,5,-5
5,Arkansas,19,Iowa,141,O'Brien County,0,77,-77
5,Arkansas,19,Iowa,149,Plymouth County,55,0,55
5,Arkansas,19,Iowa,153,Polk County,24,243,-219
5,Arkansas,19,Iowa,155,Pottawattamie County,4,0,4
5,Arkansas,19,Iowa,163,Scott County,72,33,39
5,Arkansas,19,Iowa,169,Story County,0,21,-21
5,Arkansas,19,Iowa,175,Union County,0,3,-3
5,Arkansas,19,Iowa,179,Wapello County,0,48,-48
5,Arkansas,19,Iowa,181,Warren County,14,10,4
5,Arkansas,19,Iowa,185,Wayne County,12,0,12
5,Arkansas,19,Iowa,187,Webster County,73,5,68
5,Arkansas,19,Iowa,189,Winnebago County,16,0,16
5,Arkansas,19,Iowa,193,Woodbury County,30,0,30
5,Arkansas,19,Iowa,197,Wright County,0,1,-1
5,Arkansas,2,Alaska,20,Anchorage Municipality,40,14,26
5,Arkansas,2,Alaska,60,Bristol Bay Borough,0,4,-4
5,Arkansas,2,Alaska,68,Denali Borough,0,6,-6
5,Arkansas,2,Alaska,90,Fairbanks North Star Borough,54,88,-34
5,Arkansas,2,Alaska,110,Juneau City and Borough,13,22,-9
5,Arkansas,2,Alaska,122,Kenai Peninsula Borough,231,0,231
5,Arkansas,2,Alaska,158,Kusilvak Census Area,14,0,14
5,Arkansas,2,Alaska,170,Matanuska-Susitna Borough,20,15,5
5,Arkansas,2,Alaska,180,Nome Census Area,0,8,-8
5,Arkansas,2,Alaska,185,North Slope Borough,0,2,-2
5,Arkansas,2,Alaska,198,Prince of Wales-Hyder Census Area,0,1,-1
5,Arkansas,2,Alaska,282,Yakutat City and Borough,0,4,-4
5,Arkansas,20,Kansas,9,Barton County,0,6,-6
5,Arkansas,20,Kansas,11,Bourbon County,7,4,3
5,Arkansas,20,Kansas,15,Butler County,25,42,-17
5,Arkansas,20,Kansas,21,Cherokee County,6,0,6
5,Arkansas,20,Kansas,31,Coffey County,22,0,22
5,Arkansas,20,Kansas,33,Comanche County,30,0,30
5,Arkansas,20,Kansas,35,Cowley County,0,30,-30
5,Arkansas,20,Kansas,37,Crawford County,41,176,-135
5,Arkansas,20,Kansas,41,Dickinson County,18,0,18
5,Arkansas,20,Kansas,45,Douglas County,73,30,43
5,Arkansas,20,Kansas,47,Edwards County,10,0,10
5,Arkansas,20,Kansas,51,Ellis County,0,5,-5
5,Arkansas,20,Kansas,53,Ellsworth County,11,0,11
5,Arkansas,20,Kansas,55,Finney County,6,7,-1
5,Arkansas,20,Kansas,57,Ford County,4,0,4
5,Arkansas,20,Kansas,59,Franklin County,0,44,-44
5,Arkansas,20,Kansas,61,Geary County,9,48,-39
5,Arkansas,20,Kansas,71,Greeley County,0,10,-10
5,Arkansas,20,Kansas,79,Harvey County,61,0,61
5,Arkansas,20,Kansas,85,Jackson County,0,15,-15
5,Arkansas,20,Kansas,89,Jewell County,0,2,-2
5,Arkansas,20,Kansas,91,Johnson County,402,291,111
5,Arkansas,20,Kansas,93,Kearny County,0,11,-11
5,Arkansas,20,Kansas,97,Kiowa County,2,1,1
5,Arkansas,20,Kansas,99,Labette County,22,13,9
5,Arkansas,20,Kansas,103,Leavenworth County,12,5,7
5,Arkansas,20,Kansas,107,Linn County,1,0,1
5,Arkansas,20,Kansas,111,Lyon County,0,12,-12
5,Arkansas,20,Kansas,113,McPherson County,4,0,4
5,Arkansas,20,Kansas,119,Meade County,8,0,8
5,Arkansas,20,Kansas,121,Miami County,24,18,6
5,Arkansas,20,Kansas,125,Montgomery County,42,39,3
5,Arkansas,20,Kansas,127,Morris County,38,0,38
5,Arkansas,20,Kansas,131,Nemaha County,10,0,10
5,Arkansas,20,Kansas,133,Neosho County,0,13,-13
5,Arkansas,20,Kansas,139,Osage County,0,5,-5
5,Arkansas,20,Kansas,147,Phillips County,10,0,10
5,Arkansas,20,Kansas,149,Pottawatomie County,11,0,11
5,Arkansas,20,Kansas,153,Rawlins County,6,0,6
5,Arkansas,20,Kansas,155,Reno County,12,13,-1
5,Arkansas,20,Kansas,161,Riley County,0,18,-18
5,Arkansas,20,Kansas,163,Rooks County,11,0,11
5,Arkansas,20,Kansas,169,Saline County,128,0,128
5,Arkansas,20,Kansas,173,Sedgwick County,183,161,22
5,Arkansas,20,Kansas,177,Shawnee County,152,247,-95
5,Arkansas,20,Kansas,185,Stafford County,9,0,9
5,Arkansas,20,Kansas,191,Sumner County,0,25,-25
5,Arkansas,20,Kansas,195,Trego County,0,2,-2
5,Arkansas,20,Kansas,205,Wilson County,0,1,-1
5,Arkansas,20,Kansas,207,Woodson County,6,0,6
5,Arkansas,20,Kansas,209,Wyandotte County,50,112,-62
5,Arkansas,21,Kentucky,15,Boone County,0,8,-8
5,Arkansas,21,Kentucky,19,Boyd County,35,0,35
5,Arkansas,21,Kentucky,25,Breathitt County,13,0,13
5,Arkansas,21,Kentucky,27,Breckinridge County,0,18,-18
5,Arkansas,21,Kentucky,29,Bullitt County,59,0,59
5,Arkansas,21,Kentucky,45,Casey County,68,0,68
5,Arkansas,21,Kentucky,47,Christian County,33,39,-6
5,Arkansas,21,Kentucky,51,Clay County,0,8,-8
5,Arkansas,21,Kentucky,59,Daviess County,9,0,9
5,Arkansas,21,Kentucky,61,Edmonson County,0,46,-46
5,Arkansas,21,Kentucky,65,Estill County,11,0,11
5,Arkansas,21,Kentucky,67,Fayette County,54,21,33
5,Arkansas,21,Kentucky,81,Grant County,0,8,-8
5,Arkansas,21,Kentucky,83,Graves County,11,0,11
5,Arkansas,21,Kentucky,93,Hardin County,0,39,-39
5,Arkansas,21,Kentucky,103,Henry County,11,0,11
5,Arkansas,21,Kentucky,107,Hopkins County,141,0,141
5,Arkansas,21,Kentucky,111,Jefferson County,121,203,-82
5,Arkansas,21,Kentucky,117,Kenton County,7,31,-24
5,Arkansas,21,Kentucky,145,McCracken County,33,0,33
5,Arkansas,21,Kentucky,149,McLean County,0,14,-14
5,Arkansas,21,Kentucky,151,Madison County,14,0,14
5,Arkansas,21,Kentucky,163,Meade County,247,0,247
5,Arkansas,21,Kentucky,165,Menifee County,0,4,-4
5,Arkansas,21,Kentucky,171,Monroe County,22,0,22
5,Arkansas,21,Kentucky,173,Montgomery County,19,0,19
5,Arkansas,21,Kentucky,177,Muhlenberg County,0,9,-9
5,Arkansas,21,Kentucky,183,Ohio County,11,0,11
5,Arkansas,21,Kentucky,185,Oldham County,22,0,22
5,Arkansas,21,Kentucky,195,Pike County,0,6,-6
5,Arkansas,21,Kentucky,197,Powell County,0,3,-3
5,Arkansas,21,Kentucky,211,Shelby County,47,0,47
5,Arkansas,21,Kentucky,227,Warren County,13,32,-19
5,Arkansas,21,Kentucky,233,Webster County,0,7,-7
5,Arkansas,21,Kentucky,235,Whitley County,10,0,10
5,Arkansas,22,Louisiana,1,Acadia Parish,50,0,50
5,Arkansas,22,Louisiana,3,Allen Parish,159,0,159
5,Arkansas,22,Louisiana,5,Ascension Parish,38,94,-56
5,Arkansas,22,Louisiana,11,Beauregard Parish,0,77,-77
5,Arkansas,22,Louisiana,15,Bossier Parish,171,53,118
5,Arkansas,22,Louisiana,17,Caddo Parish,337,120,217
5,Arkansas,22,Louisiana,19,Calcasieu Parish,54,131,-77
5,Arkansas,22,Louisiana,27,Claiborne Parish,43,0,43
5,Arkansas,22,Louisiana,31,De Soto Parish,46,0,46
5,Arkansas,22,Louisiana,33,East Baton Rouge Parish,75,114,-39
5,Arkansas,22,Louisiana,43,Grant Parish,47,0,47
5,Arkansas,22,Louisiana,45,Iberia Parish,9,0,9
5,Arkansas,22,Louisiana,47,Iberville Parish,31,0,31
5,Arkansas,22,Louisiana,49,Jackson Parish,3,10,-7
5,Arkansas,22,Louisiana,51,Jefferson Parish,87,50,37
5,Arkansas,22,Louisiana,53,Jefferson Davis Parish,25,0,25
5,Arkansas,22,Louisiana,55,Lafayette Parish,56,109,-53
5,Arkansas,22,Louisiana,57,Lafourche Parish,2,37,-35
5,Arkansas,22,Louisiana,59,LaSalle Parish,0,63,-63
5,Arkansas,22,Louisiana,61,Lincoln Parish,47,113,-66
5,Arkansas,22,Louisiana,63,Livingston Parish,98,3,95
5,Arkansas,22,Louisiana,65,Madison Parish,0,12,-12
5,Arkansas,22,Louisiana,67,Morehouse Parish,104,0,104
5,Arkansas,22,Louisiana,69,Natchitoches Parish,7,1,6
5,Arkansas,22,Louisiana,71,Orleans Parish,123,161,-38
5,Arkansas,22,Louisiana,73,Ouachita Parish,490,393,97
5,Arkansas,22,Louisiana,75,Plaquemines Parish,0,24,-24
5,Arkansas,22,Louisiana,77,Pointe Coupee Parish,0,2,-2
5,Arkansas,22,Louisiana,79,Rapides Parish,23,113,-90
5,Arkansas,22,Louisiana,83,Richland Parish,92,42,50
5,Arkansas,22,Louisiana,85,Sabine Parish,55,0,55
5,Arkansas,22,Louisiana,87,St. Bernard Parish,8,16,-8
5,Arkansas,22,Louisiana,97,St. Landry Parish,0,6,-6
5,Arkansas,22,Louisiana,99,St. Martin Parish,0,72,-72
5,Arkansas,22,Louisiana,101,St. Mary Parish,41,22,19
5,Arkansas,22,Louisiana,103,St. Tammany Parish,148,92,56
5,Arkansas,22,Louisiana,105,Tangipahoa Parish,41,6,35
5,Arkansas,22,Louisiana,109,Terrebonne Parish,74,110,-36
5,Arkansas,22,Louisiana,111,Union Parish,85,28,57
5,Arkansas,22,Louisiana,113,Vermilion Parish,30,0,30
5,Arkansas,22,Louisiana,115,Vernon Parish,185,84,101
5,Arkansas,22,Louisiana,117,Washington Parish,25,15,10
5,Arkansas,22,Louisiana,119,Webster Parish,171,72,99
5,Arkansas,22,Louisiana,123,West Carroll Parish,33,4,29
5,Arkansas,22,Louisiana,125,West Feliciana Parish,147,0,147
5,Arkansas,22,Louisiana,127,Winn Parish,0,8,-8
5,Arkansas,23,Maine,3,Aroostook County,0,2,-2
5,Arkansas,23,Maine,29,Washington County,14,0,14
5,Arkansas,24,Maryland,3,Anne Arundel County,108,77,31
5,Arkansas,24,Maryland,5,Baltimore County,0,26,-26
5,Arkansas,24,Maryland,13,Carroll County,1,0,1
5,Arkansas,24,Maryland,25,Harford County,0,40,-40
5,Arkansas,24,Maryland,27,Howard County,23,10,13
5,Arkansas,24,Maryland,31,Montgomery County,177,58,119
5,Arkansas,24,Maryland,33,Prince George's County,148,59,89
5,Arkansas,24,Maryland,35,Queen Anne's County,33,6,27
5,Arkansas,24,Maryland,43,Washington County,10,1,9
5,Arkansas,24,Maryland,510,Baltimore city,0,4,-4
5,Arkansas,25,Massachusetts,1,Barnstable County,0,13,-13
5,Arkansas,25,Massachusetts,5,Bristol County,0,18,-18
5,Arkansas,25,Massachusetts,9,Essex County,8,0,8
5,Arkansas,25,Massachusetts,11,Franklin County,0,2,-2
5,Arkansas,25,Massachusetts,17,Middlesex County,73,89,-16
5,Arkansas,25,Massachusetts,21,Norfolk County,72,75,-3
5,Arkansas,25,Massachusetts,23,Plymouth County,0,56,-56
5,Arkansas,25,Massachusetts,25,Suffolk County,29,29,0
5,Arkansas,25,Massachusetts,27,Worcester County,0,70,-70
5,Arkansas,26,Michigan,5,Allegan County,0,7,-7
5,Arkansas,26,Michigan,7,Alpena County,8,0,8
5,Arkansas,26,Michigan,11,Arenac County,20,0,20
5,Arkansas,26,Michigan,15,Barry County,0,6,-6
5,Arkansas,26,Michigan,17,Bay County,9,30,-21
5,Arkansas,26,Michigan,19,Benzie County,0,16,-16
5,Arkansas,26,Michigan,21,Berrien County,0,125,-125
5,Arkansas,26,Michigan,25,Calhoun County,16,8,8
5,Arkansas,26,Michigan,31,Cheboygan County,155,10,145
5,Arkansas,26,Michigan,33,Chippewa County,0,11,-11
5,Arkansas,26,Michigan,45,Eaton County,15,0,15
5,Arkansas,26,Michigan,49,Genesee County,96,3,93
5,Arkansas,26,Michigan,51,Gladwin County,0,6,-6
5,Arkansas,26,Michigan,55,Grand Traverse County,8,61,-53
5,Arkansas,26,Michigan,57,Gratiot County,0,22,-22
5,Arkansas,26,Michigan,65,Ingham County,11,248,-237
5,Arkansas,26,Michigan,69,Iosco County,71,36,35
5,Arkansas,26,Michigan,71,Iron County,25,0,25
5,Arkansas,26,Michigan,73,Isabella County,54,0,54
5,Arkansas,26,Michigan,75,Jackson County,0,11,-11
5,Arkansas,26,Michigan,77,Kalamazoo County,51,0,51
5,Arkansas,26,Michigan,79,Kalkaska County,0,5,-5
5,Arkansas,26,Michigan,81,Kent County,63,74,-11
5,Arkansas,26,Michigan,91,Lenawee County,10,0,10
5,Arkansas,26,Michigan,99,Macomb County,107,31,76
5,Arkansas,26,Michigan,101,Manistee County,0,2,-2
5,Arkansas,26,Michigan,103,Marquette County,14,0,14
5,Arkansas,26,Michigan,107,Mecosta County,0,17,-17
5,Arkansas,26,Michigan,113,Missaukee County,0,6,-6
5,Arkansas,26,Michigan,121,Muskegon County,33,0,33
5,Arkansas,26,Michigan,123,Newaygo County,0,16,-16
5,Arkansas,26,Michigan,125,Oakland County,36,218,-182
5,Arkansas,26,Michigan,127,Oceana County,0,20,-20
5,Arkansas,26,Michigan,139,Ottawa County,29,0,29
5,Arkansas,26,Michigan,145,Saginaw County,25,2,23
5,Arkansas,26,Michigan,149,St. Joseph County,0,6,-6
5,Arkansas,26,Michigan,155,Shiawassee County,15,0,15
5,Arkansas,26,Michigan,157,Tuscola County,0,10,-10
5,Arkansas,26,Michigan,159,Van Buren County,0,75,-75
5,Arkansas,26,Michigan,161,Washtenaw County,73,8,65
5,Arkansas,26,Michigan,163,Wayne County,46,249,-203
5,Arkansas,27,Minnesota,1,Aitkin County,0,3,-3
5,Arkansas,27,Minnesota,7,Beltrami County,0,11,-11
5,Arkansas,27,Minnesota,13,Blue Earth County,0,16,-16
5,Arkansas,27,Minnesota,19,Carver County,0,11,-11
5,Arkansas,27,Minnesota,29,Clearwater County,9,0,9
5,Arkansas,27,Minnesota,33,Cottonwood County,0,1,-1
5,Arkansas,27,Minnesota,35,Crow Wing County,0,5,-5
5,Arkansas,27,Minnesota,37,Dakota County,0,62,-62
5,Arkansas,27,Minnesota,41,Douglas County,0,16,-16
5,Arkansas,27,Minnesota,53,Hennepin County,173,226,-53
5,Arkansas,27,Minnesota,59,Isanti County,0,4,-4
5,Arkansas,27,Minnesota,61,Itasca County,18,0,18
5,Arkansas,27,Minnesota,67,Kandiyohi County,0,22,-22
5,Arkansas,27,Minnesota,71,Koochiching County,32,0,32
5,Arkansas,27,Minnesota,79,Le Sueur County,13,0,13
5,Arkansas,27,Minnesota,81,Lincoln County,0,4,-4
5,Arkansas,27,Minnesota,105,Nobles County,0,11,-11
5,Arkansas,27,Minnesota,107,Norman County,0,7,-7
5,Arkansas,27,Minnesota,109,Olmsted County,1,8,-7
5,Arkansas,27,Minnesota,115,Pine County,0,24,-24
5,Arkansas,27,Minnesota,117,Pipestone County,0,91,-91
5,Arkansas,27,Minnesota,123,Ramsey County,24,23,1
5,Arkansas,27,Minnesota,133,Rock County,3,0,3
5,Arkansas,27,Minnesota,137,St. Louis County,21,33,-12
5,Arkansas,27,Minnesota,141,Sherburne County,36,12,24
5,Arkansas,27,Minnesota,145,Stearns County,51,0,51
5,Arkansas,27,Minnesota,149,Stevens County,0,6,-6
5,Arkansas,27,Minnesota,153,Todd County,11,0,11
5,Arkansas,27,Minnesota,161,Waseca County,0,13,-13
5,Arkansas,27,Minnesota,163,Washington County,71,0,71
5,Arkansas,27,Minnesota,171,Wright County,0,41,-41
5,Arkansas,27,Minnesota,173,Yellow Medicine County,0,5,-5
5,Arkansas,28,Mississippi,1,Adams County,40,0,40
5,Arkansas,28,Mississippi,3,Alcorn County,33,196,-163
5,Arkansas,28,Mississippi,7,Attala County,24,0,24
5,Arkansas,28,Mississippi,11,Bolivar County,0,20,-20
5,Arkansas,28,Mississippi,15,Carroll County,14,0,14
5,Arkansas,28,Mississippi,19,Choctaw County,0,1,-1
5,Arkansas,28,Mississippi,23,Clarke County,13,8,5
5,Arkansas,28,Mississippi,25,Clay County,11,0,11
5,Arkansas,28,Mississippi,27,Coahoma County,109,46,63
5,Arkansas,28,Mississippi,29,Copiah County,55,0,55
5,Arkansas,28,Mississippi,33,DeSoto County,204,341,-137
5,Arkansas,28,Mississippi,35,Forrest County,24,25,-1
5,Arkansas,28,Mississippi,41,Greene County,0,5,-5
5,Arkansas,28,Mississippi,43,Grenada County,48,0,48
5,Arkansas,28,Mississippi,45,Hancock County,69,0,69
5,Arkansas,28,Mississippi,47,Harrison County,62,143,-81
5,Arkansas,28,Mississippi,49,Hinds County,204,91,113
5,Arkansas,28,Mississippi,53,Humphreys County,12,0,12
5,Arkansas,28,Mississippi,55,Issaquena County,0,5,-5
5,Arkansas,28,Mississippi,57,Itawamba County,0,2,-2
5,Arkansas,28,Mississippi,59,Jackson County,37,101,-64
5,Arkansas,28,Mississippi,61,Jasper County,0,8,-8
5,Arkansas,28,Mississippi,65,Jefferson Davis County,33,0,33
5,Arkansas,28,Mississippi,67,Jones County,46,0,46
5,Arkansas,28,Mississippi,71,Lafayette County,66,88,-22
5,Arkansas,28,Mississippi,73,Lamar County,76,110,-34
5,Arkansas,28,Mississippi,75,Lauderdale County,0,149,-149
5,Arkansas,28,Mississippi,79,Leake County,7,47,-40
5,Arkansas,28,Mississippi,81,Lee County,40,42,-2
5,Arkansas,28,Mississippi,83,Leflore County,26,50,-24
5,Arkansas,28,Mississippi,85,Lincoln County,8,0,8
5,Arkansas,28,Mississippi,87,Lowndes County,427,19,408
5,Arkansas,28,Mississippi,89,Madison County,43,68,-25
5,Arkansas,28,Mississippi,91,Marion County,51,0,51
5,Arkansas,28,Mississippi,93,Marshall County,126,9,117
5,Arkansas,28,Mississippi,97,Montgomery County,47,9,38
5,Arkansas,28,Mississippi,99,Neshoba County,0,13,-13
5,Arkansas,28,Mississippi,103,Noxubee County,116,0,116
5,Arkansas,28,Mississippi,105,Oktibbeha County,100,30,70
5,Arkansas,28,Mississippi,107,Panola County,70,8,62
5,Arkansas,28,Mississippi,109,Pearl River County,0,13,-13
5,Arkansas,28,Mississippi,111,Perry County,24,0,24
5,Arkansas,28,Mississippi,113,Pike County,51,0,51
5,Arkansas,28,Mississippi,117,Prentiss County,0,23,-23
5,Arkansas,28,Mississippi,121,Rankin County,48,67,-19
5,Arkansas,28,Mississippi,123,Scott County,0,96,-96
5,Arkansas,28,Mississippi,131,Stone County,0,18,-18
5,Arkansas,28,Mississippi,133,Sunflower County,134,0,134
5,Arkansas,28,Mississippi,135,Tallahatchie County,0,7,-7
5,Arkansas,28,Mississippi,137,Tate County,50,0,50
5,Arkansas,28,Mississippi,139,Tippah County,17,0,17
5,Arkansas,28,Mississippi,141,Tishomingo County,4,0,4
5,Arkansas,28,Mississippi,145,Union County,66,39,27
5,Arkansas,28,Mississippi,149,Warren County,66,12,54
5,Arkansas,28,Mississippi,151,Washington County,226,109,117
5,Arkansas,28,Mississippi,155,Webster County,10,0,10
5,Arkansas,28,Mississippi,161,Yalobusha County,0,4,-4
5,Arkansas,28,Mississippi,163,Yazoo County,46,23,23
5,Arkansas,29,Missouri,1,Adair County,6,37,-31
5,Arkansas,29,Missouri,3,Andrew County,12,0,12
5,Arkansas,29,Missouri,7,Audrain County,0,7,-7
5,Arkansas,29,Missouri,9,Barry County,477,383,94
5,Arkansas,29,Missouri,11,Barton County,0,2,-2
5,Arkansas,29,Missouri,13,Bates County,70,21,49
5,Arkansas,29,Missouri,15,Benton County,0,3,-3
5,Arkansas,29,Missouri,17,Bollinger County,0,3,-3
5,Arkansas,29,Missouri,19,Boone County,192,141,51
5,Arkansas,29,Missouri,21,Buchanan County,20,27,-7
5,Arkansas,29,Missouri,23,Butler County,226,82,144
5,Arkansas,29,Missouri,25,Caldwell County,0,1,-1
5,Arkansas,29,Missouri,27,Callaway County,15,17,-2
5,Arkansas,29,Missouri,29,Camden County,86,18,68
5,Arkansas,29,Missouri,31,Cape Girardeau County,68,105,-37
5,Arkansas,29,Missouri,35,Carter County,10,9,1
5,Arkansas,29,Missouri,37,Cass County,123,28,95
5,Arkansas,29,Missouri,39,Cedar County,25,8,17
5,Arkansas,29,Missouri,41,Chariton County,0,1,-1
5,Arkansas,29,Missouri,43,Christian County,179,66,113
5,Arkansas,29,Missouri,47,Clay County,225,74,151
5,Arkansas,29,Missouri,51,Cole County,14,57,-43
5,Arkansas,29,Missouri,53,Cooper County,0,20,-20
5,Arkansas,29,Missouri,55,Crawford County,0,16,-16
5,Arkansas,29,Missouri,57,Dade County,20,54,-34
5,Arkansas,29,Missouri,59,Dallas County,5,32,-27
5,Arkansas,29,Missouri,61,Daviess County,0,4,-4
5,Arkansas,29,Missouri,65,Dent County,19,32,-13
5,Arkansas,29,Missouri,67,Douglas County,6,111,-105
5,Arkansas,29,Missouri,69,Dunklin County,203,267,-64
5,Arkansas,29,Missouri,71,Franklin County,0,5,-5
5,Arkansas,29,Missouri,75,Gentry County,0,5,-5
5,Arkansas,29,Missouri,77,Greene County,539,611,-72
5,Arkansas,29,Missouri,79,Grundy County,5,0,5
5,Arkansas,29,Missouri,83,Henry County,0,18,-18
5,Arkansas,29,Missouri,89,Howard County,0,6,-6
5,Arkansas,29,Missouri,91,Howell County,195,52,143
5,Arkansas,29,Missouri,93,Iron County,0,1,-1
5,Arkansas,29,Missouri,95,Jackson County,395,343,52
5,Arkansas,29,Missouri,97,Jasper County,200,176,24
5,Arkansas,29,Missouri,99,Jefferson County,83,172,-89
5,Arkansas,29,Missouri,101,Johnson County,6,49,-43
5,Arkansas,29,Missouri,105,Laclede County,0,3,-3
5,Arkansas,29,Missouri,107,Lafayette County,0,78,-78
5,Arkansas,29,Missouri,109,Lawrence County,24,139,-115
5,Arkansas,29,Missouri,111,Lewis County,9,0,9
5,Arkansas,29,Missouri,113,Lincoln County,40,11,29
5,Arkansas,29,Missouri,115,Linn County,30,9,21
5,Arkansas,29,Missouri,119,McDonald County,294,246,48
5,Arkansas,29,Missouri,121,Macon County,15,0,15
5,Arkansas,29,Missouri,127,Marion County,0,45,-45
5,Arkansas,29,Missouri,129,Mercer County,0,3,-3
5,Arkansas,29,Missouri,131,Miller County,0,28,-28
5,Arkansas,29,Missouri,133,Mississippi County,4,29,-25
5,Arkansas,29,Missouri,135,Moniteau County,15,8,7
5,Arkansas,29,Missouri,137,Monroe County,69,0,69
5,Arkansas,29,Missouri,141,Morgan County,0,10,-10
5,Arkansas,29,Missouri,143,New Madrid County,109,9,100
5,Arkansas,29,Missouri,145,Newton County,181,228,-47
5,Arkansas,29,Missouri,147,Nodaway County,13,33,-20
5,Arkansas,29,Missouri,149,Oregon County,203,170,33
5,Arkansas,29,Missouri,153,Ozark County,29,20,9
5,Arkansas,29,Missouri,155,Pemiscot County,138,386,-248
5,Arkansas,29,Missouri,159,Pettis County,26,50,-24
5,Arkansas,29,Missouri,161,Phelps County,55,69,-14
5,Arkansas,29,Missouri,163,Pike County,0,7,-7
5,Arkansas,29,Missouri,165,Platte County,90,398,-308
5,Arkansas,29,Missouri,167,Polk County,5,230,-225
5,Arkansas,29,Missouri,169,Pulaski County,59,199,-140
5,Arkansas,29,Missouri,173,Ralls County,4,0,4
5,Arkansas,29,Missouri,175,Randolph County,13,18,-5
5,Arkansas,29,Missouri,177,Ray County,0,2,-2
5,Arkansas,29,Missouri,179,Reynolds County,0,23,-23
5,Arkansas,29,Missouri,181,Ripley County,23,102,-79
5,Arkansas,29,Missouri,183,St. Charles County,237,170,67
5,Arkansas,29,Missouri,187,St. Francois County,25,30,-5
5,Arkansas,29,Missouri,189,St. Louis County,466,502,-36
5,Arkansas,29,Missouri,195,Saline County,0,73,-73
5,Arkansas,29,Missouri,199,Scotland County,0,9,-9
5,Arkansas,29,Missouri,201,Scott County,140,127,13
5,Arkansas,29,Missouri,203,Shannon County,0,19,-19
5,Arkansas,29,Missouri,207,Stoddard County,60,90,-30
5,Arkansas,29,Missouri,209,Stone County,119,171,-52
5,Arkansas,29,Missouri,211,Sullivan County,0,6,-6
5,Arkansas,29,Missouri,213,Taney County,165,630,-465
5,Arkansas,29,Missouri,215,Texas County,33,30,3
5,Arkansas,29,Missouri,217,Vernon County,56,5,51
5,Arkansas,29,Missouri,219,Warren County,11,0,11
5,Arkansas,29,Missouri,223,Wayne County,50,91,-41
5,Arkansas,29,Missouri,225,Webster County,29,60,-31
5,Arkansas,29,Missouri,229,Wright County,0,80,-80
5,Arkansas,29,Missouri,510,St. Louis city,649,145,504
5,Arkansas,30,Montana,1,Beaverhead County,119,0,119
5,Arkansas,30,Montana,3,Big Horn County,6,0,6
5,Arkansas,30,Montana,9,Carbon County,9,0,9
5,Arkansas,30,Montana,13,Cascade County,32,89,-57
5,Arkansas,30,Montana,17,Custer County,0,16,-16
5,Arkansas,30,Montana,29,Flathead County,29,0,29
5,Arkansas,30,Montana,31,Gallatin County,0,34,-34
5,Arkansas,30,Montana,49,Lewis and Clark County,0,188,-188
5,Arkansas,30,Montana,53,Lincoln County,23,0,23
5,Arkansas,30,Montana,63,Missoula County,0,29,-29
5,Arkansas,30,Montana,65,Musselshell County,16,0,16
5,Arkansas,30,Montana,101,Toole County,0,5,-5
5,Arkansas,30,Montana,105,Valley County,19,0,19
5,Arkansas,30,Montana,111,Yellowstone County,0,68,-68
5,Arkansas,31,Nebraska,1,Adams County,0,3,-3
5,Arkansas,31,Nebraska,13,Box Butte County,0,16,-16
5,Arkansas,31,Nebraska,19,Buffalo County,0,4,-4
5,Arkansas,31,Nebraska,39,Cuming County,0,9,-9
5,Arkansas,31,Nebraska,41,Custer County,29,2,27
5,Arkansas,31,Nebraska,53,Dodge County,36,15,21
5,Arkansas,31,Nebraska,55,Douglas County,258,119,139
5,Arkansas,31,Nebraska,91,Hooker County,0,9,-9
5,Arkansas,31,Nebraska,93,Howard County,0,17,-17
5,Arkansas,31,Nebraska,97,Johnson County,0,41,-41
5,Arkansas,31,Nebraska,101,Keith County,0,17,-17
5,Arkansas,31,Nebraska,109,Lancaster County,49,65,-16
5,Arkansas,31,Nebraska,111,Lincoln County,29,0,29
5,Arkansas,31,Nebraska,119,Madison County,0,18,-18
5,Arkansas,31,Nebraska,123,Morrill County,0,3,-3
5,Arkansas,31,Nebraska,127,Nemaha County,0,21,-21
5,Arkansas,31,Nebraska,133,Pawnee County,0,19,-19
5,Arkansas,31,Nebraska,137,Phelps County,0,8,-8
5,Arkansas,31,Nebraska,141,Platte County,0,7,-7
5,Arkansas,31,Nebraska,153,Sarpy County,0,6,-6
5,Arkansas,31,Nebraska,167,Stanton County,0,8,-8
5,Arkansas,32,Nevada,3,Clark County,220,335,-115
5,Arkansas,32,Nevada,19,Lyon County,0,163,-163
5,Arkansas,32,Nevada,31,Washoe County,286,22,264
5,Arkansas,32,Nevada,510,Carson City,0,6,-6
5,Arkansas,33,New Hampshire,5,Cheshire County,0,16,-16
5,Arkansas,33,New Hampshire,9,Grafton County,79,130,-51
5,Arkansas,33,New Hampshire,11,Hillsborough County,0,34,-34
5,Arkansas,33,New Hampshire,13,Merrimack County,0,59,-59
5,Arkansas,33,New Hampshire,17,Strafford County,0,23,-23
5,Arkansas,34,New Jersey,1,Atlantic County,35,6,29
5,Arkansas,34,New Jersey,3,Bergen County,109,17,92
5,Arkansas,34,New Jersey,5,Burlington County,18,52,-34
5,Arkansas,34,New Jersey,7,Camden County,13,0,13
5,Arkansas,34,New Jersey,11,Cumberland County,3,0,3
5,Arkansas,34,New Jersey,13,Essex County,12,10,2
5,Arkansas,34,New Jersey,15,Gloucester County,34,0,34
5,Arkansas,34,New Jersey,17,Hudson County,0,5,-5
5,Arkansas,34,New Jersey,21,Mercer County,12,43,-31
5,Arkansas,34,New Jersey,23,Middlesex County,4,0,4
5,Arkansas,34,New Jersey,27,Morris County,20,0,20
5,Arkansas,34,New Jersey,29,Ocean County,0,11,-11
5,Arkansas,34,New Jersey,35,Somerset County,7,80,-73
5,Arkansas,35,New Mexico,1,Bernalillo County,105,161,-56
5,Arkansas,35,New Mexico,5,Chaves County,7,0,7
5,Arkansas,35,New Mexico,9,Curry County,14,0,14
5,Arkansas,35,New Mexico,13,Doña Ana County,88,0,88
5,Arkansas,35,New Mexico,17,Grant County,0,17,-17
5,Arkansas,35,New Mexico,21,Harding County,0,5,-5
5,Arkansas,35,New Mexico,25,Lea County,4,0,4
5,Arkansas,35,New Mexico,27,Lincoln County,22,0,22
5,Arkansas,35,New Mexico,35,Otero County,29,0,29
5,Arkansas,35,New Mexico,39,Rio Arriba County,21,0,21
5,Arkansas,35,New Mexico,41,Roosevelt County,2,0,2
5,Arkansas,35,New Mexico,43,Sandoval County,30,29,1
5,Arkansas,35,New Mexico,49,Santa Fe County,46,0,46
5,Arkansas,35,New Mexico,51,Sierra County,15,0,15
5,Arkansas,35,New Mexico,59,Union County,0,9,-9
5,Arkansas,35,New Mexico,61,Valencia County,16,0,16
5,Arkansas,36,New York,1,Albany County,0,25,-25
5,Arkansas,36,New York,3,Allegany County,31,17,14
5,Arkansas,36,New York,13,Chautauqua County,0,18,-18
5,Arkansas,36,New York,15,Chemung County,0,30,-30
5,Arkansas,36,New York,17,Chenango County,0,12,-12
5,Arkansas,36,New York,27,Dutchess County,0,98,-98
5,Arkansas,36,New York,29,Erie County,61,0,61
5,Arkansas,36,New York,35,Fulton County,15,11,4
5,Arkansas,36,New York,45,Jefferson County,34,25,9
5,Arkansas,36,New York,47,Kings County,73,151,-78
5,Arkansas,36,New York,51,Livingston County,0,3,-3
5,Arkansas,36,New York,55,Monroe County,0,1,-1
5,Arkansas,36,New York,57,Montgomery County,21,0,21
5,Arkansas,36,New York,59,Nassau County,16,11,5
5,Arkansas,36,New York,61,New York County,268,33,235
5,Arkansas,36,New York,65,Oneida County,27,5,22
5,Arkansas,36,New York,67,Onondaga County,14,8,6
5,Arkansas,36,New York,71,Orange County,0,10,-10
5,Arkansas,36,New York,75,Oswego County,0,29,-29
5,Arkansas,36,New York,81,Queens County,0,34,-34
5,Arkansas,36,New York,85,Richmond County,0,35,-35
5,Arkansas,36,New York,93,Schenectady County,16,0,16
5,Arkansas,36,New York,101,Steuben County,0,70,-70
5,Arkansas,36,New York,103,Suffolk County,25,10,15
5,Arkansas,36,New York,109,Tompkins County,3,0,3
5,Arkansas,36,New York,111,Ulster County,27,16,11
5,Arkansas,36,New York,113,Warren County,0,4,-4
5,Arkansas,36,New York,117,Wayne County,0,18,-18
5,Arkansas,36,New York,119,Westchester County,137,40,97
5,Arkansas,37,North Carolina,1,Alamance County,0,10,-10
5,Arkansas,37,North Carolina,9,Ashe County,39,0,39
5,Arkansas,37,North Carolina,15,Bertie County,0,15,-15
5,Arkansas,37,North Carolina,19,Brunswick County,0,14,-14
5,Arkansas,37,North Carolina,21,Buncombe County,0,15,-15
5,Arkansas,37,North Carolina,23,Burke County,8,0,8
5,Arkansas,37,North Carolina,25,Cabarrus County,0,7,-7
5,Arkansas,37,North Carolina,29,Camden County,2,0,2
5,Arkansas,37,North Carolina,31,Carteret County,0,4,-4
5,Arkansas,37,North Carolina,35,Catawba County,48,6,42
5,Arkansas,37,North Carolina,45,Cleveland County,0,97,-97
5,Arkansas,37,North Carolina,47,Columbus County,3,0,3
5,Arkansas,37,North Carolina,49,Craven County,93,36,57
5,Arkansas,37,North Carolina,51,Cumberland County,52,39,13
5,Arkansas,37,North Carolina,55,Dare County,93,6,87
5,Arkansas,37,North Carolina,57,Davidson County,0,40,-40
5,Arkansas,37,North Carolina,63,Durham County,25,3,22
5,Arkansas,37,North Carolina,71,Gaston County,0,38,-38
5,Arkansas,37,North Carolina,81,Guilford County,11,74,-63
5,Arkansas,37,North Carolina,83,Halifax County,23,0,23
5,Arkansas,37,North Carolina,85,Harnett County,0,100,-100
5,Arkansas,37,North Carolina,89,Henderson County,0,56,-56
5,Arkansas,37,North Carolina,97,Iredell County,0,21,-21
5,Arkansas,37,North Carolina,101,Johnston County,50,0,50
5,Arkansas,37,North Carolina,119,Mecklenburg County,251,32,219
5,Arkansas,37,North Carolina,129,New Hanover County,0,11,-11
5,Arkansas,37,North Carolina,133,Onslow County,270,62,208
5,Arkansas,37,North Carolina,135,Orange County,0,10,-10
5,Arkansas,37,North Carolina,155,Robeson County,22,0,22
5,Arkansas,37,North Carolina,157,Rockingham County,5,0,5
5,Arkansas,37,North Carolina,165,Scotland County,22,0,22
5,Arkansas,37,North Carolina,179,Union County,0,46,-46
5,Arkansas,37,North Carolina,183,Wake County,89,67,22
5,Arkansas,37,North Carolina,191,Wayne County,151,44,107
5,Arkansas,37,North Carolina,199,Yancey County,0,12,-12
5,Arkansas,38,North Dakota,15,Burleigh County,0,5,-5
5,Arkansas,38,North Dakota,17,Cass County,53,0,53
5,Arkansas,38,North Dakota,31,Foster County,0,28,-28
5,Arkansas,38,North Dakota,37,Grant County,0,35,-35
5,Arkansas,38,North Dakota,41,Hettinger County,0,36,-36
5,Arkansas,38,North Dakota,61,Mountrail County,0,10,-10
5,Arkansas,38,North Dakota,75,Renville County,0,3,-3
5,Arkansas,38,North Dakota,77,Richland County,0,2,-2
5,Arkansas,38,North Dakota,79,Rolette County,4,0,4
5,Arkansas,38,North Dakota,101,Ward County,11,8,3
5,Arkansas,39,Ohio,3,Allen County,0,36,-36
5,Arkansas,39,Ohio,7,Ashtabula County,0,22,-22
5,Arkansas,39,Ohio,17,Butler County,0,7,-7
5,Arkansas,39,Ohio,35,Cuyahoga County,67,28,39
5,Arkansas,39,Ohio,43,Erie County,0,7,-7
5,Arkansas,39,Ohio,45,Fairfield County,0,1,-1
5,Arkansas,39,Ohio,49,Franklin County,21,104,-83
5,Arkansas,39,Ohio,57,Greene County,45,49,-4
5,Arkansas,39,Ohio,61,Hamilton County,265,224,41
5,Arkansas,39,Ohio,81,Jefferson County,0,36,-36
5,Arkansas,39,Ohio,85,Lake County,25,0,25
5,Arkansas,39,Ohio,91,Logan County,26,22,4
5,Arkansas,39,Ohio,93,Lorain County,0,46,-46
5,Arkansas,39,Ohio,95,Lucas County,0,90,-90
5,Arkansas,39,Ohio,99,Mahoning County,25,9,16
5,Arkansas,39,Ohio,101,Marion County,0,14,-14
5,Arkansas,39,Ohio,103,Medina County,0,7,-7
5,Arkansas,39,Ohio,107,Mercer County,21,0,21
5,Arkansas,39,Ohio,113,Montgomery County,50,145,-95
5,Arkansas,39,Ohio,119,Muskingum County,48,17,31
5,Arkansas,39,Ohio,137,Putnam County,3,0,3
5,Arkansas,39,Ohio,139,Richland County,0,25,-25
5,Arkansas,39,Ohio,141,Ross County,41,0,41
5,Arkansas,39,Ohio,143,Sandusky County,0,1,-1
5,Arkansas,39,Ohio,147,Seneca County,0,79,-79
5,Arkansas,39,Ohio,151,Stark County,0,17,-17
5,Arkansas,39,Ohio,153,Summit County,0,89,-89
5,Arkansas,39,Ohio,155,Trumbull County,0,41,-41
5,Arkansas,39,Ohio,165,Warren County,33,20,13
5,Arkansas,39,Ohio,169,Wayne County,20,0,20
5,Arkansas,39,Ohio,171,Williams County,0,10,-10
5,Arkansas,4,Arizona,1,Apache County,0,4,-4
5,Arkansas,4,Arizona,3,Cochise County,8,11,-3
5,Arkansas,4,Arizona,5,Coconino County,58,18,40
5,Arkansas,4,Arizona,12,La Paz County,1,0,1
5,Arkansas,4,Arizona,13,Maricopa County,663,364,299
5,Arkansas,4,Arizona,15,Mohave County,78,44,34
5,Arkansas,4,Arizona,17,Navajo County,6,8,-2
5,Arkansas,4,Arizona,19,Pima County,189,413,-224
5,Arkansas,4,Arizona,21,Pinal County,83,18,65
5,Arkansas,4,Arizona,25,Yavapai County,0,128,-128
5,Arkansas,4,Arizona,27,Yuma County,5,19,-14
5,Arkansas,40,Oklahoma,1,Adair County,335,191,144
5,Arkansas,40,Oklahoma,5,Atoka County,3,10,-7
5,Arkansas,40,Oklahoma,9,Beckham County,80,156,-76
5,Arkansas,40,Oklahoma,11,Blaine County,11,43,-32
5,Arkansas,40,Oklahoma,13,Bryan County,102,66,36
5,Arkansas,40,Oklahoma,15,Caddo County,5,7,-2
5,Arkansas,40,Oklahoma,17,Canadian County,62,85,-23
5,Arkansas,40,Oklahoma,19,Carter County,17,69,-52
5,Arkansas,40,Oklahoma,21,Cherokee County,29,136,-107
5,Arkansas,40,Oklahoma,23,Choctaw County,2,17,-15
5,Arkansas,40,Oklahoma,27,Cleveland County,164,592,-428
5,Arkansas,40,Oklahoma,29,Coal County,0,12,-12
5,Arkansas,40,Oklahoma,31,Comanche County,118,107,11
5,Arkansas,40,Oklahoma,33,Cotton County,0,8,-8
5,Arkansas,40,Oklahoma,35,Craig County,18,6,12
5,Arkansas,40,Oklahoma,37,Creek County,59,22,37
5,Arkansas,40,Oklahoma,39,Custer County,9,0,9
5,Arkansas,40,Oklahoma,41,Delaware County,154,475,-321
5,Arkansas,40,Oklahoma,43,Dewey County,0,16,-16
5,Arkansas,40,Oklahoma,47,Garfield County,188,111,77
5,Arkansas,40,Oklahoma,51,Grady County,15,44,-29
5,Arkansas,40,Oklahoma,53,Grant County,14,0,14
5,Arkansas,40,Oklahoma,55,Greer County,16,4,12
5,Arkansas,40,Oklahoma,57,Harmon County,0,6,-6
5,Arkansas,40,Oklahoma,59,Harper County,0,8,-8
5,Arkansas,40,Oklahoma,61,Haskell County,41,24,17
5,Arkansas,40,Oklahoma,65,Jackson County,0,44,-44
5,Arkansas,40,Oklahoma,67,Jefferson County,0,3,-3
5,Arkansas,40,Oklahoma,71,Kay County,79,28,51
5,Arkansas,40,Oklahoma,73,Kingfisher County,14,25,-11
5,Arkansas,40,Oklahoma,75,Kiowa County,0,32,-32
5,Arkansas,40,Oklahoma,77,Latimer County,16,7,9
5,Arkansas,40,Oklahoma,79,Le Flore County,704,673,31
5,Arkansas,40,Oklahoma,81,Lincoln County,48,45,3
5,Arkansas,40,Oklahoma,83,Logan County,108,90,18
5,Arkansas,40,Oklahoma,85,Love County,108,3,105
5,Arkansas,40,Oklahoma,87,McClain County,1,15,-14
5,Arkansas,40,Oklahoma,89,McCurtain County,151,168,-17
5,Arkansas,40,Oklahoma,91,McIntosh County,22,8,14
5,Arkansas,40,Oklahoma,95,Marshall County,0,2,-2
5,Arkansas,40,Oklahoma,97,Mayes County,49,63,-14
5,Arkansas,40,Oklahoma,99,Murray County,1,23,-22
5,Arkansas,40,Oklahoma,101,Muskogee County,184,146,38
5,Arkansas,40,Oklahoma,105,Nowata County,24,0,24
5,Arkansas,40,Oklahoma,107,Okfuskee County,11,6,5
5,Arkansas,40,Oklahoma,109,Oklahoma County,675,1139,-464
5,Arkansas,40,Oklahoma,111,Okmulgee County,39,58,-19
5,Arkansas,40,Oklahoma,113,Osage County,54,28,26
5,Arkansas,40,Oklahoma,115,Ottawa County,146,89,57
5,Arkansas,40,Oklahoma,117,Pawnee County,43,14,29
5,Arkansas,40,Oklahoma,119,Payne County,250,267,-17
5,Arkansas,40,Oklahoma,121,Pittsburg County,154,34,120
5,Arkansas,40,Oklahoma,123,Pontotoc County,17,110,-93
5,Arkansas,40,Oklahoma,125,Pottawatomie County,10,119,-109
5,Arkansas,40,Oklahoma,127,Pushmataha County,0,11,-11
5,Arkansas,40,Oklahoma,131,Rogers County,224,82,142
5,Arkansas,40,Oklahoma,133,Seminole County,3,14,-11
5,Arkansas,40,Oklahoma,135,Sequoyah County,517,459,58
5,Arkansas,40,Oklahoma,137,Stephens County,227,0,227
5,Arkansas,40,Oklahoma,141,Tillman County,12,22,-10
5,Arkansas,40,Oklahoma,143,Tulsa County,1696,1135,561
5,Arkansas,40,Oklahoma,145,Wagoner County,36,121,-85
5,Arkansas,40,Oklahoma,147,Washington County,82,50,32
5,Arkansas,40,Oklahoma,149,Washita County,0,24,-24
5,Arkansas,40,Oklahoma,151,Woods County,0,9,-9
5,Arkansas,40,Oklahoma,153,Woodward County,14,30,-16
5,Arkansas,41,Oregon,5,Clackamas County,0,66,-66
5,Arkansas,41,Oregon,7,Clatsop County,0,12,-12
5,Arkansas,41,Oregon,11,Coos County,0,41,-41
5,Arkansas,41,Oregon,17,Deschutes County,11,0,11
5,Arkansas,41,Oregon,19,Douglas County,0,35,-35
5,Arkansas,41,Oregon,29,Jackson County,11,10,1
5,Arkansas,41,Oregon,33,Josephine County,0,39,-39
5,Arkansas,41,Oregon,35,Klamath County,0,13,-13
5,Arkansas,41,Oregon,39,Lane County,83,20,63
5,Arkansas,41,Oregon,43,Linn County,0,25,-25
5,Arkansas,41,Oregon,45,Malheur County,0,16,-16
5,Arkansas,41,Oregon,47,Marion County,14,0,14
5,Arkansas,41,Oregon,51,Multnomah County,123,318,-195
5,Arkansas,41,Oregon,65,Wasco County,0,10,-10
5,Arkansas,41,Oregon,67,Washington County,121,35,86
5,Arkansas,41,Oregon,71,Yamhill County,58,0,58
5,Arkansas,42,Pennsylvania,3,Allegheny County,0,74,-74
5,Arkansas,42,Pennsylvania,11,Berks County,6,0,6
5,Arkansas,42,Pennsylvania,17,Bucks County,0,88,-88
5,Arkansas,42,Pennsylvania,19,Butler County,0,20,-20
5,Arkansas,42,Pennsylvania,27,Centre County,19,16,3
5,Arkansas,42,Pennsylvania,29,Chester County,69,0,69
5,Arkansas,42,Pennsylvania,31,Clarion County,0,22,-22
5,Arkansas,42,Pennsylvania,33,Clearfield County,84,40,44
5,Arkansas,42,Pennsylvania,37,Columbia County,0,11,-11
5,Arkansas,42,Pennsylvania,41,Cumberland County,42,3,39
5,Arkansas,42,Pennsylvania,43,Dauphin County,20,0,20
5,Arkansas,42,Pennsylvania,45,Delaware County,4,11,-7
5,Arkansas,42,Pennsylvania,49,Erie County,335,11,324
5,Arkansas,42,Pennsylvania,51,Fayette County,0,4,-4
5,Arkansas,42,Pennsylvania,55,Franklin County,20,64,-44
5,Arkansas,42,Pennsylvania,57,Fulton County,14,0,14
5,Arkansas,42,Pennsylvania,59,Greene County,0,7,-7
5,Arkansas,42,Pennsylvania,63,Indiana County,0,3,-3
5,Arkansas,42,Pennsylvania,69,Lackawanna County,0,38,-38
5,Arkansas,42,Pennsylvania,73,Lawrence County,7,99,-92
5,Arkansas,42,Pennsylvania,75,Lebanon County,42,53,-11
5,Arkansas,42,Pennsylvania,77,Lehigh County,13,0,13
5,Arkansas,42,Pennsylvania,79,Luzerne County,33,72,-39
5,Arkansas,42,Pennsylvania,81,Lycoming County,41,0,41
5,Arkansas,42,Pennsylvania,87,Mifflin County,0,40,-40
5,Arkansas,42,Pennsylvania,95,Northampton County,0,17,-17
5,Arkansas,42,Pennsylvania,97,Northumberland County,0,15,-15
5,Arkansas,42,Pennsylvania,101,Philadelphia County,0,69,-69
5,Arkansas,42,Pennsylvania,107,Schuylkill County,22,7,15
5,Arkansas,42,Pennsylvania,115,Susquehanna County,0,2,-2
5,Arkansas,42,Pennsylvania,117,Tioga County,37,0,37
5,Arkansas,42,Pennsylvania,121,Venango County,0,27,-27
5,Arkansas,42,Pennsylvania,129,Westmoreland County,23,42,-19
5,Arkansas,42,Pennsylvania,133,York County,0,7,-7
5,Arkansas,44,Rhode Island,5,Newport County,0,20,-20
5,Arkansas,44,Rhode Island,7,Providence County,10,37,-27
5,Arkansas,45,South Carolina,3,Aiken County,0,16,-16
5,Arkansas,45,South Carolina,9,Bamberg County,0,4,-4
5,Arkansas,45,South Carolina,13,Beaufort County,1,0,1
5,Arkansas,45,South Carolina,15,Berkeley County,0,71,-71
5,Arkansas,45,South Carolina,19,Charleston County,14,88,-74
5,Arkansas,45,South Carolina,31,Darlington County,8,0,8
5,Arkansas,45,South Carolina,35,Dorchester County,13,0,13
5,Arkansas,45,South Carolina,45,Greenville County,130,44,86
5,Arkansas,45,South Carolina,47,Greenwood County,0,8,-8
5,Arkansas,45,South Carolina,51,Horry County,0,12,-12
5,Arkansas,45,South Carolina,55,Kershaw County,0,20,-20
5,Arkansas,45,South Carolina,63,Lexington County,114,0,114
5,Arkansas,45,South Carolina,71,Newberry County,0,14,-14
5,Arkansas,45,South Carolina,73,Oconee County,14,0,14
5,Arkansas,45,South Carolina,75,Orangeburg County,5,0,5
5,Arkansas,45,South Carolina,77,Pickens County,28,0,28
5,Arkansas,45,South Carolina,79,Richland County,11,396,-385
5,Arkansas,45,South Carolina,81,Saluda County,0,7,-7
5,Arkansas,45,South Carolina,83,Spartanburg County,0,323,-323
5,Arkansas,45,South Carolina,85,Sumter County,45,36,9
5,Arkansas,45,South Carolina,89,Williamsburg County,0,32,-32
5,Arkansas,45,South Carolina,91,York County,13,0,13
5,Arkansas,46,South Dakota,51,Grant County,14,11,3
5,Arkansas,46,South Dakota,59,Hand County,19,0,19
5,Arkansas,46,South Dakota,61,Hanson County,16,0,16
5,Arkansas,46,South Dakota,99,Minnehaha County,0,2,-2
5,Arkansas,46,South Dakota,103,Pennington County,0,6,-6
5,Arkansas,46,South Dakota,115,Spink County,0,2,-2
5,Arkansas,46,South Dakota,127,Union County,0,85,-85
5,Arkansas,47,Tennessee,1,Anderson County,0,25,-25
5,Arkansas,47,Tennessee,3,Bedford County,37,0,37
5,Arkansas,47,Tennessee,7,Bledsoe County,0,11,-11
5,Arkansas,47,Tennessee,9,Blount County,106,24,82
5,Arkansas,47,Tennessee,11,Bradley County,63,11,52
5,Arkansas,47,Tennessee,15,Cannon County,8,0,8
5,Arkansas,47,Tennessee,17,Carroll County,18,37,-19
5,Arkansas,47,Tennessee,19,Carter County,0,22,-22
5,Arkansas,47,Tennessee,21,Cheatham County,43,26,17
5,Arkansas,47,Tennessee,23,Chester County,20,0,20
5,Arkansas,47,Tennessee,31,Coffee County,0,141,-141
5,Arkansas,47,Tennessee,33,Crockett County,23,8,15
5,Arkansas,47,Tennessee,35,Cumberland County,0,89,-89
5,Arkansas,47,Tennessee,37,Davidson County,249,564,-315
5,Arkansas,47,Tennessee,43,Dickson County,15,3,12
5,Arkansas,47,Tennessee,45,Dyer County,94,0,94
5,Arkansas,47,Tennessee,47,Fayette County,142,119,23
5,Arkansas,47,Tennessee,49,Fentress County,0,4,-4
5,Arkansas,47,Tennessee,51,Franklin County,13,0,13
5,Arkansas,47,Tennessee,53,Gibson County,73,13,60
5,Arkansas,47,Tennessee,59,Greene County,13,14,-1
5,Arkansas,47,Tennessee,61,Grundy County,0,13,-13
5,Arkansas,47,Tennessee,63,Hamblen County,13,82,-69
5,Arkansas,47,Tennessee,65,Hamilton County,10,84,-74
5,Arkansas,47,Tennessee,69,Hardeman County,9,0,9
5,Arkansas,47,Tennessee,75,Haywood County,52,21,31
5,Arkansas,47,Tennessee,77,Henderson County,0,2,-2
5,Arkansas,47,Tennessee,83,Houston County,0,4,-4
5,Arkansas,47,Tennessee,85,Humphreys County,0,9,-9
5,Arkansas,47,Tennessee,93,Knox County,82,52,30
5,Arkansas,47,Tennessee,97,Lauderdale County,21,108,-87
5,Arkansas,47,Tennessee,99,Lawrence County,24,0,24
5,Arkansas,47,Tennessee,101,Lewis County,3,0,3
5,Arkansas,47,Tennessee,103,Lincoln County,0,33,-33
5,Arkansas,47,Tennessee,105,Loudon County,30,0,30
5,Arkansas,47,Tennessee,107,McMinn County,7,3,4
5,Arkansas,47,Tennessee,113,Madison County,155,21,134
5,Arkansas,47,Tennessee,117,Marshall County,0,5,-5
5,Arkansas,47,Tennessee,119,Maury County,48,0,48
5,Arkansas,47,Tennessee,125,Montgomery County,22,50,-28
5,Arkansas,47,Tennessee,129,Morgan County,0,3,-3
5,Arkansas,47,Tennessee,131,Obion County,18,0,18
5,Arkansas,47,Tennessee,139,Polk County,0,1,-1
5,Arkansas,47,Tennessee,141,Putnam County,0,3,-3
5,Arkansas,47,Tennessee,143,Rhea County,0,7,-7
5,Arkansas,47,Tennessee,145,Roane County,10,3,7
5,Arkansas,47,Tennessee,147,Robertson County,0,1,-1
5,Arkansas,47,Tennessee,149,Rutherford County,27,452,-425
5,Arkansas,47,Tennessee,151,Scott County,0,2,-2
5,Arkansas,47,Tennessee,155,Sevier County,0,134,-134
5,Arkansas,47,Tennessee,157,Shelby County,2356,3097,-741
5,Arkansas,47,Tennessee,159,Smith County,0,32,-32
5,Arkansas,47,Tennessee,163,Sullivan County,12,8,4
5,Arkansas,47,Tennessee,165,Sumner County,44,20,24
5,Arkansas,47,Tennessee,167,Tipton County,162,121,41
5,Arkansas,47,Tennessee,171,Unicoi County,0,5,-5
5,Arkansas,47,Tennessee,173,Union County,29,0,29
5,Arkansas,47,Tennessee,177,Warren County,70,0,70
5,Arkansas,47,Tennessee,179,Washington County,4,3,1
5,Arkansas,47,Tennessee,181,Wayne County,0,2,-2
5,Arkansas,47,Tennessee,183,Weakley County,477,71,406
5,Arkansas,47,Tennessee,185,White County,0,121,-121
5,Arkansas,47,Tennessee,187,Williamson County,27,111,-84
5,Arkansas,47,Tennessee,189,Wilson County,26,1,25
5,Arkansas,48,Texas,1,Anderson County,71,31,40
5,Arkansas,48,Texas,3,Andrews County,9,0,9
5,Arkansas,48,Texas,5,Angelina County,65,181,-116
5,Arkansas,48,Texas,17,Bailey County,0,17,-17
5,Arkansas,48,Texas,21,Bastrop County,82,3,79
5,Arkansas,48,Texas,27,Bell County,221,123,98
5,Arkansas,48,Texas,29,Bexar County,388,503,-115
5,Arkansas,48,Texas,31,Blanco County,35,0,35
5,Arkansas,48,Texas,35,Bosque County,0,10,-10
5,Arkansas,48,Texas,37,Bowie County,2511,1858,653
5,Arkansas,48,Texas,39,Brazoria County,150,288,-138
5,Arkansas,48,Texas,41,Brazos County,58,39,19
5,Arkansas,48,Texas,47,Brooks County,0,234,-234
5,Arkansas,48,Texas,49,Brown County,5,4,1
5,Arkansas,48,Texas,53,Burnet County,18,0,18
5,Arkansas,48,Texas,55,Caldwell County,36,0,36
5,Arkansas,48,Texas,59,Callahan County,0,31,-31
5,Arkansas,48,Texas,61,Cameron County,119,31,88
5,Arkansas,48,Texas,63,Camp County,22,22,0
5,Arkansas,48,Texas,67,Cass County,161,28,133
5,Arkansas,48,Texas,71,Chambers County,2,182,-180
5,Arkansas,48,Texas,73,Cherokee County,62,135,-73
5,Arkansas,48,Texas,85,Collin County,767,595,172
5,Arkansas,48,Texas,89,Colorado County,1,0,1
5,Arkansas,48,Texas,91,Comal County,33,43,-10
5,Arkansas,48,Texas,95,Concho County,0,8,-8
5,Arkansas,48,Texas,99,Coryell County,0,154,-154
5,Arkansas,48,Texas,103,Crane County,16,0,16
5,Arkansas,48,Texas,105,Crockett County,33,0,33
5,Arkansas,48,Texas,113,Dallas County,1422,1534,-112
5,Arkansas,48,Texas,119,Delta County,1,0,1
5,Arkansas,48,Texas,121,Denton County,595,584,11
5,Arkansas,48,Texas,123,DeWitt County,0,34,-34
5,Arkansas,48,Texas,133,Eastland County,4,0,4
5,Arkansas,48,Texas,135,Ector County,11,59,-48
5,Arkansas,48,Texas,139,Ellis County,22,52,-30
5,Arkansas,48,Texas,141,El Paso County,235,14,221
5,Arkansas,48,Texas,143,Erath County,0,119,-119
5,Arkansas,48,Texas,145,Falls County,26,0,26
5,Arkansas,48,Texas,147,Fannin County,25,9,16
5,Arkansas,48,Texas,157,Fort Bend County,196,192,4
5,Arkansas,48,Texas,159,Franklin County,65,90,-25
5,Arkansas,48,Texas,165,Gaines County,81,10,71
5,Arkansas,48,Texas,167,Galveston County,51,32,19
5,Arkansas,48,Texas,169,Garza County,0,6,-6
5,Arkansas,48,Texas,179,Gray County,20,0,20
5,Arkansas,48,Texas,181,Grayson County,9,107,-98
5,Arkansas,48,Texas,183,Gregg County,131,107,24
5,Arkansas,48,Texas,187,Guadalupe County,23,82,-59
5,Arkansas,48,Texas,193,Hamilton County,38,0,38
5,Arkansas,48,Texas,199,Hardin County,30,16,14
5,Arkansas,48,Texas,201,Harris County,945,1056,-111
5,Arkansas,48,Texas,203,Harrison County,47,55,-8
5,Arkansas,48,Texas,205,Hartley County,0,1,-1
5,Arkansas,48,Texas,207,Haskell County,0,2,-2
5,Arkansas,48,Texas,209,Hays County,67,144,-77
5,Arkansas,48,Texas,211,Hemphill County,20,0,20
5,Arkansas,48,Texas,213,Henderson County,34,11,23
5,Arkansas,48,Texas,215,Hidalgo County,32,70,-38
5,Arkansas,48,Texas,219,Hockley County,44,0,44
5,Arkansas,48,Texas,221,Hood County,4,0,4
5,Arkansas,48,Texas,223,Hopkins County,52,0,52
5,Arkansas,48,Texas,225,Houston County,14,0,14
5,Arkansas,48,Texas,227,Howard County,74,0,74
5,Arkansas,48,Texas,231,Hunt County,91,40,51
5,Arkansas,48,Texas,233,Hutchinson County,8,1,7
5,Arkansas,48,Texas,241,Jasper County,7,55,-48
5,Arkansas,48,Texas,245,Jefferson County,204,39,165
5,Arkansas,48,Texas,249,Jim Wells County,0,33,-33
5,Arkansas,48,Texas,251,Johnson County,28,202,-174
5,Arkansas,48,Texas,257,Kaufman County,8,136,-128
5,Arkansas,48,Texas,259,Kendall County,9,19,-10
5,Arkansas,48,Texas,265,Kerr County,3,18,-15
5,Arkansas,48,Texas,267,Kimble County,0,34,-34
5,Arkansas,48,Texas,277,Lamar County,19,36,-17
5,Arkansas,48,Texas,281,Lampasas County,0,23,-23
5,Arkansas,48,Texas,287,Lee County,28,12,16
5,Arkansas,48,Texas,291,Liberty County,58,9,49
5,Arkansas,48,Texas,293,Limestone County,64,0,64
5,Arkansas,48,Texas,303,Lubbock County,174,127,47
5,Arkansas,48,Texas,305,Lynn County,0,9,-9
5,Arkansas,48,Texas,307,McCulloch County,158,0,158
5,Arkansas,48,Texas,309,McLennan County,65,182,-117
5,Arkansas,48,Texas,313,Madison County,19,0,19
5,Arkansas,48,Texas,315,Marion County,156,0,156
5,Arkansas,48,Texas,317,Martin County,0,34,-34
5,Arkansas,48,Texas,319,Mason County,0,11,-11
5,Arkansas,48,Texas,321,Matagorda County,69,0,69
5,Arkansas,48,Texas,323,Maverick County,0,11,-11
5,Arkansas,48,Texas,325,Medina County,0,29,-29
5,Arkansas,48,Texas,329,Midland County,12,54,-42
5,Arkansas,48,Texas,331,Milam County,0,46,-46
5,Arkansas,48,Texas,337,Montague County,0,5,-5
5,Arkansas,48,Texas,339,Montgomery County,95,179,-84
5,Arkansas,48,Texas,341,Moore County,32,0,32
5,Arkansas,48,Texas,343,Morris County,15,0,15
5,Arkansas,48,Texas,347,Nacogdoches County,112,35,77
5,Arkansas,48,Texas,349,Navarro County,27,0,27
5,Arkansas,48,Texas,353,Nolan County,0,17,-17
5,Arkansas,48,Texas,355,Nueces County,183,0,183
5,Arkansas,48,Texas,357,Ochiltree County,9,0,9
5,Arkansas,48,Texas,361,Orange County,56,0,56
5,Arkansas,48,Texas,363,Palo Pinto County,42,0,42
5,Arkansas,48,Texas,365,Panola County,12,5,7
5,Arkansas,48,Texas,367,Parker County,23,82,-59
5,Arkansas,48,Texas,369,Parmer County,3,7,-4
5,Arkansas,48,Texas,373,Polk County,16,11,5
5,Arkansas,48,Texas,375,Potter County,53,0,53
5,Arkansas,48,Texas,379,Rains County,11,16,-5
5,Arkansas,48,Texas,381,Randall County,3,46,-43
5,Arkansas,48,Texas,387,Red River County,170,0,170
5,Arkansas,48,Texas,389,Reeves County,0,57,-57
5,Arkansas,48,Texas,395,Robertson County,15,0,15
5,Arkansas,48,Texas,397,Rockwall County,81,0,81
5,Arkansas,48,Texas,401,Rusk County,7,24,-17
5,Arkansas,48,Texas,407,San Jacinto County,8,0,8
5,Arkansas,48,Texas,409,San Patricio County,130,0,130
5,Arkansas,48,Texas,419,Shelby County,16,0,16
5,Arkansas,48,Texas,423,Smith County,217,202,15
5,Arkansas,48,Texas,431,Sterling County,9,0,9
5,Arkansas,48,Texas,435,Sutton County,0,13,-13
5,Arkansas,48,Texas,439,Tarrant County,1368,1056,312
5,Arkansas,48,Texas,441,Taylor County,122,159,-37
5,Arkansas,48,Texas,445,Terry County,8,0,8
5,Arkansas,48,Texas,449,Titus County,94,16,78
5,Arkansas,48,Texas,451,Tom Green County,47,187,-140
5,Arkansas,48,Texas,453,Travis County,838,584,254
5,Arkansas,48,Texas,455,Trinity County,13,24,-11
5,Arkansas,48,Texas,459,Upshur County,5,174,-169
5,Arkansas,48,Texas,463,Uvalde County,33,92,-59
5,Arkansas,48,Texas,465,Val Verde County,101,78,23
5,Arkansas,48,Texas,467,Van Zandt County,15,38,-23
5,Arkansas,48,Texas,469,Victoria County,15,24,-9
5,Arkansas,48,Texas,471,Walker County,31,7,24
5,Arkansas,48,Texas,475,Ward County,0,4,-4
5,Arkansas,48,Texas,477,Washington County,0,7,-7
5,Arkansas,48,Texas,479,Webb County,175,0,175
5,Arkansas,48,Texas,483,Wheeler County,0,3,-3
5,Arkansas,48,Texas,485,Wichita County,100,62,38
5,Arkansas,48,Texas,487,Wilbarger County,2,2,0
5,Arkansas,48,Texas,491,Williamson County,94,224,-130
5,Arkansas,48,Texas,493,Wilson County,0,19,-19
5,Arkansas,48,Texas,497,Wise County,15,0,15
5,Arkansas,48,Texas,499,Wood County,239,56,183
5,Arkansas,48,Texas,501,Yoakum County,0,19,-19
5,Arkansas,48,Texas,507,Zavala County,19,0,19
5,Arkansas,49,Utah,3,Box Elder County,0,2,-2
5,Arkansas,49,Utah,5,Cache County,117,0,117
5,Arkansas,49,Utah,11,Davis County,0,17,-17
5,Arkansas,49,Utah,13,Duchesne County,18,21,-3
5,Arkansas,49,Utah,15,Emery County,0,4,-4
5,Arkansas,49,Utah,19,Grand County,10,0,10
5,Arkansas,49,Utah,23,Juab County,0,3,-3
5,Arkansas,49,Utah,27,Millard County,6,0,6
5,Arkansas,49,Utah,35,Salt Lake County,48,124,-76
5,Arkansas,49,Utah,39,Sanpete County,16,0,16
5,Arkansas,49,Utah,49,Utah County,301,432,-131
5,Arkansas,49,Utah,53,Washington County,8,0,8
5,Arkansas,49,Utah,57,Weber County,86,31,55
5,Arkansas,5,Arkansas,1,Arkansas County,1101,657,444
5,Arkansas,5,Arkansas,3,Ashley County,620,239,381
5,Arkansas,5,Arkansas,5,Baxter County,1089,1311,-222
5,Arkansas,5,Arkansas,7,Benton County,5501,5211,290
5,Arkansas,5,Arkansas,9,Boone County,1111,1345,-234
5,Arkansas,5,Arkansas,11,Bradley County,567,196,371
5,Arkansas,5,Arkansas,13,Calhoun County,203,291,-88
5,Arkansas,5,Arkansas,15,Carroll County,1280,923,357
5,Arkansas,5,Arkansas,17,Chicot County,356,481,-125
5,Arkansas,5,Arkansas,19,Clark County,914,1901,-987
5,Arkansas,5,Arkansas,21,Clay County,949,466,483
5,Arkansas,5,Arkansas,23,Cleburne County,1036,784,252
5,Arkansas,5,Arkansas,25,Cleveland County,342,156,186
5,Arkansas,5,Arkansas,27,Columbia County,601,1330,-729
5,Arkansas,5,Arkansas,29,Conway County,1056,579,477
5,Arkansas,5,Arkansas,31,Craighead County,4236,5557,-1321
5,Arkansas,5,Arkansas,33,Crawford County,2427,1714,713
5,Arkansas,5,Arkansas,35,Crittenden County,1229,807,422
5,Arkansas,5,Arkansas,37,Cross County,635,589,46
5,Arkansas,5,Arkansas,39,Dallas County,506,646,-140
5,Arkansas,5,Arkansas,41,Desha County,873,267,606
5,Arkansas,5,Arkansas,43,Drew County,599,709,-110
5,Arkansas,5,Arkansas,45,Faulkner County,4867,5488,-621
5,Arkansas,5,Arkansas,47,Franklin County,815,963,-148
5,Arkansas,5,Arkansas,49,Fulton County,611,742,-131
5,Arkansas,5,Arkansas,51,Garland County,3655,3014,641
5,Arkansas,5,Arkansas,53,Grant County,877,823,54
5,Arkansas,5,Arkansas,55,Greene County,1711,1556,155
5,Arkansas,5,Arkansas,57,Hempstead County,1310,691,619
5,Arkansas,5,Arkansas,59,Hot Spring County,1568,1971,-403
5,Arkansas,5,Arkansas,61,Howard County,609,310,299
5,Arkansas,5,Arkansas,63,Independence County,1828,1644,184
5,Arkansas,5,Arkansas,65,Izard County,896,743,153
5,Arkansas,5,Arkansas,67,Jackson County,1490,2232,-742
5,Arkansas,5,Arkansas,69,Jefferson County,2588,2622,-34
5,Arkansas,5,Arkansas,71,Johnson County,894,738,156
5,Arkansas,5,Arkansas,73,Lafayette County,229,223,6
5,Arkansas,5,Arkansas,75,Lawrence County,779,938,-159
5,Arkansas,5,Arkansas,77,Lee County,339,408,-69
5,Arkansas,5,Arkansas,79,Lincoln County,475,734,-259
5,Arkansas,5,Arkansas,81,Little River County,345,470,-125
5,Arkansas,5,Arkansas,83,Logan County,691,1080,-389
5,Arkansas,5,Arkansas,85,Lonoke County,3870,3090,780
5,Arkansas,5,Arkansas,87,Madison County,596,302,294
5,Arkansas,5,Arkansas,89,Marion County,909,764,145
5,Arkansas,5,Arkansas,91,Miller County,900,1583,-683
5,Arkansas,5,Arkansas,93,Mississippi County,1356,1619,-263
5,Arkansas,5,Arkansas,95,Monroe County,445,344,101
5,Arkansas,5,Arkansas,97,Montgomery County,414,443,-29
5,Arkansas,5,Arkansas,99,Nevada County,366,195,171
5,Arkansas,5,Arkansas,101,Newton County,288,403,-115
5,Arkansas,5,Arkansas,103,Ouachita County,1043,421,622
5,Arkansas,5,Arkansas,105,Perry County,526,393,133
5,Arkansas,5,Arkansas,107,Phillips County,619,390,229
5,Arkansas,5,Arkansas,109,Pike County,753,630,123
5,Arkansas,5,Arkansas,111,Poinsett County,1452,1276,176
5,Arkansas,5,Arkansas,113,Polk County,660,283,377
5,Arkansas,5,Arkansas,115,Pope County,2362,3795,-1433
5,Arkansas,5,Arkansas,117,Prairie County,376,381,-5
5,Arkansas,5,Arkansas,119,Pulaski County,12300,11238,1062
5,Arkansas,5,Arkansas,121,Randolph County,1133,686,447
5,Arkansas,5,Arkansas,123,St. Francis County,1265,664,601
5,Arkansas,5,Arkansas,125,Saline County,4428,4345,83
5,Arkansas,5,Arkansas,127,Scott County,378,264,114
5,Arkansas,5,Arkansas,129,Searcy County,285,216,69
5,Arkansas,5,Arkansas,131,Sebastian County,3622,4068,-446
5,Arkansas,5,Arkansas,133,Sevier County,607,254,353
5,Arkansas,5,Arkansas,135,Sharp County,1006,1113,-107
5,Arkansas,5,Arkansas,137,Stone County,469,537,-68
5,Arkansas,5,Arkansas,139,Union County,962,870,92
5,Arkansas,5,Arkansas,141,Van Buren County,628,684,-56
5,Arkansas,5,Arkansas,143,Washington County,6241,9091,-2850
5,Arkansas,5,Arkansas,145,White County,2651,3471,-820
5,Arkansas,5,Arkansas,147,Woodruff County,339,165,174
5,Arkansas,5,Arkansas,149,Yell County,1387,917,470
5,Arkansas,50,Vermont,1,Addison County,9,0,9
5,Arkansas,50,Vermont,3,Bennington County,0,4,-4
5,Arkansas,51,Virginia,3,Albemarle County,0,6,-6
5,Arkansas,51,Virginia,13,Arlington County,28,86,-58
5,Arkansas,51,Virginia,15,Augusta County,0,9,-9
5,Arkansas,51,Virginia,59,Fairfax County,119,87,32
5,Arkansas,51,Virginia,83,Halifax County,14,40,-26
5,Arkansas,51,Virginia,85,Hanover County,0,13,-13
5,Arkansas,51,Virginia,87,Henrico County,53,42,11
5,Arkansas,51,Virginia,93,Isle of Wight County,20,0,20
5,Arkansas,51,Virginia,95,James City County,1,0,1
5,Arkansas,51,Virginia,109,Louisa County,20,0,20
5,Arkansas,51,Virginia,127,New Kent County,0,69,-69
5,Arkansas,51,Virginia,137,Orange County,0,42,-42
5,Arkansas,51,Virginia,139,Page County,10,0,10
5,Arkansas,51,Virginia,147,Prince Edward County,0,10,-10
5,Arkansas,51,Virginia,153,Prince William County,109,0,109
5,Arkansas,51,Virginia,155,Pulaski County,3,0,3
5,Arkansas,51,Virginia,161,Roanoke County,57,0,57
5,Arkansas,51,Virginia,179,Stafford County,0,42,-42
5,Arkansas,51,Virginia,510,Alexandria city,100,44,56
5,Arkansas,51,Virginia,540,Charlottesville city,0,20,-20
5,Arkansas,51,Virginia,550,Chesapeake city,54,0,54
5,Arkansas,51,Virginia,570,Colonial Heights city,14,0,14
5,Arkansas,51,Virginia,590,Danville city,11,0,11
5,Arkansas,51,Virginia,650,Hampton city,0,5,-5
5,Arkansas,51,Virginia,678,Lexington city,0,5,-5
5,Arkansas,51,Virginia,680,Lynchburg city,0,54,-54
5,Arkansas,51,Virginia,690,Martinsville city,44,0,44
5,Arkansas,51,Virginia,700,Newport News city,256,0,256
5,Arkansas,51,Virginia,710,Norfolk city,65,13,52
5,Arkansas,51,Virginia,760,Richmond city,12,27,-15
5,Arkansas,51,Virginia,775,Salem city,0,7,-7
5,Arkansas,51,Virginia,810,Virginia Beach city,9,62,-53
5,Arkansas,51,Virginia,830,Williamsburg city,3,0,3
5,Arkansas,51,Virginia,840,Winchester city,10,12,-2
5,Arkansas,53,Washington,3,Asotin County,83,11,72
5,Arkansas,53,Washington,11,Clark County,61,91,-30
5,Arkansas,53,Washington,21,Franklin County,0,51,-51
5,Arkansas,53,Washington,25,Grant County,4,0,4
5,Arkansas,53,Washington,27,Grays Harbor County,0,6,-6
5,Arkansas,53,Washington,29,Island County,0,25,-25
5,Arkansas,53,Washington,33,King County,88,322,-234
5,Arkansas,53,Washington,35,Kitsap County,0,143,-143
5,Arkansas,53,Washington,39,Klickitat County,31,0,31
5,Arkansas,53,Washington,41,Lewis County,6,0,6
5,Arkansas,53,Washington,51,Pend Oreille County,4,0,4
5,Arkansas,53,Washington,53,Pierce County,189,143,46
5,Arkansas,53,Washington,57,Skagit County,45,3,42
5,Arkansas,53,Washington,61,Snohomish County,80,104,-24
5,Arkansas,53,Washington,63,Spokane County,8,177,-169
5,Arkansas,53,Washington,65,Stevens County,232,14,218
5,Arkansas,53,Washington,67,Thurston County,0,109,-109
5,Arkansas,53,Washington,71,Walla Walla County,0,17,-17
5,Arkansas,53,Washington,75,Whitman County,0,8,-8
5,Arkansas,53,Washington,77,Yakima County,197,5,192
5,Arkansas,54,West Virginia,31,Hardy County,59,0,59
5,Arkansas,54,West Virginia,37,Jefferson County,9,116,-107
5,Arkansas,54,West Virginia,49,Marion County,12,0,12
5,Arkansas,54,West Virginia,55,Mercer County,33,0,33
5,Arkansas,54,West Virginia,61,Monongalia County,22,0,22
5,Arkansas,54,West Virginia,69,Ohio County,0,31,-31
5,Arkansas,54,West Virginia,71,Pendleton County,0,1,-1
5,Arkansas,54,West Virginia,75,Pocahontas County,0,8,-8
5,Arkansas,54,West Virginia,77,Preston County,0,1,-1
5,Arkansas,54,West Virginia,99,Wayne County,11,0,11
5,Arkansas,54,West Virginia,107,Wood County,0,10,-10
5,Arkansas,55,Wisconsin,1,Adams County,0,5,-5
5,Arkansas,55,Wisconsin,7,Bayfield County,0,4,-4
5,Arkansas,55,Wisconsin,9,Brown County,33,8,25
5,Arkansas,55,Wisconsin,11,Buffalo County,0,3,-3
5,Arkansas,55,Wisconsin,15,Calumet County,18,3,15
5,Arkansas,55,Wisconsin,17,Chippewa County,6,0,6
5,Arkansas,55,Wisconsin,25,Dane County,34,48,-14
5,Arkansas,55,Wisconsin,27,Dodge County,0,13,-13
5,Arkansas,55,Wisconsin,31,Douglas County,0,8,-8
5,Arkansas,55,Wisconsin,33,Dunn County,0,1,-1
5,Arkansas,55,Wisconsin,35,Eau Claire County,0,13,-13
5,Arkansas,55,Wisconsin,39,Fond du Lac County,25,0,25
5,Arkansas,55,Wisconsin,43,Grant County,3,3,0
5,Arkansas,55,Wisconsin,45,Green County,0,9,-9
5,Arkansas,55,Wisconsin,49,Iowa County,0,3,-3
5,Arkansas,55,Wisconsin,55,Jefferson County,0,18,-18
5,Arkansas,55,Wisconsin,57,Juneau County,0,1,-1
5,Arkansas,55,Wisconsin,59,Kenosha County,0,8,-8
5,Arkansas,55,Wisconsin,61,Kewaunee County,0,7,-7
5,Arkansas,55,Wisconsin,63,La Crosse County,8,18,-10
5,Arkansas,55,Wisconsin,73,Marathon County,0,17,-17
5,Arkansas,55,Wisconsin,75,Marinette County,66,0,66
5,Arkansas,55,Wisconsin,79,Milwaukee County,199,108,91
5,Arkansas,55,Wisconsin,81,Monroe County,25,1,24
5,Arkansas,55,Wisconsin,83,Oconto County,0,4,-4
5,Arkansas,55,Wisconsin,85,Oneida County,0,10,-10
5,Arkansas,55,Wisconsin,87,Outagamie County,0,6,-6
5,Arkansas,55,Wisconsin,93,Pierce County,35,0,35
5,Arkansas,55,Wisconsin,97,Portage County,0,1,-1
5,Arkansas,55,Wisconsin,99,Price County,0,4,-4
5,Arkansas,55,Wisconsin,101,Racine County,65,87,-22
5,Arkansas,55,Wisconsin,103,Richland County,0,2,-2
5,Arkansas,55,Wisconsin,105,Rock County,14,88,-74
5,Arkansas,55,Wisconsin,109,St. Croix County,0,8,-8
5,Arkansas,55,Wisconsin,115,Shawano County,56,4,52
5,Arkansas,55,Wisconsin,117,Sheboygan County,16,16,0
5,Arkansas,55,Wisconsin,123,Vernon County,49,0,49
5,Arkansas,55,Wisconsin,125,Vilas County,8,8,0
5,Arkansas,55,Wisconsin,131,Washington County,0,7,-7
5,Arkansas,55,Wisconsin,133,Waukesha County,36,0,36
5,Arkansas,55,Wisconsin,135,Waupaca County,0,26,-26
5,Arkansas,55,Wisconsin,137,Waushara County,0,8,-8
5,Arkansas,55,Wisconsin,139,Winnebago County,57,11,46
5,Arkansas,55,Wisconsin,141,Wood County,0,34,-34
5,Arkansas,56,Wyoming,5,Campbell County,0,11,-11
5,Arkansas,56,Wyoming,7,Carbon County,0,65,-65
5,Arkansas,56,Wyoming,9,Converse County,2,0,2
5,Arkansas,56,Wyoming,13,Fremont County,15,59,-44
5,Arkansas,56,Wyoming,21,Laramie County,29,88,-59
5,Arkansas,56,Wyoming,25,Natrona County,18,14,4
5,Arkansas,56,Wyoming,29,Park County,35,0,35
5,Arkansas,56,Wyoming,39,Teton County,8,0,8
5,Arkansas,56,Wyoming,43,Washakie County,0,5,-5
5,Arkansas,6,California,1,Alameda County,63,95,-32
5,Arkansas,6,California,5,Amador County,2,13,-11
5,Arkansas,6,California,7,Butte County,18,0,18
5,Arkansas,6,California,13,Contra Costa County,171,23,148
5,Arkansas,6,California,17,El Dorado County,18,62,-44
5,Arkansas,6,California,19,Fresno County,104,62,42
5,Arkansas,6,California,23,Humboldt County,63,0,63
5,Arkansas,6,California,27,Inyo County,0,16,-16
5,Arkansas,6,California,29,Kern County,207,129,78
5,Arkansas,6,California,31,Kings County,166,23,143
5,Arkansas,6,California,35,Lassen County,5,7,-2
5,Arkansas,6,California,37,Los Angeles County,1293,622,671
5,Arkansas,6,California,41,Marin County,0,24,-24
5,Arkansas,6,California,47,Merced County,85,73,12
5,Arkansas,6,California,53,Monterey County,132,27,105
5,Arkansas,6,California,55,Napa County,15,0,15
5,Arkansas,6,California,59,Orange County,200,90,110
5,Arkansas,6,California,61,Placer County,52,39,13
5,Arkansas,6,California,65,Riverside County,302,523,-221
5,Arkansas,6,California,67,Sacramento County,206,152,54
5,Arkansas,6,California,69,San Benito County,7,0,7
5,Arkansas,6,California,71,San Bernardino County,247,122,125
5,Arkansas,6,California,73,San Diego County,490,274,216
5,Arkansas,6,California,75,San Francisco County,42,72,-30
5,Arkansas,6,California,77,San Joaquin County,32,109,-77
5,Arkansas,6,California,79,San Luis Obispo County,24,90,-66
5,Arkansas,6,California,81,San Mateo County,33,81,-48
5,Arkansas,6,California,83,Santa Barbara County,75,12,63
5,Arkansas,6,California,85,Santa Clara County,339,68,271
5,Arkansas,6,California,87,Santa Cruz County,40,0,40
5,Arkansas,6,California,89,Shasta County,14,0,14
5,Arkansas,6,California,93,Siskiyou County,15,0,15
5,Arkansas,6,California,95,Solano County,48,119,-71
5,Arkansas,6,California,97,Sonoma County,5,0,5
5,Arkansas,6,California,99,Stanislaus County,33,31,2
5,Arkansas,6,California,101,Sutter County,0,14,-14
5,Arkansas,6,California,103,Tehama County,66,0,66
5,Arkansas,6,California,107,Tulare County,0,60,-60
5,Arkansas,6,California,111,Ventura County,195,59,136
5,Arkansas,6,California,115,Yuba County,0,90,-90
5,Arkansas,72,Puerto Rico,21,Bayamón Municipio,81,0,81
5,Arkansas,72,Puerto Rico,61,Guaynabo Municipio,22,0,22
5,Arkansas,72,Puerto Rico,69,Humacao Municipio,0,20,-20
5,Arkansas,72,Puerto Rico,87,Loíza Municipio,68,0,68
5,Arkansas,72,Puerto Rico,119,Río Grande Municipio,0,28,-28
5,Arkansas,72,Puerto Rico,121,Sabana Grande Municipio,17,0,17
5,Arkansas,72,Puerto Rico,127,San Juan Municipio,33,0,33
5,Arkansas,72,Puerto Rico,135,Toa Alta Municipio,76,0,76
5,Arkansas,8,Colorado,1,Adams County,193,6,187
5,Arkansas,8,Colorado,3,Alamosa County,0,9,-9
5,Arkansas,8,Colorado,5,Arapahoe County,593,114,479
5,Arkansas,8,Colorado,9,Baca County,3,0,3
5,Arkansas,8,Colorado,13,Boulder County,65,91,-26
5,Arkansas,8,Colorado,14,Broomfield County,23,0,23
5,Arkansas,8,Colorado,15,Chaffee County,12,0,12
5,Arkansas,8,Colorado,17,Cheyenne County,0,1,-1
5,Arkansas,8,Colorado,29,Delta County,0,31,-31
5,Arkansas,8,Colorado,31,Denver County,261,111,150
5,Arkansas,8,Colorado,35,Douglas County,80,206,-126
5,Arkansas,8,Colorado,37,Eagle County,26,0,26
5,Arkansas,8,Colorado,41,El Paso County,363,94,269
5,Arkansas,8,Colorado,43,Fremont County,0,5,-5
5,Arkansas,8,Colorado,45,Garfield County,9,66,-57
5,Arkansas,8,Colorado,49,Grand County,0,29,-29
5,Arkansas,8,Colorado,51,Gunnison County,0,83,-83
5,Arkansas,8,Colorado,55,Huerfano County,0,21,-21
5,Arkansas,8,Colorado,59,Jefferson County,160,122,38
5,Arkansas,8,Colorado,67,La Plata County,0,72,-72
5,Arkansas,8,Colorado,69,Larimer County,151,40,111
5,Arkansas,8,Colorado,71,Las Animas County,10,40,-30
5,Arkansas,8,Colorado,77,Mesa County,70,198,-128
5,Arkansas,8,Colorado,89,Otero County,0,4,-4
5,Arkansas,8,Colorado,99,Prowers County,0,4,-4
5,Arkansas,8,Colorado,101,Pueblo County,0,66,-66
5,Arkansas,8,Colorado,117,Summit County,0,40,-40
5,Arkansas,8,Colorado,119,Teller County,40,0,40
5,Arkansas,8,Colorado,123,Weld County,28,61,-33
5,Arkansas,9,Connecticut,1,Fairfield County,120,0,120
5,Arkansas,9,Connecticut,3,Hartford County,24,117,-93
5,Arkansas,9,Connecticut,13,Tolland County,12,0,12
5,Arkansas,9,Connecticut,15,Windham County,91,87,4
5,Arkansas,AFR,Africa,,-,328,0,0
5,Arkansas,ASI,Asia,,-,3617,0,0
5,Arkansas,CAM,Central America,,-,1680,0,0
5,Arkansas,CAR,Caribbean,,-,438,0,0
5,Arkansas,EUR,Europe,,-,1466,0,0
5,Arkansas,ISL,U.S. Island Areas,,-,74,0,0
5,Arkansas,NAM,Northern America,,-,292,0,0
5,Arkansas,OCE,Oceania and At Sea,,-,222,0,0
5,Arkansas,SAM,South America,,-,1050,0,0
6,California,1,Alabama,1,Autauga County,9,150,-141
6,California,1,Alabama,3,Baldwin County,176,240,-64
6,California,1,Alabama,9,Blount County,154,11,143
6,California,1,Alabama,15,Calhoun County,171,149,22
6,California,1,Alabama,17,Chambers County,14,101,-87
6,California,1,Alabama,19,Cherokee County,0,18,-18
6,California,1,Alabama,23,Choctaw County,32,15,17
6,California,1,Alabama,27,Clay County,0,11,-11
6,California,1,Alabama,31,Coffee County,0,70,-70
6,California,1,Alabama,33,Colbert County,0,48,-48
6,California,1,Alabama,39,Covington County,22,35,-13
6,California,1,Alabama,43,Cullman County,33,88,-55
6,California,1,Alabama,45,Dale County,0,118,-118
6,California,1,Alabama,47,Dallas County,14,19,-5
6,California,1,Alabama,49,DeKalb County,0,26,-26
6,California,1,Alabama,51,Elmore County,101,120,-19
6,California,1,Alabama,55,Etowah County,97,128,-31
6,California,1,Alabama,59,Franklin County,13,8,5
6,California,1,Alabama,61,Geneva County,40,83,-43
6,California,1,Alabama,69,Houston County,75,34,41
6,California,1,Alabama,71,Jackson County,34,15,19
6,California,1,Alabama,73,Jefferson County,582,485,97
6,California,1,Alabama,77,Lauderdale County,33,17,16
6,California,1,Alabama,79,Lawrence County,0,19,-19
6,California,1,Alabama,81,Lee County,133,57,76
6,California,1,Alabama,83,Limestone County,30,136,-106
6,California,1,Alabama,85,Lowndes County,0,6,-6
6,California,1,Alabama,87,Macon County,0,47,-47
6,California,1,Alabama,89,Madison County,246,761,-515
6,California,1,Alabama,91,Marengo County,0,15,-15
6,California,1,Alabama,95,Marshall County,136,33,103
6,California,1,Alabama,97,Mobile County,1415,223,1192
6,California,1,Alabama,101,Montgomery County,370,313,57
6,California,1,Alabama,103,Morgan County,118,77,41
6,California,1,Alabama,107,Pickens County,67,0,67
6,California,1,Alabama,109,Pike County,0,2,-2
6,California,1,Alabama,113,Russell County,129,0,129
6,California,1,Alabama,115,St. Clair County,11,0,11
6,California,1,Alabama,117,Shelby County,183,90,93
6,California,1,Alabama,121,Talladega County,324,60,264
6,California,1,Alabama,125,Tuscaloosa County,268,541,-273
6,California,1,Alabama,127,Walker County,46,13,33
6,California,10,Delaware,1,Kent County,194,76,118
6,California,10,Delaware,3,New Castle County,576,371,205
6,California,10,Delaware,5,Sussex County,83,186,-103
6,California,11,District of Columbia,1,District of Columbia,5003,3862,1141
6,California,12,Florida,1,Alachua County,697,216,481
6,California,12,Florida,5,Bay County,244,253,-9
6,California,12,Florida,7,Bradford County,0,72,-72
6,California,12,Florida,9,Brevard County,585,1138,-553
6,California,12,Florida,11,Broward County,2329,1698,631
6,California,12,Florida,15,Charlotte County,275,142,133
6,California,12,Florida,17,Citrus County,56,98,-42
6,California,12,Florida,19,Clay County,449,302,147
6,California,12,Florida,21,Collier County,487,474,13
6,California,12,Florida,23,Columbia County,40,31,9
6,California,12,Florida,27,DeSoto County,24,22,2
6,California,12,Florida,31,Duval County,1965,1740,225
6,California,12,Florida,33,Escambia County,2204,1607,597
6,California,12,Florida,35,Flagler County,135,92,43
6,California,12,Florida,37,Franklin County,77,0,77
6,California,12,Florida,39,Gadsden County,0,36,-36
6,California,12,Florida,47,Hamilton County,0,1,-1
6,California,12,Florida,53,Hernando County,271,102,169
6,California,12,Florida,55,Highlands County,7,141,-134
6,California,12,Florida,57,Hillsborough County,1855,1865,-10
6,California,12,Florida,59,Holmes County,0,16,-16
6,California,12,Florida,61,Indian River County,76,258,-182
6,California,12,Florida,63,Jackson County,0,23,-23
6,California,12,Florida,65,Jefferson County,14,0,14
6,California,12,Florida,69,Lake County,331,391,-60
6,California,12,Florida,71,Lee County,409,856,-447
6,California,12,Florida,73,Leon County,204,349,-145
6,California,12,Florida,75,Levy County,0,43,-43
6,California,12,Florida,79,Madison County,0,5,-5
6,California,12,Florida,81,Manatee County,306,274,32
6,California,12,Florida,83,Marion County,95,163,-68
6,California,12,Florida,85,Martin County,43,287,-244
6,California,12,Florida,86,Miami-Dade County,3438,2949,489
6,California,12,Florida,87,Monroe County,242,570,-328
6,California,12,Florida,89,Nassau County,43,46,-3
6,California,12,Florida,91,Okaloosa County,652,703,-51
6,California,12,Florida,93,Okeechobee County,32,36,-4
6,California,12,Florida,95,Orange County,2086,1496,590
6,California,12,Florida,97,Osceola County,192,172,20
6,California,12,Florida,99,Palm Beach County,1646,1987,-341
6,California,12,Florida,101,Pasco County,249,559,-310
6,California,12,Florida,103,Pinellas County,1014,1259,-245
6,California,12,Florida,105,Polk County,368,524,-156
6,California,12,Florida,107,Putnam County,74,20,54
6,California,12,Florida,109,St. Johns County,172,331,-159
6,California,12,Florida,111,St. Lucie County,214,120,94
6,California,12,Florida,113,Santa Rosa County,378,621,-243
6,California,12,Florida,115,Sarasota County,252,695,-443
6,California,12,Florida,117,Seminole County,372,722,-350
6,California,12,Florida,119,Sumter County,38,47,-9
6,California,12,Florida,123,Taylor County,5,0,5
6,California,12,Florida,125,Union County,0,32,-32
6,California,12,Florida,127,Volusia County,413,623,-210
6,California,12,Florida,131,Walton County,0,91,-91
6,California,12,Florida,133,Washington County,0,25,-25
6,California,13,Georgia,1,Appling County,15,31,-16
6,California,13,Georgia,9,Baldwin County,0,10,-10
6,California,13,Georgia,13,Barrow County,28,16,12
6,California,13,Georgia,15,Bartow County,74,0,74
6,California,13,Georgia,17,Ben Hill County,49,0,49
6,California,13,Georgia,21,Bibb County,118,85,33
6,California,13,Georgia,23,Bleckley County,0,15,-15
6,California,13,Georgia,29,Bryan County,58,40,18
6,California,13,Georgia,31,Bulloch County,8,11,-3
6,California,13,Georgia,35,Butts County,0,7,-7
6,California,13,Georgia,39,Camden County,176,261,-85
6,California,13,Georgia,45,Carroll County,0,60,-60
6,California,13,Georgia,49,Charlton County,0,26,-26
6,California,13,Georgia,51,Chatham County,722,898,-176
6,California,13,Georgia,53,Chattahoochee County,162,286,-124
6,California,13,Georgia,55,Chattooga County,0,8,-8
6,California,13,Georgia,57,Cherokee County,181,271,-90
6,California,13,Georgia,59,Clarke County,120,371,-251
6,California,13,Georgia,63,Clayton County,95,349,-254
6,California,13,Georgia,67,Cobb County,888,1734,-846
6,California,13,Georgia,69,Coffee County,0,58,-58
6,California,13,Georgia,71,Colquitt County,0,4,-4
6,California,13,Georgia,73,Columbia County,422,254,168
6,California,13,Georgia,77,Coweta County,92,207,-115
6,California,13,Georgia,83,Dade County,0,13,-13
6,California,13,Georgia,85,Dawson County,0,74,-74
6,California,13,Georgia,89,DeKalb County,1463,1295,168
6,California,13,Georgia,95,Dougherty County,9,99,-90
6,California,13,Georgia,97,Douglas County,25,188,-163
6,California,13,Georgia,103,Effingham County,108,48,60
6,California,13,Georgia,107,Emanuel County,0,49,-49
6,California,13,Georgia,109,Evans County,0,33,-33
6,California,13,Georgia,111,Fannin County,10,0,10
6,California,13,Georgia,113,Fayette County,206,264,-58
6,California,13,Georgia,115,Floyd County,1,28,-27
6,California,13,Georgia,117,Forsyth County,83,225,-142
6,California,13,Georgia,119,Franklin County,8,5,3
6,California,13,Georgia,121,Fulton County,2769,1671,1098
6,California,13,Georgia,123,Gilmer County,23,40,-17
6,California,13,Georgia,127,Glynn County,81,130,-49
6,California,13,Georgia,129,Gordon County,31,9,22
6,California,13,Georgia,131,Grady County,42,0,42
6,California,13,Georgia,133,Greene County,42,16,26
6,California,13,Georgia,135,Gwinnett County,806,1112,-306
6,California,13,Georgia,137,Habersham County,0,76,-76
6,California,13,Georgia,139,Hall County,15,269,-254
6,California,13,Georgia,141,Hancock County,0,9,-9
6,California,13,Georgia,143,Haralson County,19,0,19
6,California,13,Georgia,145,Harris County,0,7,-7
6,California,13,Georgia,147,Hart County,20,39,-19
6,California,13,Georgia,149,Heard County,11,13,-2
6,California,13,Georgia,151,Henry County,288,217,71
6,California,13,Georgia,153,Houston County,95,110,-15
6,California,13,Georgia,157,Jackson County,3,61,-58
6,California,13,Georgia,159,Jasper County,0,46,-46
6,California,13,Georgia,177,Lee County,0,12,-12
6,California,13,Georgia,179,Liberty County,341,154,187
6,California,13,Georgia,185,Lowndes County,101,292,-191
6,California,13,Georgia,193,Macon County,39,0,39
6,California,13,Georgia,195,Madison County,0,3,-3
6,California,13,Georgia,201,Miller County,0,5,-5
6,California,13,Georgia,207,Monroe County,0,180,-180
6,California,13,Georgia,209,Montgomery County,0,1,-1
6,California,13,Georgia,211,Morgan County,8,52,-44
6,California,13,Georgia,213,Murray County,17,0,17
6,California,13,Georgia,215,Muscogee County,320,607,-287
6,California,13,Georgia,217,Newton County,87,588,-501
6,California,13,Georgia,219,Oconee County,0,26,-26
6,California,13,Georgia,221,Oglethorpe County,0,8,-8
6,California,13,Georgia,223,Paulding County,87,74,13
6,California,13,Georgia,225,Peach County,26,45,-19
6,California,13,Georgia,229,Pierce County,24,0,24
6,California,13,Georgia,233,Polk County,3,14,-11
6,California,13,Georgia,237,Putnam County,23,0,23
6,California,13,Georgia,241,Rabun County,0,25,-25
6,California,13,Georgia,243,Randolph County,0,2,-2
6,California,13,Georgia,245,Richmond County,236,748,-512
6,California,13,Georgia,247,Rockdale County,0,216,-216
6,California,13,Georgia,251,Screven County,0,16,-16
6,California,13,Georgia,255,Spalding County,0,65,-65
6,California,13,Georgia,259,Stewart County,75,11,64
6,California,13,Georgia,261,Sumter County,0,1,-1
6,California,13,Georgia,263,Talbot County,0,11,-11
6,California,13,Georgia,273,Terrell County,0,8,-8
6,California,13,Georgia,283,Treutlen County,21,0,21
6,California,13,Georgia,285,Troup County,41,146,-105
6,California,13,Georgia,291,Union County,46,11,35
6,California,13,Georgia,293,Upson County,45,11,34
6,California,13,Georgia,295,Walker County,0,29,-29
6,California,13,Georgia,299,Ware County,17,0,17
6,California,13,Georgia,305,Wayne County,24,25,-1
6,California,13,Georgia,313,Whitfield County,51,63,-12
6,California,15,Hawaii,1,Hawaii County,1228,1561,-333
6,California,15,Hawaii,3,Honolulu County,9998,8078,1920
6,California,15,Hawaii,5,Kalawao County,9,1,8
6,California,15,Hawaii,7,Kauai County,767,414,353
6,California,15,Hawaii,9,Maui County,901,1164,-263
6,California,16,Idaho,1,Ada County,1996,5593,-3597
6,California,16,Idaho,3,Adams County,0,24,-24
6,California,16,Idaho,5,Bannock County,343,307,36
6,California,16,Idaho,9,Benewah County,2,34,-32
6,California,16,Idaho,11,Bingham County,239,124,115
6,California,16,Idaho,13,Blaine County,114,140,-26
6,California,16,Idaho,15,Boise County,0,27,-27
6,California,16,Idaho,17,Bonner County,160,363,-203
6,California,16,Idaho,19,Bonneville County,129,684,-555
6,California,16,Idaho,21,Boundary County,16,208,-192
6,California,16,Idaho,23,Butte County,0,26,-26
6,California,16,Idaho,25,Camas County,14,12,2
6,California,16,Idaho,27,Canyon County,670,1586,-916
6,California,16,Idaho,29,Caribou County,0,31,-31
6,California,16,Idaho,31,Cassia County,22,28,-6
6,California,16,Idaho,35,Clearwater County,37,54,-17
6,California,16,Idaho,37,Custer County,0,6,-6
6,California,16,Idaho,39,Elmore County,0,140,-140
6,California,16,Idaho,41,Franklin County,32,188,-156
6,California,16,Idaho,43,Fremont County,82,104,-22
6,California,16,Idaho,45,Gem County,19,53,-34
6,California,16,Idaho,47,Gooding County,0,2,-2
6,California,16,Idaho,49,Idaho County,21,11,10
6,California,16,Idaho,51,Jefferson County,29,53,-24
6,California,16,Idaho,53,Jerome County,44,13,31
6,California,16,Idaho,55,Kootenai County,564,1733,-1169
6,California,16,Idaho,57,Latah County,149,405,-256
6,California,16,Idaho,59,Lemhi County,51,154,-103
6,California,16,Idaho,61,Lewis County,33,12,21
6,California,16,Idaho,63,Lincoln County,51,8,43
6,California,16,Idaho,65,Madison County,621,923,-302
6,California,16,Idaho,67,Minidoka County,27,251,-224
6,California,16,Idaho,69,Nez Perce County,13,131,-118
6,California,16,Idaho,73,Owyhee County,0,67,-67
6,California,16,Idaho,75,Payette County,31,375,-344
6,California,16,Idaho,77,Power County,0,11,-11
6,California,16,Idaho,79,Shoshone County,0,22,-22
6,California,16,Idaho,81,Teton County,58,19,39
6,California,16,Idaho,83,Twin Falls County,64,503,-439
6,California,16,Idaho,85,Valley County,0,168,-168
6,California,16,Idaho,87,Washington County,0,185,-185
6,California,17,Illinois,1,Adams County,97,12,85
6,California,17,Illinois,5,Bond County,5,13,-8
6,California,17,Illinois,7,Boone County,50,66,-16
6,California,17,Illinois,11,Bureau County,5,2,3
6,California,17,Illinois,15,Carroll County,0,21,-21
6,California,17,Illinois,17,Cass County,0,7,-7
6,California,17,Illinois,19,Champaign County,1084,612,472
6,California,17,Illinois,21,Christian County,0,45,-45
6,California,17,Illinois,27,Clinton County,80,13,67
6,California,17,Illinois,29,Coles County,43,23,20
6,California,17,Illinois,31,Cook County,13718,7789,5929
6,California,17,Illinois,33,Crawford County,0,21,-21
6,California,17,Illinois,35,Cumberland County,0,3,-3
6,California,17,Illinois,37,DeKalb County,26,16,10
6,California,17,Illinois,39,De Witt County,28,0,28
6,California,17,Illinois,41,Douglas County,0,16,-16
6,California,17,Illinois,43,DuPage County,1807,1541,266
6,California,17,Illinois,47,Edwards County,0,11,-11
6,California,17,Illinois,49,Effingham County,87,0,87
6,California,17,Illinois,55,Franklin County,0,3,-3
6,California,17,Illinois,57,Fulton County,0,7,-7
6,California,17,Illinois,61,Greene County,0,31,-31
6,California,17,Illinois,63,Grundy County,57,11,46
6,California,17,Illinois,67,Hancock County,0,6,-6
6,California,17,Illinois,69,Hardin County,0,2,-2
6,California,17,Illinois,73,Henry County,0,15,-15
6,California,17,Illinois,75,Iroquois County,0,36,-36
6,California,17,Illinois,77,Jackson County,101,93,8
6,California,17,Illinois,81,Jefferson County,5,38,-33
6,California,17,Illinois,83,Jersey County,56,54,2
6,California,17,Illinois,87,Johnson County,26,0,26
6,California,17,Illinois,89,Kane County,397,479,-82
6,California,17,Illinois,91,Kankakee County,119,66,53
6,California,17,Illinois,93,Kendall County,89,61,28
6,California,17,Illinois,95,Knox County,43,15,28
6,California,17,Illinois,97,Lake County,2201,2562,-361
6,California,17,Illinois,99,LaSalle County,39,69,-30
6,California,17,Illinois,101,Lawrence County,0,49,-49
6,California,17,Illinois,103,Lee County,5,13,-8
6,California,17,Illinois,105,Livingston County,14,0,14
6,California,17,Illinois,107,Logan County,46,0,46
6,California,17,Illinois,109,McDonough County,44,21,23
6,California,17,Illinois,111,McHenry County,188,251,-63
6,California,17,Illinois,113,McLean County,254,90,164
6,California,17,Illinois,115,Macon County,88,121,-33
6,California,17,Illinois,117,Macoupin County,0,6,-6
6,California,17,Illinois,119,Madison County,227,145,82
6,California,17,Illinois,121,Marion County,0,31,-31
6,California,17,Illinois,125,Mason County,8,0,8
6,California,17,Illinois,127,Massac County,0,2,-2
6,California,17,Illinois,129,Menard County,0,43,-43
6,California,17,Illinois,133,Monroe County,29,0,29
6,California,17,Illinois,135,Montgomery County,38,7,31
6,California,17,Illinois,137,Morgan County,15,0,15
6,California,17,Illinois,139,Moultrie County,22,0,22
6,California,17,Illinois,141,Ogle County,17,61,-44
6,California,17,Illinois,143,Peoria County,190,170,20
6,California,17,Illinois,149,Pike County,35,20,15
6,California,17,Illinois,157,Randolph County,0,16,-16
6,California,17,Illinois,159,Richland County,0,17,-17
6,California,17,Illinois,161,Rock Island County,113,137,-24
6,California,17,Illinois,163,St. Clair County,429,520,-91
6,California,17,Illinois,165,Saline County,28,0,28
6,California,17,Illinois,167,Sangamon County,254,171,83
6,California,17,Illinois,171,Scott County,0,5,-5
6,California,17,Illinois,175,Stark County,19,0,19
6,California,17,Illinois,177,Stephenson County,0,86,-86
6,California,17,Illinois,179,Tazewell County,182,63,119
6,California,17,Illinois,181,Union County,31,0,31
6,California,17,Illinois,183,Vermilion County,17,6,11
6,California,17,Illinois,187,Warren County,88,3,85
6,California,17,Illinois,189,Washington County,0,16,-16
6,California,17,Illinois,195,Whiteside County,21,26,-5
6,California,17,Illinois,197,Will County,477,490,-13
6,California,17,Illinois,199,Williamson County,0,138,-138
6,California,17,Illinois,201,Winnebago County,131,273,-142
6,California,17,Illinois,203,Woodford County,25,5,20
6,California,18,Indiana,3,Allen County,303,867,-564
6,California,18,Indiana,5,Bartholomew County,65,127,-62
6,California,18,Indiana,11,Boone County,23,259,-236
6,California,18,Indiana,13,Brown County,12,22,-10
6,California,18,Indiana,19,Clark County,20,52,-32
6,California,18,Indiana,21,Clay County,0,15,-15
6,California,18,Indiana,23,Clinton County,14,8,6
6,California,18,Indiana,27,Daviess County,9,16,-7
6,California,18,Indiana,29,Dearborn County,52,54,-2
6,California,18,Indiana,31,Decatur County,51,29,22
6,California,18,Indiana,33,DeKalb County,18,0,18
6,California,18,Indiana,35,Delaware County,28,70,-42
6,California,18,Indiana,37,Dubois County,9,2,7
6,California,18,Indiana,39,Elkhart County,160,343,-183
6,California,18,Indiana,41,Fayette County,9,19,-10
6,California,18,Indiana,43,Floyd County,75,0,75
6,California,18,Indiana,45,Fountain County,0,15,-15
6,California,18,Indiana,47,Franklin County,0,10,-10
6,California,18,Indiana,53,Grant County,49,73,-24
6,California,18,Indiana,57,Hamilton County,495,226,269
6,California,18,Indiana,59,Hancock County,21,0,21
6,California,18,Indiana,61,Harrison County,0,30,-30
6,California,18,Indiana,63,Hendricks County,246,144,102
6,California,18,Indiana,65,Henry County,21,0,21
6,California,18,Indiana,67,Howard County,6,254,-248
6,California,18,Indiana,69,Huntington County,12,20,-8
6,California,18,Indiana,73,Jasper County,104,0,104
6,California,18,Indiana,77,Jefferson County,50,39,11
6,California,18,Indiana,79,Jennings County,0,63,-63
6,California,18,Indiana,81,Johnson County,108,284,-176
6,California,18,Indiana,83,Knox County,0,53,-53
6,California,18,Indiana,85,Kosciusko County,0,11,-11
6,California,18,Indiana,89,Lake County,500,449,51
6,California,18,Indiana,91,LaPorte County,83,0,83
6,California,18,Indiana,93,Lawrence County,179,15,164
6,California,18,Indiana,95,Madison County,22,84,-62
6,California,18,Indiana,97,Marion County,1378,1201,177
6,California,18,Indiana,99,Marshall County,51,41,10
6,California,18,Indiana,101,Martin County,0,64,-64
6,California,18,Indiana,103,Miami County,6,0,6
6,California,18,Indiana,105,Monroe County,421,411,10
6,California,18,Indiana,107,Montgomery County,0,16,-16
6,California,18,Indiana,109,Morgan County,0,44,-44
6,California,18,Indiana,113,Noble County,77,0,77
6,California,18,Indiana,117,Orange County,67,0,67
6,California,18,Indiana,119,Owen County,14,59,-45
6,California,18,Indiana,121,Parke County,32,6,26
6,California,18,Indiana,123,Perry County,0,26,-26
6,California,18,Indiana,127,Porter County,118,278,-160
6,California,18,Indiana,129,Posey County,0,3,-3
6,California,18,Indiana,133,Putnam County,35,0,35
6,California,18,Indiana,141,St. Joseph County,568,312,256
6,California,18,Indiana,145,Shelby County,0,19,-19
6,California,18,Indiana,147,Spencer County,0,12,-12
6,California,18,Indiana,151,Steuben County,48,18,30
6,California,18,Indiana,153,Sullivan County,15,0,15
6,California,18,Indiana,155,Switzerland County,0,7,-7
6,California,18,Indiana,157,Tippecanoe County,1083,598,485
6,California,18,Indiana,161,Union County,21,0,21
6,California,18,Indiana,163,Vanderburgh County,54,120,-66
6,California,18,Indiana,165,Vermillion County,14,4,10
6,California,18,Indiana,167,Vigo County,79,188,-109
6,California,18,Indiana,169,Wabash County,0,2,-2
6,California,18,Indiana,173,Warrick County,100,39,61
6,California,18,Indiana,177,Wayne County,103,30,73
6,California,18,Indiana,179,Wells County,21,0,21
6,California,18,Indiana,181,White County,0,186,-186
6,California,19,Iowa,5,Allamakee County,204,0,204
6,California,19,Iowa,9,Audubon County,16,12,4
6,California,19,Iowa,11,Benton County,0,84,-84
6,California,19,Iowa,13,Black Hawk County,76,64,12
6,California,19,Iowa,15,Boone County,0,34,-34
6,California,19,Iowa,17,Bremer County,0,40,-40
6,California,19,Iowa,19,Buchanan County,5,3,2
6,California,19,Iowa,21,Buena Vista County,9,33,-24
6,California,19,Iowa,25,Calhoun County,0,13,-13
6,California,19,Iowa,27,Carroll County,0,1,-1
6,California,19,Iowa,33,Cerro Gordo County,31,0,31
6,California,19,Iowa,35,Cherokee County,0,1,-1
6,California,19,Iowa,37,Chickasaw County,0,17,-17
6,California,19,Iowa,39,Clarke County,0,25,-25
6,California,19,Iowa,41,Clay County,2,12,-10
6,California,19,Iowa,43,Clayton County,0,1,-1
6,California,19,Iowa,45,Clinton County,6,3,3
6,California,19,Iowa,47,Crawford County,37,0,37
6,California,19,Iowa,49,Dallas County,160,402,-242
6,California,19,Iowa,53,Decatur County,12,19,-7
6,California,19,Iowa,57,Des Moines County,0,27,-27
6,California,19,Iowa,59,Dickinson County,11,0,11
6,California,19,Iowa,61,Dubuque County,75,148,-73
6,California,19,Iowa,63,Emmet County,17,23,-6
6,California,19,Iowa,65,Fayette County,39,16,23
6,California,19,Iowa,67,Floyd County,0,125,-125
6,California,19,Iowa,69,Franklin County,0,19,-19
6,California,19,Iowa,71,Fremont County,0,3,-3
6,California,19,Iowa,75,Grundy County,0,27,-27
6,California,19,Iowa,79,Hamilton County,8,2,6
6,California,19,Iowa,81,Hancock County,0,1,-1
6,California,19,Iowa,83,Hardin County,9,17,-8
6,California,19,Iowa,85,Harrison County,0,4,-4
6,California,19,Iowa,87,Henry County,0,91,-91
6,California,19,Iowa,95,Iowa County,0,5,-5
6,California,19,Iowa,99,Jasper County,6,16,-10
6,California,19,Iowa,101,Jefferson County,137,3,134
6,California,19,Iowa,103,Johnson County,510,320,190
6,California,19,Iowa,105,Jones County,114,2,112
6,California,19,Iowa,113,Linn County,356,138,218
6,California,19,Iowa,115,Louisa County,0,5,-5
6,California,19,Iowa,117,Lucas County,23,30,-7
6,California,19,Iowa,119,Lyon County,0,11,-11
6,California,19,Iowa,121,Madison County,142,0,142
6,California,19,Iowa,123,Mahaska County,67,16,51
6,California,19,Iowa,125,Marion County,0,4,-4
6,California,19,Iowa,127,Marshall County,7,54,-47
6,California,19,Iowa,129,Mills County,0,4,-4
6,California,19,Iowa,131,Mitchell County,0,4,-4
6,California,19,Iowa,133,Monona County,0,2,-2
6,California,19,Iowa,135,Monroe County,0,4,-4
6,California,19,Iowa,137,Montgomery County,20,0,20
6,California,19,Iowa,139,Muscatine County,4,41,-37
6,California,19,Iowa,141,O'Brien County,0,11,-11
6,California,19,Iowa,143,Osceola County,0,47,-47
6,California,19,Iowa,145,Page County,0,30,-30
6,California,19,Iowa,149,Plymouth County,0,17,-17
6,California,19,Iowa,153,Polk County,286,699,-413
6,California,19,Iowa,155,Pottawattamie County,82,139,-57
6,California,19,Iowa,157,Poweshiek County,0,25,-25
6,California,19,Iowa,159,Ringgold County,0,5,-5
6,California,19,Iowa,163,Scott County,349,49,300
6,California,19,Iowa,167,Sioux County,4,61,-57
6,California,19,Iowa,169,Story County,314,125,189
6,California,19,Iowa,171,Tama County,18,8,10
6,California,19,Iowa,173,Taylor County,0,14,-14
6,California,19,Iowa,175,Union County,0,7,-7
6,California,19,Iowa,177,Van Buren County,30,0,30
6,California,19,Iowa,179,Wapello County,0,39,-39
6,California,19,Iowa,181,Warren County,4,15,-11
6,California,19,Iowa,183,Washington County,0,26,-26
6,California,19,Iowa,185,Wayne County,0,9,-9
6,California,19,Iowa,187,Webster County,0,1,-1
6,California,19,Iowa,189,Winnebago County,0,23,-23
6,California,19,Iowa,191,Winneshiek County,26,35,-9
6,California,19,Iowa,193,Woodbury County,142,132,10
6,California,19,Iowa,197,Wright County,0,5,-5
6,California,2,Alaska,13,Aleutians East Borough,5,82,-77
6,California,2,Alaska,16,Aleutians West Census Area,82,75,7
6,California,2,Alaska,20,Anchorage Municipality,2367,1085,1282
6,California,2,Alaska,50,Bethel Census Area,78,9,69
6,California,2,Alaska,68,Denali Borough,405,115,290
6,California,2,Alaska,90,Fairbanks North Star Borough,950,526,424
6,California,2,Alaska,105,Hoonah-Angoon Census Area,0,11,-11
6,California,2,Alaska,110,Juneau City and Borough,262,275,-13
6,California,2,Alaska,122,Kenai Peninsula Borough,401,216,185
6,California,2,Alaska,130,Ketchikan Gateway Borough,416,49,367
6,California,2,Alaska,150,Kodiak Island Borough,367,73,294
6,California,2,Alaska,170,Matanuska-Susitna Borough,184,234,-50
6,California,2,Alaska,180,Nome Census Area,11,8,3
6,California,2,Alaska,185,North Slope Borough,33,23,10
6,California,2,Alaska,188,Northwest Arctic Borough,0,22,-22
6,California,2,Alaska,195,Petersburg Borough,0,27,-27
6,California,2,Alaska,198,Prince of Wales-Hyder Census Area,0,47,-47
6,California,2,Alaska,220,Sitka City and Borough,10,5,5
6,California,2,Alaska,230,Skagway Municipality,0,5,-5
6,California,2,Alaska,240,Southeast Fairbanks Census Area,0,25,-25
6,California,2,Alaska,261,Valdez-Cordova Census Area,137,12,125
6,California,2,Alaska,275,Wrangell City and Borough,0,11,-11
6,California,2,Alaska,290,Yukon-Koyukuk Census Area,0,30,-30
6,California,20,Kansas,1,Allen County,0,2,-2
6,California,20,Kansas,5,Atchison County,0,66,-66
6,California,20,Kansas,7,Barber County,0,34,-34
6,California,20,Kansas,9,Barton County,121,37,84
6,California,20,Kansas,11,Bourbon County,41,6,35
6,California,20,Kansas,13,Brown County,0,1,-1
6,California,20,Kansas,15,Butler County,13,92,-79
6,California,20,Kansas,17,Chase County,0,3,-3
6,California,20,Kansas,21,Cherokee County,0,5,-5
6,California,20,Kansas,23,Cheyenne County,0,19,-19
6,California,20,Kansas,27,Clay County,10,0,10
6,California,20,Kansas,29,Cloud County,0,31,-31
6,California,20,Kansas,31,Coffey County,0,3,-3
6,California,20,Kansas,35,Cowley County,0,14,-14
6,California,20,Kansas,37,Crawford County,26,45,-19
6,California,20,Kansas,39,Decatur County,0,8,-8
6,California,20,Kansas,41,Dickinson County,0,44,-44
6,California,20,Kansas,43,Doniphan County,0,24,-24
6,California,20,Kansas,45,Douglas County,324,311,13
6,California,20,Kansas,47,Edwards County,41,0,41
6,California,20,Kansas,53,Ellsworth County,0,12,-12
6,California,20,Kansas,55,Finney County,19,67,-48
6,California,20,Kansas,57,Ford County,132,28,104
6,California,20,Kansas,59,Franklin County,28,47,-19
6,California,20,Kansas,61,Geary County,362,352,10
6,California,20,Kansas,69,Gray County,0,6,-6
6,California,20,Kansas,73,Greenwood County,0,6,-6
6,California,20,Kansas,75,Hamilton County,0,3,-3
6,California,20,Kansas,77,Harper County,0,4,-4
6,California,20,Kansas,79,Harvey County,8,10,-2
6,California,20,Kansas,81,Haskell County,0,28,-28
6,California,20,Kansas,87,Jefferson County,0,44,-44
6,California,20,Kansas,91,Johnson County,799,795,4
6,California,20,Kansas,97,Kiowa County,0,4,-4
6,California,20,Kansas,99,Labette County,0,72,-72
6,California,20,Kansas,103,Leavenworth County,139,316,-177
6,California,20,Kansas,107,Linn County,0,13,-13
6,California,20,Kansas,111,Lyon County,0,136,-136
6,California,20,Kansas,113,McPherson County,67,59,8
6,California,20,Kansas,115,Marion County,0,15,-15
6,California,20,Kansas,117,Marshall County,0,13,-13
6,California,20,Kansas,121,Miami County,49,54,-5
6,California,20,Kansas,123,Mitchell County,0,1,-1
6,California,20,Kansas,125,Montgomery County,31,38,-7
6,California,20,Kansas,127,Morris County,0,4,-4
6,California,20,Kansas,129,Morton County,19,0,19
6,California,20,Kansas,131,Nemaha County,0,4,-4
6,California,20,Kansas,133,Neosho County,0,5,-5
6,California,20,Kansas,139,Osage County,0,4,-4
6,California,20,Kansas,141,Osborne County,0,9,-9
6,California,20,Kansas,145,Pawnee County,0,43,-43
6,California,20,Kansas,147,Phillips County,27,0,27
6,California,20,Kansas,149,Pottawatomie County,24,96,-72
6,California,20,Kansas,151,Pratt County,0,7,-7
6,California,20,Kansas,155,Reno County,23,65,-42
6,California,20,Kansas,159,Rice County,0,21,-21
6,California,20,Kansas,161,Riley County,390,169,221
6,California,20,Kansas,167,Russell County,0,287,-287
6,California,20,Kansas,169,Saline County,256,331,-75
6,California,20,Kansas,173,Sedgwick County,887,1256,-369
6,California,20,Kansas,175,Seward County,0,132,-132
6,California,20,Kansas,177,Shawnee County,153,188,-35
6,California,20,Kansas,181,Sherman County,0,56,-56
6,California,20,Kansas,183,Smith County,0,4,-4
6,California,20,Kansas,189,Stevens County,0,22,-22
6,California,20,Kansas,191,Sumner County,0,16,-16
6,California,20,Kansas,193,Thomas County,0,3,-3
6,California,20,Kansas,195,Trego County,20,0,20
6,California,20,Kansas,201,Washington County,0,8,-8
6,California,20,Kansas,203,Wichita County,0,12,-12
6,California,20,Kansas,209,Wyandotte County,703,228,475
6,California,21,Kentucky,9,Barren County,0,19,-19
6,California,21,Kentucky,11,Bath County,0,5,-5
6,California,21,Kentucky,15,Boone County,211,120,91
6,California,21,Kentucky,17,Bourbon County,0,3,-3
6,California,21,Kentucky,19,Boyd County,0,53,-53
6,California,21,Kentucky,21,Boyle County,38,28,10
6,California,21,Kentucky,29,Bullitt County,132,167,-35
6,California,21,Kentucky,35,Calloway County,0,12,-12
6,California,21,Kentucky,37,Campbell County,55,60,-5
6,California,21,Kentucky,41,Carroll County,0,56,-56
6,California,21,Kentucky,43,Carter County,0,3,-3
6,California,21,Kentucky,45,Casey County,0,46,-46
6,California,21,Kentucky,47,Christian County,220,462,-242
6,California,21,Kentucky,49,Clark County,0,8,-8
6,California,21,Kentucky,51,Clay County,56,0,56
6,California,21,Kentucky,59,Daviess County,68,99,-31
6,California,21,Kentucky,61,Edmonson County,0,107,-107
6,California,21,Kentucky,67,Fayette County,444,476,-32
6,California,21,Kentucky,73,Franklin County,13,54,-41
6,California,21,Kentucky,77,Gallatin County,0,25,-25
6,California,21,Kentucky,81,Grant County,3,0,3
6,California,21,Kentucky,83,Graves County,0,19,-19
6,California,21,Kentucky,85,Grayson County,0,8,-8
6,California,21,Kentucky,87,Green County,0,8,-8
6,California,21,Kentucky,93,Hardin County,267,272,-5
6,California,21,Kentucky,95,Harlan County,0,22,-22
6,California,21,Kentucky,97,Harrison County,0,46,-46
6,California,21,Kentucky,99,Hart County,0,25,-25
6,California,21,Kentucky,101,Henderson County,0,29,-29
6,California,21,Kentucky,107,Hopkins County,10,10,0
6,California,21,Kentucky,111,Jefferson County,1209,631,578
6,California,21,Kentucky,113,Jessamine County,0,8,-8
6,California,21,Kentucky,115,Johnson County,11,0,11
6,California,21,Kentucky,117,Kenton County,175,146,29
6,California,21,Kentucky,123,Larue County,0,62,-62
6,California,21,Kentucky,125,Laurel County,53,183,-130
6,California,21,Kentucky,127,Lawrence County,0,17,-17
6,California,21,Kentucky,137,Lincoln County,0,17,-17
6,California,21,Kentucky,141,Logan County,0,31,-31
6,California,21,Kentucky,143,Lyon County,0,4,-4
6,California,21,Kentucky,145,McCracken County,0,67,-67
6,California,21,Kentucky,151,Madison County,25,311,-286
6,California,21,Kentucky,159,Martin County,96,0,96
6,California,21,Kentucky,163,Meade County,0,80,-80
6,California,21,Kentucky,171,Monroe County,14,0,14
6,California,21,Kentucky,173,Montgomery County,4,52,-48
6,California,21,Kentucky,177,Muhlenberg County,0,44,-44
6,California,21,Kentucky,179,Nelson County,0,23,-23
6,California,21,Kentucky,185,Oldham County,162,72,90
6,California,21,Kentucky,199,Pulaski County,19,6,13
6,California,21,Kentucky,205,Rowan County,0,14,-14
6,California,21,Kentucky,209,Scott County,46,20,26
6,California,21,Kentucky,211,Shelby County,76,119,-43
6,California,21,Kentucky,213,Simpson County,76,0,76
6,California,21,Kentucky,215,Spencer County,0,1,-1
6,California,21,Kentucky,217,Taylor County,0,8,-8
6,California,21,Kentucky,221,Trigg County,0,19,-19
6,California,21,Kentucky,227,Warren County,49,39,10
6,California,21,Kentucky,229,Washington County,12,0,12
6,California,21,Kentucky,231,Wayne County,40,0,40
6,California,21,Kentucky,235,Whitley County,0,20,-20
6,California,21,Kentucky,239,Woodford County,5,41,-36
6,California,22,Louisiana,1,Acadia Parish,6,0,6
6,California,22,Louisiana,5,Ascension Parish,303,49,254
6,California,22,Louisiana,9,Avoyelles Parish,0,18,-18
6,California,22,Louisiana,11,Beauregard Parish,0,41,-41
6,California,22,Louisiana,13,Bienville Parish,0,31,-31
6,California,22,Louisiana,15,Bossier Parish,94,188,-94
6,California,22,Louisiana,17,Caddo Parish,253,182,71
6,California,22,Louisiana,19,Calcasieu Parish,125,272,-147
6,California,22,Louisiana,21,Caldwell Parish,0,22,-22
6,California,22,Louisiana,23,Cameron Parish,0,5,-5
6,California,22,Louisiana,25,Catahoula Parish,0,13,-13
6,California,22,Louisiana,27,Claiborne Parish,0,79,-79
6,California,22,Louisiana,29,Concordia Parish,71,2,69
6,California,22,Louisiana,31,De Soto Parish,0,12,-12
6,California,22,Louisiana,33,East Baton Rouge Parish,540,719,-179
6,California,22,Louisiana,35,East Carroll Parish,6,0,6
6,California,22,Louisiana,37,East Feliciana Parish,0,32,-32
6,California,22,Louisiana,43,Grant Parish,6,104,-98
6,California,22,Louisiana,45,Iberia Parish,2,0,2
6,California,22,Louisiana,47,Iberville Parish,39,9,30
6,California,22,Louisiana,49,Jackson Parish,0,6,-6
6,California,22,Louisiana,51,Jefferson Parish,616,276,340
6,California,22,Louisiana,53,Jefferson Davis Parish,0,5,-5
6,California,22,Louisiana,55,Lafayette Parish,208,328,-120
6,California,22,Louisiana,57,Lafourche Parish,0,51,-51
6,California,22,Louisiana,61,Lincoln Parish,25,82,-57
6,California,22,Louisiana,63,Livingston Parish,32,27,5
6,California,22,Louisiana,67,Morehouse Parish,10,0,10
6,California,22,Louisiana,69,Natchitoches Parish,0,20,-20
6,California,22,Louisiana,71,Orleans Parish,1446,1004,442
6,California,22,Louisiana,73,Ouachita Parish,84,78,6
6,California,22,Louisiana,75,Plaquemines Parish,138,100,38
6,California,22,Louisiana,77,Pointe Coupee Parish,0,2,-2
6,California,22,Louisiana,79,Rapides Parish,105,176,-71
6,California,22,Louisiana,83,Richland Parish,0,8,-8
6,California,22,Louisiana,85,Sabine Parish,0,18,-18
6,California,22,Louisiana,87,St. Bernard Parish,0,22,-22
6,California,22,Louisiana,89,St. Charles Parish,14,25,-11
6,California,22,Louisiana,95,St. John the Baptist Parish,158,45,113
6,California,22,Louisiana,97,St. Landry Parish,7,13,-6
6,California,22,Louisiana,99,St. Martin Parish,72,22,50
6,California,22,Louisiana,101,St. Mary Parish,55,13,42
6,California,22,Louisiana,103,St. Tammany Parish,220,302,-82
6,California,22,Louisiana,105,Tangipahoa Parish,25,164,-139
6,California,22,Louisiana,109,Terrebonne Parish,35,11,24
6,California,22,Louisiana,111,Union Parish,1,0,1
6,California,22,Louisiana,113,Vermilion Parish,0,44,-44
6,California,22,Louisiana,115,Vernon Parish,213,241,-28
6,California,22,Louisiana,119,Webster Parish,37,0,37
6,California,22,Louisiana,121,West Baton Rouge Parish,0,17,-17
6,California,22,Louisiana,127,Winn Parish,24,81,-57
6,California,23,Maine,1,Androscoggin County,61,114,-53
6,California,23,Maine,3,Aroostook County,9,111,-102
6,California,23,Maine,5,Cumberland County,689,745,-56
6,California,23,Maine,7,Franklin County,362,10,352
6,California,23,Maine,9,Hancock County,27,35,-8
6,California,23,Maine,11,Kennebec County,79,57,22
6,California,23,Maine,13,Knox County,9,14,-5
6,California,23,Maine,15,Lincoln County,13,21,-8
6,California,23,Maine,17,Oxford County,50,11,39
6,California,23,Maine,19,Penobscot County,52,109,-57
6,California,23,Maine,21,Piscataquis County,23,36,-13
6,California,23,Maine,23,Sagadahoc County,100,67,33
6,California,23,Maine,25,Somerset County,38,0,38
6,California,23,Maine,27,Waldo County,15,34,-19
6,California,23,Maine,29,Washington County,14,29,-15
6,California,23,Maine,31,York County,267,369,-102
6,California,24,Maryland,1,Allegany County,122,5,117
6,California,24,Maryland,3,Anne Arundel County,1648,1340,308
6,California,24,Maryland,5,Baltimore County,860,694,166
6,California,24,Maryland,9,Calvert County,63,50,13
6,California,24,Maryland,13,Carroll County,67,31,36
6,California,24,Maryland,15,Cecil County,61,0,61
6,California,24,Maryland,17,Charles County,117,96,21
6,California,24,Maryland,19,Dorchester County,0,59,-59
6,California,24,Maryland,21,Frederick County,369,344,25
6,California,24,Maryland,25,Harford County,84,303,-219
6,California,24,Maryland,27,Howard County,923,573,350
6,California,24,Maryland,29,Kent County,15,7,8
6,California,24,Maryland,31,Montgomery County,2360,1660,700
6,California,24,Maryland,33,Prince George's County,1046,812,234
6,California,24,Maryland,35,Queen Anne's County,0,10,-10
6,California,24,Maryland,37,St. Mary's County,396,627,-231
6,California,24,Maryland,39,Somerset County,1,0,1
6,California,24,Maryland,41,Talbot County,22,40,-18
6,California,24,Maryland,43,Washington County,199,186,13
6,California,24,Maryland,45,Wicomico County,69,31,38
6,California,24,Maryland,47,Worcester County,35,102,-67
6,California,24,Maryland,510,Baltimore city,1441,970,471
6,California,25,Massachusetts,1,Barnstable County,203,182,21
6,California,25,Massachusetts,3,Berkshire County,102,146,-44
6,California,25,Massachusetts,5,Bristol County,365,250,115
6,California,25,Massachusetts,7,Dukes County,0,143,-143
6,California,25,Massachusetts,9,Essex County,590,520,70
6,California,25,Massachusetts,11,Franklin County,78,73,5
6,California,25,Massachusetts,13,Hampden County,224,409,-185
6,California,25,Massachusetts,15,Hampshire County,293,414,-121
6,California,25,Massachusetts,17,Middlesex County,4846,4134,712
6,California,25,Massachusetts,21,Norfolk County,1072,1414,-342
6,California,25,Massachusetts,23,Plymouth County,495,450,45
6,California,25,Massachusetts,25,Suffolk County,4448,3073,1375
6,California,25,Massachusetts,27,Worcester County,1000,874,126
6,California,26,Michigan,1,Alcona County,9,19,-10
6,California,26,Michigan,5,Allegan County,168,12,156
6,California,26,Michigan,7,Alpena County,0,4,-4
6,California,26,Michigan,9,Antrim County,0,19,-19
6,California,26,Michigan,13,Baraga County,0,4,-4
6,California,26,Michigan,15,Barry County,25,16,9
6,California,26,Michigan,17,Bay County,9,126,-117
6,California,26,Michigan,19,Benzie County,0,8,-8
6,California,26,Michigan,21,Berrien County,54,206,-152
6,California,26,Michigan,23,Branch County,18,6,12
6,California,26,Michigan,25,Calhoun County,93,89,4
6,California,26,Michigan,27,Cass County,16,21,-5
6,California,26,Michigan,29,Charlevoix County,0,5,-5
6,California,26,Michigan,31,Cheboygan County,3,14,-11
6,California,26,Michigan,33,Chippewa County,49,21,28
6,California,26,Michigan,35,Clare County,0,30,-30
6,California,26,Michigan,37,Clinton County,66,98,-32
6,California,26,Michigan,39,Crawford County,0,5,-5
6,California,26,Michigan,41,Delta County,25,0,25
6,California,26,Michigan,43,Dickinson County,13,36,-23
6,California,26,Michigan,45,Eaton County,9,38,-29
6,California,26,Michigan,47,Emmet County,45,17,28
6,California,26,Michigan,49,Genesee County,189,227,-38
6,California,26,Michigan,53,Gogebic County,0,19,-19
6,California,26,Michigan,55,Grand Traverse County,102,238,-136
6,California,26,Michigan,57,Gratiot County,46,46,0
6,California,26,Michigan,59,Hillsdale County,27,69,-42
6,California,26,Michigan,61,Houghton County,33,16,17
6,California,26,Michigan,63,Huron County,0,6,-6
6,California,26,Michigan,65,Ingham County,696,607,89
6,California,26,Michigan,67,Ionia County,0,10,-10
6,California,26,Michigan,69,Iosco County,0,28,-28
6,California,26,Michigan,71,Iron County,17,1,16
6,California,26,Michigan,73,Isabella County,357,45,312
6,California,26,Michigan,75,Jackson County,84,260,-176
6,California,26,Michigan,77,Kalamazoo County,457,324,133
6,California,26,Michigan,79,Kalkaska County,53,0,53
6,California,26,Michigan,81,Kent County,881,640,241
6,California,26,Michigan,83,Keweenaw County,6,0,6
6,California,26,Michigan,87,Lapeer County,19,21,-2
6,California,26,Michigan,89,Leelanau County,0,22,-22
6,California,26,Michigan,91,Lenawee County,45,86,-41
6,California,26,Michigan,93,Livingston County,67,67,0
6,California,26,Michigan,97,Mackinac County,0,27,-27
6,California,26,Michigan,99,Macomb County,511,667,-156
6,California,26,Michigan,101,Manistee County,0,16,-16
6,California,26,Michigan,103,Marquette County,57,124,-67
6,California,26,Michigan,105,Mason County,0,40,-40
6,California,26,Michigan,107,Mecosta County,15,39,-24
6,California,26,Michigan,111,Midland County,30,98,-68
6,California,26,Michigan,113,Missaukee County,0,7,-7
6,California,26,Michigan,115,Monroe County,21,65,-44
6,California,26,Michigan,117,Montcalm County,17,72,-55
6,California,26,Michigan,121,Muskegon County,108,40,68
6,California,26,Michigan,123,Newaygo County,2,70,-68
6,California,26,Michigan,125,Oakland County,2433,1355,1078
6,California,26,Michigan,127,Oceana County,0,11,-11
6,California,26,Michigan,129,Ogemaw County,26,0,26
6,California,26,Michigan,133,Osceola County,12,24,-12
6,California,26,Michigan,135,Oscoda County,0,18,-18
6,California,26,Michigan,137,Otsego County,0,65,-65
6,California,26,Michigan,139,Ottawa County,176,236,-60
6,California,26,Michigan,141,Presque Isle County,0,14,-14
6,California,26,Michigan,143,Roscommon County,0,20,-20
6,California,26,Michigan,145,Saginaw County,31,107,-76
6,California,26,Michigan,147,St. Clair County,17,130,-113
6,California,26,Michigan,149,St. Joseph County,47,47,0
6,California,26,Michigan,151,Sanilac County,16,12,4
6,California,26,Michigan,155,Shiawassee County,77,45,32
6,California,26,Michigan,157,Tuscola County,60,18,42
6,California,26,Michigan,159,Van Buren County,31,135,-104
6,California,26,Michigan,161,Washtenaw County,1996,1355,641
6,California,26,Michigan,163,Wayne County,1016,936,80
6,California,26,Michigan,165,Wexford County,0,19,-19
6,California,27,Minnesota,1,Aitkin County,18,1,17
6,California,27,Minnesota,3,Anoka County,381,361,20
6,California,27,Minnesota,5,Becker County,30,19,11
6,California,27,Minnesota,7,Beltrami County,53,3,50
6,California,27,Minnesota,9,Benton County,19,1,18
6,California,27,Minnesota,13,Blue Earth County,58,13,45
6,California,27,Minnesota,15,Brown County,0,5,-5
6,California,27,Minnesota,17,Carlton County,0,19,-19
6,California,27,Minnesota,19,Carver County,122,92,30
6,California,27,Minnesota,21,Cass County,213,12,201
6,California,27,Minnesota,23,Chippewa County,9,20,-11
6,California,27,Minnesota,25,Chisago County,18,16,2
6,California,27,Minnesota,27,Clay County,26,54,-28
6,California,27,Minnesota,29,Clearwater County,5,2,3
6,California,27,Minnesota,31,Cook County,0,4,-4
6,California,27,Minnesota,33,Cottonwood County,0,46,-46
6,California,27,Minnesota,35,Crow Wing County,55,45,10
6,California,27,Minnesota,37,Dakota County,465,544,-79
6,California,27,Minnesota,39,Dodge County,0,5,-5
6,California,27,Minnesota,41,Douglas County,14,6,8
6,California,27,Minnesota,43,Faribault County,0,1,-1
6,California,27,Minnesota,45,Fillmore County,7,0,7
6,California,27,Minnesota,49,Goodhue County,28,49,-21
6,California,27,Minnesota,53,Hennepin County,3372,2626,746
6,California,27,Minnesota,55,Houston County,47,2,45
6,California,27,Minnesota,57,Hubbard County,0,26,-26
6,California,27,Minnesota,59,Isanti County,71,0,71
6,California,27,Minnesota,61,Itasca County,2,46,-44
6,California,27,Minnesota,63,Jackson County,0,4,-4
6,California,27,Minnesota,65,Kanabec County,0,12,-12
6,California,27,Minnesota,67,Kandiyohi County,18,31,-13
6,California,27,Minnesota,69,Kittson County,0,3,-3
6,California,27,Minnesota,75,Lake County,32,0,32
6,California,27,Minnesota,77,Lake of the Woods County,0,36,-36
6,California,27,Minnesota,79,Le Sueur County,0,38,-38
6,California,27,Minnesota,81,Lincoln County,0,6,-6
6,California,27,Minnesota,83,Lyon County,6,9,-3
6,California,27,Minnesota,85,McLeod County,28,0,28
6,California,27,Minnesota,87,Mahnomen County,0,4,-4
6,California,27,Minnesota,89,Marshall County,0,1,-1
6,California,27,Minnesota,91,Martin County,10,0,10
6,California,27,Minnesota,93,Meeker County,0,3,-3
6,California,27,Minnesota,97,Morrison County,18,25,-7
6,California,27,Minnesota,99,Mower County,19,41,-22
6,California,27,Minnesota,103,Nicollet County,16,14,2
6,California,27,Minnesota,105,Nobles County,0,3,-3
6,California,27,Minnesota,107,Norman County,0,4,-4
6,California,27,Minnesota,109,Olmsted County,410,304,106
6,California,27,Minnesota,111,Otter Tail County,0,34,-34
6,California,27,Minnesota,113,Pennington County,0,57,-57
6,California,27,Minnesota,115,Pine County,21,3,18
6,California,27,Minnesota,117,Pipestone County,21,0,21
6,California,27,Minnesota,119,Polk County,0,12,-12
6,California,27,Minnesota,121,Pope County,0,13,-13
6,California,27,Minnesota,123,Ramsey County,1205,593,612
6,California,27,Minnesota,127,Redwood County,0,9,-9
6,California,27,Minnesota,131,Rice County,18,133,-115
6,California,27,Minnesota,135,Roseau County,0,2,-2
6,California,27,Minnesota,137,St. Louis County,164,145,19
6,California,27,Minnesota,139,Scott County,27,198,-171
6,California,27,Minnesota,141,Sherburne County,81,88,-7
6,California,27,Minnesota,143,Sibley County,14,5,9
6,California,27,Minnesota,145,Stearns County,61,225,-164
6,California,27,Minnesota,149,Stevens County,0,6,-6
6,California,27,Minnesota,151,Swift County,18,14,4
6,California,27,Minnesota,153,Todd County,42,3,39
6,California,27,Minnesota,157,Wabasha County,0,17,-17
6,California,27,Minnesota,159,Wadena County,0,2,-2
6,California,27,Minnesota,161,Waseca County,25,26,-1
6,California,27,Minnesota,163,Washington County,441,388,53
6,California,27,Minnesota,165,Watonwan County,41,0,41
6,California,27,Minnesota,169,Winona County,7,19,-12
6,California,27,Minnesota,171,Wright County,78,46,32
6,California,27,Minnesota,173,Yellow Medicine County,0,1,-1
6,California,28,Mississippi,3,Alcorn County,0,194,-194
6,California,28,Mississippi,7,Attala County,0,22,-22
6,California,28,Mississippi,11,Bolivar County,0,59,-59
6,California,28,Mississippi,13,Calhoun County,0,2,-2
6,California,28,Mississippi,21,Claiborne County,9,0,9
6,California,28,Mississippi,27,Coahoma County,13,7,6
6,California,28,Mississippi,33,DeSoto County,115,37,78
6,California,28,Mississippi,35,Forrest County,59,97,-38
6,California,28,Mississippi,37,Franklin County,0,5,-5
6,California,28,Mississippi,39,George County,24,9,15
6,California,28,Mississippi,41,Greene County,75,0,75
6,California,28,Mississippi,45,Hancock County,65,121,-56
6,California,28,Mississippi,47,Harrison County,582,1071,-489
6,California,28,Mississippi,49,Hinds County,217,297,-80
6,California,28,Mississippi,55,Issaquena County,0,5,-5
6,California,28,Mississippi,59,Jackson County,89,277,-188
6,California,28,Mississippi,69,Kemper County,0,5,-5
6,California,28,Mississippi,71,Lafayette County,95,152,-57
6,California,28,Mississippi,73,Lamar County,25,88,-63
6,California,28,Mississippi,75,Lauderdale County,206,91,115
6,California,28,Mississippi,77,Lawrence County,0,8,-8
6,California,28,Mississippi,79,Leake County,14,0,14
6,California,28,Mississippi,81,Lee County,0,115,-115
6,California,28,Mississippi,87,Lowndes County,91,71,20
6,California,28,Mississippi,89,Madison County,14,66,-52
6,California,28,Mississippi,91,Marion County,0,118,-118
6,California,28,Mississippi,93,Marshall County,17,6,11
6,California,28,Mississippi,95,Monroe County,3,0,3
6,California,28,Mississippi,97,Montgomery County,0,71,-71
6,California,28,Mississippi,99,Neshoba County,0,71,-71
6,California,28,Mississippi,101,Newton County,12,0,12
6,California,28,Mississippi,105,Oktibbeha County,61,0,61
6,California,28,Mississippi,107,Panola County,61,0,61
6,California,28,Mississippi,111,Perry County,0,3,-3
6,California,28,Mississippi,113,Pike County,0,14,-14
6,California,28,Mississippi,115,Pontotoc County,0,46,-46
6,California,28,Mississippi,121,Rankin County,45,63,-18
6,California,28,Mississippi,123,Scott County,0,86,-86
6,California,28,Mississippi,127,Simpson County,0,48,-48
6,California,28,Mississippi,131,Stone County,0,6,-6
6,California,28,Mississippi,133,Sunflower County,0,14,-14
6,California,28,Mississippi,135,Tallahatchie County,412,774,-362
6,California,28,Mississippi,141,Tishomingo County,0,18,-18
6,California,28,Mississippi,145,Union County,0,27,-27
6,California,28,Mississippi,147,Walthall County,62,0,62
6,California,28,Mississippi,149,Warren County,164,19,145
6,California,28,Mississippi,151,Washington County,8,22,-14
6,California,28,Mississippi,161,Yalobusha County,0,11,-11
6,California,28,Mississippi,163,Yazoo County,0,24,-24
6,California,29,Missouri,1,Adair County,20,0,20
6,California,29,Missouri,3,Andrew County,23,0,23
6,California,29,Missouri,5,Atchison County,7,0,7
6,California,29,Missouri,9,Barry County,16,59,-43
6,California,29,Missouri,11,Barton County,0,13,-13
6,California,29,Missouri,13,Bates County,0,13,-13
6,California,29,Missouri,15,Benton County,0,8,-8
6,California,29,Missouri,17,Bollinger County,0,4,-4
6,California,29,Missouri,19,Boone County,331,370,-39
6,California,29,Missouri,21,Buchanan County,55,0,55
6,California,29,Missouri,23,Butler County,38,41,-3
6,California,29,Missouri,27,Callaway County,0,35,-35
6,California,29,Missouri,29,Camden County,66,72,-6
6,California,29,Missouri,31,Cape Girardeau County,129,26,103
6,California,29,Missouri,33,Carroll County,0,33,-33
6,California,29,Missouri,37,Cass County,72,179,-107
6,California,29,Missouri,39,Cedar County,0,56,-56
6,California,29,Missouri,43,Christian County,66,162,-96
6,California,29,Missouri,47,Clay County,390,99,291
6,California,29,Missouri,49,Clinton County,0,30,-30
6,California,29,Missouri,51,Cole County,64,128,-64
6,California,29,Missouri,55,Crawford County,122,0,122
6,California,29,Missouri,57,Dade County,16,0,16
6,California,29,Missouri,59,Dallas County,10,23,-13
6,California,29,Missouri,63,DeKalb County,0,8,-8
6,California,29,Missouri,65,Dent County,0,79,-79
6,California,29,Missouri,67,Douglas County,0,41,-41
6,California,29,Missouri,69,Dunklin County,19,0,19
6,California,29,Missouri,71,Franklin County,18,20,-2
6,California,29,Missouri,75,Gentry County,10,0,10
6,California,29,Missouri,77,Greene County,620,672,-52
6,California,29,Missouri,83,Henry County,0,5,-5
6,California,29,Missouri,85,Hickory County,7,22,-15
6,California,29,Missouri,89,Howard County,0,36,-36
6,California,29,Missouri,91,Howell County,0,49,-49
6,California,29,Missouri,95,Jackson County,1050,779,271
6,California,29,Missouri,97,Jasper County,101,148,-47
6,California,29,Missouri,99,Jefferson County,95,117,-22
6,California,29,Missouri,101,Johnson County,131,161,-30
6,California,29,Missouri,105,Laclede County,13,0,13
6,California,29,Missouri,107,Lafayette County,0,59,-59
6,California,29,Missouri,109,Lawrence County,0,66,-66
6,California,29,Missouri,111,Lewis County,0,79,-79
6,California,29,Missouri,113,Lincoln County,120,33,87
6,California,29,Missouri,117,Livingston County,0,1,-1
6,California,29,Missouri,119,McDonald County,0,100,-100
6,California,29,Missouri,121,Macon County,0,12,-12
6,California,29,Missouri,127,Marion County,0,39,-39
6,California,29,Missouri,131,Miller County,0,2,-2
6,California,29,Missouri,137,Monroe County,0,21,-21
6,California,29,Missouri,139,Montgomery County,0,5,-5
6,California,29,Missouri,141,Morgan County,0,19,-19
6,California,29,Missouri,145,Newton County,0,6,-6
6,California,29,Missouri,147,Nodaway County,0,14,-14
6,California,29,Missouri,149,Oregon County,6,35,-29
6,California,29,Missouri,151,Osage County,0,1,-1
6,California,29,Missouri,153,Ozark County,0,37,-37
6,California,29,Missouri,157,Perry County,25,0,25
6,California,29,Missouri,159,Pettis County,140,16,124
6,California,29,Missouri,161,Phelps County,21,69,-48
6,California,29,Missouri,163,Pike County,0,15,-15
6,California,29,Missouri,165,Platte County,137,92,45
6,California,29,Missouri,167,Polk County,0,51,-51
6,California,29,Missouri,169,Pulaski County,63,685,-622
6,California,29,Missouri,171,Putnam County,0,14,-14
6,California,29,Missouri,175,Randolph County,6,17,-11
6,California,29,Missouri,177,Ray County,0,4,-4
6,California,29,Missouri,183,St. Charles County,512,439,73
6,California,29,Missouri,185,St. Clair County,0,42,-42
6,California,29,Missouri,187,St. Francois County,17,0,17
6,California,29,Missouri,189,St. Louis County,1663,1301,362
6,California,29,Missouri,195,Saline County,0,84,-84
6,California,29,Missouri,201,Scott County,0,12,-12
6,California,29,Missouri,203,Shannon County,16,33,-17
6,California,29,Missouri,205,Shelby County,98,0,98
6,California,29,Missouri,207,Stoddard County,29,2,27
6,California,29,Missouri,209,Stone County,0,60,-60
6,California,29,Missouri,211,Sullivan County,161,4,157
6,California,29,Missouri,213,Taney County,10,88,-78
6,California,29,Missouri,215,Texas County,8,11,-3
6,California,29,Missouri,219,Warren County,36,0,36
6,California,29,Missouri,221,Washington County,0,6,-6
6,California,29,Missouri,223,Wayne County,0,11,-11
6,California,29,Missouri,225,Webster County,22,30,-8
6,California,29,Missouri,229,Wright County,0,39,-39
6,California,29,Missouri,510,St. Louis city,731,400,331
6,California,30,Montana,1,Beaverhead County,36,73,-37
6,California,30,Montana,3,Big Horn County,26,5,21
6,California,30,Montana,5,Blaine County,23,0,23
6,California,30,Montana,9,Carbon County,13,11,2
6,California,30,Montana,13,Cascade County,173,411,-238
6,California,30,Montana,17,Custer County,0,99,-99
6,California,30,Montana,21,Dawson County,6,26,-20
6,California,30,Montana,23,Deer Lodge County,0,39,-39
6,California,30,Montana,27,Fergus County,6,21,-15
6,California,30,Montana,29,Flathead County,381,752,-371
6,California,30,Montana,31,Gallatin County,530,604,-74
6,California,30,Montana,35,Glacier County,65,43,22
6,California,30,Montana,39,Granite County,0,3,-3
6,California,30,Montana,41,Hill County,0,26,-26
6,California,30,Montana,43,Jefferson County,19,4,15
6,California,30,Montana,45,Judith Basin County,0,4,-4
6,California,30,Montana,47,Lake County,12,269,-257
6,California,30,Montana,49,Lewis and Clark County,38,268,-230
6,California,30,Montana,53,Lincoln County,60,8,52
6,California,30,Montana,57,Madison County,0,32,-32
6,California,30,Montana,59,Meagher County,7,26,-19
6,California,30,Montana,61,Mineral County,0,49,-49
6,California,30,Montana,63,Missoula County,284,715,-431
6,California,30,Montana,65,Musselshell County,9,0,9
6,California,30,Montana,67,Park County,40,9,31
6,California,30,Montana,73,Pondera County,0,30,-30
6,California,30,Montana,77,Powell County,0,16,-16
6,California,30,Montana,81,Ravalli County,120,315,-195
6,California,30,Montana,83,Richland County,23,76,-53
6,California,30,Montana,85,Roosevelt County,34,20,14
6,California,30,Montana,87,Rosebud County,0,28,-28
6,California,30,Montana,89,Sanders County,34,0,34
6,California,30,Montana,93,Silver Bow County,135,22,113
6,California,30,Montana,95,Stillwater County,0,15,-15
6,California,30,Montana,99,Teton County,0,32,-32
6,California,30,Montana,103,Treasure County,0,3,-3
6,California,30,Montana,105,Valley County,0,38,-38
6,California,30,Montana,111,Yellowstone County,266,573,-307
6,California,31,Nebraska,1,Adams County,0,7,-7
6,California,31,Nebraska,7,Banner County,0,16,-16
6,California,31,Nebraska,11,Boone County,10,17,-7
6,California,31,Nebraska,13,Box Butte County,0,2,-2
6,California,31,Nebraska,15,Boyd County,0,1,-1
6,California,31,Nebraska,17,Brown County,0,1,-1
6,California,31,Nebraska,19,Buffalo County,64,63,1
6,California,31,Nebraska,25,Cass County,0,67,-67
6,California,31,Nebraska,27,Cedar County,0,26,-26
6,California,31,Nebraska,29,Chase County,0,1,-1
6,California,31,Nebraska,37,Colfax County,0,1,-1
6,California,31,Nebraska,39,Cuming County,0,11,-11
6,California,31,Nebraska,41,Custer County,0,38,-38
6,California,31,Nebraska,43,Dakota County,0,21,-21
6,California,31,Nebraska,45,Dawes County,0,53,-53
6,California,31,Nebraska,49,Deuel County,11,0,11
6,California,31,Nebraska,53,Dodge County,85,40,45
6,California,31,Nebraska,55,Douglas County,1015,1326,-311
6,California,31,Nebraska,59,Fillmore County,0,4,-4
6,California,31,Nebraska,65,Furnas County,0,3,-3
6,California,31,Nebraska,67,Gage County,64,2,62
6,California,31,Nebraska,73,Gosper County,25,0,25
6,California,31,Nebraska,77,Greeley County,0,3,-3
6,California,31,Nebraska,79,Hall County,23,90,-67
6,California,31,Nebraska,83,Harlan County,0,3,-3
6,California,31,Nebraska,85,Hayes County,0,11,-11
6,California,31,Nebraska,87,Hitchcock County,0,1,-1
6,California,31,Nebraska,97,Johnson County,0,2,-2
6,California,31,Nebraska,105,Kimball County,0,9,-9
6,California,31,Nebraska,107,Knox County,0,1,-1
6,California,31,Nebraska,109,Lancaster County,407,693,-286
6,California,31,Nebraska,111,Lincoln County,44,87,-43
6,California,31,Nebraska,119,Madison County,0,67,-67
6,California,31,Nebraska,123,Morrill County,35,0,35
6,California,31,Nebraska,127,Nemaha County,0,39,-39
6,California,31,Nebraska,129,Nuckolls County,0,5,-5
6,California,31,Nebraska,131,Otoe County,0,14,-14
6,California,31,Nebraska,133,Pawnee County,0,4,-4
6,California,31,Nebraska,135,Perkins County,0,2,-2
6,California,31,Nebraska,137,Phelps County,0,8,-8
6,California,31,Nebraska,151,Saline County,23,0,23
6,California,31,Nebraska,153,Sarpy County,642,495,147
6,California,31,Nebraska,157,Scotts Bluff County,55,114,-59
6,California,31,Nebraska,159,Seward County,0,29,-29
6,California,31,Nebraska,161,Sheridan County,0,5,-5
6,California,31,Nebraska,165,Sioux County,0,5,-5
6,California,31,Nebraska,173,Thurston County,42,0,42
6,California,31,Nebraska,177,Washington County,0,9,-9
6,California,31,Nebraska,179,Wayne County,0,41,-41
6,California,31,Nebraska,185,York County,0,6,-6
6,California,32,Nevada,1,Churchill County,256,283,-27
6,California,32,Nevada,3,Clark County,17993,33834,-15841
6,California,32,Nevada,5,Douglas County,847,1409,-562
6,California,32,Nevada,7,Elko County,100,235,-135
6,California,32,Nevada,9,Esmeralda County,0,4,-4
6,California,32,Nevada,13,Humboldt County,140,197,-57
6,California,32,Nevada,17,Lincoln County,0,18,-18
6,California,32,Nevada,19,Lyon County,437,1098,-661
6,California,32,Nevada,21,Mineral County,21,21,0
6,California,32,Nevada,23,Nye County,355,567,-212
6,California,32,Nevada,27,Pershing County,9,1,8
6,California,32,Nevada,29,Storey County,0,228,-228
6,California,32,Nevada,31,Washoe County,5886,9377,-3491
6,California,32,Nevada,33,White Pine County,10,13,-3
6,California,32,Nevada,510,Carson City,1123,1332,-209
6,California,33,New Hampshire,1,Belknap County,27,149,-122
6,California,33,New Hampshire,3,Carroll County,37,35,2
6,California,33,New Hampshire,5,Cheshire County,22,36,-14
6,California,33,New Hampshire,7,Coos County,3,50,-47
6,California,33,New Hampshire,9,Grafton County,143,215,-72
6,California,33,New Hampshire,11,Hillsborough County,286,470,-184
6,California,33,New Hampshire,13,Merrimack County,80,16,64
6,California,33,New Hampshire,15,Rockingham County,200,635,-435
6,California,33,New Hampshire,17,Strafford County,134,209,-75
6,California,33,New Hampshire,19,Sullivan County,187,11,176
6,California,34,New Jersey,1,Atlantic County,139,52,87
6,California,34,New Jersey,3,Bergen County,1464,606,858
6,California,34,New Jersey,5,Burlington County,973,391,582
6,California,34,New Jersey,7,Camden County,250,265,-15
6,California,34,New Jersey,9,Cape May County,64,280,-216
6,California,34,New Jersey,11,Cumberland County,59,63,-4
6,California,34,New Jersey,13,Essex County,1014,356,658
6,California,34,New Jersey,15,Gloucester County,300,72,228
6,California,34,New Jersey,17,Hudson County,1971,767,1204
6,California,34,New Jersey,19,Hunterdon County,238,10,228
6,California,34,New Jersey,21,Mercer County,758,621,137
6,California,34,New Jersey,23,Middlesex County,1388,452,936
6,California,34,New Jersey,25,Monmouth County,563,465,98
6,California,34,New Jersey,27,Morris County,1010,480,530
6,California,34,New Jersey,29,Ocean County,255,589,-334
6,California,34,New Jersey,31,Passaic County,296,270,26
6,California,34,New Jersey,33,Salem County,2,90,-88
6,California,34,New Jersey,35,Somerset County,372,302,70
6,California,34,New Jersey,37,Sussex County,378,97,281
6,California,34,New Jersey,39,Union County,823,281,542
6,California,34,New Jersey,41,Warren County,26,17,9
6,California,35,New Mexico,1,Bernalillo County,2927,2020,907
6,California,35,New Mexico,5,Chaves County,102,220,-118
6,California,35,New Mexico,6,Cibola County,25,12,13
6,California,35,New Mexico,9,Curry County,103,128,-25
6,California,35,New Mexico,11,De Baca County,0,1,-1
6,California,35,New Mexico,13,Doña Ana County,837,547,290
6,California,35,New Mexico,15,Eddy County,140,82,58
6,California,35,New Mexico,17,Grant County,56,25,31
6,California,35,New Mexico,19,Guadalupe County,0,13,-13
6,California,35,New Mexico,25,Lea County,37,93,-56
6,California,35,New Mexico,27,Lincoln County,48,0,48
6,California,35,New Mexico,28,Los Alamos County,22,59,-37
6,California,35,New Mexico,29,Luna County,178,59,119
6,California,35,New Mexico,31,McKinley County,21,51,-30
6,California,35,New Mexico,35,Otero County,304,516,-212
6,California,35,New Mexico,37,Quay County,0,4,-4
6,California,35,New Mexico,39,Rio Arriba County,19,8,11
6,California,35,New Mexico,41,Roosevelt County,46,27,19
6,California,35,New Mexico,43,Sandoval County,244,216,28
6,California,35,New Mexico,45,San Juan County,73,240,-167
6,California,35,New Mexico,47,San Miguel County,106,73,33
6,California,35,New Mexico,49,Santa Fe County,491,733,-242
6,California,35,New Mexico,51,Sierra County,68,0,68
6,California,35,New Mexico,53,Socorro County,0,3,-3
6,California,35,New Mexico,55,Taos County,40,149,-109
6,California,35,New Mexico,57,Torrance County,0,10,-10
6,California,35,New Mexico,59,Union County,0,21,-21
6,California,35,New Mexico,61,Valencia County,102,263,-161
6,California,36,New York,1,Albany County,470,437,33
6,California,36,New York,3,Allegany County,94,24,70
6,California,36,New York,5,Bronx County,746,543,203
6,California,36,New York,7,Broome County,183,174,9
6,California,36,New York,9,Cattaraugus County,40,0,40
6,California,36,New York,11,Cayuga County,15,8,7
6,California,36,New York,13,Chautauqua County,33,23,10
6,California,36,New York,15,Chemung County,157,31,126
6,California,36,New York,17,Chenango County,0,29,-29
6,California,36,New York,19,Clinton County,50,118,-68
6,California,36,New York,21,Columbia County,51,81,-30
6,California,36,New York,23,Cortland County,17,63,-46
6,California,36,New York,25,Delaware County,7,18,-11
6,California,36,New York,27,Dutchess County,269,381,-112
6,California,36,New York,29,Erie County,915,479,436
6,California,36,New York,31,Essex County,18,16,2
6,California,36,New York,33,Franklin County,20,0,20
6,California,36,New York,37,Genesee County,16,9,7
6,California,36,New York,39,Greene County,51,0,51
6,California,36,New York,41,Hamilton County,10,0,10
6,California,36,New York,43,Herkimer County,44,14,30
6,California,36,New York,45,Jefferson County,574,486,88
6,California,36,New York,47,Kings County,7772,4000,3772
6,California,36,New York,49,Lewis County,0,31,-31
6,California,36,New York,51,Livingston County,91,39,52
6,California,36,New York,53,Madison County,31,56,-25
6,California,36,New York,55,Monroe County,865,818,47
6,California,36,New York,57,Montgomery County,0,13,-13
6,California,36,New York,59,Nassau County,1459,1251,208
6,California,36,New York,61,New York County,10697,8708,1989
6,California,36,New York,63,Niagara County,107,109,-2
6,California,36,New York,65,Oneida County,168,73,95
6,California,36,New York,67,Onondaga County,817,554,263
6,California,36,New York,69,Ontario County,143,155,-12
6,California,36,New York,71,Orange County,308,198,110
6,California,36,New York,73,Orleans County,20,3,17
6,California,36,New York,75,Oswego County,41,11,30
6,California,36,New York,77,Otsego County,23,5,18
6,California,36,New York,79,Putnam County,28,14,14
6,California,36,New York,81,Queens County,2703,1374,1329
6,California,36,New York,83,Rensselaer County,150,152,-2
6,California,36,New York,85,Richmond County,376,145,231
6,California,36,New York,87,Rockland County,307,206,101
6,California,36,New York,89,St. Lawrence County,0,26,-26
6,California,36,New York,91,Saratoga County,183,419,-236
6,California,36,New York,93,Schenectady County,184,74,110
6,California,36,New York,95,Schoharie County,14,8,6
6,California,36,New York,97,Schuyler County,0,7,-7
6,California,36,New York,99,Seneca County,0,19,-19
6,California,36,New York,101,Steuben County,168,22,146
6,California,36,New York,103,Suffolk County,1205,612,593
6,California,36,New York,105,Sullivan County,42,125,-83
6,California,36,New York,107,Tioga County,12,13,-1
6,California,36,New York,109,Tompkins County,1141,559,582
6,California,36,New York,111,Ulster County,374,50,324
6,California,36,New York,113,Warren County,0,6,-6
6,California,36,New York,115,Washington County,0,19,-19
6,California,36,New York,117,Wayne County,12,43,-31
6,California,36,New York,119,Westchester County,2128,631,1497
6,California,36,New York,121,Wyoming County,0,9,-9
6,California,36,New York,123,Yates County,33,27,6
6,California,37,North Carolina,1,Alamance County,242,70,172
6,California,37,North Carolina,3,Alexander County,0,28,-28
6,California,37,North Carolina,7,Anson County,0,5,-5
6,California,37,North Carolina,11,Avery County,0,3,-3
6,California,37,North Carolina,13,Beaufort County,22,2,20
6,California,37,North Carolina,15,Bertie County,7,0,7
6,California,37,North Carolina,19,Brunswick County,164,145,19
6,California,37,North Carolina,21,Buncombe County,118,640,-522
6,California,37,North Carolina,23,Burke County,97,11,86
6,California,37,North Carolina,25,Cabarrus County,56,119,-63
6,California,37,North Carolina,27,Caldwell County,54,65,-11
6,California,37,North Carolina,31,Carteret County,72,129,-57
6,California,37,North Carolina,35,Catawba County,62,153,-91
6,California,37,North Carolina,37,Chatham County,79,166,-87
6,California,37,North Carolina,41,Chowan County,0,100,-100
6,California,37,North Carolina,45,Cleveland County,41,25,16
6,California,37,North Carolina,47,Columbus County,11,0,11
6,California,37,North Carolina,49,Craven County,769,1081,-312
6,California,37,North Carolina,51,Cumberland County,871,1327,-456
6,California,37,North Carolina,55,Dare County,9,23,-14
6,California,37,North Carolina,57,Davidson County,28,86,-58
6,California,37,North Carolina,59,Davie County,0,16,-16
6,California,37,North Carolina,61,Duplin County,0,38,-38
6,California,37,North Carolina,63,Durham County,1034,1133,-99
6,California,37,North Carolina,65,Edgecombe County,46,2,44
6,California,37,North Carolina,67,Forsyth County,337,267,70
6,California,37,North Carolina,69,Franklin County,54,0,54
6,California,37,North Carolina,71,Gaston County,67,234,-167
6,California,37,North Carolina,77,Granville County,103,11,92
6,California,37,North Carolina,81,Guilford County,510,551,-41
6,California,37,North Carolina,83,Halifax County,12,8,4
6,California,37,North Carolina,85,Harnett County,325,139,186
6,California,37,North Carolina,87,Haywood County,31,331,-300
6,California,37,North Carolina,89,Henderson County,63,215,-152
6,California,37,North Carolina,91,Hertford County,0,2,-2
6,California,37,North Carolina,93,Hoke County,4,91,-87
6,California,37,North Carolina,97,Iredell County,201,368,-167
6,California,37,North Carolina,99,Jackson County,10,38,-28
6,California,37,North Carolina,101,Johnston County,138,104,34
6,California,37,North Carolina,103,Jones County,0,7,-7
6,California,37,North Carolina,105,Lee County,23,33,-10
6,California,37,North Carolina,109,Lincoln County,69,45,24
6,California,37,North Carolina,111,McDowell County,11,0,11
6,California,37,North Carolina,113,Macon County,0,8,-8
6,California,37,North Carolina,115,Madison County,15,25,-10
6,California,37,North Carolina,119,Mecklenburg County,1301,2166,-865
6,California,37,North Carolina,125,Moore County,135,113,22
6,California,37,North Carolina,127,Nash County,92,182,-90
6,California,37,North Carolina,129,New Hanover County,334,288,46
6,California,37,North Carolina,133,Onslow County,2533,3245,-712
6,California,37,North Carolina,135,Orange County,371,627,-256
6,California,37,North Carolina,137,Pamlico County,0,48,-48
6,California,37,North Carolina,139,Pasquotank County,16,16,0
6,California,37,North Carolina,141,Pender County,6,10,-4
6,California,37,North Carolina,145,Person County,0,11,-11
6,California,37,North Carolina,147,Pitt County,125,48,77
6,California,37,North Carolina,149,Polk County,60,49,11
6,California,37,North Carolina,151,Randolph County,76,23,53
6,California,37,North Carolina,153,Richmond County,9,12,-3
6,California,37,North Carolina,155,Robeson County,0,64,-64
6,California,37,North Carolina,157,Rockingham County,95,28,67
6,California,37,North Carolina,159,Rowan County,127,21,106
6,California,37,North Carolina,163,Sampson County,0,53,-53
6,California,37,North Carolina,165,Scotland County,0,24,-24
6,California,37,North Carolina,167,Stanly County,39,14,25
6,California,37,North Carolina,169,Stokes County,9,0,9
6,California,37,North Carolina,171,Surry County,0,54,-54
6,California,37,North Carolina,173,Swain County,0,17,-17
6,California,37,North Carolina,179,Union County,92,455,-363
6,California,37,North Carolina,183,Wake County,1554,2361,-807
6,California,37,North Carolina,185,Warren County,0,27,-27
6,California,37,North Carolina,189,Watauga County,67,62,5
6,California,37,North Carolina,191,Wayne County,72,113,-41
6,California,37,North Carolina,193,Wilkes County,17,8,9
6,California,37,North Carolina,195,Wilson County,49,48,1
6,California,37,North Carolina,197,Yadkin County,0,6,-6
6,California,38,North Dakota,1,Adams County,0,19,-19
6,California,38,North Dakota,3,Barnes County,0,21,-21
6,California,38,North Dakota,5,Benson County,0,6,-6
6,California,38,North Dakota,9,Bottineau County,27,82,-55
6,California,38,North Dakota,15,Burleigh County,101,169,-68
6,California,38,North Dakota,17,Cass County,385,250,135
6,California,38,North Dakota,21,Dickey County,0,4,-4
6,California,38,North Dakota,27,Eddy County,0,12,-12
6,California,38,North Dakota,33,Golden Valley County,0,5,-5
6,California,38,North Dakota,35,Grand Forks County,25,261,-236
6,California,38,North Dakota,41,Hettinger County,0,10,-10
6,California,38,North Dakota,47,Logan County,0,4,-4
6,California,38,North Dakota,53,McKenzie County,33,266,-233
6,California,38,North Dakota,55,McLean County,20,1,19
6,California,38,North Dakota,57,Mercer County,0,37,-37
6,California,38,North Dakota,59,Morton County,0,46,-46
6,California,38,North Dakota,61,Mountrail County,0,24,-24
6,California,38,North Dakota,63,Nelson County,58,17,41
6,California,38,North Dakota,67,Pembina County,0,15,-15
6,California,38,North Dakota,75,Renville County,0,10,-10
6,California,38,North Dakota,77,Richland County,24,8,16
6,California,38,North Dakota,81,Sargent County,0,4,-4
6,California,38,North Dakota,83,Sheridan County,19,0,19
6,California,38,North Dakota,85,Sioux County,0,5,-5
6,California,38,North Dakota,89,Stark County,184,190,-6
6,California,38,North Dakota,93,Stutsman County,44,88,-44
6,California,38,North Dakota,97,Traill County,6,53,-47
6,California,38,North Dakota,101,Ward County,352,463,-111
6,California,38,North Dakota,103,Wells County,0,12,-12
6,California,38,North Dakota,105,Williams County,240,332,-92
6,California,39,Ohio,3,Allen County,12,268,-256
6,California,39,Ohio,5,Ashland County,0,127,-127
6,California,39,Ohio,7,Ashtabula County,0,24,-24
6,California,39,Ohio,9,Athens County,143,114,29
6,California,39,Ohio,11,Auglaize County,62,27,35
6,California,39,Ohio,13,Belmont County,30,14,16
6,California,39,Ohio,15,Brown County,0,65,-65
6,California,39,Ohio,17,Butler County,408,524,-116
6,California,39,Ohio,21,Champaign County,0,47,-47
6,California,39,Ohio,23,Clark County,30,168,-138
6,California,39,Ohio,25,Clermont County,137,144,-7
6,California,39,Ohio,27,Clinton County,0,94,-94
6,California,39,Ohio,29,Columbiana County,10,82,-72
6,California,39,Ohio,31,Coshocton County,0,32,-32
6,California,39,Ohio,35,Cuyahoga County,1385,1191,194
6,California,39,Ohio,37,Darke County,0,4,-4
6,California,39,Ohio,41,Delaware County,67,220,-153
6,California,39,Ohio,43,Erie County,27,37,-10
6,California,39,Ohio,45,Fairfield County,26,253,-227
6,California,39,Ohio,47,Fayette County,0,26,-26
6,California,39,Ohio,49,Franklin County,2443,1239,1204
6,California,39,Ohio,51,Fulton County,15,7,8
6,California,39,Ohio,55,Geauga County,20,81,-61
6,California,39,Ohio,57,Greene County,262,545,-283
6,California,39,Ohio,59,Guernsey County,12,74,-62
6,California,39,Ohio,61,Hamilton County,890,883,7
6,California,39,Ohio,63,Hancock County,42,93,-51
6,California,39,Ohio,65,Hardin County,32,121,-89
6,California,39,Ohio,69,Henry County,7,22,-15
6,California,39,Ohio,73,Hocking County,0,10,-10
6,California,39,Ohio,75,Holmes County,24,0,24
6,California,39,Ohio,77,Huron County,13,32,-19
6,California,39,Ohio,79,Jackson County,9,66,-57
6,California,39,Ohio,81,Jefferson County,0,158,-158
6,California,39,Ohio,83,Knox County,106,96,10
6,California,39,Ohio,85,Lake County,50,71,-21
6,California,39,Ohio,87,Lawrence County,49,1,48
6,California,39,Ohio,89,Licking County,29,57,-28
6,California,39,Ohio,91,Logan County,38,24,14
6,California,39,Ohio,93,Lorain County,199,214,-15
6,California,39,Ohio,95,Lucas County,503,350,153
6,California,39,Ohio,97,Madison County,0,20,-20
6,California,39,Ohio,99,Mahoning County,170,258,-88
6,California,39,Ohio,101,Marion County,0,28,-28
6,California,39,Ohio,103,Medina County,36,183,-147
6,California,39,Ohio,105,Meigs County,0,17,-17
6,California,39,Ohio,107,Mercer County,0,126,-126
6,California,39,Ohio,109,Miami County,123,54,69
6,California,39,Ohio,113,Montgomery County,650,420,230
6,California,39,Ohio,117,Morrow County,0,2,-2
6,California,39,Ohio,119,Muskingum County,19,43,-24
6,California,39,Ohio,127,Perry County,15,50,-35
6,California,39,Ohio,129,Pickaway County,0,32,-32
6,California,39,Ohio,131,Pike County,0,7,-7
6,California,39,Ohio,133,Portage County,126,102,24
6,California,39,Ohio,135,Preble County,0,24,-24
6,California,39,Ohio,139,Richland County,0,3,-3
6,California,39,Ohio,141,Ross County,16,14,2
6,California,39,Ohio,143,Sandusky County,95,33,62
6,California,39,Ohio,145,Scioto County,12,0,12
6,California,39,Ohio,147,Seneca County,0,37,-37
6,California,39,Ohio,149,Shelby County,0,7,-7
6,California,39,Ohio,151,Stark County,209,237,-28
6,California,39,Ohio,153,Summit County,401,293,108
6,California,39,Ohio,155,Trumbull County,173,37,136
6,California,39,Ohio,157,Tuscarawas County,27,13,14
6,California,39,Ohio,159,Union County,37,53,-16
6,California,39,Ohio,161,Van Wert County,7,0,7
6,California,39,Ohio,163,Vinton County,24,0,24
6,California,39,Ohio,165,Warren County,128,290,-162
6,California,39,Ohio,167,Washington County,0,23,-23
6,California,39,Ohio,169,Wayne County,0,42,-42
6,California,39,Ohio,171,Williams County,6,17,-11
6,California,39,Ohio,173,Wood County,82,76,6
6,California,39,Ohio,175,Wyandot County,11,10,1
6,California,4,Arizona,1,Apache County,137,89,48
6,California,4,Arizona,3,Cochise County,586,668,-82
6,California,4,Arizona,5,Coconino County,1012,2974,-1962
6,California,4,Arizona,7,Gila County,96,327,-231
6,California,4,Arizona,9,Graham County,177,261,-84
6,California,4,Arizona,11,Greenlee County,0,4,-4
6,California,4,Arizona,12,La Paz County,183,424,-241
6,California,4,Arizona,13,Maricopa County,18187,31213,-13026
6,California,4,Arizona,15,Mohave County,2123,4036,-1913
6,California,4,Arizona,17,Navajo County,155,229,-74
6,California,4,Arizona,19,Pima County,4808,6844,-2036
6,California,4,Arizona,21,Pinal County,1933,2737,-804
6,California,4,Arizona,23,Santa Cruz County,305,276,29
6,California,4,Arizona,25,Yavapai County,1723,2779,-1056
6,California,4,Arizona,27,Yuma County,1655,2652,-997
6,California,40,Oklahoma,1,Adair County,13,33,-20
6,California,40,Oklahoma,3,Alfalfa County,0,9,-9
6,California,40,Oklahoma,5,Atoka County,129,9,120
6,California,40,Oklahoma,7,Beaver County,0,5,-5
6,California,40,Oklahoma,9,Beckham County,186,105,81
6,California,40,Oklahoma,13,Bryan County,0,49,-49
6,California,40,Oklahoma,15,Caddo County,36,33,3
6,California,40,Oklahoma,17,Canadian County,100,580,-480
6,California,40,Oklahoma,19,Carter County,0,46,-46
6,California,40,Oklahoma,21,Cherokee County,11,60,-49
6,California,40,Oklahoma,23,Choctaw County,36,0,36
6,California,40,Oklahoma,25,Cimarron County,0,5,-5
6,California,40,Oklahoma,27,Cleveland County,570,384,186
6,California,40,Oklahoma,29,Coal County,0,6,-6
6,California,40,Oklahoma,31,Comanche County,486,626,-140
6,California,40,Oklahoma,35,Craig County,13,37,-24
6,California,40,Oklahoma,37,Creek County,84,10,74
6,California,40,Oklahoma,39,Custer County,81,0,81
6,California,40,Oklahoma,41,Delaware County,19,35,-16
6,California,40,Oklahoma,45,Ellis County,0,22,-22
6,California,40,Oklahoma,47,Garfield County,36,168,-132
6,California,40,Oklahoma,51,Grady County,63,98,-35
6,California,40,Oklahoma,61,Haskell County,0,3,-3
6,California,40,Oklahoma,65,Jackson County,129,85,44
6,California,40,Oklahoma,69,Johnston County,127,3,124
6,California,40,Oklahoma,71,Kay County,14,25,-11
6,California,40,Oklahoma,75,Kiowa County,15,0,15
6,California,40,Oklahoma,77,Latimer County,0,40,-40
6,California,40,Oklahoma,79,Le Flore County,7,17,-10
6,California,40,Oklahoma,81,Lincoln County,15,70,-55
6,California,40,Oklahoma,83,Logan County,170,97,73
6,California,40,Oklahoma,87,McClain County,13,35,-22
6,California,40,Oklahoma,89,McCurtain County,0,10,-10
6,California,40,Oklahoma,91,McIntosh County,38,38,0
6,California,40,Oklahoma,95,Marshall County,0,81,-81
6,California,40,Oklahoma,97,Mayes County,0,34,-34
6,California,40,Oklahoma,99,Murray County,17,7,10
6,California,40,Oklahoma,101,Muskogee County,12,346,-334
6,California,40,Oklahoma,103,Noble County,0,44,-44
6,California,40,Oklahoma,105,Nowata County,40,0,40
6,California,40,Oklahoma,109,Oklahoma County,1640,2066,-426
6,California,40,Oklahoma,111,Okmulgee County,20,80,-60
6,California,40,Oklahoma,113,Osage County,13,17,-4
6,California,40,Oklahoma,115,Ottawa County,29,53,-24
6,California,40,Oklahoma,117,Pawnee County,0,8,-8
6,California,40,Oklahoma,119,Payne County,136,218,-82
6,California,40,Oklahoma,121,Pittsburg County,13,123,-110
6,California,40,Oklahoma,123,Pontotoc County,44,89,-45
6,California,40,Oklahoma,125,Pottawatomie County,136,183,-47
6,California,40,Oklahoma,127,Pushmataha County,0,3,-3
6,California,40,Oklahoma,131,Rogers County,102,82,20
6,California,40,Oklahoma,133,Seminole County,12,81,-69
6,California,40,Oklahoma,135,Sequoyah County,62,13,49
6,California,40,Oklahoma,137,Stephens County,110,89,21
6,California,40,Oklahoma,139,Texas County,0,4,-4
6,California,40,Oklahoma,141,Tillman County,0,25,-25
6,California,40,Oklahoma,143,Tulsa County,807,1639,-832
6,California,40,Oklahoma,145,Wagoner County,29,123,-94
6,California,40,Oklahoma,147,Washington County,52,151,-99
6,California,40,Oklahoma,149,Washita County,0,8,-8
6,California,40,Oklahoma,151,Woods County,0,10,-10
6,California,40,Oklahoma,153,Woodward County,39,28,11
6,California,41,Oregon,1,Baker County,2,43,-41
6,California,41,Oregon,3,Benton County,680,1116,-436
6,California,41,Oregon,5,Clackamas County,1105,2369,-1264
6,California,41,Oregon,7,Clatsop County,386,327,59
6,California,41,Oregon,9,Columbia County,12,308,-296
6,California,41,Oregon,11,Coos County,432,526,-94
6,California,41,Oregon,13,Crook County,88,173,-85
6,California,41,Oregon,15,Curry County,230,483,-253
6,California,41,Oregon,17,Deschutes County,1163,2408,-1245
6,California,41,Oregon,19,Douglas County,327,1472,-1145
6,California,41,Oregon,21,Gilliam County,0,1,-1
6,California,41,Oregon,23,Grant County,52,17,35
6,California,41,Oregon,25,Harney County,0,28,-28
6,California,41,Oregon,27,Hood River County,8,281,-273
6,California,41,Oregon,29,Jackson County,1679,2838,-1159
6,California,41,Oregon,31,Jefferson County,9,111,-102
6,California,41,Oregon,33,Josephine County,427,1668,-1241
6,California,41,Oregon,35,Klamath County,691,1071,-380
6,California,41,Oregon,37,Lake County,207,115,92
6,California,41,Oregon,39,Lane County,1809,4971,-3162
6,California,41,Oregon,41,Lincoln County,266,423,-157
6,California,41,Oregon,43,Linn County,364,903,-539
6,California,41,Oregon,45,Malheur County,238,135,103
6,California,41,Oregon,47,Marion County,1079,1601,-522
6,California,41,Oregon,51,Multnomah County,4533,8293,-3760
6,California,41,Oregon,53,Polk County,155,568,-413
6,California,41,Oregon,55,Sherman County,0,7,-7
6,California,41,Oregon,57,Tillamook County,49,70,-21
6,California,41,Oregon,59,Umatilla County,186,255,-69
6,California,41,Oregon,61,Union County,86,102,-16
6,California,41,Oregon,63,Wallowa County,0,47,-47
6,California,41,Oregon,65,Wasco County,153,109,44
6,California,41,Oregon,67,Washington County,3214,4934,-1720
6,California,41,Oregon,69,Wheeler County,0,8,-8
6,California,41,Oregon,71,Yamhill County,392,819,-427
6,California,42,Pennsylvania,1,Adams County,40,77,-37
6,California,42,Pennsylvania,3,Allegheny County,2818,1497,1321
6,California,42,Pennsylvania,5,Armstrong County,7,10,-3
6,California,42,Pennsylvania,7,Beaver County,7,138,-131
6,California,42,Pennsylvania,9,Bedford County,0,2,-2
6,California,42,Pennsylvania,11,Berks County,262,234,28
6,California,42,Pennsylvania,13,Blair County,11,44,-33
6,California,42,Pennsylvania,15,Bradford County,45,0,45
6,California,42,Pennsylvania,17,Bucks County,815,240,575
6,California,42,Pennsylvania,19,Butler County,195,5,190
6,California,42,Pennsylvania,21,Cambria County,41,94,-53
6,California,42,Pennsylvania,25,Carbon County,0,38,-38
6,California,42,Pennsylvania,27,Centre County,655,331,324
6,California,42,Pennsylvania,29,Chester County,557,487,70
6,California,42,Pennsylvania,31,Clarion County,0,3,-3
6,California,42,Pennsylvania,33,Clearfield County,45,49,-4
6,California,42,Pennsylvania,35,Clinton County,0,9,-9
6,California,42,Pennsylvania,37,Columbia County,0,3,-3
6,California,42,Pennsylvania,39,Crawford County,54,82,-28
6,California,42,Pennsylvania,41,Cumberland County,176,581,-405
6,California,42,Pennsylvania,43,Dauphin County,463,192,271
6,California,42,Pennsylvania,45,Delaware County,517,511,6
6,California,42,Pennsylvania,47,Elk County,31,0,31
6,California,42,Pennsylvania,49,Erie County,75,151,-76
6,California,42,Pennsylvania,51,Fayette County,29,55,-26
6,California,42,Pennsylvania,53,Forest County,0,6,-6
6,California,42,Pennsylvania,55,Franklin County,26,28,-2
6,California,42,Pennsylvania,59,Greene County,0,5,-5
6,California,42,Pennsylvania,61,Huntingdon County,0,17,-17
6,California,42,Pennsylvania,63,Indiana County,33,72,-39
6,California,42,Pennsylvania,65,Jefferson County,0,3,-3
6,California,42,Pennsylvania,67,Juniata County,0,5,-5
6,California,42,Pennsylvania,69,Lackawanna County,45,180,-135
6,California,42,Pennsylvania,71,Lancaster County,296,356,-60
6,California,42,Pennsylvania,73,Lawrence County,7,18,-11
6,California,42,Pennsylvania,75,Lebanon County,14,59,-45
6,California,42,Pennsylvania,77,Lehigh County,317,215,102
6,California,42,Pennsylvania,79,Luzerne County,107,201,-94
6,California,42,Pennsylvania,81,Lycoming County,101,15,86
6,California,42,Pennsylvania,83,McKean County,19,34,-15
6,California,42,Pennsylvania,85,Mercer County,62,259,-197
6,California,42,Pennsylvania,87,Mifflin County,14,5,9
6,California,42,Pennsylvania,89,Monroe County,94,32,62
6,California,42,Pennsylvania,91,Montgomery County,923,703,220
6,California,42,Pennsylvania,95,Northampton County,348,406,-58
6,California,42,Pennsylvania,97,Northumberland County,37,14,23
6,California,42,Pennsylvania,99,Perry County,59,54,5
6,California,42,Pennsylvania,101,Philadelphia County,3102,1552,1550
6,California,42,Pennsylvania,103,Pike County,15,9,6
6,California,42,Pennsylvania,107,Schuylkill County,182,57,125
6,California,42,Pennsylvania,109,Snyder County,0,12,-12
6,California,42,Pennsylvania,111,Somerset County,0,12,-12
6,California,42,Pennsylvania,113,Sullivan County,0,8,-8
6,California,42,Pennsylvania,115,Susquehanna County,28,19,9
6,California,42,Pennsylvania,117,Tioga County,0,10,-10
6,California,42,Pennsylvania,119,Union County,39,134,-95
6,California,42,Pennsylvania,125,Washington County,26,167,-141
6,California,42,Pennsylvania,127,Wayne County,78,7,71
6,California,42,Pennsylvania,129,Westmoreland County,152,84,68
6,California,42,Pennsylvania,131,Wyoming County,0,24,-24
6,California,42,Pennsylvania,133,York County,317,101,216
6,California,44,Rhode Island,1,Bristol County,114,19,95
6,California,44,Rhode Island,3,Kent County,320,199,121
6,California,44,Rhode Island,5,Newport County,341,623,-282
6,California,44,Rhode Island,7,Providence County,722,985,-263
6,California,44,Rhode Island,9,Washington County,294,63,231
6,California,45,South Carolina,3,Aiken County,40,119,-79
6,California,45,South Carolina,7,Anderson County,91,211,-120
6,California,45,South Carolina,11,Barnwell County,10,0,10
6,California,45,South Carolina,13,Beaufort County,2216,827,1389
6,California,45,South Carolina,15,Berkeley County,461,574,-113
6,California,45,South Carolina,19,Charleston County,510,391,119
6,California,45,South Carolina,21,Cherokee County,9,0,9
6,California,45,South Carolina,23,Chester County,0,34,-34
6,California,45,South Carolina,25,Chesterfield County,13,5,8
6,California,45,South Carolina,27,Clarendon County,0,8,-8
6,California,45,South Carolina,29,Colleton County,0,19,-19
6,California,45,South Carolina,35,Dorchester County,112,266,-154
6,California,45,South Carolina,37,Edgefield County,0,31,-31
6,California,45,South Carolina,41,Florence County,134,68,66
6,California,45,South Carolina,43,Georgetown County,24,13,11
6,California,45,South Carolina,45,Greenville County,466,462,4
6,California,45,South Carolina,47,Greenwood County,113,68,45
6,California,45,South Carolina,49,Hampton County,0,27,-27
6,California,45,South Carolina,51,Horry County,291,150,141
6,California,45,South Carolina,53,Jasper County,0,42,-42
6,California,45,South Carolina,55,Kershaw County,0,35,-35
6,California,45,South Carolina,63,Lexington County,151,172,-21
6,California,45,South Carolina,65,McCormick County,0,1,-1
6,California,45,South Carolina,67,Marion County,0,13,-13
6,California,45,South Carolina,69,Marlboro County,59,24,35
6,California,45,South Carolina,71,Newberry County,9,0,9
6,California,45,South Carolina,73,Oconee County,37,41,-4
6,California,45,South Carolina,75,Orangeburg County,0,16,-16
6,California,45,South Carolina,77,Pickens County,165,156,9
6,California,45,South Carolina,79,Richland County,510,1858,-1348
6,California,45,South Carolina,81,Saluda County,0,64,-64
6,California,45,South Carolina,83,Spartanburg County,436,239,197
6,California,45,South Carolina,85,Sumter County,37,124,-87
6,California,45,South Carolina,91,York County,293,560,-267
6,California,46,South Dakota,5,Beadle County,13,0,13
6,California,46,South Dakota,7,Bennett County,7,0,7
6,California,46,South Dakota,9,Bon Homme County,0,28,-28
6,California,46,South Dakota,11,Brookings County,0,98,-98
6,California,46,South Dakota,13,Brown County,0,70,-70
6,California,46,South Dakota,15,Brule County,0,6,-6
6,California,46,South Dakota,23,Charles Mix County,0,10,-10
6,California,46,South Dakota,27,Clay County,16,15,1
6,California,46,South Dakota,29,Codington County,0,115,-115
6,California,46,South Dakota,33,Custer County,0,27,-27
6,California,46,South Dakota,35,Davison County,0,14,-14
6,California,46,South Dakota,37,Day County,0,11,-11
6,California,46,South Dakota,41,Dewey County,35,0,35
6,California,46,South Dakota,45,Edmunds County,0,6,-6
6,California,46,South Dakota,47,Fall River County,0,20,-20
6,California,46,South Dakota,51,Grant County,0,2,-2
6,California,46,South Dakota,53,Gregory County,0,3,-3
6,California,46,South Dakota,65,Hughes County,22,5,17
6,California,46,South Dakota,67,Hutchinson County,0,6,-6
6,California,46,South Dakota,79,Lake County,0,48,-48
6,California,46,South Dakota,81,Lawrence County,112,30,82
6,California,46,South Dakota,83,Lincoln County,61,633,-572
6,California,46,South Dakota,91,Marshall County,0,35,-35
6,California,46,South Dakota,93,Meade County,39,434,-395
6,California,46,South Dakota,97,Miner County,0,17,-17
6,California,46,South Dakota,99,Minnehaha County,438,149,289
6,California,46,South Dakota,101,Moody County,0,60,-60
6,California,46,South Dakota,102,Oglala Lakota County,18,28,-10
6,California,46,South Dakota,103,Pennington County,463,374,89
6,California,46,South Dakota,105,Perkins County,0,5,-5
6,California,46,South Dakota,109,Roberts County,0,12,-12
6,California,46,South Dakota,115,Spink County,0,65,-65
6,California,46,South Dakota,123,Tripp County,0,72,-72
6,California,46,South Dakota,125,Turner County,0,4,-4
6,California,46,South Dakota,127,Union County,0,13,-13
6,California,46,South Dakota,129,Walworth County,0,29,-29
6,California,46,South Dakota,135,Yankton County,23,59,-36
6,California,47,Tennessee,1,Anderson County,0,14,-14
6,California,47,Tennessee,3,Bedford County,3,59,-56
6,California,47,Tennessee,5,Benton County,0,40,-40
6,California,47,Tennessee,9,Blount County,30,124,-94
6,California,47,Tennessee,11,Bradley County,94,103,-9
6,California,47,Tennessee,17,Carroll County,0,31,-31
6,California,47,Tennessee,19,Carter County,27,36,-9
6,California,47,Tennessee,21,Cheatham County,0,20,-20
6,California,47,Tennessee,23,Chester County,19,0,19
6,California,47,Tennessee,25,Claiborne County,0,9,-9
6,California,47,Tennessee,31,Coffee County,17,10,7
6,California,47,Tennessee,33,Crockett County,0,2,-2
6,California,47,Tennessee,35,Cumberland County,20,25,-5
6,California,47,Tennessee,37,Davidson County,1281,1938,-657
6,California,47,Tennessee,41,DeKalb County,0,32,-32
6,California,47,Tennessee,43,Dickson County,10,252,-242
6,California,47,Tennessee,47,Fayette County,5,0,5
6,California,47,Tennessee,51,Franklin County,0,10,-10
6,California,47,Tennessee,53,Gibson County,0,14,-14
6,California,47,Tennessee,59,Greene County,119,1,118
6,California,47,Tennessee,61,Grundy County,0,35,-35
6,California,47,Tennessee,63,Hamblen County,0,57,-57
6,California,47,Tennessee,65,Hamilton County,303,781,-478
6,California,47,Tennessee,69,Hardeman County,0,17,-17
6,California,47,Tennessee,71,Hardin County,55,27,28
6,California,47,Tennessee,73,Hawkins County,27,0,27
6,California,47,Tennessee,77,Henderson County,5,4,1
6,California,47,Tennessee,79,Henry County,0,1,-1
6,California,47,Tennessee,81,Hickman County,32,13,19
6,California,47,Tennessee,85,Humphreys County,0,5,-5
6,California,47,Tennessee,89,Jefferson County,8,0,8
6,California,47,Tennessee,91,Johnson County,0,17,-17
6,California,47,Tennessee,93,Knox County,464,391,73
6,California,47,Tennessee,95,Lake County,18,0,18
6,California,47,Tennessee,97,Lauderdale County,0,19,-19
6,California,47,Tennessee,99,Lawrence County,0,16,-16
6,California,47,Tennessee,103,Lincoln County,0,28,-28
6,California,47,Tennessee,105,Loudon County,0,40,-40
6,California,47,Tennessee,107,McMinn County,23,9,14
6,California,47,Tennessee,109,McNairy County,27,21,6
6,California,47,Tennessee,113,Madison County,12,13,-1
6,California,47,Tennessee,117,Marshall County,28,0,28
6,California,47,Tennessee,119,Maury County,20,71,-51
6,California,47,Tennessee,123,Monroe County,0,101,-101
6,California,47,Tennessee,125,Montgomery County,829,547,282
6,California,47,Tennessee,127,Moore County,0,1,-1
6,California,47,Tennessee,131,Obion County,159,95,64
6,California,47,Tennessee,141,Putnam County,72,66,6
6,California,47,Tennessee,143,Rhea County,9,8,1
6,California,47,Tennessee,145,Roane County,11,20,-9
6,California,47,Tennessee,147,Robertson County,52,20,32
6,California,47,Tennessee,149,Rutherford County,315,768,-453
6,California,47,Tennessee,155,Sevier County,43,2,41
6,California,47,Tennessee,157,Shelby County,1107,1290,-183
6,California,47,Tennessee,159,Smith County,0,21,-21
6,California,47,Tennessee,161,Stewart County,43,51,-8
6,California,47,Tennessee,163,Sullivan County,89,108,-19
6,California,47,Tennessee,165,Sumner County,267,423,-156
6,California,47,Tennessee,167,Tipton County,66,97,-31
6,California,47,Tennessee,177,Warren County,0,32,-32
6,California,47,Tennessee,179,Washington County,0,27,-27
6,California,47,Tennessee,183,Weakley County,0,27,-27
6,California,47,Tennessee,185,White County,0,2,-2
6,California,47,Tennessee,187,Williamson County,551,1007,-456
6,California,47,Tennessee,189,Wilson County,85,43,42
6,California,48,Texas,1,Anderson County,0,5,-5
6,California,48,Texas,5,Angelina County,32,121,-89
6,California,48,Texas,7,Aransas County,0,74,-74
6,California,48,Texas,13,Atascosa County,25,15,10
6,California,48,Texas,19,Bandera County,0,197,-197
6,California,48,Texas,21,Bastrop County,12,84,-72
6,California,48,Texas,25,Bee County,12,106,-94
6,California,48,Texas,27,Bell County,1157,998,159
6,California,48,Texas,29,Bexar County,2650,5088,-2438
6,California,48,Texas,31,Blanco County,0,27,-27
6,California,48,Texas,35,Bosque County,27,10,17
6,California,48,Texas,37,Bowie County,128,165,-37
6,California,48,Texas,39,Brazoria County,351,571,-220
6,California,48,Texas,41,Brazos County,467,675,-208
6,California,48,Texas,43,Brewster County,15,37,-22
6,California,48,Texas,47,Brooks County,20,8,12
6,California,48,Texas,49,Brown County,37,28,9
6,California,48,Texas,51,Burleson County,0,5,-5
6,California,48,Texas,53,Burnet County,58,51,7
6,California,48,Texas,55,Caldwell County,15,42,-27
6,California,48,Texas,57,Calhoun County,0,14,-14
6,California,48,Texas,61,Cameron County,261,349,-88
6,California,48,Texas,63,Camp County,18,6,12
6,California,48,Texas,65,Carson County,0,11,-11
6,California,48,Texas,67,Cass County,0,4,-4
6,California,48,Texas,69,Castro County,0,9,-9
6,California,48,Texas,71,Chambers County,11,0,11
6,California,48,Texas,75,Childress County,0,3,-3
6,California,48,Texas,77,Clay County,0,6,-6
6,California,48,Texas,81,Coke County,46,0,46
6,California,48,Texas,85,Collin County,1885,3789,-1904
6,California,48,Texas,89,Colorado County,0,32,-32
6,California,48,Texas,91,Comal County,122,342,-220
6,California,48,Texas,93,Comanche County,12,0,12
6,California,48,Texas,95,Concho County,0,25,-25
6,California,48,Texas,97,Cooke County,8,7,1
6,California,48,Texas,99,Coryell County,105,745,-640
6,California,48,Texas,111,Dallam County,4,0,4
6,California,48,Texas,113,Dallas County,3967,7585,-3618
6,California,48,Texas,115,Dawson County,25,126,-101
6,California,48,Texas,117,Deaf Smith County,109,23,86
6,California,48,Texas,121,Denton County,1252,3001,-1749
6,California,48,Texas,127,Dimmit County,20,0,20
6,California,48,Texas,129,Donley County,0,9,-9
6,California,48,Texas,133,Eastland County,0,10,-10
6,California,48,Texas,135,Ector County,48,298,-250
6,California,48,Texas,139,Ellis County,55,143,-88
6,California,48,Texas,141,El Paso County,2317,2052,265
6,California,48,Texas,143,Erath County,46,43,3
6,California,48,Texas,149,Fayette County,11,0,11
6,California,48,Texas,151,Fisher County,0,25,-25
6,California,48,Texas,155,Foard County,6,0,6
6,California,48,Texas,157,Fort Bend County,1441,1727,-286
6,California,48,Texas,159,Franklin County,9,46,-37
6,California,48,Texas,161,Freestone County,0,17,-17
6,California,48,Texas,165,Gaines County,0,20,-20
6,California,48,Texas,167,Galveston County,260,107,153
6,California,48,Texas,169,Garza County,0,46,-46
6,California,48,Texas,171,Gillespie County,10,8,2
6,California,48,Texas,175,Goliad County,20,4,16
6,California,48,Texas,179,Gray County,0,9,-9
6,California,48,Texas,181,Grayson County,23,267,-244
6,California,48,Texas,183,Gregg County,89,167,-78
6,California,48,Texas,185,Grimes County,28,14,14
6,California,48,Texas,187,Guadalupe County,199,325,-126
6,California,48,Texas,189,Hale County,0,9,-9
6,California,48,Texas,195,Hansford County,0,104,-104
6,California,48,Texas,199,Hardin County,16,58,-42
6,California,48,Texas,201,Harris County,6921,8809,-1888
6,California,48,Texas,203,Harrison County,65,41,24
6,California,48,Texas,207,Haskell County,0,13,-13
6,California,48,Texas,209,Hays County,182,216,-34
6,California,48,Texas,211,Hemphill County,0,98,-98
6,California,48,Texas,213,Henderson County,42,237,-195
6,California,48,Texas,215,Hidalgo County,395,396,-1
6,California,48,Texas,217,Hill County,0,22,-22
6,California,48,Texas,221,Hood County,25,38,-13
6,California,48,Texas,223,Hopkins County,17,62,-45
6,California,48,Texas,225,Houston County,37,0,37
6,California,48,Texas,227,Howard County,75,137,-62
6,California,48,Texas,229,Hudspeth County,3,13,-10
6,California,48,Texas,231,Hunt County,32,31,1
6,California,48,Texas,233,Hutchinson County,29,97,-68
6,California,48,Texas,241,Jasper County,0,18,-18
6,California,48,Texas,243,Jeff Davis County,0,8,-8
6,California,48,Texas,245,Jefferson County,114,345,-231
6,California,48,Texas,249,Jim Wells County,1,0,1
6,California,48,Texas,251,Johnson County,182,137,45
6,California,48,Texas,253,Jones County,0,10,-10
6,California,48,Texas,255,Karnes County,31,0,31
6,California,48,Texas,257,Kaufman County,100,277,-177
6,California,48,Texas,259,Kendall County,58,569,-511
6,California,48,Texas,265,Kerr County,12,126,-114
6,California,48,Texas,271,Kinney County,0,17,-17
6,California,48,Texas,273,Kleberg County,317,0,317
6,California,48,Texas,277,Lamar County,5,32,-27
6,California,48,Texas,279,Lamb County,0,23,-23
6,California,48,Texas,281,Lampasas County,0,10,-10
6,California,48,Texas,285,Lavaca County,0,2,-2
6,California,48,Texas,287,Lee County,0,10,-10
6,California,48,Texas,289,Leon County,37,0,37
6,California,48,Texas,291,Liberty County,0,13,-13
6,California,48,Texas,293,Limestone County,35,0,35
6,California,48,Texas,297,Live Oak County,0,38,-38
6,California,48,Texas,299,Llano County,0,4,-4
6,California,48,Texas,303,Lubbock County,447,770,-323
6,California,48,Texas,309,McLennan County,389,557,-168
6,California,48,Texas,313,Madison County,12,0,12
6,California,48,Texas,315,Marion County,87,19,68
6,California,48,Texas,321,Matagorda County,28,36,-8
6,California,48,Texas,323,Maverick County,61,26,35
6,California,48,Texas,325,Medina County,7,77,-70
6,California,48,Texas,329,Midland County,126,438,-312
6,California,48,Texas,335,Mitchell County,152,0,152
6,California,48,Texas,337,Montague County,29,1,28
6,California,48,Texas,339,Montgomery County,538,1486,-948
6,California,48,Texas,341,Moore County,0,44,-44
6,California,48,Texas,343,Morris County,0,8,-8
6,California,48,Texas,347,Nacogdoches County,137,263,-126
6,California,48,Texas,349,Navarro County,55,84,-29
6,California,48,Texas,353,Nolan County,27,0,27
6,California,48,Texas,355,Nueces County,652,1064,-412
6,California,48,Texas,357,Ochiltree County,0,1,-1
6,California,48,Texas,361,Orange County,90,44,46
6,California,48,Texas,365,Panola County,0,2,-2
6,California,48,Texas,367,Parker County,65,413,-348
6,California,48,Texas,371,Pecos County,16,0,16
6,California,48,Texas,373,Polk County,76,37,39
6,California,48,Texas,375,Potter County,125,83,42
6,California,48,Texas,377,Presidio County,0,1,-1
6,California,48,Texas,379,Rains County,0,3,-3
6,California,48,Texas,381,Randall County,227,410,-183
6,California,48,Texas,389,Reeves County,12,75,-63
6,California,48,Texas,395,Robertson County,12,9,3
6,California,48,Texas,397,Rockwall County,68,82,-14
6,California,48,Texas,399,Runnels County,0,9,-9
6,California,48,Texas,401,Rusk County,43,35,8
6,California,48,Texas,403,Sabine County,0,44,-44
6,California,48,Texas,409,San Patricio County,162,45,117
6,California,48,Texas,411,San Saba County,0,25,-25
6,California,48,Texas,419,Shelby County,0,44,-44
6,California,48,Texas,421,Sherman County,0,5,-5
6,California,48,Texas,423,Smith County,113,455,-342
6,California,48,Texas,425,Somervell County,0,23,-23
6,California,48,Texas,427,Starr County,44,63,-19
6,California,48,Texas,437,Swisher County,0,12,-12
6,California,48,Texas,439,Tarrant County,3371,6186,-2815
6,California,48,Texas,441,Taylor County,154,254,-100
6,California,48,Texas,447,Throckmorton County,0,5,-5
6,California,48,Texas,449,Titus County,0,64,-64
6,California,48,Texas,451,Tom Green County,158,1074,-916
6,California,48,Texas,453,Travis County,3639,5190,-1551
6,California,48,Texas,455,Trinity County,0,34,-34
6,California,48,Texas,457,Tyler County,0,10,-10
6,California,48,Texas,459,Upshur County,0,26,-26
6,California,48,Texas,461,Upton County,0,15,-15
6,California,48,Texas,463,Uvalde County,0,373,-373
6,California,48,Texas,465,Val Verde County,45,367,-322
6,California,48,Texas,467,Van Zandt County,16,20,-4
6,California,48,Texas,469,Victoria County,32,46,-14
6,California,48,Texas,471,Walker County,44,99,-55
6,California,48,Texas,473,Waller County,0,31,-31
6,California,48,Texas,477,Washington County,3,18,-15
6,California,48,Texas,479,Webb County,119,183,-64
6,California,48,Texas,483,Wheeler County,0,47,-47
6,California,48,Texas,485,Wichita County,162,911,-749
6,California,48,Texas,487,Wilbarger County,0,8,-8
6,California,48,Texas,489,Willacy County,23,10,13
6,California,48,Texas,491,Williamson County,691,2693,-2002
6,California,48,Texas,497,Wise County,3,54,-51
6,California,48,Texas,499,Wood County,35,140,-105
6,California,48,Texas,503,Young County,0,3,-3
6,California,48,Texas,507,Zavala County,0,4,-4
6,California,49,Utah,1,Beaver County,40,46,-6
6,California,49,Utah,3,Box Elder County,48,393,-345
6,California,49,Utah,5,Cache County,163,487,-324
6,California,49,Utah,7,Carbon County,29,25,4
6,California,49,Utah,11,Davis County,910,1802,-892
6,California,49,Utah,13,Duchesne County,123,31,92
6,California,49,Utah,15,Emery County,0,29,-29
6,California,49,Utah,17,Garfield County,20,28,-8
6,California,49,Utah,19,Grand County,0,21,-21
6,California,49,Utah,21,Iron County,168,932,-764
6,California,49,Utah,23,Juab County,21,0,21
6,California,49,Utah,25,Kane County,65,27,38
6,California,49,Utah,27,Millard County,0,132,-132
6,California,49,Utah,29,Morgan County,14,8,6
6,California,49,Utah,31,Piute County,0,19,-19
6,California,49,Utah,35,Salt Lake County,4294,5921,-1627
6,California,49,Utah,37,San Juan County,12,17,-5
6,California,49,Utah,39,Sanpete County,110,183,-73
6,California,49,Utah,41,Sevier County,22,141,-119
6,California,49,Utah,43,Summit County,252,201,51
6,California,49,Utah,45,Tooele County,84,131,-47
6,California,49,Utah,47,Uintah County,253,63,190
6,California,49,Utah,49,Utah County,3065,4155,-1090
6,California,49,Utah,51,Wasatch County,51,321,-270
6,California,49,Utah,53,Washington County,394,1363,-969
6,California,49,Utah,55,Wayne County,0,7,-7
6,California,49,Utah,57,Weber County,995,793,202
6,California,5,Arkansas,3,Ashley County,14,6,8
6,California,5,Arkansas,5,Baxter County,0,95,-95
6,California,5,Arkansas,7,Benton County,530,649,-119
6,California,5,Arkansas,9,Boone County,0,40,-40
6,California,5,Arkansas,15,Carroll County,14,15,-1
6,California,5,Arkansas,17,Chicot County,10,0,10
6,California,5,Arkansas,19,Clark County,0,13,-13
6,California,5,Arkansas,21,Clay County,7,0,7
6,California,5,Arkansas,23,Cleburne County,18,51,-33
6,California,5,Arkansas,27,Columbia County,0,48,-48
6,California,5,Arkansas,29,Conway County,10,1,9
6,California,5,Arkansas,31,Craighead County,53,13,40
6,California,5,Arkansas,33,Crawford County,221,169,52
6,California,5,Arkansas,35,Crittenden County,2,30,-28
6,California,5,Arkansas,41,Desha County,0,14,-14
6,California,5,Arkansas,43,Drew County,0,22,-22
6,California,5,Arkansas,45,Faulkner County,63,66,-3
6,California,5,Arkansas,47,Franklin County,0,5,-5
6,California,5,Arkansas,49,Fulton County,0,54,-54
6,California,5,Arkansas,51,Garland County,78,386,-308
6,California,5,Arkansas,53,Grant County,92,12,80
6,California,5,Arkansas,55,Greene County,15,2,13
6,California,5,Arkansas,57,Hempstead County,0,5,-5
6,California,5,Arkansas,59,Hot Spring County,0,11,-11
6,California,5,Arkansas,61,Howard County,0,2,-2
6,California,5,Arkansas,63,Independence County,32,92,-60
6,California,5,Arkansas,65,Izard County,0,60,-60
6,California,5,Arkansas,67,Jackson County,0,20,-20
6,California,5,Arkansas,69,Jefferson County,177,166,11
6,California,5,Arkansas,71,Johnson County,15,26,-11
6,California,5,Arkansas,75,Lawrence County,0,55,-55
6,California,5,Arkansas,77,Lee County,17,2,15
6,California,5,Arkansas,83,Logan County,0,43,-43
6,California,5,Arkansas,85,Lonoke County,22,170,-148
6,California,5,Arkansas,87,Madison County,0,7,-7
6,California,5,Arkansas,89,Marion County,0,9,-9
6,California,5,Arkansas,91,Miller County,8,3,5
6,California,5,Arkansas,93,Mississippi County,39,25,14
6,California,5,Arkansas,95,Monroe County,0,12,-12
6,California,5,Arkansas,97,Montgomery County,17,18,-1
6,California,5,Arkansas,99,Nevada County,53,1,52
6,California,5,Arkansas,101,Newton County,0,18,-18
6,California,5,Arkansas,103,Ouachita County,0,45,-45
6,California,5,Arkansas,107,Phillips County,0,11,-11
6,California,5,Arkansas,109,Pike County,0,13,-13
6,California,5,Arkansas,113,Polk County,0,105,-105
6,California,5,Arkansas,115,Pope County,49,165,-116
6,California,5,Arkansas,117,Prairie County,97,5,92
6,California,5,Arkansas,119,Pulaski County,873,265,608
6,California,5,Arkansas,123,St. Francis County,45,0,45
6,California,5,Arkansas,125,Saline County,94,46,48
6,California,5,Arkansas,127,Scott County,0,78,-78
6,California,5,Arkansas,129,Searcy County,0,10,-10
6,California,5,Arkansas,131,Sebastian County,155,349,-194
6,California,5,Arkansas,135,Sharp County,31,35,-4
6,California,5,Arkansas,137,Stone County,26,0,26
6,California,5,Arkansas,139,Union County,0,132,-132
6,California,5,Arkansas,141,Van Buren County,0,8,-8
6,California,5,Arkansas,143,Washington County,244,1014,-770
6,California,5,Arkansas,145,White County,60,64,-4
6,California,5,Arkansas,147,Woodruff County,0,13,-13
6,California,5,Arkansas,149,Yell County,0,13,-13
6,California,50,Vermont,1,Addison County,104,140,-36
6,California,50,Vermont,3,Bennington County,63,99,-36
6,California,50,Vermont,5,Caledonia County,0,6,-6
6,California,50,Vermont,7,Chittenden County,266,374,-108
6,California,50,Vermont,9,Essex County,32,22,10
6,California,50,Vermont,11,Franklin County,0,10,-10
6,California,50,Vermont,13,Grand Isle County,33,0,33
6,California,50,Vermont,15,Lamoille County,5,105,-100
6,California,50,Vermont,17,Orange County,0,38,-38
6,California,50,Vermont,19,Orleans County,50,16,34
6,California,50,Vermont,21,Rutland County,51,68,-17
6,California,50,Vermont,23,Washington County,80,64,16
6,California,50,Vermont,25,Windham County,0,31,-31
6,California,50,Vermont,27,Windsor County,213,38,175
6,California,51,Virginia,1,Accomack County,74,31,43
6,California,51,Virginia,3,Albemarle County,172,200,-28
6,California,51,Virginia,5,Alleghany County,0,1,-1
6,California,51,Virginia,13,Arlington County,1239,1069,170
6,California,51,Virginia,15,Augusta County,23,0,23
6,California,51,Virginia,19,Bedford County,25,34,-9
6,California,51,Virginia,31,Campbell County,0,15,-15
6,California,51,Virginia,33,Caroline County,10,149,-139
6,California,51,Virginia,35,Carroll County,0,8,-8
6,California,51,Virginia,36,Charles City County,0,5,-5
6,California,51,Virginia,37,Charlotte County,0,8,-8
6,California,51,Virginia,41,Chesterfield County,126,113,13
6,California,51,Virginia,47,Culpeper County,0,43,-43
6,California,51,Virginia,49,Cumberland County,62,0,62
6,California,51,Virginia,51,Dickenson County,0,6,-6
6,California,51,Virginia,53,Dinwiddie County,18,24,-6
6,California,51,Virginia,57,Essex County,0,17,-17
6,California,51,Virginia,59,Fairfax County,3352,2964,388
6,California,51,Virginia,61,Fauquier County,160,182,-22
6,California,51,Virginia,65,Fluvanna County,33,26,7
6,California,51,Virginia,67,Franklin County,0,1,-1
6,California,51,Virginia,69,Frederick County,75,51,24
6,California,51,Virginia,71,Giles County,15,17,-2
6,California,51,Virginia,73,Gloucester County,7,16,-9
6,California,51,Virginia,85,Hanover County,54,165,-111
6,California,51,Virginia,87,Henrico County,223,481,-258
6,California,51,Virginia,89,Henry County,29,6,23
6,California,51,Virginia,93,Isle of Wight County,12,0,12
6,California,51,Virginia,95,James City County,28,89,-61
6,California,51,Virginia,99,King George County,97,181,-84
6,California,51,Virginia,107,Loudoun County,979,617,362
6,California,51,Virginia,109,Louisa County,0,23,-23
6,California,51,Virginia,111,Lunenburg County,0,6,-6
6,California,51,Virginia,119,Middlesex County,0,12,-12
6,California,51,Virginia,121,Montgomery County,138,138,0
6,California,51,Virginia,127,New Kent County,0,13,-13
6,California,51,Virginia,135,Nottoway County,16,0,16
6,California,51,Virginia,141,Patrick County,0,7,-7
6,California,51,Virginia,143,Pittsylvania County,0,22,-22
6,California,51,Virginia,145,Powhatan County,15,0,15
6,California,51,Virginia,147,Prince Edward County,10,0,10
6,California,51,Virginia,149,Prince George County,117,195,-78
6,California,51,Virginia,153,Prince William County,1261,992,269
6,California,51,Virginia,155,Pulaski County,0,57,-57
6,California,51,Virginia,157,Rappahannock County,55,0,55
6,California,51,Virginia,159,Richmond County,12,0,12
6,California,51,Virginia,161,Roanoke County,19,29,-10
6,California,51,Virginia,163,Rockbridge County,0,15,-15
6,California,51,Virginia,171,Shenandoah County,0,16,-16
6,California,51,Virginia,173,Smyth County,26,0,26
6,California,51,Virginia,177,Spotsylvania County,24,120,-96
6,California,51,Virginia,179,Stafford County,400,1037,-637
6,California,51,Virginia,185,Tazewell County,0,11,-11
6,California,51,Virginia,187,Warren County,0,167,-167
6,California,51,Virginia,191,Washington County,0,55,-55
6,California,51,Virginia,195,Wise County,35,0,35
6,California,51,Virginia,197,Wythe County,6,0,6
6,California,51,Virginia,199,York County,152,187,-35
6,California,51,Virginia,510,Alexandria city,560,389,171
6,California,51,Virginia,520,Bristol city,65,0,65
6,California,51,Virginia,530,Buena Vista city,11,112,-101
6,California,51,Virginia,540,Charlottesville city,120,145,-25
6,California,51,Virginia,550,Chesapeake city,510,675,-165
6,California,51,Virginia,570,Colonial Heights city,31,139,-108
6,California,51,Virginia,590,Danville city,48,4,44
6,California,51,Virginia,600,Fairfax city,79,0,79
6,California,51,Virginia,610,Falls Church city,0,18,-18
6,California,51,Virginia,630,Fredericksburg city,66,71,-5
6,California,51,Virginia,650,Hampton city,490,275,215
6,California,51,Virginia,660,Harrisonburg city,51,60,-9
6,California,51,Virginia,670,Hopewell city,3,0,3
6,California,51,Virginia,678,Lexington city,39,103,-64
6,California,51,Virginia,680,Lynchburg city,74,136,-62
6,California,51,Virginia,683,Manassas city,225,15,210
6,California,51,Virginia,685,Manassas Park city,36,0,36
6,California,51,Virginia,690,Martinsville city,48,0,48
6,California,51,Virginia,700,Newport News city,371,531,-160
6,California,51,Virginia,710,Norfolk city,969,2199,-1230
6,California,51,Virginia,720,Norton city,0,7,-7
6,California,51,Virginia,735,Poquoson city,0,19,-19
6,California,51,Virginia,740,Portsmouth city,174,294,-120
6,California,51,Virginia,760,Richmond city,503,308,195
6,California,51,Virginia,770,Roanoke city,25,122,-97
6,California,51,Virginia,790,Staunton city,37,0,37
6,California,51,Virginia,800,Suffolk city,237,322,-85
6,California,51,Virginia,810,Virginia Beach city,1972,2063,-91
6,California,51,Virginia,830,Williamsburg city,50,47,3
6,California,51,Virginia,840,Winchester city,7,48,-41
6,California,53,Washington,1,Adams County,0,35,-35
6,California,53,Washington,3,Asotin County,17,30,-13
6,California,53,Washington,5,Benton County,204,401,-197
6,California,53,Washington,7,Chelan County,207,71,136
6,California,53,Washington,9,Clallam County,415,560,-145
6,California,53,Washington,11,Clark County,1607,3150,-1543
6,California,53,Washington,13,Columbia County,26,16,10
6,California,53,Washington,15,Cowlitz County,106,249,-143
6,California,53,Washington,17,Douglas County,180,314,-134
6,California,53,Washington,19,Ferry County,13,49,-36
6,California,53,Washington,21,Franklin County,54,90,-36
6,California,53,Washington,25,Grant County,102,224,-122
6,California,53,Washington,27,Grays Harbor County,206,262,-56
6,California,53,Washington,29,Island County,922,1206,-284
6,California,53,Washington,31,Jefferson County,123,79,44
6,California,53,Washington,33,King County,14410,16505,-2095
6,California,53,Washington,35,Kitsap County,1946,2876,-930
6,California,53,Washington,37,Kittitas County,180,242,-62
6,California,53,Washington,39,Klickitat County,116,77,39
6,California,53,Washington,41,Lewis County,201,605,-404
6,California,53,Washington,43,Lincoln County,90,45,45
6,California,53,Washington,45,Mason County,160,177,-17
6,California,53,Washington,47,Okanogan County,288,187,101
6,California,53,Washington,49,Pacific County,0,50,-50
6,California,53,Washington,51,Pend Oreille County,0,66,-66
6,California,53,Washington,53,Pierce County,3196,4724,-1528
6,California,53,Washington,55,San Juan County,103,192,-89
6,California,53,Washington,57,Skagit County,273,622,-349
6,California,53,Washington,59,Skamania County,11,6,5
6,California,53,Washington,61,Snohomish County,2866,3658,-792
6,California,53,Washington,63,Spokane County,1378,2835,-1457
6,California,53,Washington,65,Stevens County,12,67,-55
6,California,53,Washington,67,Thurston County,2083,1927,156
6,California,53,Washington,71,Walla Walla County,257,565,-308
6,California,53,Washington,73,Whatcom County,1031,1350,-319
6,California,53,Washington,75,Whitman County,254,710,-456
6,California,53,Washington,77,Yakima County,374,1132,-758
6,California,54,West Virginia,1,Barbour County,0,29,-29
6,California,54,West Virginia,3,Berkeley County,56,123,-67
6,California,54,West Virginia,11,Cabell County,9,30,-21
6,California,54,West Virginia,19,Fayette County,45,0,45
6,California,54,West Virginia,25,Greenbrier County,23,0,23
6,California,54,West Virginia,29,Hancock County,14,92,-78
6,California,54,West Virginia,33,Harrison County,12,22,-10
6,California,54,West Virginia,37,Jefferson County,14,213,-199
6,California,54,West Virginia,39,Kanawha County,180,219,-39
6,California,54,West Virginia,41,Lewis County,0,9,-9
6,California,54,West Virginia,47,McDowell County,62,1,61
6,California,54,West Virginia,49,Marion County,0,30,-30
6,California,54,West Virginia,51,Marshall County,35,11,24
6,California,54,West Virginia,55,Mercer County,23,11,12
6,California,54,West Virginia,61,Monongalia County,41,161,-120
6,California,54,West Virginia,63,Monroe County,0,30,-30
6,California,54,West Virginia,67,Nicholas County,20,0,20
6,California,54,West Virginia,69,Ohio County,9,23,-14
6,California,54,West Virginia,75,Pocahontas County,13,0,13
6,California,54,West Virginia,79,Putnam County,8,0,8
6,California,54,West Virginia,81,Raleigh County,58,10,48
6,California,54,West Virginia,91,Taylor County,0,6,-6
6,California,54,West Virginia,93,Tucker County,28,0,28
6,California,54,West Virginia,95,Tyler County,0,7,-7
6,California,54,West Virginia,99,Wayne County,14,15,-1
6,California,54,West Virginia,101,Webster County,0,22,-22
6,California,54,West Virginia,105,Wirt County,0,9,-9
6,California,54,West Virginia,107,Wood County,38,152,-114
6,California,55,Wisconsin,1,Adams County,0,13,-13
6,California,55,Wisconsin,3,Ashland County,23,0,23
6,California,55,Wisconsin,5,Barron County,148,17,131
6,California,55,Wisconsin,7,Bayfield County,12,9,3
6,California,55,Wisconsin,9,Brown County,153,432,-279
6,California,55,Wisconsin,11,Buffalo County,7,7,0
6,California,55,Wisconsin,13,Burnett County,2,1,1
6,California,55,Wisconsin,15,Calumet County,13,19,-6
6,California,55,Wisconsin,17,Chippewa County,0,6,-6
6,California,55,Wisconsin,19,Clark County,3,6,-3
6,California,55,Wisconsin,21,Columbia County,15,44,-29
6,California,55,Wisconsin,23,Crawford County,0,15,-15
6,California,55,Wisconsin,25,Dane County,1809,1258,551
6,California,55,Wisconsin,27,Dodge County,40,85,-45
6,California,55,Wisconsin,29,Door County,10,5,5
6,California,55,Wisconsin,31,Douglas County,48,46,2
6,California,55,Wisconsin,33,Dunn County,0,121,-121
6,California,55,Wisconsin,35,Eau Claire County,47,183,-136
6,California,55,Wisconsin,37,Florence County,0,5,-5
6,California,55,Wisconsin,39,Fond du Lac County,0,8,-8
6,California,55,Wisconsin,43,Grant County,27,4,23
6,California,55,Wisconsin,45,Green County,6,0,6
6,California,55,Wisconsin,47,Green Lake County,0,6,-6
6,California,55,Wisconsin,49,Iowa County,0,5,-5
6,California,55,Wisconsin,51,Iron County,0,5,-5
6,California,55,Wisconsin,55,Jefferson County,66,11,55
6,California,55,Wisconsin,57,Juneau County,0,4,-4
6,California,55,Wisconsin,59,Kenosha County,276,183,93
6,California,55,Wisconsin,61,Kewaunee County,0,18,-18
6,California,55,Wisconsin,63,La Crosse County,231,209,22
6,California,55,Wisconsin,65,Lafayette County,0,3,-3
6,California,55,Wisconsin,69,Lincoln County,0,6,-6
6,California,55,Wisconsin,71,Manitowoc County,0,41,-41
6,California,55,Wisconsin,73,Marathon County,376,34,342
6,California,55,Wisconsin,75,Marinette County,0,23,-23
6,California,55,Wisconsin,77,Marquette County,0,5,-5
6,California,55,Wisconsin,79,Milwaukee County,1563,1283,280
6,California,55,Wisconsin,81,Monroe County,35,38,-3
6,California,55,Wisconsin,83,Oconto County,125,17,108
6,California,55,Wisconsin,85,Oneida County,52,23,29
6,California,55,Wisconsin,87,Outagamie County,201,378,-177
6,California,55,Wisconsin,89,Ozaukee County,169,47,122
6,California,55,Wisconsin,91,Pepin County,26,0,26
6,California,55,Wisconsin,93,Pierce County,7,8,-1
6,California,55,Wisconsin,95,Polk County,58,26,32
6,California,55,Wisconsin,97,Portage County,0,6,-6
6,California,55,Wisconsin,99,Price County,0,14,-14
6,California,55,Wisconsin,101,Racine County,174,100,74
6,California,55,Wisconsin,105,Rock County,187,147,40
6,California,55,Wisconsin,107,Rusk County,5,1,4
6,California,55,Wisconsin,109,St. Croix County,34,13,21
6,California,55,Wisconsin,111,Sauk County,66,26,40
6,California,55,Wisconsin,113,Sawyer County,0,18,-18
6,California,55,Wisconsin,115,Shawano County,14,75,-61
6,California,55,Wisconsin,117,Sheboygan County,109,50,59
6,California,55,Wisconsin,119,Taylor County,0,1,-1
6,California,55,Wisconsin,121,Trempealeau County,0,17,-17
6,California,55,Wisconsin,123,Vernon County,0,18,-18
6,California,55,Wisconsin,125,Vilas County,5,12,-7
6,California,55,Wisconsin,127,Walworth County,83,31,52
6,California,55,Wisconsin,129,Washburn County,0,86,-86
6,California,55,Wisconsin,131,Washington County,155,62,93
6,California,55,Wisconsin,133,Waukesha County,342,211,131
6,California,55,Wisconsin,135,Waupaca County,0,1,-1
6,California,55,Wisconsin,137,Waushara County,0,22,-22
6,California,55,Wisconsin,139,Winnebago County,53,155,-102
6,California,55,Wisconsin,141,Wood County,66,24,42
6,California,56,Wyoming,1,Albany County,333,169,164
6,California,56,Wyoming,3,Big Horn County,60,14,46
6,California,56,Wyoming,5,Campbell County,182,88,94
6,California,56,Wyoming,7,Carbon County,80,10,70
6,California,56,Wyoming,9,Converse County,8,1,7
6,California,56,Wyoming,13,Fremont County,30,78,-48
6,California,56,Wyoming,15,Goshen County,16,14,2
6,California,56,Wyoming,17,Hot Springs County,0,2,-2
6,California,56,Wyoming,19,Johnson County,3,47,-44
6,California,56,Wyoming,21,Laramie County,172,639,-467
6,California,56,Wyoming,23,Lincoln County,98,70,28
6,California,56,Wyoming,25,Natrona County,134,161,-27
6,California,56,Wyoming,27,Niobrara County,11,2,9
6,California,56,Wyoming,29,Park County,41,44,-3
6,California,56,Wyoming,31,Platte County,0,37,-37
6,California,56,Wyoming,33,Sheridan County,10,137,-127
6,California,56,Wyoming,35,Sublette County,25,0,25
6,California,56,Wyoming,37,Sweetwater County,71,325,-254
6,California,56,Wyoming,39,Teton County,256,435,-179
6,California,56,Wyoming,41,Uinta County,9,40,-31
6,California,56,Wyoming,43,Washakie County,31,12,19
6,California,56,Wyoming,45,Weston County,0,2,-2
6,California,6,California,1,Alameda County,67558,60756,6802
6,California,6,California,3,Alpine County,114,22,92
6,California,6,California,5,Amador County,1899,2735,-836
6,California,6,California,7,Butte County,8714,11611,-2897
6,California,6,California,9,Calaveras County,1848,1805,43
6,California,6,California,11,Colusa County,1272,478,794
6,California,6,California,13,Contra Costa County,35401,42900,-7499
6,California,6,California,15,Del Norte County,1775,2034,-259
6,California,6,California,17,El Dorado County,7856,9931,-2075
6,California,6,California,19,Fresno County,20912,22363,-1451
6,California,6,California,21,Glenn County,1556,911,645
6,California,6,California,23,Humboldt County,4543,6393,-1850
6,California,6,California,25,Imperial County,5423,3656,1767
6,California,6,California,27,Inyo County,1122,792,330
6,California,6,California,29,Kern County,22302,29470,-7168
6,California,6,California,31,Kings County,6956,10105,-3149
6,California,6,California,33,Lake County,2993,4494,-1501
6,California,6,California,35,Lassen County,2953,5056,-2103
6,California,6,California,37,Los Angeles County,180991,110785,70206
6,California,6,California,39,Madera County,7975,7067,908
6,California,6,California,41,Marin County,12406,14168,-1762
6,California,6,California,43,Mariposa County,702,825,-123
6,California,6,California,45,Mendocino County,3068,2920,148
6,California,6,California,47,Merced County,9041,11827,-2786
6,California,6,California,49,Modoc County,582,460,122
6,California,6,California,51,Mono County,263,453,-190
6,California,6,California,53,Monterey County,13014,13969,-955
6,California,6,California,55,Napa County,6544,4877,1667
6,California,6,California,57,Nevada County,3510,4067,-557
6,California,6,California,59,Orange County,75467,76610,-1143
6,California,6,California,61,Placer County,16085,18198,-2113
6,California,6,California,63,Plumas County,924,677,247
6,California,6,California,65,Riverside County,62574,88487,-25913
6,California,6,California,67,Sacramento County,45143,54106,-8963
6,California,6,California,69,San Benito County,2572,2347,225
6,California,6,California,71,San Bernardino County,60202,84057,-23855
6,California,6,California,73,San Diego County,64245,47877,16368
6,California,6,California,75,San Francisco County,45509,32396,13113
6,California,6,California,77,San Joaquin County,21055,28241,-7186
6,California,6,California,79,San Luis Obispo County,9894,15280,-5386
6,California,6,California,81,San Mateo County,33559,29472,4087
6,California,6,California,83,Santa Barbara County,13579,19409,-5830
6,California,6,California,85,Santa Clara County,63719,45287,18432
6,California,6,California,87,Santa Cruz County,11499,13550,-2051
6,California,6,California,89,Shasta County,6523,6461,62
6,California,6,California,91,Sierra County,100,99,1
6,California,6,California,93,Siskiyou County,1480,1388,92
6,California,6,California,95,Solano County,15555,21134,-5579
6,California,6,California,97,Sonoma County,13970,17299,-3329
6,California,6,California,99,Stanislaus County,15438,16673,-1235
6,California,6,California,101,Sutter County,5054,4168,886
6,California,6,California,103,Tehama County,2775,3905,-1130
6,California,6,California,105,Trinity County,337,484,-147
6,California,6,California,107,Tulare County,9958,9369,589
6,California,6,California,109,Tuolumne County,2612,3846,-1234
6,California,6,California,111,Ventura County,20137,21149,-1012
6,California,6,California,113,Yolo County,13543,17666,-4123
6,California,6,California,115,Yuba County,3955,4191,-236
6,California,72,Puerto Rico,3,Aguada Municipio,26,0,26
6,California,72,Puerto Rico,5,Aguadilla Municipio,0,23,-23
6,California,72,Puerto Rico,7,Aguas Buenas Municipio,54,0,54
6,California,72,Puerto Rico,13,Arecibo Municipio,46,0,46
6,California,72,Puerto Rico,21,Bayamón Municipio,147,106,41
6,California,72,Puerto Rico,25,Caguas Municipio,85,0,85
6,California,72,Puerto Rico,31,Carolina Municipio,20,23,-3
6,California,72,Puerto Rico,35,Cayey Municipio,82,22,60
6,California,72,Puerto Rico,41,Cidra Municipio,0,11,-11
6,California,72,Puerto Rico,53,Fajardo Municipio,0,142,-142
6,California,72,Puerto Rico,59,Guayanilla Municipio,0,9,-9
6,California,72,Puerto Rico,61,Guaynabo Municipio,78,0,78
6,California,72,Puerto Rico,63,Gurabo Municipio,107,0,107
6,California,72,Puerto Rico,71,Isabela Municipio,0,58,-58
6,California,72,Puerto Rico,75,Juana Díaz Municipio,0,27,-27
6,California,72,Puerto Rico,97,Mayagüez Municipio,95,3,92
6,California,72,Puerto Rico,113,Ponce Municipio,37,37,0
6,California,72,Puerto Rico,119,Río Grande Municipio,18,0,18
6,California,72,Puerto Rico,121,Sabana Grande Municipio,18,0,18
6,California,72,Puerto Rico,125,San Germán Municipio,11,0,11
6,California,72,Puerto Rico,127,San Juan Municipio,639,50,589
6,California,72,Puerto Rico,133,Santa Isabel Municipio,87,0,87
6,California,72,Puerto Rico,135,Toa Alta Municipio,50,0,50
6,California,72,Puerto Rico,137,Toa Baja Municipio,733,20,713
6,California,72,Puerto Rico,139,Trujillo Alto Municipio,0,27,-27
6,California,8,Colorado,1,Adams County,651,1790,-1139
6,California,8,Colorado,3,Alamosa County,95,51,44
6,California,8,Colorado,5,Arapahoe County,2461,2703,-242
6,California,8,Colorado,7,Archuleta County,158,41,117
6,California,8,Colorado,11,Bent County,23,0,23
6,California,8,Colorado,13,Boulder County,2024,3443,-1419
6,California,8,Colorado,14,Broomfield County,48,387,-339
6,California,8,Colorado,15,Chaffee County,23,4,19
6,California,8,Colorado,17,Cheyenne County,0,37,-37
6,California,8,Colorado,19,Clear Creek County,54,15,39
6,California,8,Colorado,23,Costilla County,7,34,-27
6,California,8,Colorado,25,Crowley County,0,5,-5
6,California,8,Colorado,27,Custer County,0,2,-2
6,California,8,Colorado,29,Delta County,63,43,20
6,California,8,Colorado,31,Denver County,3013,3945,-932
6,California,8,Colorado,35,Douglas County,1244,1783,-539
6,California,8,Colorado,37,Eagle County,261,229,32
6,California,8,Colorado,39,Elbert County,0,100,-100
6,California,8,Colorado,41,El Paso County,4508,4397,111
6,California,8,Colorado,43,Fremont County,73,188,-115
6,California,8,Colorado,45,Garfield County,266,196,70
6,California,8,Colorado,47,Gilpin County,0,18,-18
6,California,8,Colorado,49,Grand County,6,23,-17
6,California,8,Colorado,51,Gunnison County,0,58,-58
6,California,8,Colorado,53,Hinsdale County,0,3,-3
6,California,8,Colorado,55,Huerfano County,0,8,-8
6,California,8,Colorado,59,Jefferson County,1320,2159,-839
6,California,8,Colorado,61,Kiowa County,0,2,-2
6,California,8,Colorado,63,Kit Carson County,0,14,-14
6,California,8,Colorado,65,Lake County,0,11,-11
6,California,8,Colorado,67,La Plata County,143,258,-115
6,California,8,Colorado,69,Larimer County,1443,2297,-854
6,California,8,Colorado,71,Las Animas County,43,19,24
6,California,8,Colorado,73,Lincoln County,0,3,-3
6,California,8,Colorado,75,Logan County,47,15,32
6,California,8,Colorado,77,Mesa County,468,277,191
6,California,8,Colorado,79,Mineral County,0,8,-8
6,California,8,Colorado,81,Moffat County,0,26,-26
6,California,8,Colorado,85,Montrose County,213,95,118
6,California,8,Colorado,87,Morgan County,15,93,-78
6,California,8,Colorado,89,Otero County,78,45,33
6,California,8,Colorado,91,Ouray County,43,40,3
6,California,8,Colorado,93,Park County,63,0,63
6,California,8,Colorado,97,Pitkin County,187,192,-5
6,California,8,Colorado,99,Prowers County,29,7,22
6,California,8,Colorado,101,Pueblo County,330,155,175
6,California,8,Colorado,103,Rio Blanco County,21,16,5
6,California,8,Colorado,105,Rio Grande County,0,13,-13
6,California,8,Colorado,107,Routt County,53,43,10
6,California,8,Colorado,109,Saguache County,0,18,-18
6,California,8,Colorado,113,San Miguel County,27,112,-85
6,California,8,Colorado,115,Sedgwick County,0,7,-7
6,California,8,Colorado,117,Summit County,89,86,3
6,California,8,Colorado,119,Teller County,120,71,49
6,California,8,Colorado,121,Washington County,0,50,-50
6,California,8,Colorado,123,Weld County,477,1037,-560
6,California,9,Connecticut,1,Fairfield County,1993,679,1314
6,California,9,Connecticut,3,Hartford County,971,669,302
6,California,9,Connecticut,5,Litchfield County,329,132,197
6,California,9,Connecticut,7,Middlesex County,67,223,-156
6,California,9,Connecticut,9,New Haven County,910,976,-66
6,California,9,Connecticut,11,New London County,648,900,-252
6,California,9,Connecticut,13,Tolland County,148,87,61
6,California,9,Connecticut,15,Windham County,93,147,-54
6,California,AFR,Africa,,-,9182,0,0
6,California,ASI,Asia,,-,166607,0,0
6,California,CAM,Central America,,-,57465,0,0
6,California,CAR,Caribbean,,-,2280,0,0
6,California,EUR,Europe,,-,47380,0,0
6,California,ISL,U.S. Island Areas,,-,1919,0,0
6,California,NAM,Northern America,,-,11916,0,0
6,California,OCE,Oceania and At Sea,,-,7087,0,0
6,California,SAM,South America,,-,12183,0,0
8,Colorado,1,Alabama,3,Baldwin County,42,103,-61
8,Colorado,1,Alabama,7,Bibb County,16,0,16
8,Colorado,1,Alabama,9,Blount County,24,0,24
8,Colorado,1,Alabama,15,Calhoun County,53,45,8
8,Colorado,1,Alabama,17,Chambers County,0,28,-28
8,Colorado,1,Alabama,29,Cleburne County,20,0,20
8,Colorado,1,Alabama,31,Coffee County,277,25,252
8,Colorado,1,Alabama,33,Colbert County,0,10,-10
8,Colorado,1,Alabama,35,Conecuh County,6,0,6
8,Colorado,1,Alabama,39,Covington County,0,4,-4
8,Colorado,1,Alabama,43,Cullman County,0,74,-74
8,Colorado,1,Alabama,45,Dale County,67,100,-33
8,Colorado,1,Alabama,51,Elmore County,0,43,-43
8,Colorado,1,Alabama,55,Etowah County,0,10,-10
8,Colorado,1,Alabama,59,Franklin County,34,0,34
8,Colorado,1,Alabama,69,Houston County,80,25,55
8,Colorado,1,Alabama,73,Jefferson County,226,123,103
8,Colorado,1,Alabama,77,Lauderdale County,0,17,-17
8,Colorado,1,Alabama,81,Lee County,68,459,-391
8,Colorado,1,Alabama,83,Limestone County,0,59,-59
8,Colorado,1,Alabama,89,Madison County,366,37,329
8,Colorado,1,Alabama,91,Marengo County,9,0,9
8,Colorado,1,Alabama,95,Marshall County,0,4,-4
8,Colorado,1,Alabama,97,Mobile County,351,97,254
8,Colorado,1,Alabama,99,Monroe County,0,54,-54
8,Colorado,1,Alabama,101,Montgomery County,85,11,74
8,Colorado,1,Alabama,103,Morgan County,0,60,-60
8,Colorado,1,Alabama,109,Pike County,20,29,-9
8,Colorado,1,Alabama,113,Russell County,174,59,115
8,Colorado,1,Alabama,115,St. Clair County,16,0,16
8,Colorado,1,Alabama,117,Shelby County,124,25,99
8,Colorado,1,Alabama,119,Sumter County,200,0,200
8,Colorado,1,Alabama,121,Talladega County,0,25,-25
8,Colorado,1,Alabama,123,Tallapoosa County,0,16,-16
8,Colorado,1,Alabama,125,Tuscaloosa County,65,119,-54
8,Colorado,1,Alabama,129,Washington County,18,0,18
8,Colorado,10,Delaware,1,Kent County,0,51,-51
8,Colorado,10,Delaware,3,New Castle County,253,46,207
8,Colorado,10,Delaware,5,Sussex County,26,17,9
8,Colorado,11,District of Columbia,1,District of Columbia,978,609,369
8,Colorado,12,Florida,1,Alachua County,87,117,-30
8,Colorado,12,Florida,3,Baker County,9,12,-3
8,Colorado,12,Florida,5,Bay County,320,60,260
8,Colorado,12,Florida,9,Brevard County,339,754,-415
8,Colorado,12,Florida,11,Broward County,839,733,106
8,Colorado,12,Florida,15,Charlotte County,54,148,-94
8,Colorado,12,Florida,17,Citrus County,24,83,-59
8,Colorado,12,Florida,19,Clay County,131,24,107
8,Colorado,12,Florida,21,Collier County,412,205,207
8,Colorado,12,Florida,23,Columbia County,0,31,-31
8,Colorado,12,Florida,27,DeSoto County,9,0,9
8,Colorado,12,Florida,31,Duval County,474,241,233
8,Colorado,12,Florida,33,Escambia County,320,363,-43
8,Colorado,12,Florida,35,Flagler County,158,81,77
8,Colorado,12,Florida,37,Franklin County,0,23,-23
8,Colorado,12,Florida,49,Hardee County,12,0,12
8,Colorado,12,Florida,53,Hernando County,21,185,-164
8,Colorado,12,Florida,57,Hillsborough County,1220,603,617
8,Colorado,12,Florida,61,Indian River County,23,161,-138
8,Colorado,12,Florida,69,Lake County,102,128,-26
8,Colorado,12,Florida,71,Lee County,277,282,-5
8,Colorado,12,Florida,73,Leon County,390,117,273
8,Colorado,12,Florida,75,Levy County,0,11,-11
8,Colorado,12,Florida,79,Madison County,0,2,-2
8,Colorado,12,Florida,81,Manatee County,301,168,133
8,Colorado,12,Florida,83,Marion County,124,104,20
8,Colorado,12,Florida,85,Martin County,78,85,-7
8,Colorado,12,Florida,86,Miami-Dade County,848,106,742
8,Colorado,12,Florida,87,Monroe County,64,62,2
8,Colorado,12,Florida,89,Nassau County,31,0,31
8,Colorado,12,Florida,91,Okaloosa County,205,390,-185
8,Colorado,12,Florida,93,Okeechobee County,35,0,35
8,Colorado,12,Florida,95,Orange County,621,750,-129
8,Colorado,12,Florida,97,Osceola County,159,131,28
8,Colorado,12,Florida,99,Palm Beach County,853,353,500
8,Colorado,12,Florida,101,Pasco County,71,221,-150
8,Colorado,12,Florida,103,Pinellas County,654,676,-22
8,Colorado,12,Florida,105,Polk County,165,195,-30
8,Colorado,12,Florida,107,Putnam County,0,55,-55
8,Colorado,12,Florida,109,St. Johns County,139,280,-141
8,Colorado,12,Florida,111,St. Lucie County,184,53,131
8,Colorado,12,Florida,113,Santa Rosa County,88,218,-130
8,Colorado,12,Florida,115,Sarasota County,258,382,-124
8,Colorado,12,Florida,117,Seminole County,370,162,208
8,Colorado,12,Florida,119,Sumter County,42,27,15
8,Colorado,12,Florida,127,Volusia County,366,371,-5
8,Colorado,12,Florida,129,Wakulla County,76,13,63
8,Colorado,12,Florida,131,Walton County,52,84,-32
8,Colorado,12,Florida,133,Washington County,43,0,43
8,Colorado,13,Georgia,1,Appling County,41,0,41
8,Colorado,13,Georgia,9,Baldwin County,4,0,4
8,Colorado,13,Georgia,13,Barrow County,11,36,-25
8,Colorado,13,Georgia,21,Bibb County,3,7,-4
8,Colorado,13,Georgia,27,Brooks County,19,0,19
8,Colorado,13,Georgia,29,Bryan County,50,123,-73
8,Colorado,13,Georgia,31,Bulloch County,15,39,-24
8,Colorado,13,Georgia,39,Camden County,35,28,7
8,Colorado,13,Georgia,45,Carroll County,33,15,18
8,Colorado,13,Georgia,49,Charlton County,0,6,-6
8,Colorado,13,Georgia,51,Chatham County,119,385,-266
8,Colorado,13,Georgia,53,Chattahoochee County,523,137,386
8,Colorado,13,Georgia,57,Cherokee County,16,136,-120
8,Colorado,13,Georgia,59,Clarke County,84,38,46
8,Colorado,13,Georgia,63,Clayton County,27,15,12
8,Colorado,13,Georgia,67,Cobb County,987,300,687
8,Colorado,13,Georgia,71,Colquitt County,0,90,-90
8,Colorado,13,Georgia,73,Columbia County,228,31,197
8,Colorado,13,Georgia,77,Coweta County,32,33,-1
8,Colorado,13,Georgia,81,Crisp County,0,10,-10
8,Colorado,13,Georgia,83,Dade County,0,42,-42
8,Colorado,13,Georgia,85,Dawson County,10,0,10
8,Colorado,13,Georgia,89,DeKalb County,267,457,-190
8,Colorado,13,Georgia,91,Dodge County,0,5,-5
8,Colorado,13,Georgia,95,Dougherty County,95,29,66
8,Colorado,13,Georgia,97,Douglas County,82,104,-22
8,Colorado,13,Georgia,103,Effingham County,0,52,-52
8,Colorado,13,Georgia,109,Evans County,0,4,-4
8,Colorado,13,Georgia,111,Fannin County,0,91,-91
8,Colorado,13,Georgia,113,Fayette County,30,19,11
8,Colorado,13,Georgia,115,Floyd County,0,8,-8
8,Colorado,13,Georgia,117,Forsyth County,0,57,-57
8,Colorado,13,Georgia,121,Fulton County,589,352,237
8,Colorado,13,Georgia,123,Gilmer County,0,4,-4
8,Colorado,13,Georgia,127,Glynn County,0,65,-65
8,Colorado,13,Georgia,135,Gwinnett County,455,116,339
8,Colorado,13,Georgia,137,Habersham County,13,0,13
8,Colorado,13,Georgia,139,Hall County,56,124,-68
8,Colorado,13,Georgia,145,Harris County,0,5,-5
8,Colorado,13,Georgia,147,Hart County,31,0,31
8,Colorado,13,Georgia,151,Henry County,78,0,78
8,Colorado,13,Georgia,153,Houston County,175,29,146
8,Colorado,13,Georgia,175,Laurens County,123,0,123
8,Colorado,13,Georgia,179,Liberty County,872,272,600
8,Colorado,13,Georgia,185,Lowndes County,11,62,-51
8,Colorado,13,Georgia,187,Lumpkin County,11,8,3
8,Colorado,13,Georgia,195,Madison County,9,0,9
8,Colorado,13,Georgia,209,Montgomery County,11,0,11
8,Colorado,13,Georgia,215,Muscogee County,212,376,-164
8,Colorado,13,Georgia,217,Newton County,0,230,-230
8,Colorado,13,Georgia,219,Oconee County,0,37,-37
8,Colorado,13,Georgia,221,Oglethorpe County,0,30,-30
8,Colorado,13,Georgia,223,Paulding County,19,46,-27
8,Colorado,13,Georgia,227,Pickens County,0,2,-2
8,Colorado,13,Georgia,241,Rabun County,0,29,-29
8,Colorado,13,Georgia,245,Richmond County,104,155,-51
8,Colorado,13,Georgia,257,Stephens County,0,104,-104
8,Colorado,13,Georgia,267,Tattnall County,15,0,15
8,Colorado,13,Georgia,275,Thomas County,18,0,18
8,Colorado,13,Georgia,281,Towns County,36,0,36
8,Colorado,13,Georgia,293,Upson County,48,0,48
8,Colorado,13,Georgia,295,Walker County,0,30,-30
8,Colorado,13,Georgia,297,Walton County,61,0,61
8,Colorado,13,Georgia,299,Ware County,72,0,72
8,Colorado,13,Georgia,305,Wayne County,0,12,-12
8,Colorado,13,Georgia,313,Whitfield County,22,0,22
8,Colorado,13,Georgia,315,Wilcox County,4,6,-2
8,Colorado,15,Hawaii,1,Hawaii County,411,166,245
8,Colorado,15,Hawaii,3,Honolulu County,2327,1419,908
8,Colorado,15,Hawaii,7,Kauai County,14,228,-214
8,Colorado,15,Hawaii,9,Maui County,246,207,39
8,Colorado,16,Idaho,1,Ada County,704,709,-5
8,Colorado,16,Idaho,3,Adams County,0,11,-11
8,Colorado,16,Idaho,5,Bannock County,130,239,-109
8,Colorado,16,Idaho,11,Bingham County,21,35,-14
8,Colorado,16,Idaho,13,Blaine County,84,38,46
8,Colorado,16,Idaho,15,Boise County,0,34,-34
8,Colorado,16,Idaho,17,Bonner County,29,175,-146
8,Colorado,16,Idaho,19,Bonneville County,156,162,-6
8,Colorado,16,Idaho,21,Boundary County,0,57,-57
8,Colorado,16,Idaho,27,Canyon County,24,345,-321
8,Colorado,16,Idaho,29,Caribou County,75,0,75
8,Colorado,16,Idaho,35,Clearwater County,0,30,-30
8,Colorado,16,Idaho,37,Custer County,0,9,-9
8,Colorado,16,Idaho,39,Elmore County,38,34,4
8,Colorado,16,Idaho,41,Franklin County,0,1,-1
8,Colorado,16,Idaho,43,Fremont County,0,12,-12
8,Colorado,16,Idaho,51,Jefferson County,47,187,-140
8,Colorado,16,Idaho,53,Jerome County,0,27,-27
8,Colorado,16,Idaho,55,Kootenai County,285,156,129
8,Colorado,16,Idaho,57,Latah County,56,17,39
8,Colorado,16,Idaho,59,Lemhi County,66,41,25
8,Colorado,16,Idaho,63,Lincoln County,0,3,-3
8,Colorado,16,Idaho,65,Madison County,141,72,69
8,Colorado,16,Idaho,67,Minidoka County,35,0,35
8,Colorado,16,Idaho,69,Nez Perce County,51,4,47
8,Colorado,16,Idaho,71,Oneida County,0,8,-8
8,Colorado,16,Idaho,73,Owyhee County,0,14,-14
8,Colorado,16,Idaho,75,Payette County,0,8,-8
8,Colorado,16,Idaho,77,Power County,0,8,-8
8,Colorado,16,Idaho,81,Teton County,0,5,-5
8,Colorado,16,Idaho,83,Twin Falls County,44,97,-53
8,Colorado,16,Idaho,85,Valley County,0,5,-5
8,Colorado,17,Illinois,1,Adams County,72,0,72
8,Colorado,17,Illinois,5,Bond County,44,32,12
8,Colorado,17,Illinois,7,Boone County,29,12,17
8,Colorado,17,Illinois,9,Brown County,7,0,7
8,Colorado,17,Illinois,11,Bureau County,20,2,18
8,Colorado,17,Illinois,15,Carroll County,0,1,-1
8,Colorado,17,Illinois,19,Champaign County,246,285,-39
8,Colorado,17,Illinois,27,Clinton County,9,0,9
8,Colorado,17,Illinois,29,Coles County,5,0,5
8,Colorado,17,Illinois,31,Cook County,3714,1249,2465
8,Colorado,17,Illinois,33,Crawford County,17,0,17
8,Colorado,17,Illinois,35,Cumberland County,0,50,-50
8,Colorado,17,Illinois,37,DeKalb County,167,3,164
8,Colorado,17,Illinois,39,De Witt County,41,0,41
8,Colorado,17,Illinois,41,Douglas County,0,7,-7
8,Colorado,17,Illinois,43,DuPage County,917,565,352
8,Colorado,17,Illinois,49,Effingham County,9,0,9
8,Colorado,17,Illinois,53,Ford County,154,0,154
8,Colorado,17,Illinois,55,Franklin County,0,5,-5
8,Colorado,17,Illinois,57,Fulton County,5,2,3
8,Colorado,17,Illinois,63,Grundy County,4,33,-29
8,Colorado,17,Illinois,67,Hancock County,0,30,-30
8,Colorado,17,Illinois,73,Henry County,7,0,7
8,Colorado,17,Illinois,77,Jackson County,26,0,26
8,Colorado,17,Illinois,83,Jersey County,0,10,-10
8,Colorado,17,Illinois,85,Jo Daviess County,4,0,4
8,Colorado,17,Illinois,89,Kane County,225,150,75
8,Colorado,17,Illinois,91,Kankakee County,93,60,33
8,Colorado,17,Illinois,93,Kendall County,49,0,49
8,Colorado,17,Illinois,95,Knox County,0,16,-16
8,Colorado,17,Illinois,97,Lake County,544,412,132
8,Colorado,17,Illinois,99,LaSalle County,190,18,172
8,Colorado,17,Illinois,107,Logan County,10,14,-4
8,Colorado,17,Illinois,111,McHenry County,677,106,571
8,Colorado,17,Illinois,113,McLean County,114,52,62
8,Colorado,17,Illinois,115,Macon County,0,7,-7
8,Colorado,17,Illinois,119,Madison County,78,71,7
8,Colorado,17,Illinois,121,Marion County,98,2,96
8,Colorado,17,Illinois,123,Marshall County,0,2,-2
8,Colorado,17,Illinois,133,Monroe County,15,0,15
8,Colorado,17,Illinois,135,Montgomery County,4,0,4
8,Colorado,17,Illinois,141,Ogle County,59,2,57
8,Colorado,17,Illinois,143,Peoria County,275,44,231
8,Colorado,17,Illinois,145,Perry County,0,17,-17
8,Colorado,17,Illinois,147,Piatt County,106,13,93
8,Colorado,17,Illinois,161,Rock Island County,177,149,28
8,Colorado,17,Illinois,163,St. Clair County,300,77,223
8,Colorado,17,Illinois,167,Sangamon County,55,52,3
8,Colorado,17,Illinois,173,Shelby County,0,10,-10
8,Colorado,17,Illinois,177,Stephenson County,28,27,1
8,Colorado,17,Illinois,179,Tazewell County,112,15,97
8,Colorado,17,Illinois,181,Union County,45,0,45
8,Colorado,17,Illinois,193,White County,18,0,18
8,Colorado,17,Illinois,195,Whiteside County,36,10,26
8,Colorado,17,Illinois,197,Will County,550,122,428
8,Colorado,17,Illinois,199,Williamson County,0,49,-49
8,Colorado,17,Illinois,201,Winnebago County,76,16,60
8,Colorado,17,Illinois,203,Woodford County,61,0,61
8,Colorado,18,Indiana,3,Allen County,122,63,59
8,Colorado,18,Indiana,5,Bartholomew County,14,24,-10
8,Colorado,18,Indiana,9,Blackford County,16,0,16
8,Colorado,18,Indiana,11,Boone County,83,0,83
8,Colorado,18,Indiana,15,Carroll County,0,7,-7
8,Colorado,18,Indiana,19,Clark County,11,0,11
8,Colorado,18,Indiana,23,Clinton County,18,0,18
8,Colorado,18,Indiana,27,Daviess County,0,24,-24
8,Colorado,18,Indiana,29,Dearborn County,0,2,-2
8,Colorado,18,Indiana,31,Decatur County,13,22,-9
8,Colorado,18,Indiana,35,Delaware County,70,42,28
8,Colorado,18,Indiana,39,Elkhart County,29,11,18
8,Colorado,18,Indiana,43,Floyd County,6,0,6
8,Colorado,18,Indiana,45,Fountain County,5,0,5
8,Colorado,18,Indiana,51,Gibson County,26,0,26
8,Colorado,18,Indiana,57,Hamilton County,310,188,122
8,Colorado,18,Indiana,59,Hancock County,95,0,95
8,Colorado,18,Indiana,63,Hendricks County,52,272,-220
8,Colorado,18,Indiana,69,Huntington County,10,24,-14
8,Colorado,18,Indiana,73,Jasper County,23,0,23
8,Colorado,18,Indiana,81,Johnson County,56,91,-35
8,Colorado,18,Indiana,83,Knox County,0,2,-2
8,Colorado,18,Indiana,85,Kosciusko County,12,12,0
8,Colorado,18,Indiana,87,LaGrange County,0,16,-16
8,Colorado,18,Indiana,89,Lake County,136,153,-17
8,Colorado,18,Indiana,91,LaPorte County,41,26,15
8,Colorado,18,Indiana,93,Lawrence County,0,14,-14
8,Colorado,18,Indiana,95,Madison County,0,18,-18
8,Colorado,18,Indiana,97,Marion County,344,457,-113
8,Colorado,18,Indiana,99,Marshall County,14,26,-12
8,Colorado,18,Indiana,105,Monroe County,151,141,10
8,Colorado,18,Indiana,107,Montgomery County,0,67,-67
8,Colorado,18,Indiana,113,Noble County,0,9,-9
8,Colorado,18,Indiana,117,Orange County,28,0,28
8,Colorado,18,Indiana,119,Owen County,31,0,31
8,Colorado,18,Indiana,121,Parke County,0,29,-29
8,Colorado,18,Indiana,127,Porter County,108,90,18
8,Colorado,18,Indiana,133,Putnam County,14,25,-11
8,Colorado,18,Indiana,135,Randolph County,9,0,9
8,Colorado,18,Indiana,141,St. Joseph County,318,59,259
8,Colorado,18,Indiana,145,Shelby County,26,0,26
8,Colorado,18,Indiana,151,Steuben County,6,3,3
8,Colorado,18,Indiana,153,Sullivan County,0,2,-2
8,Colorado,18,Indiana,155,Switzerland County,13,0,13
8,Colorado,18,Indiana,157,Tippecanoe County,220,41,179
8,Colorado,18,Indiana,163,Vanderburgh County,23,14,9
8,Colorado,18,Indiana,165,Vermillion County,26,0,26
8,Colorado,18,Indiana,167,Vigo County,81,0,81
8,Colorado,18,Indiana,169,Wabash County,0,1,-1
8,Colorado,18,Indiana,173,Warrick County,13,0,13
8,Colorado,18,Indiana,177,Wayne County,0,5,-5
8,Colorado,18,Indiana,183,Whitley County,0,52,-52
8,Colorado,19,Iowa,5,Allamakee County,0,8,-8
8,Colorado,19,Iowa,7,Appanoose County,9,0,9
8,Colorado,19,Iowa,11,Benton County,40,0,40
8,Colorado,19,Iowa,13,Black Hawk County,138,114,24
8,Colorado,19,Iowa,15,Boone County,44,22,22
8,Colorado,19,Iowa,17,Bremer County,137,56,81
8,Colorado,19,Iowa,19,Buchanan County,0,4,-4
8,Colorado,19,Iowa,21,Buena Vista County,11,4,7
8,Colorado,19,Iowa,25,Calhoun County,0,1,-1
8,Colorado,19,Iowa,27,Carroll County,0,11,-11
8,Colorado,19,Iowa,29,Cass County,0,2,-2
8,Colorado,19,Iowa,31,Cedar County,0,28,-28
8,Colorado,19,Iowa,33,Cerro Gordo County,16,5,11
8,Colorado,19,Iowa,35,Cherokee County,11,20,-9
8,Colorado,19,Iowa,37,Chickasaw County,0,17,-17
8,Colorado,19,Iowa,41,Clay County,0,10,-10
8,Colorado,19,Iowa,45,Clinton County,0,22,-22
8,Colorado,19,Iowa,47,Crawford County,0,2,-2
8,Colorado,19,Iowa,49,Dallas County,104,78,26
8,Colorado,19,Iowa,51,Davis County,0,3,-3
8,Colorado,19,Iowa,57,Des Moines County,7,0,7
8,Colorado,19,Iowa,59,Dickinson County,19,91,-72
8,Colorado,19,Iowa,61,Dubuque County,77,74,3
8,Colorado,19,Iowa,65,Fayette County,0,3,-3
8,Colorado,19,Iowa,71,Fremont County,0,7,-7
8,Colorado,19,Iowa,77,Guthrie County,0,6,-6
8,Colorado,19,Iowa,85,Harrison County,0,6,-6
8,Colorado,19,Iowa,87,Henry County,17,5,12
8,Colorado,19,Iowa,91,Humboldt County,66,1,65
8,Colorado,19,Iowa,95,Iowa County,14,0,14
8,Colorado,19,Iowa,99,Jasper County,0,5,-5
8,Colorado,19,Iowa,101,Jefferson County,52,37,15
8,Colorado,19,Iowa,103,Johnson County,446,97,349
8,Colorado,19,Iowa,105,Jones County,20,15,5
8,Colorado,19,Iowa,111,Lee County,0,15,-15
8,Colorado,19,Iowa,113,Linn County,289,132,157
8,Colorado,19,Iowa,115,Louisa County,0,1,-1
8,Colorado,19,Iowa,117,Lucas County,0,6,-6
8,Colorado,19,Iowa,119,Lyon County,8,4,4
8,Colorado,19,Iowa,123,Mahaska County,4,0,4
8,Colorado,19,Iowa,125,Marion County,1,26,-25
8,Colorado,19,Iowa,127,Marshall County,7,0,7
8,Colorado,19,Iowa,129,Mills County,0,46,-46
8,Colorado,19,Iowa,139,Muscatine County,35,0,35
8,Colorado,19,Iowa,141,O'Brien County,0,4,-4
8,Colorado,19,Iowa,145,Page County,6,0,6
8,Colorado,19,Iowa,147,Palo Alto County,15,0,15
8,Colorado,19,Iowa,153,Polk County,571,610,-39
8,Colorado,19,Iowa,155,Pottawattamie County,314,127,187
8,Colorado,19,Iowa,157,Poweshiek County,0,8,-8
8,Colorado,19,Iowa,159,Ringgold County,0,10,-10
8,Colorado,19,Iowa,161,Sac County,28,0,28
8,Colorado,19,Iowa,163,Scott County,108,89,19
8,Colorado,19,Iowa,165,Shelby County,34,25,9
8,Colorado,19,Iowa,167,Sioux County,8,42,-34
8,Colorado,19,Iowa,169,Story County,135,80,55
8,Colorado,19,Iowa,171,Tama County,0,9,-9
8,Colorado,19,Iowa,173,Taylor County,0,43,-43
8,Colorado,19,Iowa,175,Union County,0,11,-11
8,Colorado,19,Iowa,177,Van Buren County,70,0,70
8,Colorado,19,Iowa,179,Wapello County,19,6,13
8,Colorado,19,Iowa,181,Warren County,24,107,-83
8,Colorado,19,Iowa,183,Washington County,0,9,-9
8,Colorado,19,Iowa,185,Wayne County,0,9,-9
8,Colorado,19,Iowa,187,Webster County,78,23,55
8,Colorado,19,Iowa,191,Winneshiek County,50,9,41
8,Colorado,19,Iowa,193,Woodbury County,150,77,73
8,Colorado,19,Iowa,197,Wright County,0,45,-45
8,Colorado,2,Alaska,16,Aleutians West Census Area,48,0,48
8,Colorado,2,Alaska,20,Anchorage Municipality,804,903,-99
8,Colorado,2,Alaska,60,Bristol Bay Borough,9,0,9
8,Colorado,2,Alaska,68,Denali Borough,49,84,-35
8,Colorado,2,Alaska,90,Fairbanks North Star Borough,367,232,135
8,Colorado,2,Alaska,110,Juneau City and Borough,150,23,127
8,Colorado,2,Alaska,122,Kenai Peninsula Borough,75,147,-72
8,Colorado,2,Alaska,130,Ketchikan Gateway Borough,0,49,-49
8,Colorado,2,Alaska,150,Kodiak Island Borough,0,21,-21
8,Colorado,2,Alaska,158,Kusilvak Census Area,28,0,28
8,Colorado,2,Alaska,170,Matanuska-Susitna Borough,227,177,50
8,Colorado,2,Alaska,180,Nome Census Area,0,5,-5
8,Colorado,2,Alaska,185,North Slope Borough,0,26,-26
8,Colorado,2,Alaska,188,Northwest Arctic Borough,3,19,-16
8,Colorado,2,Alaska,198,Prince of Wales-Hyder Census Area,10,13,-3
8,Colorado,2,Alaska,220,Sitka City and Borough,0,10,-10
8,Colorado,2,Alaska,230,Skagway Municipality,0,12,-12
8,Colorado,2,Alaska,261,Valdez-Cordova Census Area,0,45,-45
8,Colorado,2,Alaska,275,Wrangell City and Borough,8,0,8
8,Colorado,2,Alaska,290,Yukon-Koyukuk Census Area,0,9,-9
8,Colorado,20,Kansas,1,Allen County,23,0,23
8,Colorado,20,Kansas,5,Atchison County,5,50,-45
8,Colorado,20,Kansas,9,Barton County,554,14,540
8,Colorado,20,Kansas,11,Bourbon County,0,34,-34
8,Colorado,20,Kansas,13,Brown County,0,22,-22
8,Colorado,20,Kansas,15,Butler County,0,15,-15
8,Colorado,20,Kansas,23,Cheyenne County,0,20,-20
8,Colorado,20,Kansas,27,Clay County,46,13,33
8,Colorado,20,Kansas,29,Cloud County,19,6,13
8,Colorado,20,Kansas,31,Coffey County,0,18,-18
8,Colorado,20,Kansas,35,Cowley County,43,12,31
8,Colorado,20,Kansas,37,Crawford County,0,11,-11
8,Colorado,20,Kansas,39,Decatur County,0,24,-24
8,Colorado,20,Kansas,41,Dickinson County,24,90,-66
8,Colorado,20,Kansas,43,Doniphan County,0,17,-17
8,Colorado,20,Kansas,45,Douglas County,258,286,-28
8,Colorado,20,Kansas,47,Edwards County,0,3,-3
8,Colorado,20,Kansas,49,Elk County,0,5,-5
8,Colorado,20,Kansas,51,Ellis County,166,329,-163
8,Colorado,20,Kansas,53,Ellsworth County,0,2,-2
8,Colorado,20,Kansas,55,Finney County,37,98,-61
8,Colorado,20,Kansas,57,Ford County,10,111,-101
8,Colorado,20,Kansas,59,Franklin County,10,8,2
8,Colorado,20,Kansas,61,Geary County,234,185,49
8,Colorado,20,Kansas,63,Gove County,55,8,47
8,Colorado,20,Kansas,65,Graham County,9,3,6
8,Colorado,20,Kansas,67,Grant County,0,46,-46
8,Colorado,20,Kansas,73,Greenwood County,0,4,-4
8,Colorado,20,Kansas,75,Hamilton County,80,29,51
8,Colorado,20,Kansas,77,Harper County,0,22,-22
8,Colorado,20,Kansas,79,Harvey County,35,53,-18
8,Colorado,20,Kansas,81,Haskell County,19,0,19
8,Colorado,20,Kansas,83,Hodgeman County,0,15,-15
8,Colorado,20,Kansas,85,Jackson County,0,4,-4
8,Colorado,20,Kansas,87,Jefferson County,0,14,-14
8,Colorado,20,Kansas,91,Johnson County,1258,652,606
8,Colorado,20,Kansas,93,Kearny County,0,47,-47
8,Colorado,20,Kansas,97,Kiowa County,0,12,-12
8,Colorado,20,Kansas,99,Labette County,26,24,2
8,Colorado,20,Kansas,101,Lane County,0,2,-2
8,Colorado,20,Kansas,103,Leavenworth County,323,211,112
8,Colorado,20,Kansas,105,Lincoln County,0,3,-3
8,Colorado,20,Kansas,107,Linn County,3,0,3
8,Colorado,20,Kansas,109,Logan County,0,18,-18
8,Colorado,20,Kansas,111,Lyon County,21,0,21
8,Colorado,20,Kansas,113,McPherson County,22,10,12
8,Colorado,20,Kansas,115,Marion County,19,16,3
8,Colorado,20,Kansas,117,Marshall County,46,4,42
8,Colorado,20,Kansas,121,Miami County,0,24,-24
8,Colorado,20,Kansas,123,Mitchell County,0,6,-6
8,Colorado,20,Kansas,125,Montgomery County,64,24,40
8,Colorado,20,Kansas,127,Morris County,47,1,46
8,Colorado,20,Kansas,131,Nemaha County,27,0,27
8,Colorado,20,Kansas,135,Ness County,0,14,-14
8,Colorado,20,Kansas,137,Norton County,0,5,-5
8,Colorado,20,Kansas,139,Osage County,0,8,-8
8,Colorado,20,Kansas,141,Osborne County,0,10,-10
8,Colorado,20,Kansas,145,Pawnee County,7,22,-15
8,Colorado,20,Kansas,147,Phillips County,0,2,-2
8,Colorado,20,Kansas,149,Pottawatomie County,66,7,59
8,Colorado,20,Kansas,151,Pratt County,12,0,12
8,Colorado,20,Kansas,153,Rawlins County,0,15,-15
8,Colorado,20,Kansas,155,Reno County,35,12,23
8,Colorado,20,Kansas,157,Republic County,0,9,-9
8,Colorado,20,Kansas,159,Rice County,12,58,-46
8,Colorado,20,Kansas,161,Riley County,398,180,218
8,Colorado,20,Kansas,163,Rooks County,0,3,-3
8,Colorado,20,Kansas,165,Rush County,0,8,-8
8,Colorado,20,Kansas,167,Russell County,0,5,-5
8,Colorado,20,Kansas,169,Saline County,54,109,-55
8,Colorado,20,Kansas,173,Sedgwick County,761,1051,-290
8,Colorado,20,Kansas,175,Seward County,100,6,94
8,Colorado,20,Kansas,177,Shawnee County,103,115,-12
8,Colorado,20,Kansas,179,Sheridan County,18,7,11
8,Colorado,20,Kansas,181,Sherman County,1,60,-59
8,Colorado,20,Kansas,183,Smith County,0,33,-33
8,Colorado,20,Kansas,185,Stafford County,12,0,12
8,Colorado,20,Kansas,187,Stanton County,21,20,1
8,Colorado,20,Kansas,189,Stevens County,0,45,-45
8,Colorado,20,Kansas,191,Sumner County,10,105,-95
8,Colorado,20,Kansas,193,Thomas County,15,86,-71
8,Colorado,20,Kansas,199,Wallace County,5,15,-10
8,Colorado,20,Kansas,203,Wichita County,66,0,66
8,Colorado,20,Kansas,207,Woodson County,35,0,35
8,Colorado,20,Kansas,209,Wyandotte County,524,85,439
8,Colorado,21,Kentucky,3,Allen County,0,10,-10
8,Colorado,21,Kentucky,9,Barren County,0,17,-17
8,Colorado,21,Kentucky,13,Bell County,0,23,-23
8,Colorado,21,Kentucky,15,Boone County,10,41,-31
8,Colorado,21,Kentucky,19,Boyd County,40,143,-103
8,Colorado,21,Kentucky,27,Breckinridge County,0,73,-73
8,Colorado,21,Kentucky,37,Campbell County,9,0,9
8,Colorado,21,Kentucky,47,Christian County,286,209,77
8,Colorado,21,Kentucky,49,Clark County,16,0,16
8,Colorado,21,Kentucky,55,Crittenden County,0,10,-10
8,Colorado,21,Kentucky,59,Daviess County,83,0,83
8,Colorado,21,Kentucky,67,Fayette County,156,218,-62
8,Colorado,21,Kentucky,73,Franklin County,54,0,54
8,Colorado,21,Kentucky,75,Fulton County,16,0,16
8,Colorado,21,Kentucky,79,Garrard County,8,0,8
8,Colorado,21,Kentucky,83,Graves County,9,0,9
8,Colorado,21,Kentucky,93,Hardin County,141,220,-79
8,Colorado,21,Kentucky,95,Harlan County,23,0,23
8,Colorado,21,Kentucky,101,Henderson County,61,20,41
8,Colorado,21,Kentucky,111,Jefferson County,316,159,157
8,Colorado,21,Kentucky,113,Jessamine County,20,14,6
8,Colorado,21,Kentucky,117,Kenton County,62,109,-47
8,Colorado,21,Kentucky,125,Laurel County,0,14,-14
8,Colorado,21,Kentucky,141,Logan County,20,0,20
8,Colorado,21,Kentucky,145,McCracken County,83,0,83
8,Colorado,21,Kentucky,151,Madison County,7,119,-112
8,Colorado,21,Kentucky,157,Marshall County,0,20,-20
8,Colorado,21,Kentucky,163,Meade County,22,0,22
8,Colorado,21,Kentucky,171,Monroe County,7,0,7
8,Colorado,21,Kentucky,185,Oldham County,13,22,-9
8,Colorado,21,Kentucky,191,Pendleton County,0,6,-6
8,Colorado,21,Kentucky,199,Pulaski County,46,8,38
8,Colorado,21,Kentucky,203,Rockcastle County,199,0,199
8,Colorado,21,Kentucky,211,Shelby County,0,51,-51
8,Colorado,21,Kentucky,219,Todd County,0,53,-53
8,Colorado,21,Kentucky,221,Trigg County,30,0,30
8,Colorado,21,Kentucky,227,Warren County,21,32,-11
8,Colorado,21,Kentucky,239,Woodford County,0,23,-23
8,Colorado,22,Louisiana,5,Ascension Parish,97,0,97
8,Colorado,22,Louisiana,7,Assumption Parish,0,19,-19
8,Colorado,22,Louisiana,11,Beauregard Parish,38,62,-24
8,Colorado,22,Louisiana,15,Bossier Parish,135,99,36
8,Colorado,22,Louisiana,17,Caddo Parish,386,55,331
8,Colorado,22,Louisiana,19,Calcasieu Parish,76,7,69
8,Colorado,22,Louisiana,31,De Soto Parish,0,7,-7
8,Colorado,22,Louisiana,33,East Baton Rouge Parish,409,111,298
8,Colorado,22,Louisiana,41,Franklin Parish,0,9,-9
8,Colorado,22,Louisiana,43,Grant Parish,0,40,-40
8,Colorado,22,Louisiana,45,Iberia Parish,16,0,16
8,Colorado,22,Louisiana,47,Iberville Parish,0,4,-4
8,Colorado,22,Louisiana,51,Jefferson Parish,111,109,2
8,Colorado,22,Louisiana,53,Jefferson Davis Parish,108,0,108
8,Colorado,22,Louisiana,55,Lafayette Parish,99,385,-286
8,Colorado,22,Louisiana,61,Lincoln Parish,95,8,87
8,Colorado,22,Louisiana,63,Livingston Parish,46,38,8
8,Colorado,22,Louisiana,69,Natchitoches Parish,0,18,-18
8,Colorado,22,Louisiana,71,Orleans Parish,577,145,432
8,Colorado,22,Louisiana,73,Ouachita Parish,5,72,-67
8,Colorado,22,Louisiana,75,Plaquemines Parish,10,0,10
8,Colorado,22,Louisiana,79,Rapides Parish,81,11,70
8,Colorado,22,Louisiana,85,Sabine Parish,0,6,-6
8,Colorado,22,Louisiana,87,St. Bernard Parish,0,13,-13
8,Colorado,22,Louisiana,95,St. John the Baptist Parish,8,0,8
8,Colorado,22,Louisiana,97,St. Landry Parish,31,26,5
8,Colorado,22,Louisiana,99,St. Martin Parish,56,0,56
8,Colorado,22,Louisiana,101,St. Mary Parish,11,26,-15
8,Colorado,22,Louisiana,103,St. Tammany Parish,111,188,-77
8,Colorado,22,Louisiana,105,Tangipahoa Parish,27,7,20
8,Colorado,22,Louisiana,109,Terrebonne Parish,44,55,-11
8,Colorado,22,Louisiana,115,Vernon Parish,248,272,-24
8,Colorado,22,Louisiana,117,Washington Parish,0,67,-67
8,Colorado,22,Louisiana,123,West Carroll Parish,0,9,-9
8,Colorado,22,Louisiana,125,West Feliciana Parish,33,7,26
8,Colorado,23,Maine,1,Androscoggin County,0,1,-1
8,Colorado,23,Maine,3,Aroostook County,0,4,-4
8,Colorado,23,Maine,5,Cumberland County,181,369,-188
8,Colorado,23,Maine,7,Franklin County,4,0,4
8,Colorado,23,Maine,9,Hancock County,0,8,-8
8,Colorado,23,Maine,11,Kennebec County,76,33,43
8,Colorado,23,Maine,13,Knox County,0,14,-14
8,Colorado,23,Maine,17,Oxford County,9,22,-13
8,Colorado,23,Maine,19,Penobscot County,0,16,-16
8,Colorado,23,Maine,21,Piscataquis County,12,0,12
8,Colorado,23,Maine,25,Somerset County,0,7,-7
8,Colorado,23,Maine,27,Waldo County,2,18,-16
8,Colorado,23,Maine,29,Washington County,0,2,-2
8,Colorado,23,Maine,31,York County,80,27,53
8,Colorado,24,Maryland,1,Allegany County,7,5,2
8,Colorado,24,Maryland,3,Anne Arundel County,278,258,20
8,Colorado,24,Maryland,5,Baltimore County,278,155,123
8,Colorado,24,Maryland,9,Calvert County,52,84,-32
8,Colorado,24,Maryland,11,Caroline County,111,63,48
8,Colorado,24,Maryland,13,Carroll County,0,52,-52
8,Colorado,24,Maryland,15,Cecil County,57,0,57
8,Colorado,24,Maryland,17,Charles County,25,30,-5
8,Colorado,24,Maryland,19,Dorchester County,0,5,-5
8,Colorado,24,Maryland,21,Frederick County,130,60,70
8,Colorado,24,Maryland,25,Harford County,137,12,125
8,Colorado,24,Maryland,27,Howard County,125,73,52
8,Colorado,24,Maryland,31,Montgomery County,661,712,-51
8,Colorado,24,Maryland,33,Prince George's County,465,345,120
8,Colorado,24,Maryland,35,Queen Anne's County,0,9,-9
8,Colorado,24,Maryland,37,St. Mary's County,122,48,74
8,Colorado,24,Maryland,39,Somerset County,0,20,-20
8,Colorado,24,Maryland,41,Talbot County,30,0,30
8,Colorado,24,Maryland,43,Washington County,27,0,27
8,Colorado,24,Maryland,45,Wicomico County,0,9,-9
8,Colorado,24,Maryland,47,Worcester County,38,0,38
8,Colorado,24,Maryland,510,Baltimore city,321,263,58
8,Colorado,25,Massachusetts,1,Barnstable County,18,114,-96
8,Colorado,25,Massachusetts,3,Berkshire County,55,55,0
8,Colorado,25,Massachusetts,5,Bristol County,22,78,-56
8,Colorado,25,Massachusetts,9,Essex County,219,362,-143
8,Colorado,25,Massachusetts,11,Franklin County,8,0,8
8,Colorado,25,Massachusetts,13,Hampden County,12,113,-101
8,Colorado,25,Massachusetts,15,Hampshire County,97,38,59
8,Colorado,25,Massachusetts,17,Middlesex County,716,596,120
8,Colorado,25,Massachusetts,19,Nantucket County,60,0,60
8,Colorado,25,Massachusetts,21,Norfolk County,245,95,150
8,Colorado,25,Massachusetts,23,Plymouth County,261,21,240
8,Colorado,25,Massachusetts,25,Suffolk County,303,365,-62
8,Colorado,25,Massachusetts,27,Worcester County,147,566,-419
8,Colorado,26,Michigan,1,Alcona County,0,2,-2
8,Colorado,26,Michigan,5,Allegan County,25,7,18
8,Colorado,26,Michigan,7,Alpena County,0,4,-4
8,Colorado,26,Michigan,9,Antrim County,0,4,-4
8,Colorado,26,Michigan,15,Barry County,2,19,-17
8,Colorado,26,Michigan,17,Bay County,29,0,29
8,Colorado,26,Michigan,19,Benzie County,0,4,-4
8,Colorado,26,Michigan,21,Berrien County,26,103,-77
8,Colorado,26,Michigan,25,Calhoun County,124,12,112
8,Colorado,26,Michigan,29,Charlevoix County,12,2,10
8,Colorado,26,Michigan,31,Cheboygan County,0,4,-4
8,Colorado,26,Michigan,33,Chippewa County,0,16,-16
8,Colorado,26,Michigan,35,Clare County,0,3,-3
8,Colorado,26,Michigan,45,Eaton County,80,24,56
8,Colorado,26,Michigan,47,Emmet County,16,3,13
8,Colorado,26,Michigan,49,Genesee County,304,29,275
8,Colorado,26,Michigan,55,Grand Traverse County,30,76,-46
8,Colorado,26,Michigan,57,Gratiot County,0,2,-2
8,Colorado,26,Michigan,59,Hillsdale County,11,58,-47
8,Colorado,26,Michigan,61,Houghton County,0,33,-33
8,Colorado,26,Michigan,63,Huron County,7,0,7
8,Colorado,26,Michigan,65,Ingham County,173,98,75
8,Colorado,26,Michigan,67,Ionia County,5,45,-40
8,Colorado,26,Michigan,71,Iron County,9,6,3
8,Colorado,26,Michigan,73,Isabella County,86,26,60
8,Colorado,26,Michigan,75,Jackson County,0,14,-14
8,Colorado,26,Michigan,77,Kalamazoo County,174,58,116
8,Colorado,26,Michigan,79,Kalkaska County,0,4,-4
8,Colorado,26,Michigan,81,Kent County,344,88,256
8,Colorado,26,Michigan,87,Lapeer County,17,8,9
8,Colorado,26,Michigan,89,Leelanau County,25,18,7
8,Colorado,26,Michigan,91,Lenawee County,32,1,31
8,Colorado,26,Michigan,93,Livingston County,65,65,0
8,Colorado,26,Michigan,95,Luce County,0,6,-6
8,Colorado,26,Michigan,99,Macomb County,185,92,93
8,Colorado,26,Michigan,101,Manistee County,52,0,52
8,Colorado,26,Michigan,103,Marquette County,12,33,-21
8,Colorado,26,Michigan,105,Mason County,19,0,19
8,Colorado,26,Michigan,107,Mecosta County,0,54,-54
8,Colorado,26,Michigan,109,Menominee County,0,11,-11
8,Colorado,26,Michigan,111,Midland County,39,0,39
8,Colorado,26,Michigan,113,Missaukee County,0,5,-5
8,Colorado,26,Michigan,115,Monroe County,14,0,14
8,Colorado,26,Michigan,117,Montcalm County,0,40,-40
8,Colorado,26,Michigan,119,Montmorency County,0,37,-37
8,Colorado,26,Michigan,121,Muskegon County,57,32,25
8,Colorado,26,Michigan,123,Newaygo County,0,20,-20
8,Colorado,26,Michigan,125,Oakland County,484,283,201
8,Colorado,26,Michigan,127,Oceana County,2,6,-4
8,Colorado,26,Michigan,133,Osceola County,0,27,-27
8,Colorado,26,Michigan,137,Otsego County,10,0,10
8,Colorado,26,Michigan,139,Ottawa County,20,71,-51
8,Colorado,26,Michigan,143,Roscommon County,0,2,-2
8,Colorado,26,Michigan,145,Saginaw County,91,48,43
8,Colorado,26,Michigan,147,St. Clair County,0,62,-62
8,Colorado,26,Michigan,151,Sanilac County,0,4,-4
8,Colorado,26,Michigan,153,Schoolcraft County,52,0,52
8,Colorado,26,Michigan,155,Shiawassee County,10,71,-61
8,Colorado,26,Michigan,157,Tuscola County,5,40,-35
8,Colorado,26,Michigan,159,Van Buren County,0,31,-31
8,Colorado,26,Michigan,161,Washtenaw County,205,90,115
8,Colorado,26,Michigan,163,Wayne County,365,310,55
8,Colorado,27,Minnesota,3,Anoka County,241,149,92
8,Colorado,27,Minnesota,5,Becker County,123,33,90
8,Colorado,27,Minnesota,7,Beltrami County,0,44,-44
8,Colorado,27,Minnesota,9,Benton County,17,51,-34
8,Colorado,27,Minnesota,13,Blue Earth County,48,34,14
8,Colorado,27,Minnesota,15,Brown County,0,31,-31
8,Colorado,27,Minnesota,19,Carver County,235,96,139
8,Colorado,27,Minnesota,21,Cass County,0,53,-53
8,Colorado,27,Minnesota,23,Chippewa County,0,12,-12
8,Colorado,27,Minnesota,25,Chisago County,0,9,-9
8,Colorado,27,Minnesota,27,Clay County,37,0,37
8,Colorado,27,Minnesota,31,Cook County,12,0,12
8,Colorado,27,Minnesota,33,Cottonwood County,0,4,-4
8,Colorado,27,Minnesota,35,Crow Wing County,16,22,-6
8,Colorado,27,Minnesota,37,Dakota County,200,224,-24
8,Colorado,27,Minnesota,39,Dodge County,6,0,6
8,Colorado,27,Minnesota,41,Douglas County,9,8,1
8,Colorado,27,Minnesota,43,Faribault County,0,1,-1
8,Colorado,27,Minnesota,45,Fillmore County,0,12,-12
8,Colorado,27,Minnesota,47,Freeborn County,0,14,-14
8,Colorado,27,Minnesota,49,Goodhue County,0,18,-18
8,Colorado,27,Minnesota,51,Grant County,0,2,-2
8,Colorado,27,Minnesota,53,Hennepin County,1371,949,422
8,Colorado,27,Minnesota,55,Houston County,9,12,-3
8,Colorado,27,Minnesota,57,Hubbard County,11,37,-26
8,Colorado,27,Minnesota,59,Isanti County,122,9,113
8,Colorado,27,Minnesota,61,Itasca County,0,9,-9
8,Colorado,27,Minnesota,63,Jackson County,0,23,-23
8,Colorado,27,Minnesota,65,Kanabec County,0,8,-8
8,Colorado,27,Minnesota,67,Kandiyohi County,6,64,-58
8,Colorado,27,Minnesota,71,Koochiching County,0,73,-73
8,Colorado,27,Minnesota,79,Le Sueur County,6,0,6
8,Colorado,27,Minnesota,81,Lincoln County,0,13,-13
8,Colorado,27,Minnesota,83,Lyon County,50,0,50
8,Colorado,27,Minnesota,87,Mahnomen County,0,4,-4
8,Colorado,27,Minnesota,91,Martin County,0,52,-52
8,Colorado,27,Minnesota,93,Meeker County,0,5,-5
8,Colorado,27,Minnesota,97,Morrison County,0,9,-9
8,Colorado,27,Minnesota,99,Mower County,0,11,-11
8,Colorado,27,Minnesota,101,Murray County,9,0,9
8,Colorado,27,Minnesota,109,Olmsted County,10,78,-68
8,Colorado,27,Minnesota,111,Otter Tail County,27,20,7
8,Colorado,27,Minnesota,115,Pine County,0,23,-23
8,Colorado,27,Minnesota,119,Polk County,5,35,-30
8,Colorado,27,Minnesota,123,Ramsey County,291,357,-66
8,Colorado,27,Minnesota,129,Renville County,64,0,64
8,Colorado,27,Minnesota,131,Rice County,26,23,3
8,Colorado,27,Minnesota,137,St. Louis County,217,199,18
8,Colorado,27,Minnesota,139,Scott County,125,33,92
8,Colorado,27,Minnesota,141,Sherburne County,239,0,239
8,Colorado,27,Minnesota,145,Stearns County,130,99,31
8,Colorado,27,Minnesota,147,Steele County,4,154,-150
8,Colorado,27,Minnesota,151,Swift County,0,8,-8
8,Colorado,27,Minnesota,153,Todd County,13,1,12
8,Colorado,27,Minnesota,159,Wadena County,0,2,-2
8,Colorado,27,Minnesota,163,Washington County,217,110,107
8,Colorado,27,Minnesota,169,Winona County,190,6,184
8,Colorado,27,Minnesota,171,Wright County,106,82,24
8,Colorado,27,Minnesota,173,Yellow Medicine County,0,4,-4
8,Colorado,28,Mississippi,1,Adams County,102,0,102
8,Colorado,28,Mississippi,25,Clay County,0,18,-18
8,Colorado,28,Mississippi,33,DeSoto County,80,19,61
8,Colorado,28,Mississippi,35,Forrest County,44,0,44
8,Colorado,28,Mississippi,47,Harrison County,276,140,136
8,Colorado,28,Mississippi,49,Hinds County,0,2,-2
8,Colorado,28,Mississippi,71,Lafayette County,83,148,-65
8,Colorado,28,Mississippi,73,Lamar County,70,16,54
8,Colorado,28,Mississippi,75,Lauderdale County,6,11,-5
8,Colorado,28,Mississippi,83,Leflore County,0,3,-3
8,Colorado,28,Mississippi,87,Lowndes County,185,145,40
8,Colorado,28,Mississippi,89,Madison County,24,111,-87
8,Colorado,28,Mississippi,93,Marshall County,0,5,-5
8,Colorado,28,Mississippi,95,Monroe County,69,0,69
8,Colorado,28,Mississippi,101,Newton County,55,0,55
8,Colorado,28,Mississippi,117,Prentiss County,0,7,-7
8,Colorado,28,Mississippi,121,Rankin County,4,54,-50
8,Colorado,28,Mississippi,127,Simpson County,13,0,13
8,Colorado,28,Mississippi,149,Warren County,0,1,-1
8,Colorado,28,Mississippi,151,Washington County,49,23,26
8,Colorado,29,Missouri,1,Adair County,58,23,35
8,Colorado,29,Missouri,5,Atchison County,0,15,-15
8,Colorado,29,Missouri,7,Audrain County,0,23,-23
8,Colorado,29,Missouri,11,Barton County,0,2,-2
8,Colorado,29,Missouri,13,Bates County,2,0,2
8,Colorado,29,Missouri,19,Boone County,432,129,303
8,Colorado,29,Missouri,21,Buchanan County,71,62,9
8,Colorado,29,Missouri,23,Butler County,140,117,23
8,Colorado,29,Missouri,27,Callaway County,11,80,-69
8,Colorado,29,Missouri,29,Camden County,2,131,-129
8,Colorado,29,Missouri,31,Cape Girardeau County,50,78,-28
8,Colorado,29,Missouri,35,Carter County,0,9,-9
8,Colorado,29,Missouri,37,Cass County,7,94,-87
8,Colorado,29,Missouri,39,Cedar County,13,2,11
8,Colorado,29,Missouri,43,Christian County,124,86,38
8,Colorado,29,Missouri,45,Clark County,0,2,-2
8,Colorado,29,Missouri,47,Clay County,214,422,-208
8,Colorado,29,Missouri,51,Cole County,47,0,47
8,Colorado,29,Missouri,53,Cooper County,6,0,6
8,Colorado,29,Missouri,55,Crawford County,0,3,-3
8,Colorado,29,Missouri,57,Dade County,0,29,-29
8,Colorado,29,Missouri,61,Daviess County,0,8,-8
8,Colorado,29,Missouri,67,Douglas County,1,81,-80
8,Colorado,29,Missouri,69,Dunklin County,0,21,-21
8,Colorado,29,Missouri,71,Franklin County,17,0,17
8,Colorado,29,Missouri,77,Greene County,312,277,35
8,Colorado,29,Missouri,79,Grundy County,16,0,16
8,Colorado,29,Missouri,85,Hickory County,0,29,-29
8,Colorado,29,Missouri,87,Holt County,0,9,-9
8,Colorado,29,Missouri,93,Iron County,0,11,-11
8,Colorado,29,Missouri,95,Jackson County,1087,593,494
8,Colorado,29,Missouri,97,Jasper County,18,113,-95
8,Colorado,29,Missouri,99,Jefferson County,119,21,98
8,Colorado,29,Missouri,101,Johnson County,212,44,168
8,Colorado,29,Missouri,105,Laclede County,26,62,-36
8,Colorado,29,Missouri,109,Lawrence County,0,10,-10
8,Colorado,29,Missouri,123,Madison County,0,11,-11
8,Colorado,29,Missouri,127,Marion County,0,4,-4
8,Colorado,29,Missouri,131,Miller County,46,0,46
8,Colorado,29,Missouri,141,Morgan County,16,8,8
8,Colorado,29,Missouri,145,Newton County,0,10,-10
8,Colorado,29,Missouri,147,Nodaway County,0,11,-11
8,Colorado,29,Missouri,149,Oregon County,0,55,-55
8,Colorado,29,Missouri,159,Pettis County,25,3,22
8,Colorado,29,Missouri,161,Phelps County,19,24,-5
8,Colorado,29,Missouri,163,Pike County,0,4,-4
8,Colorado,29,Missouri,165,Platte County,54,90,-36
8,Colorado,29,Missouri,169,Pulaski County,404,185,219
8,Colorado,29,Missouri,171,Putnam County,0,2,-2
8,Colorado,29,Missouri,173,Ralls County,0,12,-12
8,Colorado,29,Missouri,175,Randolph County,0,9,-9
8,Colorado,29,Missouri,177,Ray County,81,0,81
8,Colorado,29,Missouri,183,St. Charles County,184,42,142
8,Colorado,29,Missouri,189,St. Louis County,775,448,327
8,Colorado,29,Missouri,199,Scotland County,0,18,-18
8,Colorado,29,Missouri,201,Scott County,26,8,18
8,Colorado,29,Missouri,203,Shannon County,0,26,-26
8,Colorado,29,Missouri,205,Shelby County,4,2,2
8,Colorado,29,Missouri,207,Stoddard County,0,12,-12
8,Colorado,29,Missouri,209,Stone County,170,138,32
8,Colorado,29,Missouri,213,Taney County,191,93,98
8,Colorado,29,Missouri,217,Vernon County,0,3,-3
8,Colorado,29,Missouri,219,Warren County,5,0,5
8,Colorado,29,Missouri,225,Webster County,18,18,0
8,Colorado,29,Missouri,229,Wright County,66,0,66
8,Colorado,29,Missouri,510,St. Louis city,503,240,263
8,Colorado,30,Montana,1,Beaverhead County,0,14,-14
8,Colorado,30,Montana,3,Big Horn County,19,5,14
8,Colorado,30,Montana,5,Blaine County,0,12,-12
8,Colorado,30,Montana,7,Broadwater County,0,26,-26
8,Colorado,30,Montana,9,Carbon County,0,22,-22
8,Colorado,30,Montana,11,Carter County,0,2,-2
8,Colorado,30,Montana,13,Cascade County,108,53,55
8,Colorado,30,Montana,17,Custer County,29,3,26
8,Colorado,30,Montana,21,Dawson County,0,3,-3
8,Colorado,30,Montana,23,Deer Lodge County,29,126,-97
8,Colorado,30,Montana,27,Fergus County,0,2,-2
8,Colorado,30,Montana,29,Flathead County,208,159,49
8,Colorado,30,Montana,31,Gallatin County,207,666,-459
8,Colorado,30,Montana,33,Garfield County,0,1,-1
8,Colorado,30,Montana,35,Glacier County,38,68,-30
8,Colorado,30,Montana,39,Granite County,0,12,-12
8,Colorado,30,Montana,41,Hill County,13,0,13
8,Colorado,30,Montana,43,Jefferson County,4,0,4
8,Colorado,30,Montana,47,Lake County,27,57,-30
8,Colorado,30,Montana,49,Lewis and Clark County,0,186,-186
8,Colorado,30,Montana,53,Lincoln County,0,10,-10
8,Colorado,30,Montana,55,McCone County,0,1,-1
8,Colorado,30,Montana,57,Madison County,0,12,-12
8,Colorado,30,Montana,61,Mineral County,0,10,-10
8,Colorado,30,Montana,63,Missoula County,242,276,-34
8,Colorado,30,Montana,65,Musselshell County,0,75,-75
8,Colorado,30,Montana,67,Park County,13,62,-49
8,Colorado,30,Montana,73,Pondera County,0,23,-23
8,Colorado,30,Montana,75,Powder River County,0,6,-6
8,Colorado,30,Montana,81,Ravalli County,136,65,71
8,Colorado,30,Montana,83,Richland County,0,15,-15
8,Colorado,30,Montana,85,Roosevelt County,0,11,-11
8,Colorado,30,Montana,89,Sanders County,0,6,-6
8,Colorado,30,Montana,93,Silver Bow County,48,10,38
8,Colorado,30,Montana,99,Teton County,0,22,-22
8,Colorado,30,Montana,103,Treasure County,0,5,-5
8,Colorado,30,Montana,105,Valley County,18,0,18
8,Colorado,30,Montana,111,Yellowstone County,557,226,331
8,Colorado,31,Nebraska,1,Adams County,64,207,-143
8,Colorado,31,Nebraska,3,Antelope County,0,2,-2
8,Colorado,31,Nebraska,7,Banner County,37,0,37
8,Colorado,31,Nebraska,11,Boone County,0,13,-13
8,Colorado,31,Nebraska,13,Box Butte County,10,0,10
8,Colorado,31,Nebraska,19,Buffalo County,135,170,-35
8,Colorado,31,Nebraska,21,Burt County,0,18,-18
8,Colorado,31,Nebraska,23,Butler County,51,4,47
8,Colorado,31,Nebraska,25,Cass County,90,60,30
8,Colorado,31,Nebraska,29,Chase County,0,64,-64
8,Colorado,31,Nebraska,31,Cherry County,0,15,-15
8,Colorado,31,Nebraska,33,Cheyenne County,51,115,-64
8,Colorado,31,Nebraska,35,Clay County,16,10,6
8,Colorado,31,Nebraska,37,Colfax County,0,39,-39
8,Colorado,31,Nebraska,41,Custer County,10,9,1
8,Colorado,31,Nebraska,45,Dawes County,26,101,-75
8,Colorado,31,Nebraska,47,Dawson County,0,175,-175
8,Colorado,31,Nebraska,49,Deuel County,24,41,-17
8,Colorado,31,Nebraska,53,Dodge County,0,34,-34
8,Colorado,31,Nebraska,55,Douglas County,878,587,291
8,Colorado,31,Nebraska,57,Dundy County,21,72,-51
8,Colorado,31,Nebraska,59,Fillmore County,0,8,-8
8,Colorado,31,Nebraska,61,Franklin County,0,30,-30
8,Colorado,31,Nebraska,67,Gage County,0,35,-35
8,Colorado,31,Nebraska,69,Garden County,19,57,-38
8,Colorado,31,Nebraska,73,Gosper County,0,2,-2
8,Colorado,31,Nebraska,75,Grant County,0,2,-2
8,Colorado,31,Nebraska,79,Hall County,56,59,-3
8,Colorado,31,Nebraska,81,Hamilton County,33,0,33
8,Colorado,31,Nebraska,83,Harlan County,0,2,-2
8,Colorado,31,Nebraska,87,Hitchcock County,24,34,-10
8,Colorado,31,Nebraska,89,Holt County,25,54,-29
8,Colorado,31,Nebraska,91,Hooker County,0,14,-14
8,Colorado,31,Nebraska,95,Jefferson County,40,0,40
8,Colorado,31,Nebraska,97,Johnson County,0,2,-2
8,Colorado,31,Nebraska,99,Kearney County,5,0,5
8,Colorado,31,Nebraska,101,Keith County,9,172,-163
8,Colorado,31,Nebraska,105,Kimball County,14,52,-38
8,Colorado,31,Nebraska,107,Knox County,8,36,-28
8,Colorado,31,Nebraska,109,Lancaster County,889,532,357
8,Colorado,31,Nebraska,111,Lincoln County,128,98,30
8,Colorado,31,Nebraska,113,Logan County,0,10,-10
8,Colorado,31,Nebraska,115,Loup County,0,9,-9
8,Colorado,31,Nebraska,119,Madison County,92,18,74
8,Colorado,31,Nebraska,123,Morrill County,51,26,25
8,Colorado,31,Nebraska,127,Nemaha County,14,12,2
8,Colorado,31,Nebraska,129,Nuckolls County,0,8,-8
8,Colorado,31,Nebraska,131,Otoe County,10,3,7
8,Colorado,31,Nebraska,135,Perkins County,0,91,-91
8,Colorado,31,Nebraska,137,Phelps County,103,58,45
8,Colorado,31,Nebraska,141,Platte County,9,28,-19
8,Colorado,31,Nebraska,143,Polk County,0,17,-17
8,Colorado,31,Nebraska,145,Red Willow County,93,50,43
8,Colorado,31,Nebraska,147,Richardson County,0,1,-1
8,Colorado,31,Nebraska,151,Saline County,0,14,-14
8,Colorado,31,Nebraska,153,Sarpy County,374,275,99
8,Colorado,31,Nebraska,155,Saunders County,0,2,-2
8,Colorado,31,Nebraska,157,Scotts Bluff County,233,397,-164
8,Colorado,31,Nebraska,159,Seward County,17,98,-81
8,Colorado,31,Nebraska,161,Sheridan County,24,5,19
8,Colorado,31,Nebraska,163,Sherman County,0,1,-1
8,Colorado,31,Nebraska,169,Thayer County,0,9,-9
8,Colorado,31,Nebraska,171,Thomas County,0,21,-21
8,Colorado,31,Nebraska,173,Thurston County,0,11,-11
8,Colorado,31,Nebraska,175,Valley County,0,3,-3
8,Colorado,31,Nebraska,177,Washington County,0,154,-154
8,Colorado,31,Nebraska,181,Webster County,0,26,-26
8,Colorado,31,Nebraska,185,York County,45,49,-4
8,Colorado,32,Nevada,1,Churchill County,57,0,57
8,Colorado,32,Nevada,3,Clark County,2768,3057,-289
8,Colorado,32,Nevada,5,Douglas County,6,48,-42
8,Colorado,32,Nevada,7,Elko County,41,31,10
8,Colorado,32,Nevada,13,Humboldt County,64,0,64
8,Colorado,32,Nevada,17,Lincoln County,0,17,-17
8,Colorado,32,Nevada,19,Lyon County,16,0,16
8,Colorado,32,Nevada,23,Nye County,13,96,-83
8,Colorado,32,Nevada,31,Washoe County,459,496,-37
8,Colorado,32,Nevada,33,White Pine County,61,0,61
8,Colorado,32,Nevada,510,Carson City,24,23,1
8,Colorado,33,New Hampshire,1,Belknap County,8,0,8
8,Colorado,33,New Hampshire,3,Carroll County,134,0,134
8,Colorado,33,New Hampshire,5,Cheshire County,52,54,-2
8,Colorado,33,New Hampshire,9,Grafton County,114,84,30
8,Colorado,33,New Hampshire,11,Hillsborough County,254,156,98
8,Colorado,33,New Hampshire,13,Merrimack County,46,44,2
8,Colorado,33,New Hampshire,15,Rockingham County,171,189,-18
8,Colorado,33,New Hampshire,17,Strafford County,31,8,23
8,Colorado,33,New Hampshire,19,Sullivan County,18,54,-36
8,Colorado,34,New Jersey,1,Atlantic County,18,3,15
8,Colorado,34,New Jersey,3,Bergen County,141,266,-125
8,Colorado,34,New Jersey,5,Burlington County,242,125,117
8,Colorado,34,New Jersey,7,Camden County,196,15,181
8,Colorado,34,New Jersey,9,Cape May County,0,2,-2
8,Colorado,34,New Jersey,11,Cumberland County,8,3,5
8,Colorado,34,New Jersey,13,Essex County,206,24,182
8,Colorado,34,New Jersey,15,Gloucester County,32,46,-14
8,Colorado,34,New Jersey,17,Hudson County,180,60,120
8,Colorado,34,New Jersey,19,Hunterdon County,22,0,22
8,Colorado,34,New Jersey,21,Mercer County,69,86,-17
8,Colorado,34,New Jersey,23,Middlesex County,346,79,267
8,Colorado,34,New Jersey,25,Monmouth County,196,109,87
8,Colorado,34,New Jersey,27,Morris County,413,99,314
8,Colorado,34,New Jersey,29,Ocean County,22,119,-97
8,Colorado,34,New Jersey,31,Passaic County,258,46,212
8,Colorado,34,New Jersey,33,Salem County,10,0,10
8,Colorado,34,New Jersey,35,Somerset County,162,14,148
8,Colorado,34,New Jersey,37,Sussex County,219,8,211
8,Colorado,34,New Jersey,39,Union County,56,0,56
8,Colorado,34,New Jersey,41,Warren County,15,0,15
8,Colorado,35,New Mexico,1,Bernalillo County,1661,1625,36
8,Colorado,35,New Mexico,3,Catron County,8,0,8
8,Colorado,35,New Mexico,5,Chaves County,203,116,87
8,Colorado,35,New Mexico,6,Cibola County,0,42,-42
8,Colorado,35,New Mexico,7,Colfax County,159,123,36
8,Colorado,35,New Mexico,9,Curry County,124,45,79
8,Colorado,35,New Mexico,11,De Baca County,23,2,21
8,Colorado,35,New Mexico,13,Doña Ana County,502,237,265
8,Colorado,35,New Mexico,15,Eddy County,64,84,-20
8,Colorado,35,New Mexico,17,Grant County,8,120,-112
8,Colorado,35,New Mexico,19,Guadalupe County,31,9,22
8,Colorado,35,New Mexico,23,Hidalgo County,0,29,-29
8,Colorado,35,New Mexico,25,Lea County,187,54,133
8,Colorado,35,New Mexico,27,Lincoln County,11,65,-54
8,Colorado,35,New Mexico,28,Los Alamos County,50,0,50
8,Colorado,35,New Mexico,29,Luna County,0,19,-19
8,Colorado,35,New Mexico,31,McKinley County,112,43,69
8,Colorado,35,New Mexico,33,Mora County,70,1,69
8,Colorado,35,New Mexico,35,Otero County,119,77,42
8,Colorado,35,New Mexico,37,Quay County,11,26,-15
8,Colorado,35,New Mexico,39,Rio Arriba County,145,6,139
8,Colorado,35,New Mexico,41,Roosevelt County,52,7,45
8,Colorado,35,New Mexico,43,Sandoval County,607,209,398
8,Colorado,35,New Mexico,45,San Juan County,608,673,-65
8,Colorado,35,New Mexico,47,San Miguel County,42,34,8
8,Colorado,35,New Mexico,49,Santa Fe County,649,365,284
8,Colorado,35,New Mexico,51,Sierra County,100,4,96
8,Colorado,35,New Mexico,53,Socorro County,57,43,14
8,Colorado,35,New Mexico,55,Taos County,249,146,103
8,Colorado,35,New Mexico,57,Torrance County,0,36,-36
8,Colorado,35,New Mexico,59,Union County,0,5,-5
8,Colorado,35,New Mexico,61,Valencia County,127,387,-260
8,Colorado,36,New York,1,Albany County,76,46,30
8,Colorado,36,New York,3,Allegany County,0,8,-8
8,Colorado,36,New York,5,Bronx County,261,42,219
8,Colorado,36,New York,7,Broome County,49,5,44
8,Colorado,36,New York,9,Cattaraugus County,19,13,6
8,Colorado,36,New York,11,Cayuga County,16,9,7
8,Colorado,36,New York,13,Chautauqua County,44,18,26
8,Colorado,36,New York,15,Chemung County,13,0,13
8,Colorado,36,New York,17,Chenango County,3,48,-45
8,Colorado,36,New York,21,Columbia County,30,0,30
8,Colorado,36,New York,23,Cortland County,7,0,7
8,Colorado,36,New York,27,Dutchess County,89,55,34
8,Colorado,36,New York,29,Erie County,243,87,156
8,Colorado,36,New York,31,Essex County,194,35,159
8,Colorado,36,New York,33,Franklin County,58,0,58
8,Colorado,36,New York,35,Fulton County,182,0,182
8,Colorado,36,New York,37,Genesee County,24,0,24
8,Colorado,36,New York,39,Greene County,66,0,66
8,Colorado,36,New York,43,Herkimer County,32,0,32
8,Colorado,36,New York,45,Jefferson County,314,232,82
8,Colorado,36,New York,47,Kings County,1046,345,701
8,Colorado,36,New York,51,Livingston County,213,9,204
8,Colorado,36,New York,53,Madison County,35,20,15
8,Colorado,36,New York,55,Monroe County,550,182,368
8,Colorado,36,New York,57,Montgomery County,0,13,-13
8,Colorado,36,New York,59,Nassau County,231,43,188
8,Colorado,36,New York,61,New York County,806,458,348
8,Colorado,36,New York,63,Niagara County,78,11,67
8,Colorado,36,New York,65,Oneida County,98,22,76
8,Colorado,36,New York,67,Onondaga County,318,59,259
8,Colorado,36,New York,69,Ontario County,33,23,10
8,Colorado,36,New York,71,Orange County,381,58,323
8,Colorado,36,New York,75,Oswego County,17,79,-62
8,Colorado,36,New York,77,Otsego County,108,0,108
8,Colorado,36,New York,79,Putnam County,11,6,5
8,Colorado,36,New York,81,Queens County,517,106,411
8,Colorado,36,New York,83,Rensselaer County,0,16,-16
8,Colorado,36,New York,85,Richmond County,19,63,-44
8,Colorado,36,New York,87,Rockland County,28,29,-1
8,Colorado,36,New York,89,St. Lawrence County,21,28,-7
8,Colorado,36,New York,91,Saratoga County,116,66,50
8,Colorado,36,New York,93,Schenectady County,85,16,69
8,Colorado,36,New York,95,Schoharie County,9,12,-3
8,Colorado,36,New York,99,Seneca County,27,59,-32
8,Colorado,36,New York,101,Steuben County,0,30,-30
8,Colorado,36,New York,103,Suffolk County,475,256,219
8,Colorado,36,New York,105,Sullivan County,17,0,17
8,Colorado,36,New York,107,Tioga County,5,44,-39
8,Colorado,36,New York,109,Tompkins County,87,125,-38
8,Colorado,36,New York,111,Ulster County,179,25,154
8,Colorado,36,New York,113,Warren County,15,24,-9
8,Colorado,36,New York,115,Washington County,0,5,-5
8,Colorado,36,New York,117,Wayne County,0,12,-12
8,Colorado,36,New York,119,Westchester County,493,210,283
8,Colorado,36,New York,123,Yates County,13,0,13
8,Colorado,37,North Carolina,1,Alamance County,39,23,16
8,Colorado,37,North Carolina,13,Beaufort County,127,0,127
8,Colorado,37,North Carolina,19,Brunswick County,0,54,-54
8,Colorado,37,North Carolina,21,Buncombe County,162,334,-172
8,Colorado,37,North Carolina,23,Burke County,10,23,-13
8,Colorado,37,North Carolina,25,Cabarrus County,16,114,-98
8,Colorado,37,North Carolina,27,Caldwell County,95,14,81
8,Colorado,37,North Carolina,35,Catawba County,55,0,55
8,Colorado,37,North Carolina,37,Chatham County,85,32,53
8,Colorado,37,North Carolina,45,Cleveland County,36,0,36
8,Colorado,37,North Carolina,49,Craven County,45,50,-5
8,Colorado,37,North Carolina,51,Cumberland County,793,568,225
8,Colorado,37,North Carolina,55,Dare County,0,15,-15
8,Colorado,37,North Carolina,57,Davidson County,0,158,-158
8,Colorado,37,North Carolina,63,Durham County,120,240,-120
8,Colorado,37,North Carolina,65,Edgecombe County,0,8,-8
8,Colorado,37,North Carolina,67,Forsyth County,282,109,173
8,Colorado,37,North Carolina,69,Franklin County,109,59,50
8,Colorado,37,North Carolina,71,Gaston County,25,5,20
8,Colorado,37,North Carolina,81,Guilford County,45,110,-65
8,Colorado,37,North Carolina,85,Harnett County,108,91,17
8,Colorado,37,North Carolina,87,Haywood County,0,22,-22
8,Colorado,37,North Carolina,89,Henderson County,93,279,-186
8,Colorado,37,North Carolina,93,Hoke County,363,24,339
8,Colorado,37,North Carolina,97,Iredell County,11,0,11
8,Colorado,37,North Carolina,99,Jackson County,10,89,-79
8,Colorado,37,North Carolina,101,Johnston County,0,30,-30
8,Colorado,37,North Carolina,105,Lee County,59,31,28
8,Colorado,37,North Carolina,109,Lincoln County,0,33,-33
8,Colorado,37,North Carolina,111,McDowell County,0,15,-15
8,Colorado,37,North Carolina,113,Macon County,0,48,-48
8,Colorado,37,North Carolina,115,Madison County,13,18,-5
8,Colorado,37,North Carolina,117,Martin County,0,14,-14
8,Colorado,37,North Carolina,119,Mecklenburg County,434,396,38
8,Colorado,37,North Carolina,125,Moore County,160,38,122
8,Colorado,37,North Carolina,129,New Hanover County,106,68,38
8,Colorado,37,North Carolina,133,Onslow County,237,218,19
8,Colorado,37,North Carolina,135,Orange County,142,127,15
8,Colorado,37,North Carolina,137,Pamlico County,0,2,-2
8,Colorado,37,North Carolina,139,Pasquotank County,5,0,5
8,Colorado,37,North Carolina,141,Pender County,159,23,136
8,Colorado,37,North Carolina,147,Pitt County,56,0,56
8,Colorado,37,North Carolina,149,Polk County,3,0,3
8,Colorado,37,North Carolina,151,Randolph County,12,4,8
8,Colorado,37,North Carolina,157,Rockingham County,15,0,15
8,Colorado,37,North Carolina,159,Rowan County,75,41,34
8,Colorado,37,North Carolina,169,Stokes County,0,22,-22
8,Colorado,37,North Carolina,171,Surry County,103,0,103
8,Colorado,37,North Carolina,175,Transylvania County,0,126,-126
8,Colorado,37,North Carolina,179,Union County,38,250,-212
8,Colorado,37,North Carolina,181,Vance County,6,0,6
8,Colorado,37,North Carolina,183,Wake County,1030,335,695
8,Colorado,37,North Carolina,189,Watauga County,22,20,2
8,Colorado,37,North Carolina,191,Wayne County,0,2,-2
8,Colorado,37,North Carolina,199,Yancey County,0,23,-23
8,Colorado,38,North Dakota,1,Adams County,0,15,-15
8,Colorado,38,North Dakota,3,Barnes County,18,0,18
8,Colorado,38,North Dakota,9,Bottineau County,0,22,-22
8,Colorado,38,North Dakota,15,Burleigh County,135,90,45
8,Colorado,38,North Dakota,17,Cass County,43,399,-356
8,Colorado,38,North Dakota,19,Cavalier County,0,1,-1
8,Colorado,38,North Dakota,21,Dickey County,0,4,-4
8,Colorado,38,North Dakota,31,Foster County,0,3,-3
8,Colorado,38,North Dakota,33,Golden Valley County,0,36,-36
8,Colorado,38,North Dakota,35,Grand Forks County,184,101,83
8,Colorado,38,North Dakota,37,Grant County,0,6,-6
8,Colorado,38,North Dakota,41,Hettinger County,0,6,-6
8,Colorado,38,North Dakota,45,LaMoure County,0,1,-1
8,Colorado,38,North Dakota,49,McHenry County,0,33,-33
8,Colorado,38,North Dakota,51,McIntosh County,0,8,-8
8,Colorado,38,North Dakota,53,McKenzie County,42,1,41
8,Colorado,38,North Dakota,59,Morton County,0,21,-21
8,Colorado,38,North Dakota,61,Mountrail County,15,0,15
8,Colorado,38,North Dakota,63,Nelson County,45,0,45
8,Colorado,38,North Dakota,67,Pembina County,16,0,16
8,Colorado,38,North Dakota,69,Pierce County,0,4,-4
8,Colorado,38,North Dakota,71,Ramsey County,0,1,-1
8,Colorado,38,North Dakota,89,Stark County,119,85,34
8,Colorado,38,North Dakota,93,Stutsman County,99,0,99
8,Colorado,38,North Dakota,95,Towner County,37,0,37
8,Colorado,38,North Dakota,97,Traill County,9,4,5
8,Colorado,38,North Dakota,99,Walsh County,0,9,-9
8,Colorado,38,North Dakota,101,Ward County,170,116,54
8,Colorado,38,North Dakota,103,Wells County,19,0,19
8,Colorado,38,North Dakota,105,Williams County,283,22,261
8,Colorado,39,Ohio,3,Allen County,18,47,-29
8,Colorado,39,Ohio,5,Ashland County,0,20,-20
8,Colorado,39,Ohio,7,Ashtabula County,8,0,8
8,Colorado,39,Ohio,9,Athens County,119,59,60
8,Colorado,39,Ohio,11,Auglaize County,13,7,6
8,Colorado,39,Ohio,13,Belmont County,24,34,-10
8,Colorado,39,Ohio,17,Butler County,385,145,240
8,Colorado,39,Ohio,19,Carroll County,38,32,6
8,Colorado,39,Ohio,23,Clark County,0,108,-108
8,Colorado,39,Ohio,25,Clermont County,41,0,41
8,Colorado,39,Ohio,27,Clinton County,10,0,10
8,Colorado,39,Ohio,29,Columbiana County,0,50,-50
8,Colorado,39,Ohio,31,Coshocton County,11,2,9
8,Colorado,39,Ohio,35,Cuyahoga County,538,159,379
8,Colorado,39,Ohio,41,Delaware County,76,64,12
8,Colorado,39,Ohio,43,Erie County,21,58,-37
8,Colorado,39,Ohio,45,Fairfield County,60,13,47
8,Colorado,39,Ohio,49,Franklin County,858,821,37
8,Colorado,39,Ohio,53,Gallia County,15,0,15
8,Colorado,39,Ohio,55,Geauga County,26,0,26
8,Colorado,39,Ohio,57,Greene County,138,247,-109
8,Colorado,39,Ohio,59,Guernsey County,18,0,18
8,Colorado,39,Ohio,61,Hamilton County,314,186,128
8,Colorado,39,Ohio,63,Hancock County,51,0,51
8,Colorado,39,Ohio,65,Hardin County,34,11,23
8,Colorado,39,Ohio,69,Henry County,0,2,-2
8,Colorado,39,Ohio,71,Highland County,0,43,-43
8,Colorado,39,Ohio,73,Hocking County,11,0,11
8,Colorado,39,Ohio,77,Huron County,10,0,10
8,Colorado,39,Ohio,81,Jefferson County,44,10,34
8,Colorado,39,Ohio,83,Knox County,0,11,-11
8,Colorado,39,Ohio,85,Lake County,132,11,121
8,Colorado,39,Ohio,89,Licking County,26,61,-35
8,Colorado,39,Ohio,93,Lorain County,163,108,55
8,Colorado,39,Ohio,95,Lucas County,100,59,41
8,Colorado,39,Ohio,99,Mahoning County,0,15,-15
8,Colorado,39,Ohio,103,Medina County,97,39,58
8,Colorado,39,Ohio,109,Miami County,0,133,-133
8,Colorado,39,Ohio,113,Montgomery County,273,500,-227
8,Colorado,39,Ohio,119,Muskingum County,32,20,12
8,Colorado,39,Ohio,121,Noble County,0,5,-5
8,Colorado,39,Ohio,123,Ottawa County,0,9,-9
8,Colorado,39,Ohio,125,Paulding County,0,8,-8
8,Colorado,39,Ohio,129,Pickaway County,0,9,-9
8,Colorado,39,Ohio,133,Portage County,19,4,15
8,Colorado,39,Ohio,135,Preble County,14,0,14
8,Colorado,39,Ohio,141,Ross County,18,0,18
8,Colorado,39,Ohio,145,Scioto County,46,0,46
8,Colorado,39,Ohio,149,Shelby County,8,0,8
8,Colorado,39,Ohio,151,Stark County,16,182,-166
8,Colorado,39,Ohio,153,Summit County,184,126,58
8,Colorado,39,Ohio,155,Trumbull County,10,0,10
8,Colorado,39,Ohio,157,Tuscarawas County,0,65,-65
8,Colorado,39,Ohio,159,Union County,19,17,2
8,Colorado,39,Ohio,165,Warren County,72,44,28
8,Colorado,39,Ohio,169,Wayne County,18,0,18
8,Colorado,39,Ohio,173,Wood County,63,3,60
8,Colorado,4,Arizona,1,Apache County,202,10,192
8,Colorado,4,Arizona,3,Cochise County,156,317,-161
8,Colorado,4,Arizona,5,Coconino County,459,552,-93
8,Colorado,4,Arizona,7,Gila County,79,17,62
8,Colorado,4,Arizona,9,Graham County,27,7,20
8,Colorado,4,Arizona,12,La Paz County,68,12,56
8,Colorado,4,Arizona,13,Maricopa County,5400,6776,-1376
8,Colorado,4,Arizona,15,Mohave County,389,170,219
8,Colorado,4,Arizona,17,Navajo County,56,143,-87
8,Colorado,4,Arizona,19,Pima County,1896,1795,101
8,Colorado,4,Arizona,21,Pinal County,690,598,92
8,Colorado,4,Arizona,23,Santa Cruz County,64,112,-48
8,Colorado,4,Arizona,25,Yavapai County,504,321,183
8,Colorado,4,Arizona,27,Yuma County,198,170,28
8,Colorado,40,Oklahoma,1,Adair County,0,7,-7
8,Colorado,40,Oklahoma,7,Beaver County,80,5,75
8,Colorado,40,Oklahoma,9,Beckham County,14,23,-9
8,Colorado,40,Oklahoma,11,Blaine County,0,1,-1
8,Colorado,40,Oklahoma,13,Bryan County,89,2,87
8,Colorado,40,Oklahoma,15,Caddo County,0,4,-4
8,Colorado,40,Oklahoma,17,Canadian County,380,146,234
8,Colorado,40,Oklahoma,19,Carter County,0,143,-143
8,Colorado,40,Oklahoma,21,Cherokee County,147,79,68
8,Colorado,40,Oklahoma,25,Cimarron County,0,15,-15
8,Colorado,40,Oklahoma,27,Cleveland County,396,309,87
8,Colorado,40,Oklahoma,31,Comanche County,328,255,73
8,Colorado,40,Oklahoma,35,Craig County,0,15,-15
8,Colorado,40,Oklahoma,37,Creek County,137,16,121
8,Colorado,40,Oklahoma,39,Custer County,15,10,5
8,Colorado,40,Oklahoma,41,Delaware County,0,27,-27
8,Colorado,40,Oklahoma,43,Dewey County,40,0,40
8,Colorado,40,Oklahoma,45,Ellis County,82,0,82
8,Colorado,40,Oklahoma,47,Garfield County,290,266,24
8,Colorado,40,Oklahoma,49,Garvin County,0,4,-4
8,Colorado,40,Oklahoma,51,Grady County,16,27,-11
8,Colorado,40,Oklahoma,53,Grant County,0,4,-4
8,Colorado,40,Oklahoma,57,Harmon County,0,2,-2
8,Colorado,40,Oklahoma,59,Harper County,0,14,-14
8,Colorado,40,Oklahoma,63,Hughes County,0,4,-4
8,Colorado,40,Oklahoma,65,Jackson County,0,62,-62
8,Colorado,40,Oklahoma,67,Jefferson County,0,1,-1
8,Colorado,40,Oklahoma,69,Johnston County,0,2,-2
8,Colorado,40,Oklahoma,71,Kay County,33,16,17
8,Colorado,40,Oklahoma,73,Kingfisher County,17,28,-11
8,Colorado,40,Oklahoma,75,Kiowa County,0,4,-4
8,Colorado,40,Oklahoma,77,Latimer County,0,16,-16
8,Colorado,40,Oklahoma,79,Le Flore County,0,3,-3
8,Colorado,40,Oklahoma,81,Lincoln County,0,6,-6
8,Colorado,40,Oklahoma,83,Logan County,55,96,-41
8,Colorado,40,Oklahoma,85,Love County,25,0,25
8,Colorado,40,Oklahoma,87,McClain County,259,0,259
8,Colorado,40,Oklahoma,89,McCurtain County,0,9,-9
8,Colorado,40,Oklahoma,91,McIntosh County,0,19,-19
8,Colorado,40,Oklahoma,93,Major County,0,5,-5
8,Colorado,40,Oklahoma,95,Marshall County,0,29,-29
8,Colorado,40,Oklahoma,97,Mayes County,6,1,5
8,Colorado,40,Oklahoma,99,Murray County,0,44,-44
8,Colorado,40,Oklahoma,101,Muskogee County,175,136,39
8,Colorado,40,Oklahoma,103,Noble County,0,6,-6
8,Colorado,40,Oklahoma,105,Nowata County,0,1,-1
8,Colorado,40,Oklahoma,109,Oklahoma County,827,783,44
8,Colorado,40,Oklahoma,111,Okmulgee County,0,75,-75
8,Colorado,40,Oklahoma,113,Osage County,9,0,9
8,Colorado,40,Oklahoma,115,Ottawa County,42,58,-16
8,Colorado,40,Oklahoma,117,Pawnee County,0,18,-18
8,Colorado,40,Oklahoma,119,Payne County,375,122,253
8,Colorado,40,Oklahoma,121,Pittsburg County,139,7,132
8,Colorado,40,Oklahoma,123,Pontotoc County,116,19,97
8,Colorado,40,Oklahoma,125,Pottawatomie County,0,72,-72
8,Colorado,40,Oklahoma,127,Pushmataha County,0,3,-3
8,Colorado,40,Oklahoma,129,Roger Mills County,7,1,6
8,Colorado,40,Oklahoma,131,Rogers County,33,5,28
8,Colorado,40,Oklahoma,133,Seminole County,0,19,-19
8,Colorado,40,Oklahoma,135,Sequoyah County,152,92,60
8,Colorado,40,Oklahoma,137,Stephens County,0,11,-11
8,Colorado,40,Oklahoma,139,Texas County,13,138,-125
8,Colorado,40,Oklahoma,141,Tillman County,6,3,3
8,Colorado,40,Oklahoma,143,Tulsa County,751,547,204
8,Colorado,40,Oklahoma,145,Wagoner County,82,17,65
8,Colorado,40,Oklahoma,147,Washington County,56,53,3
8,Colorado,40,Oklahoma,151,Woods County,18,62,-44
8,Colorado,40,Oklahoma,153,Woodward County,62,34,28
8,Colorado,41,Oregon,1,Baker County,0,15,-15
8,Colorado,41,Oregon,3,Benton County,32,113,-81
8,Colorado,41,Oregon,5,Clackamas County,342,138,204
8,Colorado,41,Oregon,7,Clatsop County,0,56,-56
8,Colorado,41,Oregon,9,Columbia County,50,16,34
8,Colorado,41,Oregon,11,Coos County,26,55,-29
8,Colorado,41,Oregon,13,Crook County,0,5,-5
8,Colorado,41,Oregon,17,Deschutes County,198,248,-50
8,Colorado,41,Oregon,19,Douglas County,74,135,-61
8,Colorado,41,Oregon,23,Grant County,0,17,-17
8,Colorado,41,Oregon,27,Hood River County,3,0,3
8,Colorado,41,Oregon,29,Jackson County,185,640,-455
8,Colorado,41,Oregon,31,Jefferson County,0,7,-7
8,Colorado,41,Oregon,33,Josephine County,14,44,-30
8,Colorado,41,Oregon,35,Klamath County,41,17,24
8,Colorado,41,Oregon,39,Lane County,516,478,38
8,Colorado,41,Oregon,41,Lincoln County,0,140,-140
8,Colorado,41,Oregon,43,Linn County,12,51,-39
8,Colorado,41,Oregon,45,Malheur County,0,4,-4
8,Colorado,41,Oregon,47,Marion County,82,212,-130
8,Colorado,41,Oregon,51,Multnomah County,856,947,-91
8,Colorado,41,Oregon,53,Polk County,33,61,-28
8,Colorado,41,Oregon,57,Tillamook County,9,15,-6
8,Colorado,41,Oregon,59,Umatilla County,126,15,111
8,Colorado,41,Oregon,61,Union County,4,0,4
8,Colorado,41,Oregon,63,Wallowa County,0,11,-11
8,Colorado,41,Oregon,65,Wasco County,8,33,-25
8,Colorado,41,Oregon,67,Washington County,667,560,107
8,Colorado,41,Oregon,71,Yamhill County,91,148,-57
8,Colorado,42,Pennsylvania,1,Adams County,25,46,-21
8,Colorado,42,Pennsylvania,3,Allegheny County,407,400,7
8,Colorado,42,Pennsylvania,5,Armstrong County,0,4,-4
8,Colorado,42,Pennsylvania,11,Berks County,84,32,52
8,Colorado,42,Pennsylvania,13,Blair County,32,0,32
8,Colorado,42,Pennsylvania,15,Bradford County,33,0,33
8,Colorado,42,Pennsylvania,17,Bucks County,290,267,23
8,Colorado,42,Pennsylvania,19,Butler County,31,37,-6
8,Colorado,42,Pennsylvania,21,Cambria County,0,8,-8
8,Colorado,42,Pennsylvania,23,Cameron County,21,0,21
8,Colorado,42,Pennsylvania,27,Centre County,76,34,42
8,Colorado,42,Pennsylvania,29,Chester County,209,19,190
8,Colorado,42,Pennsylvania,33,Clearfield County,0,29,-29
8,Colorado,42,Pennsylvania,35,Clinton County,8,0,8
8,Colorado,42,Pennsylvania,37,Columbia County,7,28,-21
8,Colorado,42,Pennsylvania,39,Crawford County,15,28,-13
8,Colorado,42,Pennsylvania,41,Cumberland County,141,34,107
8,Colorado,42,Pennsylvania,43,Dauphin County,108,90,18
8,Colorado,42,Pennsylvania,45,Delaware County,74,150,-76
8,Colorado,42,Pennsylvania,49,Erie County,81,3,78
8,Colorado,42,Pennsylvania,51,Fayette County,109,9,100
8,Colorado,42,Pennsylvania,53,Forest County,8,0,8
8,Colorado,42,Pennsylvania,55,Franklin County,0,1,-1
8,Colorado,42,Pennsylvania,59,Greene County,30,0,30
8,Colorado,42,Pennsylvania,61,Huntingdon County,4,0,4
8,Colorado,42,Pennsylvania,63,Indiana County,39,37,2
8,Colorado,42,Pennsylvania,65,Jefferson County,0,44,-44
8,Colorado,42,Pennsylvania,67,Juniata County,0,7,-7
8,Colorado,42,Pennsylvania,69,Lackawanna County,0,90,-90
8,Colorado,42,Pennsylvania,71,Lancaster County,48,213,-165
8,Colorado,42,Pennsylvania,73,Lawrence County,60,34,26
8,Colorado,42,Pennsylvania,75,Lebanon County,39,55,-16
8,Colorado,42,Pennsylvania,77,Lehigh County,51,34,17
8,Colorado,42,Pennsylvania,79,Luzerne County,25,0,25
8,Colorado,42,Pennsylvania,81,Lycoming County,16,82,-66
8,Colorado,42,Pennsylvania,89,Monroe County,32,19,13
8,Colorado,42,Pennsylvania,91,Montgomery County,273,278,-5
8,Colorado,42,Pennsylvania,95,Northampton County,334,119,215
8,Colorado,42,Pennsylvania,97,Northumberland County,31,0,31
8,Colorado,42,Pennsylvania,99,Perry County,14,0,14
8,Colorado,42,Pennsylvania,101,Philadelphia County,765,236,529
8,Colorado,42,Pennsylvania,105,Potter County,50,0,50
8,Colorado,42,Pennsylvania,107,Schuylkill County,39,0,39
8,Colorado,42,Pennsylvania,109,Snyder County,12,0,12
8,Colorado,42,Pennsylvania,111,Somerset County,6,0,6
8,Colorado,42,Pennsylvania,115,Susquehanna County,0,53,-53
8,Colorado,42,Pennsylvania,119,Union County,43,0,43
8,Colorado,42,Pennsylvania,121,Venango County,0,11,-11
8,Colorado,42,Pennsylvania,123,Warren County,47,28,19
8,Colorado,42,Pennsylvania,125,Washington County,316,14,302
8,Colorado,42,Pennsylvania,127,Wayne County,0,7,-7
8,Colorado,42,Pennsylvania,129,Westmoreland County,328,53,275
8,Colorado,42,Pennsylvania,131,Wyoming County,4,0,4
8,Colorado,42,Pennsylvania,133,York County,30,27,3
8,Colorado,44,Rhode Island,5,Newport County,31,116,-85
8,Colorado,44,Rhode Island,7,Providence County,240,136,104
8,Colorado,44,Rhode Island,9,Washington County,29,28,1
8,Colorado,45,South Carolina,3,Aiken County,1,30,-29
8,Colorado,45,South Carolina,7,Anderson County,2,13,-11
8,Colorado,45,South Carolina,13,Beaufort County,237,113,124
8,Colorado,45,South Carolina,15,Berkeley County,8,453,-445
8,Colorado,45,South Carolina,19,Charleston County,197,188,9
8,Colorado,45,South Carolina,25,Chesterfield County,110,0,110
8,Colorado,45,South Carolina,35,Dorchester County,9,150,-141
8,Colorado,45,South Carolina,37,Edgefield County,0,30,-30
8,Colorado,45,South Carolina,41,Florence County,31,91,-60
8,Colorado,45,South Carolina,43,Georgetown County,0,52,-52
8,Colorado,45,South Carolina,45,Greenville County,309,349,-40
8,Colorado,45,South Carolina,49,Hampton County,0,30,-30
8,Colorado,45,South Carolina,51,Horry County,30,52,-22
8,Colorado,45,South Carolina,55,Kershaw County,0,19,-19
8,Colorado,45,South Carolina,57,Lancaster County,0,50,-50
8,Colorado,45,South Carolina,59,Laurens County,0,87,-87
8,Colorado,45,South Carolina,63,Lexington County,80,62,18
8,Colorado,45,South Carolina,73,Oconee County,11,5,6
8,Colorado,45,South Carolina,75,Orangeburg County,0,42,-42
8,Colorado,45,South Carolina,77,Pickens County,69,0,69
8,Colorado,45,South Carolina,79,Richland County,513,260,253
8,Colorado,45,South Carolina,83,Spartanburg County,67,35,32
8,Colorado,45,South Carolina,85,Sumter County,82,111,-29
8,Colorado,45,South Carolina,91,York County,41,206,-165
8,Colorado,46,South Dakota,5,Beadle County,84,6,78
8,Colorado,46,South Dakota,9,Bon Homme County,0,18,-18
8,Colorado,46,South Dakota,11,Brookings County,46,0,46
8,Colorado,46,South Dakota,13,Brown County,19,17,2
8,Colorado,46,South Dakota,15,Brule County,9,0,9
8,Colorado,46,South Dakota,19,Butte County,0,65,-65
8,Colorado,46,South Dakota,23,Charles Mix County,0,2,-2
8,Colorado,46,South Dakota,25,Clark County,0,4,-4
8,Colorado,46,South Dakota,27,Clay County,25,17,8
8,Colorado,46,South Dakota,29,Codington County,0,3,-3
8,Colorado,46,South Dakota,31,Corson County,0,1,-1
8,Colorado,46,South Dakota,33,Custer County,53,5,48
8,Colorado,46,South Dakota,35,Davison County,228,20,208
8,Colorado,46,South Dakota,37,Day County,0,4,-4
8,Colorado,46,South Dakota,39,Deuel County,0,4,-4
8,Colorado,46,South Dakota,47,Fall River County,39,85,-46
8,Colorado,46,South Dakota,49,Faulk County,0,5,-5
8,Colorado,46,South Dakota,53,Gregory County,0,15,-15
8,Colorado,46,South Dakota,55,Haakon County,0,15,-15
8,Colorado,46,South Dakota,59,Hand County,12,0,12
8,Colorado,46,South Dakota,65,Hughes County,7,21,-14
8,Colorado,46,South Dakota,67,Hutchinson County,0,4,-4
8,Colorado,46,South Dakota,69,Hyde County,0,4,-4
8,Colorado,46,South Dakota,73,Jerauld County,0,8,-8
8,Colorado,46,South Dakota,79,Lake County,2,72,-70
8,Colorado,46,South Dakota,81,Lawrence County,130,139,-9
8,Colorado,46,South Dakota,83,Lincoln County,0,84,-84
8,Colorado,46,South Dakota,85,Lyman County,0,5,-5
8,Colorado,46,South Dakota,93,Meade County,28,16,12
8,Colorado,46,South Dakota,95,Mellette County,17,0,17
8,Colorado,46,South Dakota,99,Minnehaha County,255,273,-18
8,Colorado,46,South Dakota,101,Moody County,162,0,162
8,Colorado,46,South Dakota,102,Oglala Lakota County,14,0,14
8,Colorado,46,South Dakota,103,Pennington County,199,282,-83
8,Colorado,46,South Dakota,107,Potter County,0,3,-3
8,Colorado,46,South Dakota,109,Roberts County,0,3,-3
8,Colorado,46,South Dakota,115,Spink County,0,15,-15
8,Colorado,46,South Dakota,119,Sully County,0,5,-5
8,Colorado,46,South Dakota,121,Todd County,64,0,64
8,Colorado,46,South Dakota,125,Turner County,0,3,-3
8,Colorado,46,South Dakota,127,Union County,0,16,-16
8,Colorado,46,South Dakota,129,Walworth County,0,9,-9
8,Colorado,46,South Dakota,135,Yankton County,42,45,-3
8,Colorado,47,Tennessee,1,Anderson County,26,53,-27
8,Colorado,47,Tennessee,9,Blount County,32,17,15
8,Colorado,47,Tennessee,11,Bradley County,44,0,44
8,Colorado,47,Tennessee,21,Cheatham County,9,0,9
8,Colorado,47,Tennessee,23,Chester County,0,3,-3
8,Colorado,47,Tennessee,25,Claiborne County,0,17,-17
8,Colorado,47,Tennessee,29,Cocke County,82,0,82
8,Colorado,47,Tennessee,31,Coffee County,69,10,59
8,Colorado,47,Tennessee,35,Cumberland County,0,59,-59
8,Colorado,47,Tennessee,37,Davidson County,359,450,-91
8,Colorado,47,Tennessee,51,Franklin County,20,11,9
8,Colorado,47,Tennessee,55,Giles County,7,0,7
8,Colorado,47,Tennessee,57,Grainger County,0,20,-20
8,Colorado,47,Tennessee,65,Hamilton County,148,125,23
8,Colorado,47,Tennessee,73,Hawkins County,57,0,57
8,Colorado,47,Tennessee,79,Henry County,0,6,-6
8,Colorado,47,Tennessee,81,Hickman County,0,12,-12
8,Colorado,47,Tennessee,87,Jackson County,0,6,-6
8,Colorado,47,Tennessee,89,Jefferson County,0,6,-6
8,Colorado,47,Tennessee,93,Knox County,228,149,79
8,Colorado,47,Tennessee,97,Lauderdale County,0,4,-4
8,Colorado,47,Tennessee,105,Loudon County,68,24,44
8,Colorado,47,Tennessee,107,McMinn County,25,17,8
8,Colorado,47,Tennessee,113,Madison County,0,1,-1
8,Colorado,47,Tennessee,117,Marshall County,155,39,116
8,Colorado,47,Tennessee,119,Maury County,0,84,-84
8,Colorado,47,Tennessee,121,Meigs County,0,28,-28
8,Colorado,47,Tennessee,123,Monroe County,24,0,24
8,Colorado,47,Tennessee,125,Montgomery County,424,124,300
8,Colorado,47,Tennessee,131,Obion County,0,28,-28
8,Colorado,47,Tennessee,141,Putnam County,22,25,-3
8,Colorado,47,Tennessee,145,Roane County,10,8,2
8,Colorado,47,Tennessee,147,Robertson County,0,18,-18
8,Colorado,47,Tennessee,149,Rutherford County,124,22,102
8,Colorado,47,Tennessee,155,Sevier County,0,98,-98
8,Colorado,47,Tennessee,157,Shelby County,511,83,428
8,Colorado,47,Tennessee,161,Stewart County,11,0,11
8,Colorado,47,Tennessee,163,Sullivan County,12,18,-6
8,Colorado,47,Tennessee,165,Sumner County,44,215,-171
8,Colorado,47,Tennessee,167,Tipton County,70,0,70
8,Colorado,47,Tennessee,179,Washington County,15,1,14
8,Colorado,47,Tennessee,181,Wayne County,0,1,-1
8,Colorado,47,Tennessee,183,Weakley County,11,29,-18
8,Colorado,47,Tennessee,187,Williamson County,129,100,29
8,Colorado,47,Tennessee,189,Wilson County,60,35,25
8,Colorado,48,Texas,1,Anderson County,15,9,6
8,Colorado,48,Texas,3,Andrews County,0,57,-57
8,Colorado,48,Texas,5,Angelina County,16,133,-117
8,Colorado,48,Texas,7,Aransas County,21,53,-32
8,Colorado,48,Texas,15,Austin County,5,0,5
8,Colorado,48,Texas,19,Bandera County,0,9,-9
8,Colorado,48,Texas,21,Bastrop County,31,24,7
8,Colorado,48,Texas,25,Bee County,16,0,16
8,Colorado,48,Texas,27,Bell County,1117,769,348
8,Colorado,48,Texas,29,Bexar County,1306,1360,-54
8,Colorado,48,Texas,31,Blanco County,0,41,-41
8,Colorado,48,Texas,37,Bowie County,73,46,27
8,Colorado,48,Texas,39,Brazoria County,55,105,-50
8,Colorado,48,Texas,41,Brazos County,90,251,-161
8,Colorado,48,Texas,47,Brooks County,0,1,-1
8,Colorado,48,Texas,49,Brown County,33,0,33
8,Colorado,48,Texas,53,Burnet County,35,47,-12
8,Colorado,48,Texas,55,Caldwell County,12,0,12
8,Colorado,48,Texas,61,Cameron County,23,10,13
8,Colorado,48,Texas,67,Cass County,13,0,13
8,Colorado,48,Texas,73,Cherokee County,43,0,43
8,Colorado,48,Texas,75,Childress County,0,44,-44
8,Colorado,48,Texas,85,Collin County,810,427,383
8,Colorado,48,Texas,89,Colorado County,34,0,34
8,Colorado,48,Texas,91,Comal County,94,202,-108
8,Colorado,48,Texas,93,Comanche County,0,9,-9
8,Colorado,48,Texas,97,Cooke County,0,41,-41
8,Colorado,48,Texas,99,Coryell County,408,59,349
8,Colorado,48,Texas,103,Crane County,16,0,16
8,Colorado,48,Texas,111,Dallam County,2,3,-1
8,Colorado,48,Texas,113,Dallas County,2017,1208,809
8,Colorado,48,Texas,117,Deaf Smith County,113,27,86
8,Colorado,48,Texas,121,Denton County,755,797,-42
8,Colorado,48,Texas,125,Dickens County,0,2,-2
8,Colorado,48,Texas,129,Donley County,16,4,12
8,Colorado,48,Texas,135,Ector County,94,366,-272
8,Colorado,48,Texas,139,Ellis County,0,15,-15
8,Colorado,48,Texas,141,El Paso County,1567,1292,275
8,Colorado,48,Texas,143,Erath County,11,0,11
8,Colorado,48,Texas,147,Fannin County,0,103,-103
8,Colorado,48,Texas,157,Fort Bend County,421,452,-31
8,Colorado,48,Texas,163,Frio County,48,18,30
8,Colorado,48,Texas,165,Gaines County,65,27,38
8,Colorado,48,Texas,167,Galveston County,117,141,-24
8,Colorado,48,Texas,169,Garza County,0,26,-26
8,Colorado,48,Texas,175,Goliad County,0,12,-12
8,Colorado,48,Texas,181,Grayson County,22,49,-27
8,Colorado,48,Texas,183,Gregg County,128,37,91
8,Colorado,48,Texas,185,Grimes County,0,2,-2
8,Colorado,48,Texas,187,Guadalupe County,80,507,-427
8,Colorado,48,Texas,189,Hale County,6,26,-20
8,Colorado,48,Texas,191,Hall County,0,7,-7
8,Colorado,48,Texas,193,Hamilton County,4,0,4
8,Colorado,48,Texas,195,Hansford County,0,1,-1
8,Colorado,48,Texas,197,Hardeman County,127,0,127
8,Colorado,48,Texas,201,Harris County,3705,2824,881
8,Colorado,48,Texas,203,Harrison County,0,19,-19
8,Colorado,48,Texas,205,Hartley County,0,12,-12
8,Colorado,48,Texas,207,Haskell County,0,4,-4
8,Colorado,48,Texas,209,Hays County,222,240,-18
8,Colorado,48,Texas,211,Hemphill County,0,18,-18
8,Colorado,48,Texas,213,Henderson County,109,63,46
8,Colorado,48,Texas,215,Hidalgo County,104,73,31
8,Colorado,48,Texas,217,Hill County,34,13,21
8,Colorado,48,Texas,221,Hood County,78,0,78
8,Colorado,48,Texas,223,Hopkins County,0,14,-14
8,Colorado,48,Texas,225,Houston County,161,5,156
8,Colorado,48,Texas,227,Howard County,123,78,45
8,Colorado,48,Texas,229,Hudspeth County,0,12,-12
8,Colorado,48,Texas,231,Hunt County,14,10,4
8,Colorado,48,Texas,233,Hutchinson County,18,81,-63
8,Colorado,48,Texas,237,Jack County,121,0,121
8,Colorado,48,Texas,239,Jackson County,0,13,-13
8,Colorado,48,Texas,243,Jeff Davis County,0,9,-9
8,Colorado,48,Texas,245,Jefferson County,94,29,65
8,Colorado,48,Texas,251,Johnson County,40,104,-64
8,Colorado,48,Texas,253,Jones County,0,9,-9
8,Colorado,48,Texas,257,Kaufman County,46,66,-20
8,Colorado,48,Texas,259,Kendall County,0,92,-92
8,Colorado,48,Texas,265,Kerr County,90,64,26
8,Colorado,48,Texas,273,Kleberg County,7,18,-11
8,Colorado,48,Texas,275,Knox County,0,14,-14
8,Colorado,48,Texas,277,Lamar County,20,0,20
8,Colorado,48,Texas,281,Lampasas County,0,24,-24
8,Colorado,48,Texas,287,Lee County,0,20,-20
8,Colorado,48,Texas,291,Liberty County,112,22,90
8,Colorado,48,Texas,297,Live Oak County,23,0,23
8,Colorado,48,Texas,303,Lubbock County,244,654,-410
8,Colorado,48,Texas,307,McCulloch County,0,32,-32
8,Colorado,48,Texas,309,McLennan County,72,433,-361
8,Colorado,48,Texas,325,Medina County,59,0,59
8,Colorado,48,Texas,329,Midland County,390,403,-13
8,Colorado,48,Texas,339,Montgomery County,576,361,215
8,Colorado,48,Texas,341,Moore County,15,0,15
8,Colorado,48,Texas,347,Nacogdoches County,43,8,35
8,Colorado,48,Texas,349,Navarro County,41,4,37
8,Colorado,48,Texas,351,Newton County,0,16,-16
8,Colorado,48,Texas,353,Nolan County,0,20,-20
8,Colorado,48,Texas,355,Nueces County,209,282,-73
8,Colorado,48,Texas,357,Ochiltree County,131,73,58
8,Colorado,48,Texas,361,Orange County,38,36,2
8,Colorado,48,Texas,363,Palo Pinto County,0,11,-11
8,Colorado,48,Texas,365,Panola County,0,15,-15
8,Colorado,48,Texas,367,Parker County,183,45,138
8,Colorado,48,Texas,369,Parmer County,0,36,-36
8,Colorado,48,Texas,371,Pecos County,34,0,34
8,Colorado,48,Texas,373,Polk County,67,0,67
8,Colorado,48,Texas,375,Potter County,268,74,194
8,Colorado,48,Texas,381,Randall County,165,319,-154
8,Colorado,48,Texas,389,Reeves County,0,31,-31
8,Colorado,48,Texas,397,Rockwall County,116,81,35
8,Colorado,48,Texas,401,Rusk County,28,14,14
8,Colorado,48,Texas,403,Sabine County,0,11,-11
8,Colorado,48,Texas,407,San Jacinto County,0,65,-65
8,Colorado,48,Texas,409,San Patricio County,0,39,-39
8,Colorado,48,Texas,415,Scurry County,74,36,38
8,Colorado,48,Texas,423,Smith County,123,164,-41
8,Colorado,48,Texas,427,Starr County,0,11,-11
8,Colorado,48,Texas,429,Stephens County,18,45,-27
8,Colorado,48,Texas,437,Swisher County,0,2,-2
8,Colorado,48,Texas,439,Tarrant County,1683,936,747
8,Colorado,48,Texas,441,Taylor County,244,127,117
8,Colorado,48,Texas,449,Titus County,0,43,-43
8,Colorado,48,Texas,451,Tom Green County,312,313,-1
8,Colorado,48,Texas,453,Travis County,1689,1200,489
8,Colorado,48,Texas,455,Trinity County,0,14,-14
8,Colorado,48,Texas,457,Tyler County,24,0,24
8,Colorado,48,Texas,459,Upshur County,30,0,30
8,Colorado,48,Texas,461,Upton County,0,10,-10
8,Colorado,48,Texas,465,Val Verde County,46,111,-65
8,Colorado,48,Texas,467,Van Zandt County,17,47,-30
8,Colorado,48,Texas,469,Victoria County,10,26,-16
8,Colorado,48,Texas,471,Walker County,0,47,-47
8,Colorado,48,Texas,477,Washington County,25,0,25
8,Colorado,48,Texas,479,Webb County,0,39,-39
8,Colorado,48,Texas,481,Wharton County,19,0,19
8,Colorado,48,Texas,483,Wheeler County,49,0,49
8,Colorado,48,Texas,485,Wichita County,137,318,-181
8,Colorado,48,Texas,487,Wilbarger County,0,74,-74
8,Colorado,48,Texas,491,Williamson County,556,607,-51
8,Colorado,48,Texas,495,Winkler County,0,5,-5
8,Colorado,48,Texas,497,Wise County,85,12,73
8,Colorado,48,Texas,499,Wood County,0,80,-80
8,Colorado,49,Utah,3,Box Elder County,20,177,-157
8,Colorado,49,Utah,5,Cache County,124,172,-48
8,Colorado,49,Utah,7,Carbon County,41,22,19
8,Colorado,49,Utah,11,Davis County,187,307,-120
8,Colorado,49,Utah,13,Duchesne County,4,25,-21
8,Colorado,49,Utah,15,Emery County,0,25,-25
8,Colorado,49,Utah,17,Garfield County,20,0,20
8,Colorado,49,Utah,19,Grand County,109,16,93
8,Colorado,49,Utah,21,Iron County,17,43,-26
8,Colorado,49,Utah,23,Juab County,177,0,177
8,Colorado,49,Utah,25,Kane County,0,1,-1
8,Colorado,49,Utah,27,Millard County,0,115,-115
8,Colorado,49,Utah,29,Morgan County,41,14,27
8,Colorado,49,Utah,31,Piute County,10,4,6
8,Colorado,49,Utah,33,Rich County,0,14,-14
8,Colorado,49,Utah,35,Salt Lake County,1277,1513,-236
8,Colorado,49,Utah,37,San Juan County,70,1,69
8,Colorado,49,Utah,39,Sanpete County,182,166,16
8,Colorado,49,Utah,41,Sevier County,46,48,-2
8,Colorado,49,Utah,43,Summit County,203,113,90
8,Colorado,49,Utah,45,Tooele County,79,75,4
8,Colorado,49,Utah,47,Uintah County,192,271,-79
8,Colorado,49,Utah,49,Utah County,601,974,-373
8,Colorado,49,Utah,51,Wasatch County,1,29,-28
8,Colorado,49,Utah,53,Washington County,316,363,-47
8,Colorado,49,Utah,57,Weber County,327,135,192
8,Colorado,5,Arkansas,7,Benton County,155,286,-131
8,Colorado,5,Arkansas,15,Carroll County,0,30,-30
8,Colorado,5,Arkansas,19,Clark County,6,12,-6
8,Colorado,5,Arkansas,21,Clay County,0,1,-1
8,Colorado,5,Arkansas,29,Conway County,0,24,-24
8,Colorado,5,Arkansas,31,Craighead County,14,85,-71
8,Colorado,5,Arkansas,33,Crawford County,155,0,155
8,Colorado,5,Arkansas,45,Faulkner County,72,169,-97
8,Colorado,5,Arkansas,51,Garland County,19,38,-19
8,Colorado,5,Arkansas,53,Grant County,9,120,-111
8,Colorado,5,Arkansas,55,Greene County,0,50,-50
8,Colorado,5,Arkansas,57,Hempstead County,0,31,-31
8,Colorado,5,Arkansas,69,Jefferson County,5,16,-11
8,Colorado,5,Arkansas,87,Madison County,0,22,-22
8,Colorado,5,Arkansas,89,Marion County,0,20,-20
8,Colorado,5,Arkansas,91,Miller County,0,2,-2
8,Colorado,5,Arkansas,93,Mississippi County,0,4,-4
8,Colorado,5,Arkansas,97,Montgomery County,0,26,-26
8,Colorado,5,Arkansas,105,Perry County,0,4,-4
8,Colorado,5,Arkansas,115,Pope County,59,0,59
8,Colorado,5,Arkansas,117,Prairie County,0,27,-27
8,Colorado,5,Arkansas,119,Pulaski County,477,368,109
8,Colorado,5,Arkansas,123,St. Francis County,0,11,-11
8,Colorado,5,Arkansas,125,Saline County,56,110,-54
8,Colorado,5,Arkansas,131,Sebastian County,59,50,9
8,Colorado,5,Arkansas,135,Sharp County,0,97,-97
8,Colorado,5,Arkansas,141,Van Buren County,27,18,9
8,Colorado,5,Arkansas,143,Washington County,401,267,134
8,Colorado,5,Arkansas,145,White County,0,196,-196
8,Colorado,5,Arkansas,149,Yell County,0,3,-3
8,Colorado,50,Vermont,1,Addison County,0,49,-49
8,Colorado,50,Vermont,3,Bennington County,9,25,-16
8,Colorado,50,Vermont,5,Caledonia County,7,17,-10
8,Colorado,50,Vermont,7,Chittenden County,294,174,120
8,Colorado,50,Vermont,11,Franklin County,20,0,20
8,Colorado,50,Vermont,13,Grand Isle County,0,5,-5
8,Colorado,50,Vermont,15,Lamoille County,31,0,31
8,Colorado,50,Vermont,17,Orange County,26,13,13
8,Colorado,50,Vermont,19,Orleans County,7,13,-6
8,Colorado,50,Vermont,21,Rutland County,64,158,-94
8,Colorado,50,Vermont,23,Washington County,65,46,19
8,Colorado,50,Vermont,25,Windham County,83,41,42
8,Colorado,50,Vermont,27,Windsor County,51,10,41
8,Colorado,51,Virginia,1,Accomack County,7,0,7
8,Colorado,51,Virginia,3,Albemarle County,137,13,124
8,Colorado,51,Virginia,13,Arlington County,407,274,133
8,Colorado,51,Virginia,15,Augusta County,20,0,20
8,Colorado,51,Virginia,25,Brunswick County,0,7,-7
8,Colorado,51,Virginia,31,Campbell County,0,24,-24
8,Colorado,51,Virginia,41,Chesterfield County,118,92,26
8,Colorado,51,Virginia,45,Craig County,0,1,-1
8,Colorado,51,Virginia,47,Culpeper County,94,31,63
8,Colorado,51,Virginia,59,Fairfax County,1457,512,945
8,Colorado,51,Virginia,61,Fauquier County,20,0,20
8,Colorado,51,Virginia,69,Frederick County,61,14,47
8,Colorado,51,Virginia,71,Giles County,0,28,-28
8,Colorado,51,Virginia,73,Gloucester County,4,8,-4
8,Colorado,51,Virginia,75,Goochland County,0,21,-21
8,Colorado,51,Virginia,83,Halifax County,0,3,-3
8,Colorado,51,Virginia,85,Hanover County,7,0,7
8,Colorado,51,Virginia,87,Henrico County,104,28,76
8,Colorado,51,Virginia,93,Isle of Wight County,0,10,-10
8,Colorado,51,Virginia,95,James City County,32,45,-13
8,Colorado,51,Virginia,99,King George County,0,2,-2
8,Colorado,51,Virginia,105,Lee County,34,54,-20
8,Colorado,51,Virginia,107,Loudoun County,377,220,157
8,Colorado,51,Virginia,115,Mathews County,29,0,29
8,Colorado,51,Virginia,121,Montgomery County,49,23,26
8,Colorado,51,Virginia,125,Nelson County,0,52,-52
8,Colorado,51,Virginia,127,New Kent County,0,26,-26
8,Colorado,51,Virginia,137,Orange County,0,11,-11
8,Colorado,51,Virginia,139,Page County,32,0,32
8,Colorado,51,Virginia,145,Powhatan County,0,15,-15
8,Colorado,51,Virginia,147,Prince Edward County,29,0,29
8,Colorado,51,Virginia,149,Prince George County,241,108,133
8,Colorado,51,Virginia,153,Prince William County,760,149,611
8,Colorado,51,Virginia,161,Roanoke County,43,16,27
8,Colorado,51,Virginia,165,Rockingham County,5,4,1
8,Colorado,51,Virginia,169,Scott County,0,54,-54
8,Colorado,51,Virginia,171,Shenandoah County,16,3,13
8,Colorado,51,Virginia,173,Smyth County,0,7,-7
8,Colorado,51,Virginia,175,Southampton County,0,4,-4
8,Colorado,51,Virginia,177,Spotsylvania County,114,72,42
8,Colorado,51,Virginia,179,Stafford County,187,47,140
8,Colorado,51,Virginia,187,Warren County,9,0,9
8,Colorado,51,Virginia,191,Washington County,93,110,-17
8,Colorado,51,Virginia,193,Westmoreland County,0,80,-80
8,Colorado,51,Virginia,199,York County,101,85,16
8,Colorado,51,Virginia,510,Alexandria city,165,109,56
8,Colorado,51,Virginia,530,Buena Vista city,0,7,-7
8,Colorado,51,Virginia,540,Charlottesville city,26,40,-14
8,Colorado,51,Virginia,550,Chesapeake city,584,193,391
8,Colorado,51,Virginia,570,Colonial Heights city,0,33,-33
8,Colorado,51,Virginia,580,Covington city,0,188,-188
8,Colorado,51,Virginia,590,Danville city,25,0,25
8,Colorado,51,Virginia,600,Fairfax city,57,0,57
8,Colorado,51,Virginia,630,Fredericksburg city,62,38,24
8,Colorado,51,Virginia,640,Galax city,6,0,6
8,Colorado,51,Virginia,650,Hampton city,13,6,7
8,Colorado,51,Virginia,660,Harrisonburg city,30,10,20
8,Colorado,51,Virginia,678,Lexington city,26,15,11
8,Colorado,51,Virginia,680,Lynchburg city,13,12,1
8,Colorado,51,Virginia,685,Manassas Park city,59,0,59
8,Colorado,51,Virginia,700,Newport News city,224,149,75
8,Colorado,51,Virginia,710,Norfolk city,45,138,-93
8,Colorado,51,Virginia,740,Portsmouth city,0,147,-147
8,Colorado,51,Virginia,750,Radford city,159,0,159
8,Colorado,51,Virginia,760,Richmond city,225,163,62
8,Colorado,51,Virginia,770,Roanoke city,153,17,136
8,Colorado,51,Virginia,790,Staunton city,0,27,-27
8,Colorado,51,Virginia,800,Suffolk city,23,24,-1
8,Colorado,51,Virginia,810,Virginia Beach city,176,179,-3
8,Colorado,51,Virginia,830,Williamsburg city,10,5,5
8,Colorado,53,Washington,1,Adams County,0,5,-5
8,Colorado,53,Washington,3,Asotin County,0,8,-8
8,Colorado,53,Washington,5,Benton County,183,129,54
8,Colorado,53,Washington,7,Chelan County,16,0,16
8,Colorado,53,Washington,9,Clallam County,63,49,14
8,Colorado,53,Washington,11,Clark County,321,292,29
8,Colorado,53,Washington,13,Columbia County,0,3,-3
8,Colorado,53,Washington,15,Cowlitz County,20,131,-111
8,Colorado,53,Washington,17,Douglas County,33,17,16
8,Colorado,53,Washington,19,Ferry County,0,6,-6
8,Colorado,53,Washington,27,Grays Harbor County,0,14,-14
8,Colorado,53,Washington,29,Island County,26,148,-122
8,Colorado,53,Washington,31,Jefferson County,0,9,-9
8,Colorado,53,Washington,33,King County,2199,2693,-494
8,Colorado,53,Washington,35,Kitsap County,309,160,149
8,Colorado,53,Washington,37,Kittitas County,85,48,37
8,Colorado,53,Washington,41,Lewis County,53,107,-54
8,Colorado,53,Washington,45,Mason County,47,10,37
8,Colorado,53,Washington,47,Okanogan County,0,6,-6
8,Colorado,53,Washington,49,Pacific County,0,31,-31
8,Colorado,53,Washington,53,Pierce County,1452,1251,201
8,Colorado,53,Washington,55,San Juan County,10,20,-10
8,Colorado,53,Washington,57,Skagit County,140,65,75
8,Colorado,53,Washington,59,Skamania County,29,2,27
8,Colorado,53,Washington,61,Snohomish County,433,975,-542
8,Colorado,53,Washington,63,Spokane County,377,575,-198
8,Colorado,53,Washington,65,Stevens County,15,47,-32
8,Colorado,53,Washington,67,Thurston County,543,430,113
8,Colorado,53,Washington,71,Walla Walla County,0,19,-19
8,Colorado,53,Washington,73,Whatcom County,176,395,-219
8,Colorado,53,Washington,75,Whitman County,161,19,142
8,Colorado,53,Washington,77,Yakima County,53,67,-14
8,Colorado,54,West Virginia,3,Berkeley County,4,0,4
8,Colorado,54,West Virginia,11,Cabell County,18,0,18
8,Colorado,54,West Virginia,25,Greenbrier County,8,0,8
8,Colorado,54,West Virginia,31,Hardy County,0,17,-17
8,Colorado,54,West Virginia,33,Harrison County,0,78,-78
8,Colorado,54,West Virginia,35,Jackson County,0,20,-20
8,Colorado,54,West Virginia,37,Jefferson County,26,55,-29
8,Colorado,54,West Virginia,39,Kanawha County,43,0,43
8,Colorado,54,West Virginia,49,Marion County,0,50,-50
8,Colorado,54,West Virginia,61,Monongalia County,224,46,178
8,Colorado,54,West Virginia,65,Morgan County,0,21,-21
8,Colorado,54,West Virginia,67,Nicholas County,0,16,-16
8,Colorado,54,West Virginia,69,Ohio County,7,73,-66
8,Colorado,54,West Virginia,75,Pocahontas County,0,50,-50
8,Colorado,54,West Virginia,77,Preston County,38,14,24
8,Colorado,54,West Virginia,79,Putnam County,0,13,-13
8,Colorado,54,West Virginia,107,Wood County,0,5,-5
8,Colorado,55,Wisconsin,1,Adams County,0,31,-31
8,Colorado,55,Wisconsin,3,Ashland County,21,29,-8
8,Colorado,55,Wisconsin,5,Barron County,0,8,-8
8,Colorado,55,Wisconsin,7,Bayfield County,0,5,-5
8,Colorado,55,Wisconsin,9,Brown County,176,76,100
8,Colorado,55,Wisconsin,11,Buffalo County,0,12,-12
8,Colorado,55,Wisconsin,13,Burnett County,0,9,-9
8,Colorado,55,Wisconsin,15,Calumet County,27,14,13
8,Colorado,55,Wisconsin,17,Chippewa County,0,13,-13
8,Colorado,55,Wisconsin,21,Columbia County,9,130,-121
8,Colorado,55,Wisconsin,25,Dane County,755,246,509
8,Colorado,55,Wisconsin,27,Dodge County,65,12,53
8,Colorado,55,Wisconsin,29,Door County,62,0,62
8,Colorado,55,Wisconsin,31,Douglas County,0,9,-9
8,Colorado,55,Wisconsin,33,Dunn County,0,8,-8
8,Colorado,55,Wisconsin,35,Eau Claire County,35,48,-13
8,Colorado,55,Wisconsin,39,Fond du Lac County,11,4,7
8,Colorado,55,Wisconsin,43,Grant County,51,0,51
8,Colorado,55,Wisconsin,45,Green County,15,2,13
8,Colorado,55,Wisconsin,47,Green Lake County,12,0,12
8,Colorado,55,Wisconsin,49,Iowa County,98,6,92
8,Colorado,55,Wisconsin,51,Iron County,18,7,11
8,Colorado,55,Wisconsin,55,Jefferson County,0,58,-58
8,Colorado,55,Wisconsin,57,Juneau County,0,2,-2
8,Colorado,55,Wisconsin,59,Kenosha County,105,15,90
8,Colorado,55,Wisconsin,63,La Crosse County,67,26,41
8,Colorado,55,Wisconsin,69,Lincoln County,15,4,11
8,Colorado,55,Wisconsin,71,Manitowoc County,0,18,-18
8,Colorado,55,Wisconsin,73,Marathon County,0,31,-31
8,Colorado,55,Wisconsin,75,Marinette County,12,6,6
8,Colorado,55,Wisconsin,79,Milwaukee County,804,224,580
8,Colorado,55,Wisconsin,81,Monroe County,50,31,19
8,Colorado,55,Wisconsin,83,Oconto County,26,10,16
8,Colorado,55,Wisconsin,85,Oneida County,0,8,-8
8,Colorado,55,Wisconsin,87,Outagamie County,42,87,-45
8,Colorado,55,Wisconsin,89,Ozaukee County,169,32,137
8,Colorado,55,Wisconsin,91,Pepin County,22,0,22
8,Colorado,55,Wisconsin,93,Pierce County,17,72,-55
8,Colorado,55,Wisconsin,95,Polk County,29,4,25
8,Colorado,55,Wisconsin,97,Portage County,167,30,137
8,Colorado,55,Wisconsin,101,Racine County,224,96,128
8,Colorado,55,Wisconsin,103,Richland County,0,4,-4
8,Colorado,55,Wisconsin,105,Rock County,206,70,136
8,Colorado,55,Wisconsin,109,St. Croix County,3,24,-21
8,Colorado,55,Wisconsin,111,Sauk County,24,0,24
8,Colorado,55,Wisconsin,113,Sawyer County,10,0,10
8,Colorado,55,Wisconsin,115,Shawano County,8,0,8
8,Colorado,55,Wisconsin,117,Sheboygan County,31,53,-22
8,Colorado,55,Wisconsin,121,Trempealeau County,0,3,-3
8,Colorado,55,Wisconsin,123,Vernon County,0,13,-13
8,Colorado,55,Wisconsin,125,Vilas County,0,3,-3
8,Colorado,55,Wisconsin,127,Walworth County,94,107,-13
8,Colorado,55,Wisconsin,129,Washburn County,24,6,18
8,Colorado,55,Wisconsin,131,Washington County,56,29,27
8,Colorado,55,Wisconsin,133,Waukesha County,111,110,1
8,Colorado,55,Wisconsin,135,Waupaca County,0,18,-18
8,Colorado,55,Wisconsin,137,Waushara County,0,7,-7
8,Colorado,55,Wisconsin,139,Winnebago County,65,76,-11
8,Colorado,55,Wisconsin,141,Wood County,22,0,22
8,Colorado,56,Wyoming,1,Albany County,856,1328,-472
8,Colorado,56,Wyoming,3,Big Horn County,0,8,-8
8,Colorado,56,Wyoming,5,Campbell County,165,609,-444
8,Colorado,56,Wyoming,7,Carbon County,126,66,60
8,Colorado,56,Wyoming,9,Converse County,67,95,-28
8,Colorado,56,Wyoming,11,Crook County,0,18,-18
8,Colorado,56,Wyoming,13,Fremont County,153,95,58
8,Colorado,56,Wyoming,15,Goshen County,51,261,-210
8,Colorado,56,Wyoming,17,Hot Springs County,2,5,-3
8,Colorado,56,Wyoming,19,Johnson County,11,10,1
8,Colorado,56,Wyoming,21,Laramie County,1221,1168,53
8,Colorado,56,Wyoming,23,Lincoln County,90,2,88
8,Colorado,56,Wyoming,25,Natrona County,413,202,211
8,Colorado,56,Wyoming,27,Niobrara County,0,13,-13
8,Colorado,56,Wyoming,29,Park County,175,113,62
8,Colorado,56,Wyoming,31,Platte County,62,38,24
8,Colorado,56,Wyoming,33,Sheridan County,104,155,-51
8,Colorado,56,Wyoming,35,Sublette County,16,13,3
8,Colorado,56,Wyoming,37,Sweetwater County,358,225,133
8,Colorado,56,Wyoming,39,Teton County,253,191,62
8,Colorado,56,Wyoming,41,Uinta County,42,22,20
8,Colorado,56,Wyoming,43,Washakie County,7,12,-5
8,Colorado,56,Wyoming,45,Weston County,24,97,-73
8,Colorado,6,California,1,Alameda County,1373,568,805
8,Colorado,6,California,3,Alpine County,0,2,-2
8,Colorado,6,California,5,Amador County,46,54,-8
8,Colorado,6,California,7,Butte County,137,135,2
8,Colorado,6,California,13,Contra Costa County,719,463,256
8,Colorado,6,California,15,Del Norte County,21,28,-7
8,Colorado,6,California,17,El Dorado County,221,99,122
8,Colorado,6,California,19,Fresno County,170,341,-171
8,Colorado,6,California,23,Humboldt County,151,143,8
8,Colorado,6,California,25,Imperial County,18,35,-17
8,Colorado,6,California,27,Inyo County,60,9,51
8,Colorado,6,California,29,Kern County,791,587,204
8,Colorado,6,California,31,Kings County,90,45,45
8,Colorado,6,California,33,Lake County,0,19,-19
8,Colorado,6,California,35,Lassen County,8,0,8
8,Colorado,6,California,37,Los Angeles County,5173,3609,1564
8,Colorado,6,California,39,Madera County,317,8,309
8,Colorado,6,California,41,Marin County,138,277,-139
8,Colorado,6,California,43,Mariposa County,16,17,-1
8,Colorado,6,California,45,Mendocino County,0,98,-98
8,Colorado,6,California,47,Merced County,176,81,95
8,Colorado,6,California,49,Modoc County,0,58,-58
8,Colorado,6,California,51,Mono County,6,2,4
8,Colorado,6,California,53,Monterey County,462,409,53
8,Colorado,6,California,55,Napa County,133,113,20
8,Colorado,6,California,57,Nevada County,120,112,8
8,Colorado,6,California,59,Orange County,2539,1452,1087
8,Colorado,6,California,61,Placer County,552,273,279
8,Colorado,6,California,65,Riverside County,1248,686,562
8,Colorado,6,California,67,Sacramento County,735,406,329
8,Colorado,6,California,69,San Benito County,0,39,-39
8,Colorado,6,California,71,San Bernardino County,1471,1266,205
8,Colorado,6,California,73,San Diego County,3270,2947,323
8,Colorado,6,California,75,San Francisco County,955,666,289
8,Colorado,6,California,77,San Joaquin County,176,289,-113
8,Colorado,6,California,79,San Luis Obispo County,437,286,151
8,Colorado,6,California,81,San Mateo County,538,549,-11
8,Colorado,6,California,83,Santa Barbara County,674,756,-82
8,Colorado,6,California,85,Santa Clara County,1237,1102,135
8,Colorado,6,California,87,Santa Cruz County,165,133,32
8,Colorado,6,California,89,Shasta County,120,165,-45
8,Colorado,6,California,93,Siskiyou County,0,21,-21
8,Colorado,6,California,95,Solano County,418,352,66
8,Colorado,6,California,97,Sonoma County,438,274,164
8,Colorado,6,California,99,Stanislaus County,239,302,-63
8,Colorado,6,California,101,Sutter County,5,49,-44
8,Colorado,6,California,103,Tehama County,20,0,20
8,Colorado,6,California,105,Trinity County,0,12,-12
8,Colorado,6,California,107,Tulare County,116,178,-62
8,Colorado,6,California,111,Ventura County,894,424,470
8,Colorado,6,California,113,Yolo County,79,210,-131
8,Colorado,6,California,115,Yuba County,0,38,-38
8,Colorado,72,Puerto Rico,21,Bayamón Municipio,26,0,26
8,Colorado,72,Puerto Rico,31,Carolina Municipio,66,0,66
8,Colorado,72,Puerto Rico,55,Guánica Municipio,61,0,61
8,Colorado,72,Puerto Rico,61,Guaynabo Municipio,0,9,-9
8,Colorado,72,Puerto Rico,83,Las Marías Municipio,0,8,-8
8,Colorado,72,Puerto Rico,113,Ponce Municipio,5,0,5
8,Colorado,72,Puerto Rico,119,Río Grande Municipio,33,0,33
8,Colorado,72,Puerto Rico,127,San Juan Municipio,245,0,245
8,Colorado,72,Puerto Rico,139,Trujillo Alto Municipio,6,0,6
8,Colorado,72,Puerto Rico,145,Vega Baja Municipio,7,0,7
8,Colorado,8,Colorado,1,Adams County,27499,25789,1710
8,Colorado,8,Colorado,3,Alamosa County,995,1421,-426
8,Colorado,8,Colorado,5,Arapahoe County,39514,39378,136
8,Colorado,8,Colorado,7,Archuleta County,186,397,-211
8,Colorado,8,Colorado,9,Baca County,294,111,183
8,Colorado,8,Colorado,11,Bent County,347,523,-176
8,Colorado,8,Colorado,13,Boulder County,15774,14957,817
8,Colorado,8,Colorado,14,Broomfield County,4895,7380,-2485
8,Colorado,8,Colorado,15,Chaffee County,724,628,96
8,Colorado,8,Colorado,17,Cheyenne County,85,195,-110
8,Colorado,8,Colorado,19,Clear Creek County,671,785,-114
8,Colorado,8,Colorado,21,Conejos County,299,422,-123
8,Colorado,8,Colorado,23,Costilla County,39,108,-69
8,Colorado,8,Colorado,25,Crowley County,450,287,163
8,Colorado,8,Colorado,27,Custer County,425,234,191
8,Colorado,8,Colorado,29,Delta County,1793,1117,676
8,Colorado,8,Colorado,31,Denver County,51209,43684,7525
8,Colorado,8,Colorado,33,Dolores County,157,61,96
8,Colorado,8,Colorado,35,Douglas County,16069,15671,398
8,Colorado,8,Colorado,37,Eagle County,1998,1827,171
8,Colorado,8,Colorado,39,Elbert County,2047,2034,13
8,Colorado,8,Colorado,41,El Paso County,13843,14641,-798
8,Colorado,8,Colorado,43,Fremont County,2300,1425,875
8,Colorado,8,Colorado,45,Garfield County,2052,2135,-83
8,Colorado,8,Colorado,47,Gilpin County,404,480,-76
8,Colorado,8,Colorado,49,Grand County,932,763,169
8,Colorado,8,Colorado,51,Gunnison County,683,1095,-412
8,Colorado,8,Colorado,53,Hinsdale County,22,14,8
8,Colorado,8,Colorado,55,Huerfano County,292,231,61
8,Colorado,8,Colorado,57,Jackson County,119,49,70
8,Colorado,8,Colorado,59,Jefferson County,31914,28700,3214
8,Colorado,8,Colorado,61,Kiowa County,71,29,42
8,Colorado,8,Colorado,63,Kit Carson County,277,251,26
8,Colorado,8,Colorado,65,Lake County,531,424,107
8,Colorado,8,Colorado,67,La Plata County,1558,1521,37
8,Colorado,8,Colorado,69,Larimer County,12054,15420,-3366
8,Colorado,8,Colorado,71,Las Animas County,632,656,-24
8,Colorado,8,Colorado,73,Lincoln County,555,237,318
8,Colorado,8,Colorado,75,Logan County,1323,1800,-477
8,Colorado,8,Colorado,77,Mesa County,3491,5638,-2147
8,Colorado,8,Colorado,79,Mineral County,0,39,-39
8,Colorado,8,Colorado,81,Moffat County,495,579,-84
8,Colorado,8,Colorado,83,Montezuma County,697,410,287
8,Colorado,8,Colorado,85,Montrose County,1550,1644,-94
8,Colorado,8,Colorado,87,Morgan County,1053,1457,-404
8,Colorado,8,Colorado,89,Otero County,857,827,30
8,Colorado,8,Colorado,91,Ouray County,220,115,105
8,Colorado,8,Colorado,93,Park County,1090,1445,-355
8,Colorado,8,Colorado,95,Phillips County,208,265,-57
8,Colorado,8,Colorado,97,Pitkin County,665,1005,-340
8,Colorado,8,Colorado,99,Prowers County,623,365,258
8,Colorado,8,Colorado,101,Pueblo County,4291,4881,-590
8,Colorado,8,Colorado,103,Rio Blanco County,267,317,-50
8,Colorado,8,Colorado,105,Rio Grande County,827,536,291
8,Colorado,8,Colorado,107,Routt County,1246,1473,-227
8,Colorado,8,Colorado,109,Saguache County,409,97,312
8,Colorado,8,Colorado,111,San Juan County,38,20,18
8,Colorado,8,Colorado,113,San Miguel County,276,251,25
8,Colorado,8,Colorado,115,Sedgwick County,156,170,-14
8,Colorado,8,Colorado,117,Summit County,1870,1028,842
8,Colorado,8,Colorado,119,Teller County,1406,1833,-427
8,Colorado,8,Colorado,121,Washington County,108,495,-387
8,Colorado,8,Colorado,123,Weld County,11725,16655,-4930
8,Colorado,8,Colorado,125,Yuma County,327,502,-175
8,Colorado,9,Connecticut,1,Fairfield County,601,98,503
8,Colorado,9,Connecticut,3,Hartford County,257,233,24
8,Colorado,9,Connecticut,5,Litchfield County,105,6,99
8,Colorado,9,Connecticut,7,Middlesex County,133,39,94
8,Colorado,9,Connecticut,9,New Haven County,285,163,122
8,Colorado,9,Connecticut,11,New London County,210,61,149
8,Colorado,9,Connecticut,13,Tolland County,53,70,-17
8,Colorado,9,Connecticut,15,Windham County,8,0,8
8,Colorado,AFR,Africa,,-,2427,0,0
8,Colorado,ASI,Asia,,-,13664,0,0
8,Colorado,CAM,Central America,,-,5074,0,0
8,Colorado,CAR,Caribbean,,-,625,0,0
8,Colorado,EUR,Europe,,-,7029,0,0
8,Colorado,ISL,U.S. Island Areas,,-,490,0,0
8,Colorado,NAM,Northern America,,-,1229,0,0
8,Colorado,OCE,Oceania and At Sea,,-,1133,0,0
8,Colorado,SAM,South America,,-,1400,0,0
9,Connecticut,1,Alabama,1,Autauga County,27,0,27
9,Connecticut,1,Alabama,11,Bullock County,0,1,-1
9,Connecticut,1,Alabama,13,Butler County,0,8,-8
9,Connecticut,1,Alabama,31,Coffee County,0,7,-7
9,Connecticut,1,Alabama,39,Covington County,0,4,-4
9,Connecticut,1,Alabama,43,Cullman County,0,16,-16
9,Connecticut,1,Alabama,45,Dale County,18,58,-40
9,Connecticut,1,Alabama,49,DeKalb County,0,262,-262
9,Connecticut,1,Alabama,55,Etowah County,5,0,5
9,Connecticut,1,Alabama,69,Houston County,17,0,17
9,Connecticut,1,Alabama,73,Jefferson County,122,16,106
9,Connecticut,1,Alabama,81,Lee County,0,37,-37
9,Connecticut,1,Alabama,87,Macon County,0,14,-14
9,Connecticut,1,Alabama,89,Madison County,0,66,-66
9,Connecticut,1,Alabama,97,Mobile County,63,0,63
9,Connecticut,1,Alabama,101,Montgomery County,62,24,38
9,Connecticut,1,Alabama,105,Perry County,68,0,68
9,Connecticut,1,Alabama,115,St. Clair County,3,0,3
9,Connecticut,1,Alabama,123,Tallapoosa County,0,4,-4
9,Connecticut,1,Alabama,125,Tuscaloosa County,16,133,-117
9,Connecticut,1,Alabama,131,Wilcox County,7,0,7
9,Connecticut,10,Delaware,1,Kent County,0,50,-50
9,Connecticut,10,Delaware,3,New Castle County,411,301,110
9,Connecticut,10,Delaware,5,Sussex County,0,298,-298
9,Connecticut,11,District of Columbia,1,District of Columbia,383,1362,-979
9,Connecticut,12,Florida,1,Alachua County,190,91,99
9,Connecticut,12,Florida,5,Bay County,99,35,64
9,Connecticut,12,Florida,9,Brevard County,196,417,-221
9,Connecticut,12,Florida,11,Broward County,474,917,-443
9,Connecticut,12,Florida,15,Charlotte County,154,200,-46
9,Connecticut,12,Florida,17,Citrus County,85,0,85
9,Connecticut,12,Florida,19,Clay County,0,9,-9
9,Connecticut,12,Florida,21,Collier County,227,679,-452
9,Connecticut,12,Florida,27,DeSoto County,0,27,-27
9,Connecticut,12,Florida,31,Duval County,611,287,324
9,Connecticut,12,Florida,33,Escambia County,48,212,-164
9,Connecticut,12,Florida,35,Flagler County,57,251,-194
9,Connecticut,12,Florida,39,Gadsden County,72,0,72
9,Connecticut,12,Florida,53,Hernando County,102,124,-22
9,Connecticut,12,Florida,57,Hillsborough County,299,549,-250
9,Connecticut,12,Florida,61,Indian River County,75,116,-41
9,Connecticut,12,Florida,69,Lake County,81,106,-25
9,Connecticut,12,Florida,71,Lee County,304,534,-230
9,Connecticut,12,Florida,73,Leon County,168,225,-57
9,Connecticut,12,Florida,75,Levy County,8,0,8
9,Connecticut,12,Florida,81,Manatee County,45,344,-299
9,Connecticut,12,Florida,83,Marion County,148,203,-55
9,Connecticut,12,Florida,85,Martin County,120,502,-382
9,Connecticut,12,Florida,86,Miami-Dade County,446,481,-35
9,Connecticut,12,Florida,87,Monroe County,27,64,-37
9,Connecticut,12,Florida,89,Nassau County,66,0,66
9,Connecticut,12,Florida,91,Okaloosa County,0,95,-95
9,Connecticut,12,Florida,93,Okeechobee County,0,6,-6
9,Connecticut,12,Florida,95,Orange County,322,1051,-729
9,Connecticut,12,Florida,97,Osceola County,172,84,88
9,Connecticut,12,Florida,99,Palm Beach County,491,1451,-960
9,Connecticut,12,Florida,101,Pasco County,47,445,-398
9,Connecticut,12,Florida,103,Pinellas County,106,584,-478
9,Connecticut,12,Florida,105,Polk County,106,282,-176
9,Connecticut,12,Florida,107,Putnam County,0,91,-91
9,Connecticut,12,Florida,109,St. Johns County,34,150,-116
9,Connecticut,12,Florida,111,St. Lucie County,98,173,-75
9,Connecticut,12,Florida,113,Santa Rosa County,27,9,18
9,Connecticut,12,Florida,115,Sarasota County,201,768,-567
9,Connecticut,12,Florida,117,Seminole County,224,466,-242
9,Connecticut,12,Florida,119,Sumter County,27,45,-18
9,Connecticut,12,Florida,121,Suwannee County,0,31,-31
9,Connecticut,12,Florida,127,Volusia County,103,568,-465
9,Connecticut,13,Georgia,13,Barrow County,0,17,-17
9,Connecticut,13,Georgia,21,Bibb County,20,9,11
9,Connecticut,13,Georgia,29,Bryan County,11,22,-11
9,Connecticut,13,Georgia,39,Camden County,90,192,-102
9,Connecticut,13,Georgia,45,Carroll County,75,0,75
9,Connecticut,13,Georgia,49,Charlton County,24,0,24
9,Connecticut,13,Georgia,51,Chatham County,13,109,-96
9,Connecticut,13,Georgia,53,Chattahoochee County,0,40,-40
9,Connecticut,13,Georgia,57,Cherokee County,15,66,-51
9,Connecticut,13,Georgia,59,Clarke County,0,34,-34
9,Connecticut,13,Georgia,63,Clayton County,16,150,-134
9,Connecticut,13,Georgia,67,Cobb County,101,309,-208
9,Connecticut,13,Georgia,73,Columbia County,42,0,42
9,Connecticut,13,Georgia,77,Coweta County,0,19,-19
9,Connecticut,13,Georgia,87,Decatur County,0,9,-9
9,Connecticut,13,Georgia,89,DeKalb County,127,108,19
9,Connecticut,13,Georgia,97,Douglas County,0,197,-197
9,Connecticut,13,Georgia,103,Effingham County,13,0,13
9,Connecticut,13,Georgia,113,Fayette County,0,184,-184
9,Connecticut,13,Georgia,115,Floyd County,6,0,6
9,Connecticut,13,Georgia,117,Forsyth County,0,66,-66
9,Connecticut,13,Georgia,121,Fulton County,524,621,-97
9,Connecticut,13,Georgia,127,Glynn County,0,44,-44
9,Connecticut,13,Georgia,135,Gwinnett County,136,391,-255
9,Connecticut,13,Georgia,137,Habersham County,0,3,-3
9,Connecticut,13,Georgia,145,Harris County,20,0,20
9,Connecticut,13,Georgia,151,Henry County,0,28,-28
9,Connecticut,13,Georgia,153,Houston County,87,0,87
9,Connecticut,13,Georgia,175,Laurens County,0,98,-98
9,Connecticut,13,Georgia,179,Liberty County,26,47,-21
9,Connecticut,13,Georgia,181,Lincoln County,28,0,28
9,Connecticut,13,Georgia,189,McDuffie County,48,0,48
9,Connecticut,13,Georgia,205,Mitchell County,5,0,5
9,Connecticut,13,Georgia,215,Muscogee County,45,264,-219
9,Connecticut,13,Georgia,217,Newton County,26,9,17
9,Connecticut,13,Georgia,225,Peach County,9,7,2
9,Connecticut,13,Georgia,245,Richmond County,32,131,-99
9,Connecticut,13,Georgia,247,Rockdale County,0,339,-339
9,Connecticut,13,Georgia,261,Sumter County,6,11,-5
9,Connecticut,13,Georgia,281,Towns County,0,2,-2
9,Connecticut,13,Georgia,297,Walton County,0,66,-66
9,Connecticut,13,Georgia,317,Wilkes County,0,9,-9
9,Connecticut,13,Georgia,319,Wilkinson County,0,2,-2
9,Connecticut,15,Hawaii,1,Hawaii County,30,8,22
9,Connecticut,15,Hawaii,3,Honolulu County,419,413,6
9,Connecticut,15,Hawaii,7,Kauai County,0,13,-13
9,Connecticut,16,Idaho,1,Ada County,0,24,-24
9,Connecticut,16,Idaho,13,Blaine County,11,0,11
9,Connecticut,16,Idaho,15,Boise County,0,4,-4
9,Connecticut,16,Idaho,55,Kootenai County,0,10,-10
9,Connecticut,16,Idaho,65,Madison County,0,11,-11
9,Connecticut,16,Idaho,71,Oneida County,0,10,-10
9,Connecticut,17,Illinois,5,Bond County,16,0,16
9,Connecticut,17,Illinois,19,Champaign County,44,17,27
9,Connecticut,17,Illinois,21,Christian County,0,1,-1
9,Connecticut,17,Illinois,27,Clinton County,9,0,9
9,Connecticut,17,Illinois,31,Cook County,943,903,40
9,Connecticut,17,Illinois,37,DeKalb County,0,13,-13
9,Connecticut,17,Illinois,43,DuPage County,234,150,84
9,Connecticut,17,Illinois,77,Jackson County,0,15,-15
9,Connecticut,17,Illinois,81,Jefferson County,0,17,-17
9,Connecticut,17,Illinois,85,Jo Daviess County,0,5,-5
9,Connecticut,17,Illinois,89,Kane County,26,0,26
9,Connecticut,17,Illinois,97,Lake County,182,224,-42
9,Connecticut,17,Illinois,99,LaSalle County,0,24,-24
9,Connecticut,17,Illinois,103,Lee County,0,5,-5
9,Connecticut,17,Illinois,111,McHenry County,5,0,5
9,Connecticut,17,Illinois,113,McLean County,21,27,-6
9,Connecticut,17,Illinois,119,Madison County,0,5,-5
9,Connecticut,17,Illinois,141,Ogle County,0,4,-4
9,Connecticut,17,Illinois,161,Rock Island County,0,9,-9
9,Connecticut,17,Illinois,163,St. Clair County,16,0,16
9,Connecticut,17,Illinois,167,Sangamon County,34,8,26
9,Connecticut,17,Illinois,187,Warren County,0,6,-6
9,Connecticut,17,Illinois,197,Will County,36,40,-4
9,Connecticut,17,Illinois,201,Winnebago County,51,110,-59
9,Connecticut,18,Indiana,3,Allen County,0,73,-73
9,Connecticut,18,Indiana,5,Bartholomew County,38,0,38
9,Connecticut,18,Indiana,17,Cass County,13,0,13
9,Connecticut,18,Indiana,27,Daviess County,0,51,-51
9,Connecticut,18,Indiana,45,Fountain County,32,0,32
9,Connecticut,18,Indiana,49,Fulton County,28,0,28
9,Connecticut,18,Indiana,57,Hamilton County,71,0,71
9,Connecticut,18,Indiana,61,Harrison County,0,32,-32
9,Connecticut,18,Indiana,63,Hendricks County,21,0,21
9,Connecticut,18,Indiana,67,Howard County,44,0,44
9,Connecticut,18,Indiana,69,Huntington County,0,8,-8
9,Connecticut,18,Indiana,81,Johnson County,0,16,-16
9,Connecticut,18,Indiana,89,Lake County,15,0,15
9,Connecticut,18,Indiana,91,LaPorte County,0,6,-6
9,Connecticut,18,Indiana,97,Marion County,48,202,-154
9,Connecticut,18,Indiana,105,Monroe County,0,74,-74
9,Connecticut,18,Indiana,133,Putnam County,6,0,6
9,Connecticut,18,Indiana,141,St. Joseph County,9,129,-120
9,Connecticut,18,Indiana,157,Tippecanoe County,84,65,19
9,Connecticut,18,Indiana,163,Vanderburgh County,59,90,-31
9,Connecticut,18,Indiana,177,Wayne County,0,7,-7
9,Connecticut,19,Iowa,27,Carroll County,0,16,-16
9,Connecticut,19,Iowa,45,Clinton County,43,0,43
9,Connecticut,19,Iowa,61,Dubuque County,11,8,3
9,Connecticut,19,Iowa,75,Grundy County,0,2,-2
9,Connecticut,19,Iowa,85,Harrison County,0,4,-4
9,Connecticut,19,Iowa,103,Johnson County,16,42,-26
9,Connecticut,19,Iowa,109,Kossuth County,0,5,-5
9,Connecticut,19,Iowa,153,Polk County,36,44,-8
9,Connecticut,19,Iowa,157,Poweshiek County,0,15,-15
9,Connecticut,19,Iowa,163,Scott County,0,11,-11
9,Connecticut,19,Iowa,167,Sioux County,0,8,-8
9,Connecticut,19,Iowa,169,Story County,14,11,3
9,Connecticut,19,Iowa,187,Webster County,0,7,-7
9,Connecticut,2,Alaska,20,Anchorage Municipality,827,44,783
9,Connecticut,2,Alaska,122,Kenai Peninsula Borough,36,11,25
9,Connecticut,2,Alaska,150,Kodiak Island Borough,11,0,11
9,Connecticut,2,Alaska,180,Nome Census Area,0,4,-4
9,Connecticut,2,Alaska,185,North Slope Borough,0,1,-1
9,Connecticut,2,Alaska,220,Sitka City and Borough,0,6,-6
9,Connecticut,20,Kansas,11,Bourbon County,0,5,-5
9,Connecticut,20,Kansas,45,Douglas County,85,0,85
9,Connecticut,20,Kansas,51,Ellis County,0,48,-48
9,Connecticut,20,Kansas,61,Geary County,0,4,-4
9,Connecticut,20,Kansas,79,Harvey County,0,81,-81
9,Connecticut,20,Kansas,83,Hodgeman County,0,5,-5
9,Connecticut,20,Kansas,91,Johnson County,27,47,-20
9,Connecticut,20,Kansas,99,Labette County,0,6,-6
9,Connecticut,20,Kansas,161,Riley County,8,15,-7
9,Connecticut,20,Kansas,173,Sedgwick County,20,86,-66
9,Connecticut,20,Kansas,177,Shawnee County,0,63,-63
9,Connecticut,21,Kentucky,3,Allen County,31,0,31
9,Connecticut,21,Kentucky,9,Barren County,0,18,-18
9,Connecticut,21,Kentucky,17,Bourbon County,0,24,-24
9,Connecticut,21,Kentucky,29,Bullitt County,0,35,-35
9,Connecticut,21,Kentucky,43,Carter County,23,0,23
9,Connecticut,21,Kentucky,47,Christian County,8,38,-30
9,Connecticut,21,Kentucky,67,Fayette County,0,45,-45
9,Connecticut,21,Kentucky,93,Hardin County,150,19,131
9,Connecticut,21,Kentucky,111,Jefferson County,26,84,-58
9,Connecticut,21,Kentucky,113,Jessamine County,0,8,-8
9,Connecticut,21,Kentucky,117,Kenton County,0,47,-47
9,Connecticut,21,Kentucky,151,Madison County,8,0,8
9,Connecticut,21,Kentucky,163,Meade County,8,0,8
9,Connecticut,21,Kentucky,167,Mercer County,0,14,-14
9,Connecticut,21,Kentucky,169,Metcalfe County,0,15,-15
9,Connecticut,21,Kentucky,225,Union County,0,17,-17
9,Connecticut,21,Kentucky,227,Warren County,0,9,-9
9,Connecticut,22,Louisiana,9,Avoyelles Parish,2,0,2
9,Connecticut,22,Louisiana,19,Calcasieu Parish,0,32,-32
9,Connecticut,22,Louisiana,33,East Baton Rouge Parish,24,38,-14
9,Connecticut,22,Louisiana,43,Grant Parish,8,0,8
9,Connecticut,22,Louisiana,51,Jefferson Parish,0,27,-27
9,Connecticut,22,Louisiana,55,Lafayette Parish,35,0,35
9,Connecticut,22,Louisiana,71,Orleans Parish,152,138,14
9,Connecticut,22,Louisiana,103,St. Tammany Parish,6,12,-6
9,Connecticut,22,Louisiana,105,Tangipahoa Parish,9,16,-7
9,Connecticut,22,Louisiana,109,Terrebonne Parish,0,30,-30
9,Connecticut,22,Louisiana,115,Vernon Parish,34,0,34
9,Connecticut,23,Maine,1,Androscoggin County,37,122,-85
9,Connecticut,23,Maine,3,Aroostook County,72,108,-36
9,Connecticut,23,Maine,5,Cumberland County,407,503,-96
9,Connecticut,23,Maine,7,Franklin County,16,44,-28
9,Connecticut,23,Maine,9,Hancock County,9,146,-137
9,Connecticut,23,Maine,11,Kennebec County,151,128,23
9,Connecticut,23,Maine,13,Knox County,8,56,-48
9,Connecticut,23,Maine,15,Lincoln County,39,26,13
9,Connecticut,23,Maine,17,Oxford County,8,19,-11
9,Connecticut,23,Maine,19,Penobscot County,37,268,-231
9,Connecticut,23,Maine,21,Piscataquis County,1,0,1
9,Connecticut,23,Maine,23,Sagadahoc County,20,0,20
9,Connecticut,23,Maine,25,Somerset County,0,33,-33
9,Connecticut,23,Maine,27,Waldo County,23,41,-18
9,Connecticut,23,Maine,31,York County,42,317,-275
9,Connecticut,24,Maryland,1,Allegany County,0,17,-17
9,Connecticut,24,Maryland,3,Anne Arundel County,179,171,8
9,Connecticut,24,Maryland,5,Baltimore County,72,123,-51
9,Connecticut,24,Maryland,9,Calvert County,33,0,33
9,Connecticut,24,Maryland,13,Carroll County,47,35,12
9,Connecticut,24,Maryland,15,Cecil County,38,4,34
9,Connecticut,24,Maryland,21,Frederick County,129,22,107
9,Connecticut,24,Maryland,23,Garrett County,0,16,-16
9,Connecticut,24,Maryland,25,Harford County,0,10,-10
9,Connecticut,24,Maryland,27,Howard County,120,140,-20
9,Connecticut,24,Maryland,29,Kent County,0,29,-29
9,Connecticut,24,Maryland,31,Montgomery County,147,336,-189
9,Connecticut,24,Maryland,33,Prince George's County,188,176,12
9,Connecticut,24,Maryland,35,Queen Anne's County,47,0,47
9,Connecticut,24,Maryland,37,St. Mary's County,62,0,62
9,Connecticut,24,Maryland,41,Talbot County,0,25,-25
9,Connecticut,24,Maryland,43,Washington County,33,0,33
9,Connecticut,24,Maryland,45,Wicomico County,7,21,-14
9,Connecticut,24,Maryland,47,Worcester County,31,23,8
9,Connecticut,24,Maryland,510,Baltimore city,284,248,36
9,Connecticut,25,Massachusetts,1,Barnstable County,258,246,12
9,Connecticut,25,Massachusetts,3,Berkshire County,268,209,59
9,Connecticut,25,Massachusetts,5,Bristol County,162,271,-109
9,Connecticut,25,Massachusetts,7,Dukes County,9,11,-2
9,Connecticut,25,Massachusetts,9,Essex County,338,606,-268
9,Connecticut,25,Massachusetts,11,Franklin County,108,81,27
9,Connecticut,25,Massachusetts,13,Hampden County,2515,1753,762
9,Connecticut,25,Massachusetts,15,Hampshire County,247,690,-443
9,Connecticut,25,Massachusetts,17,Middlesex County,1065,2120,-1055
9,Connecticut,25,Massachusetts,19,Nantucket County,23,20,3
9,Connecticut,25,Massachusetts,21,Norfolk County,1136,753,383
9,Connecticut,25,Massachusetts,23,Plymouth County,262,314,-52
9,Connecticut,25,Massachusetts,25,Suffolk County,1224,2038,-814
9,Connecticut,25,Massachusetts,27,Worcester County,1378,1169,209
9,Connecticut,26,Michigan,9,Antrim County,0,12,-12
9,Connecticut,26,Michigan,17,Bay County,14,0,14
9,Connecticut,26,Michigan,19,Benzie County,0,5,-5
9,Connecticut,26,Michigan,21,Berrien County,0,26,-26
9,Connecticut,26,Michigan,23,Branch County,0,7,-7
9,Connecticut,26,Michigan,25,Calhoun County,11,0,11
9,Connecticut,26,Michigan,37,Clinton County,0,79,-79
9,Connecticut,26,Michigan,45,Eaton County,31,0,31
9,Connecticut,26,Michigan,49,Genesee County,13,10,3
9,Connecticut,26,Michigan,55,Grand Traverse County,0,4,-4
9,Connecticut,26,Michigan,59,Hillsdale County,0,4,-4
9,Connecticut,26,Michigan,65,Ingham County,29,66,-37
9,Connecticut,26,Michigan,81,Kent County,27,54,-27
9,Connecticut,26,Michigan,85,Lake County,0,6,-6
9,Connecticut,26,Michigan,87,Lapeer County,6,0,6
9,Connecticut,26,Michigan,91,Lenawee County,11,0,11
9,Connecticut,26,Michigan,93,Livingston County,7,10,-3
9,Connecticut,26,Michigan,105,Mason County,0,8,-8
9,Connecticut,26,Michigan,111,Midland County,0,10,-10
9,Connecticut,26,Michigan,115,Monroe County,7,0,7
9,Connecticut,26,Michigan,119,Montmorency County,0,3,-3
9,Connecticut,26,Michigan,121,Muskegon County,8,106,-98
9,Connecticut,26,Michigan,125,Oakland County,105,170,-65
9,Connecticut,26,Michigan,137,Otsego County,0,14,-14
9,Connecticut,26,Michigan,139,Ottawa County,19,6,13
9,Connecticut,26,Michigan,147,St. Clair County,0,54,-54
9,Connecticut,26,Michigan,161,Washtenaw County,172,321,-149
9,Connecticut,26,Michigan,163,Wayne County,50,62,-12
9,Connecticut,27,Minnesota,3,Anoka County,34,0,34
9,Connecticut,27,Minnesota,7,Beltrami County,0,6,-6
9,Connecticut,27,Minnesota,19,Carver County,39,36,3
9,Connecticut,27,Minnesota,35,Crow Wing County,10,0,10
9,Connecticut,27,Minnesota,37,Dakota County,63,16,47
9,Connecticut,27,Minnesota,53,Hennepin County,117,363,-246
9,Connecticut,27,Minnesota,61,Itasca County,16,0,16
9,Connecticut,27,Minnesota,67,Kandiyohi County,16,0,16
9,Connecticut,27,Minnesota,109,Olmsted County,15,11,4
9,Connecticut,27,Minnesota,111,Otter Tail County,0,6,-6
9,Connecticut,27,Minnesota,123,Ramsey County,66,8,58
9,Connecticut,27,Minnesota,131,Rice County,34,38,-4
9,Connecticut,27,Minnesota,137,St. Louis County,46,0,46
9,Connecticut,27,Minnesota,139,Scott County,94,0,94
9,Connecticut,27,Minnesota,141,Sherburne County,0,30,-30
9,Connecticut,27,Minnesota,145,Stearns County,0,2,-2
9,Connecticut,27,Minnesota,149,Stevens County,0,15,-15
9,Connecticut,27,Minnesota,163,Washington County,14,0,14
9,Connecticut,27,Minnesota,169,Winona County,0,8,-8
9,Connecticut,28,Mississippi,1,Adams County,13,0,13
9,Connecticut,28,Mississippi,19,Choctaw County,0,8,-8
9,Connecticut,28,Mississippi,33,DeSoto County,0,22,-22
9,Connecticut,28,Mississippi,47,Harrison County,0,16,-16
9,Connecticut,28,Mississippi,49,Hinds County,0,9,-9
9,Connecticut,28,Mississippi,59,Jackson County,0,21,-21
9,Connecticut,28,Mississippi,71,Lafayette County,0,38,-38
9,Connecticut,28,Mississippi,105,Oktibbeha County,24,0,24
9,Connecticut,28,Mississippi,109,Pearl River County,0,5,-5
9,Connecticut,28,Mississippi,133,Sunflower County,5,0,5
9,Connecticut,28,Mississippi,147,Walthall County,12,0,12
9,Connecticut,29,Missouri,7,Audrain County,0,4,-4
9,Connecticut,29,Missouri,19,Boone County,0,11,-11
9,Connecticut,29,Missouri,21,Buchanan County,55,5,50
9,Connecticut,29,Missouri,29,Camden County,41,0,41
9,Connecticut,29,Missouri,47,Clay County,10,0,10
9,Connecticut,29,Missouri,63,DeKalb County,11,0,11
9,Connecticut,29,Missouri,77,Greene County,35,19,16
9,Connecticut,29,Missouri,95,Jackson County,37,47,-10
9,Connecticut,29,Missouri,101,Johnson County,41,0,41
9,Connecticut,29,Missouri,141,Morgan County,11,0,11
9,Connecticut,29,Missouri,147,Nodaway County,8,0,8
9,Connecticut,29,Missouri,165,Platte County,39,0,39
9,Connecticut,29,Missouri,169,Pulaski County,0,104,-104
9,Connecticut,29,Missouri,183,St. Charles County,10,16,-6
9,Connecticut,29,Missouri,189,St. Louis County,249,150,99
9,Connecticut,29,Missouri,217,Vernon County,10,0,10
9,Connecticut,29,Missouri,219,Warren County,0,7,-7
9,Connecticut,29,Missouri,510,St. Louis city,154,41,113
9,Connecticut,30,Montana,31,Gallatin County,0,15,-15
9,Connecticut,30,Montana,111,Yellowstone County,11,0,11
9,Connecticut,31,Nebraska,35,Clay County,0,2,-2
9,Connecticut,31,Nebraska,53,Dodge County,0,17,-17
9,Connecticut,31,Nebraska,55,Douglas County,39,167,-128
9,Connecticut,31,Nebraska,109,Lancaster County,0,19,-19
9,Connecticut,31,Nebraska,111,Lincoln County,0,3,-3
9,Connecticut,31,Nebraska,153,Sarpy County,0,45,-45
9,Connecticut,32,Nevada,3,Clark County,214,509,-295
9,Connecticut,32,Nevada,31,Washoe County,14,247,-233
9,Connecticut,33,New Hampshire,1,Belknap County,32,87,-55
9,Connecticut,33,New Hampshire,3,Carroll County,104,37,67
9,Connecticut,33,New Hampshire,5,Cheshire County,140,434,-294
9,Connecticut,33,New Hampshire,7,Coos County,25,75,-50
9,Connecticut,33,New Hampshire,9,Grafton County,55,290,-235
9,Connecticut,33,New Hampshire,11,Hillsborough County,309,301,8
9,Connecticut,33,New Hampshire,13,Merrimack County,161,218,-57
9,Connecticut,33,New Hampshire,15,Rockingham County,243,630,-387
9,Connecticut,33,New Hampshire,17,Strafford County,128,352,-224
9,Connecticut,33,New Hampshire,19,Sullivan County,45,24,21
9,Connecticut,34,New Jersey,1,Atlantic County,55,28,27
9,Connecticut,34,New Jersey,3,Bergen County,836,227,609
9,Connecticut,34,New Jersey,5,Burlington County,313,48,265
9,Connecticut,34,New Jersey,7,Camden County,158,201,-43
9,Connecticut,34,New Jersey,9,Cape May County,85,4,81
9,Connecticut,34,New Jersey,11,Cumberland County,6,20,-14
9,Connecticut,34,New Jersey,13,Essex County,200,471,-271
9,Connecticut,34,New Jersey,15,Gloucester County,32,12,20
9,Connecticut,34,New Jersey,17,Hudson County,679,361,318
9,Connecticut,34,New Jersey,19,Hunterdon County,61,53,8
9,Connecticut,34,New Jersey,21,Mercer County,259,358,-99
9,Connecticut,34,New Jersey,23,Middlesex County,429,341,88
9,Connecticut,34,New Jersey,25,Monmouth County,233,55,178
9,Connecticut,34,New Jersey,27,Morris County,248,360,-112
9,Connecticut,34,New Jersey,29,Ocean County,177,111,66
9,Connecticut,34,New Jersey,31,Passaic County,371,59,312
9,Connecticut,34,New Jersey,35,Somerset County,129,154,-25
9,Connecticut,34,New Jersey,37,Sussex County,130,104,26
9,Connecticut,34,New Jersey,39,Union County,394,100,294
9,Connecticut,34,New Jersey,41,Warren County,96,138,-42
9,Connecticut,35,New Mexico,1,Bernalillo County,120,180,-60
9,Connecticut,35,New Mexico,5,Chaves County,34,0,34
9,Connecticut,35,New Mexico,9,Curry County,0,21,-21
9,Connecticut,35,New Mexico,13,Doña Ana County,0,12,-12
9,Connecticut,35,New Mexico,43,Sandoval County,52,0,52
9,Connecticut,35,New Mexico,49,Santa Fe County,11,39,-28
9,Connecticut,35,New Mexico,55,Taos County,0,27,-27
9,Connecticut,36,New York,1,Albany County,174,164,10
9,Connecticut,36,New York,3,Allegany County,14,0,14
9,Connecticut,36,New York,5,Bronx County,2962,690,2272
9,Connecticut,36,New York,7,Broome County,96,52,44
9,Connecticut,36,New York,9,Cattaraugus County,0,31,-31
9,Connecticut,36,New York,11,Cayuga County,0,39,-39
9,Connecticut,36,New York,13,Chautauqua County,0,34,-34
9,Connecticut,36,New York,15,Chemung County,33,21,12
9,Connecticut,36,New York,17,Chenango County,0,5,-5
9,Connecticut,36,New York,19,Clinton County,44,120,-76
9,Connecticut,36,New York,21,Columbia County,32,25,7
9,Connecticut,36,New York,23,Cortland County,32,0,32
9,Connecticut,36,New York,27,Dutchess County,849,695,154
9,Connecticut,36,New York,29,Erie County,313,294,19
9,Connecticut,36,New York,31,Essex County,82,50,32
9,Connecticut,36,New York,33,Franklin County,4,97,-93
9,Connecticut,36,New York,35,Fulton County,48,8,40
9,Connecticut,36,New York,37,Genesee County,25,1,24
9,Connecticut,36,New York,39,Greene County,0,8,-8
9,Connecticut,36,New York,41,Hamilton County,0,14,-14
9,Connecticut,36,New York,43,Herkimer County,0,8,-8
9,Connecticut,36,New York,45,Jefferson County,177,25,152
9,Connecticut,36,New York,47,Kings County,2866,1304,1562
9,Connecticut,36,New York,49,Lewis County,14,0,14
9,Connecticut,36,New York,51,Livingston County,0,20,-20
9,Connecticut,36,New York,53,Madison County,148,33,115
9,Connecticut,36,New York,55,Monroe County,323,393,-70
9,Connecticut,36,New York,57,Montgomery County,4,21,-17
9,Connecticut,36,New York,59,Nassau County,1085,559,526
9,Connecticut,36,New York,61,New York County,4086,3137,949
9,Connecticut,36,New York,63,Niagara County,0,10,-10
9,Connecticut,36,New York,65,Oneida County,128,102,26
9,Connecticut,36,New York,67,Onondaga County,294,462,-168
9,Connecticut,36,New York,69,Ontario County,11,152,-141
9,Connecticut,36,New York,71,Orange County,277,98,179
9,Connecticut,36,New York,75,Oswego County,0,9,-9
9,Connecticut,36,New York,77,Otsego County,32,15,17
9,Connecticut,36,New York,79,Putnam County,545,147,398
9,Connecticut,36,New York,81,Queens County,1389,938,451
9,Connecticut,36,New York,83,Rensselaer County,87,298,-211
9,Connecticut,36,New York,85,Richmond County,55,17,38
9,Connecticut,36,New York,87,Rockland County,223,352,-129
9,Connecticut,36,New York,89,St. Lawrence County,206,89,117
9,Connecticut,36,New York,91,Saratoga County,306,307,-1
9,Connecticut,36,New York,93,Schenectady County,92,112,-20
9,Connecticut,36,New York,95,Schoharie County,14,15,-1
9,Connecticut,36,New York,101,Steuben County,39,0,39
9,Connecticut,36,New York,103,Suffolk County,1254,403,851
9,Connecticut,36,New York,105,Sullivan County,25,48,-23
9,Connecticut,36,New York,107,Tioga County,0,21,-21
9,Connecticut,36,New York,109,Tompkins County,87,114,-27
9,Connecticut,36,New York,111,Ulster County,190,73,117
9,Connecticut,36,New York,113,Warren County,0,74,-74
9,Connecticut,36,New York,115,Washington County,39,71,-32
9,Connecticut,36,New York,117,Wayne County,7,0,7
9,Connecticut,36,New York,119,Westchester County,4079,2783,1296
9,Connecticut,37,North Carolina,1,Alamance County,13,155,-142
9,Connecticut,37,North Carolina,11,Avery County,18,0,18
9,Connecticut,37,North Carolina,13,Beaufort County,6,0,6
9,Connecticut,37,North Carolina,19,Brunswick County,17,77,-60
9,Connecticut,37,North Carolina,21,Buncombe County,0,59,-59
9,Connecticut,37,North Carolina,23,Burke County,0,6,-6
9,Connecticut,37,North Carolina,25,Cabarrus County,40,0,40
9,Connecticut,37,North Carolina,27,Caldwell County,0,49,-49
9,Connecticut,37,North Carolina,31,Carteret County,34,63,-29
9,Connecticut,37,North Carolina,35,Catawba County,41,203,-162
9,Connecticut,37,North Carolina,45,Cleveland County,9,66,-57
9,Connecticut,37,North Carolina,47,Columbus County,0,20,-20
9,Connecticut,37,North Carolina,49,Craven County,0,162,-162
9,Connecticut,37,North Carolina,51,Cumberland County,73,265,-192
9,Connecticut,37,North Carolina,53,Currituck County,17,7,10
9,Connecticut,37,North Carolina,59,Davie County,0,183,-183
9,Connecticut,37,North Carolina,63,Durham County,95,97,-2
9,Connecticut,37,North Carolina,67,Forsyth County,43,196,-153
9,Connecticut,37,North Carolina,71,Gaston County,0,91,-91
9,Connecticut,37,North Carolina,75,Graham County,0,17,-17
9,Connecticut,37,North Carolina,77,Granville County,53,0,53
9,Connecticut,37,North Carolina,81,Guilford County,22,232,-210
9,Connecticut,37,North Carolina,85,Harnett County,0,83,-83
9,Connecticut,37,North Carolina,87,Haywood County,0,6,-6
9,Connecticut,37,North Carolina,91,Hertford County,0,10,-10
9,Connecticut,37,North Carolina,97,Iredell County,23,316,-293
9,Connecticut,37,North Carolina,101,Johnston County,0,55,-55
9,Connecticut,37,North Carolina,107,Lenoir County,0,84,-84
9,Connecticut,37,North Carolina,109,Lincoln County,0,173,-173
9,Connecticut,37,North Carolina,111,McDowell County,0,29,-29
9,Connecticut,37,North Carolina,113,Macon County,0,12,-12
9,Connecticut,37,North Carolina,115,Madison County,0,4,-4
9,Connecticut,37,North Carolina,119,Mecklenburg County,504,1011,-507
9,Connecticut,37,North Carolina,121,Mitchell County,0,23,-23
9,Connecticut,37,North Carolina,125,Moore County,0,83,-83
9,Connecticut,37,North Carolina,127,Nash County,0,111,-111
9,Connecticut,37,North Carolina,129,New Hanover County,1,258,-257
9,Connecticut,37,North Carolina,133,Onslow County,83,118,-35
9,Connecticut,37,North Carolina,135,Orange County,41,116,-75
9,Connecticut,37,North Carolina,137,Pamlico County,21,0,21
9,Connecticut,37,North Carolina,139,Pasquotank County,0,21,-21
9,Connecticut,37,North Carolina,147,Pitt County,44,121,-77
9,Connecticut,37,North Carolina,149,Polk County,9,0,9
9,Connecticut,37,North Carolina,155,Robeson County,0,8,-8
9,Connecticut,37,North Carolina,157,Rockingham County,0,14,-14
9,Connecticut,37,North Carolina,159,Rowan County,32,0,32
9,Connecticut,37,North Carolina,163,Sampson County,0,1,-1
9,Connecticut,37,North Carolina,167,Stanly County,14,0,14
9,Connecticut,37,North Carolina,171,Surry County,33,36,-3
9,Connecticut,37,North Carolina,175,Transylvania County,0,40,-40
9,Connecticut,37,North Carolina,179,Union County,82,7,75
9,Connecticut,37,North Carolina,183,Wake County,184,884,-700
9,Connecticut,37,North Carolina,189,Watauga County,21,96,-75
9,Connecticut,37,North Carolina,191,Wayne County,0,16,-16
9,Connecticut,38,North Dakota,17,Cass County,0,53,-53
9,Connecticut,38,North Dakota,35,Grand Forks County,0,11,-11
9,Connecticut,38,North Dakota,93,Stutsman County,0,2,-2
9,Connecticut,38,North Dakota,101,Ward County,59,0,59
9,Connecticut,39,Ohio,5,Ashland County,0,1,-1
9,Connecticut,39,Ohio,9,Athens County,0,66,-66
9,Connecticut,39,Ohio,17,Butler County,57,106,-49
9,Connecticut,39,Ohio,23,Clark County,0,14,-14
9,Connecticut,39,Ohio,25,Clermont County,44,0,44
9,Connecticut,39,Ohio,29,Columbiana County,15,0,15
9,Connecticut,39,Ohio,35,Cuyahoga County,233,293,-60
9,Connecticut,39,Ohio,41,Delaware County,6,0,6
9,Connecticut,39,Ohio,49,Franklin County,146,291,-145
9,Connecticut,39,Ohio,57,Greene County,14,41,-27
9,Connecticut,39,Ohio,61,Hamilton County,205,103,102
9,Connecticut,39,Ohio,63,Hancock County,25,0,25
9,Connecticut,39,Ohio,81,Jefferson County,39,8,31
9,Connecticut,39,Ohio,85,Lake County,0,31,-31
9,Connecticut,39,Ohio,89,Licking County,0,45,-45
9,Connecticut,39,Ohio,93,Lorain County,29,68,-39
9,Connecticut,39,Ohio,95,Lucas County,60,130,-70
9,Connecticut,39,Ohio,99,Mahoning County,31,25,6
9,Connecticut,39,Ohio,101,Marion County,4,0,4
9,Connecticut,39,Ohio,103,Medina County,0,1,-1
9,Connecticut,39,Ohio,109,Miami County,100,0,100
9,Connecticut,39,Ohio,113,Montgomery County,116,166,-50
9,Connecticut,39,Ohio,121,Noble County,0,2,-2
9,Connecticut,39,Ohio,133,Portage County,0,36,-36
9,Connecticut,39,Ohio,139,Richland County,0,38,-38
9,Connecticut,39,Ohio,147,Seneca County,0,30,-30
9,Connecticut,39,Ohio,151,Stark County,8,0,8
9,Connecticut,39,Ohio,153,Summit County,57,81,-24
9,Connecticut,39,Ohio,159,Union County,5,0,5
9,Connecticut,39,Ohio,165,Warren County,0,1,-1
9,Connecticut,39,Ohio,167,Washington County,11,0,11
9,Connecticut,4,Arizona,3,Cochise County,98,45,53
9,Connecticut,4,Arizona,5,Coconino County,14,27,-13
9,Connecticut,4,Arizona,7,Gila County,0,1,-1
9,Connecticut,4,Arizona,13,Maricopa County,305,764,-459
9,Connecticut,4,Arizona,19,Pima County,130,438,-308
9,Connecticut,4,Arizona,21,Pinal County,0,12,-12
9,Connecticut,4,Arizona,23,Santa Cruz County,0,3,-3
9,Connecticut,4,Arizona,25,Yavapai County,16,32,-16
9,Connecticut,4,Arizona,27,Yuma County,16,0,16
9,Connecticut,40,Oklahoma,11,Blaine County,0,1,-1
9,Connecticut,40,Oklahoma,19,Carter County,0,45,-45
9,Connecticut,40,Oklahoma,27,Cleveland County,58,7,51
9,Connecticut,40,Oklahoma,47,Garfield County,0,11,-11
9,Connecticut,40,Oklahoma,77,Latimer County,0,9,-9
9,Connecticut,40,Oklahoma,83,Logan County,0,42,-42
9,Connecticut,40,Oklahoma,109,Oklahoma County,86,7,79
9,Connecticut,40,Oklahoma,119,Payne County,33,11,22
9,Connecticut,40,Oklahoma,131,Rogers County,16,1,15
9,Connecticut,40,Oklahoma,143,Tulsa County,0,92,-92
9,Connecticut,40,Oklahoma,153,Woodward County,0,1,-1
9,Connecticut,41,Oregon,1,Baker County,0,9,-9
9,Connecticut,41,Oregon,3,Benton County,23,0,23
9,Connecticut,41,Oregon,5,Clackamas County,0,2,-2
9,Connecticut,41,Oregon,7,Clatsop County,0,30,-30
9,Connecticut,41,Oregon,11,Coos County,0,16,-16
9,Connecticut,41,Oregon,17,Deschutes County,0,87,-87
9,Connecticut,41,Oregon,19,Douglas County,12,0,12
9,Connecticut,41,Oregon,29,Jackson County,10,8,2
9,Connecticut,41,Oregon,35,Klamath County,0,3,-3
9,Connecticut,41,Oregon,39,Lane County,46,184,-138
9,Connecticut,41,Oregon,43,Linn County,7,0,7
9,Connecticut,41,Oregon,47,Marion County,31,37,-6
9,Connecticut,41,Oregon,51,Multnomah County,157,221,-64
9,Connecticut,41,Oregon,53,Polk County,0,3,-3
9,Connecticut,41,Oregon,67,Washington County,68,9,59
9,Connecticut,42,Pennsylvania,1,Adams County,0,126,-126
9,Connecticut,42,Pennsylvania,3,Allegheny County,346,484,-138
9,Connecticut,42,Pennsylvania,7,Beaver County,7,14,-7
9,Connecticut,42,Pennsylvania,9,Bedford County,7,0,7
9,Connecticut,42,Pennsylvania,11,Berks County,159,149,10
9,Connecticut,42,Pennsylvania,13,Blair County,21,12,9
9,Connecticut,42,Pennsylvania,15,Bradford County,8,0,8
9,Connecticut,42,Pennsylvania,17,Bucks County,256,301,-45
9,Connecticut,42,Pennsylvania,19,Butler County,0,34,-34
9,Connecticut,42,Pennsylvania,21,Cambria County,0,15,-15
9,Connecticut,42,Pennsylvania,25,Carbon County,0,18,-18
9,Connecticut,42,Pennsylvania,27,Centre County,72,176,-104
9,Connecticut,42,Pennsylvania,29,Chester County,103,313,-210
9,Connecticut,42,Pennsylvania,33,Clearfield County,0,19,-19
9,Connecticut,42,Pennsylvania,35,Clinton County,0,9,-9
9,Connecticut,42,Pennsylvania,37,Columbia County,0,6,-6
9,Connecticut,42,Pennsylvania,39,Crawford County,0,32,-32
9,Connecticut,42,Pennsylvania,41,Cumberland County,129,89,40
9,Connecticut,42,Pennsylvania,43,Dauphin County,22,285,-263
9,Connecticut,42,Pennsylvania,45,Delaware County,142,180,-38
9,Connecticut,42,Pennsylvania,49,Erie County,61,56,5
9,Connecticut,42,Pennsylvania,55,Franklin County,0,11,-11
9,Connecticut,42,Pennsylvania,61,Huntingdon County,0,16,-16
9,Connecticut,42,Pennsylvania,63,Indiana County,0,15,-15
9,Connecticut,42,Pennsylvania,69,Lackawanna County,158,34,124
9,Connecticut,42,Pennsylvania,71,Lancaster County,177,109,68
9,Connecticut,42,Pennsylvania,75,Lebanon County,55,28,27
9,Connecticut,42,Pennsylvania,77,Lehigh County,116,379,-263
9,Connecticut,42,Pennsylvania,79,Luzerne County,201,10,191
9,Connecticut,42,Pennsylvania,81,Lycoming County,0,51,-51
9,Connecticut,42,Pennsylvania,85,Mercer County,0,7,-7
9,Connecticut,42,Pennsylvania,89,Monroe County,15,59,-44
9,Connecticut,42,Pennsylvania,91,Montgomery County,254,150,104
9,Connecticut,42,Pennsylvania,95,Northampton County,81,192,-111
9,Connecticut,42,Pennsylvania,97,Northumberland County,16,3,13
9,Connecticut,42,Pennsylvania,99,Perry County,0,52,-52
9,Connecticut,42,Pennsylvania,101,Philadelphia County,823,831,-8
9,Connecticut,42,Pennsylvania,103,Pike County,55,13,42
9,Connecticut,42,Pennsylvania,105,Potter County,0,8,-8
9,Connecticut,42,Pennsylvania,107,Schuylkill County,69,0,69
9,Connecticut,42,Pennsylvania,109,Snyder County,18,33,-15
9,Connecticut,42,Pennsylvania,113,Sullivan County,0,9,-9
9,Connecticut,42,Pennsylvania,115,Susquehanna County,0,20,-20
9,Connecticut,42,Pennsylvania,117,Tioga County,0,34,-34
9,Connecticut,42,Pennsylvania,119,Union County,0,134,-134
9,Connecticut,42,Pennsylvania,125,Washington County,0,82,-82
9,Connecticut,42,Pennsylvania,127,Wayne County,28,2,26
9,Connecticut,42,Pennsylvania,129,Westmoreland County,252,120,132
9,Connecticut,42,Pennsylvania,131,Wyoming County,0,5,-5
9,Connecticut,42,Pennsylvania,133,York County,79,177,-98
9,Connecticut,44,Rhode Island,1,Bristol County,81,251,-170
9,Connecticut,44,Rhode Island,3,Kent County,349,250,99
9,Connecticut,44,Rhode Island,5,Newport County,299,344,-45
9,Connecticut,44,Rhode Island,7,Providence County,1646,1468,178
9,Connecticut,44,Rhode Island,9,Washington County,837,971,-134
9,Connecticut,45,South Carolina,3,Aiken County,27,203,-176
9,Connecticut,45,South Carolina,7,Anderson County,0,1,-1
9,Connecticut,45,South Carolina,13,Beaufort County,190,378,-188
9,Connecticut,45,South Carolina,15,Berkeley County,143,310,-167
9,Connecticut,45,South Carolina,19,Charleston County,120,301,-181
9,Connecticut,45,South Carolina,35,Dorchester County,62,139,-77
9,Connecticut,45,South Carolina,37,Edgefield County,7,0,7
9,Connecticut,45,South Carolina,41,Florence County,44,64,-20
9,Connecticut,45,South Carolina,43,Georgetown County,116,35,81
9,Connecticut,45,South Carolina,45,Greenville County,114,82,32
9,Connecticut,45,South Carolina,47,Greenwood County,0,208,-208
9,Connecticut,45,South Carolina,51,Horry County,81,638,-557
9,Connecticut,45,South Carolina,53,Jasper County,0,9,-9
9,Connecticut,45,South Carolina,55,Kershaw County,0,10,-10
9,Connecticut,45,South Carolina,57,Lancaster County,0,172,-172
9,Connecticut,45,South Carolina,59,Laurens County,0,35,-35
9,Connecticut,45,South Carolina,63,Lexington County,0,167,-167
9,Connecticut,45,South Carolina,67,Marion County,17,0,17
9,Connecticut,45,South Carolina,69,Marlboro County,1,12,-11
9,Connecticut,45,South Carolina,73,Oconee County,0,11,-11
9,Connecticut,45,South Carolina,77,Pickens County,8,48,-40
9,Connecticut,45,South Carolina,79,Richland County,20,283,-263
9,Connecticut,45,South Carolina,83,Spartanburg County,4,178,-174
9,Connecticut,45,South Carolina,85,Sumter County,0,42,-42
9,Connecticut,45,South Carolina,89,Williamsburg County,0,1,-1
9,Connecticut,45,South Carolina,91,York County,38,230,-192
9,Connecticut,46,South Dakota,5,Beadle County,69,0,69
9,Connecticut,46,South Dakota,103,Pennington County,24,5,19
9,Connecticut,46,South Dakota,105,Perkins County,0,2,-2
9,Connecticut,47,Tennessee,1,Anderson County,0,23,-23
9,Connecticut,47,Tennessee,9,Blount County,0,5,-5
9,Connecticut,47,Tennessee,35,Cumberland County,9,21,-12
9,Connecticut,47,Tennessee,37,Davidson County,150,367,-217
9,Connecticut,47,Tennessee,49,Fentress County,40,0,40
9,Connecticut,47,Tennessee,59,Greene County,0,33,-33
9,Connecticut,47,Tennessee,65,Hamilton County,7,37,-30
9,Connecticut,47,Tennessee,71,Hardin County,16,0,16
9,Connecticut,47,Tennessee,73,Hawkins County,0,18,-18
9,Connecticut,47,Tennessee,93,Knox County,36,116,-80
9,Connecticut,47,Tennessee,105,Loudon County,16,73,-57
9,Connecticut,47,Tennessee,107,McMinn County,0,46,-46
9,Connecticut,47,Tennessee,113,Madison County,0,4,-4
9,Connecticut,47,Tennessee,145,Roane County,0,56,-56
9,Connecticut,47,Tennessee,149,Rutherford County,36,71,-35
9,Connecticut,47,Tennessee,155,Sevier County,0,10,-10
9,Connecticut,47,Tennessee,157,Shelby County,278,102,176
9,Connecticut,47,Tennessee,167,Tipton County,0,12,-12
9,Connecticut,47,Tennessee,179,Washington County,8,0,8
9,Connecticut,47,Tennessee,187,Williamson County,46,0,46
9,Connecticut,47,Tennessee,189,Wilson County,0,51,-51
9,Connecticut,48,Texas,27,Bell County,51,0,51
9,Connecticut,48,Texas,29,Bexar County,147,381,-234
9,Connecticut,48,Texas,39,Brazoria County,0,16,-16
9,Connecticut,48,Texas,41,Brazos County,0,56,-56
9,Connecticut,48,Texas,77,Clay County,2,0,2
9,Connecticut,48,Texas,85,Collin County,24,453,-429
9,Connecticut,48,Texas,99,Coryell County,18,0,18
9,Connecticut,48,Texas,111,Dallam County,0,45,-45
9,Connecticut,48,Texas,113,Dallas County,432,337,95
9,Connecticut,48,Texas,121,Denton County,28,80,-52
9,Connecticut,48,Texas,141,El Paso County,54,99,-45
9,Connecticut,48,Texas,145,Falls County,0,5,-5
9,Connecticut,48,Texas,157,Fort Bend County,0,76,-76
9,Connecticut,48,Texas,167,Galveston County,38,30,8
9,Connecticut,48,Texas,181,Grayson County,0,2,-2
9,Connecticut,48,Texas,189,Hale County,0,11,-11
9,Connecticut,48,Texas,201,Harris County,509,521,-12
9,Connecticut,48,Texas,209,Hays County,48,2,46
9,Connecticut,48,Texas,217,Hill County,0,1,-1
9,Connecticut,48,Texas,225,Houston County,36,0,36
9,Connecticut,48,Texas,227,Howard County,42,0,42
9,Connecticut,48,Texas,245,Jefferson County,28,0,28
9,Connecticut,48,Texas,251,Johnson County,27,0,27
9,Connecticut,48,Texas,291,Liberty County,6,0,6
9,Connecticut,48,Texas,303,Lubbock County,14,27,-13
9,Connecticut,48,Texas,309,McLennan County,6,16,-10
9,Connecticut,48,Texas,333,Mills County,13,0,13
9,Connecticut,48,Texas,339,Montgomery County,44,7,37
9,Connecticut,48,Texas,355,Nueces County,144,0,144
9,Connecticut,48,Texas,423,Smith County,0,31,-31
9,Connecticut,48,Texas,439,Tarrant County,203,106,97
9,Connecticut,48,Texas,451,Tom Green County,0,1,-1
9,Connecticut,48,Texas,453,Travis County,220,162,58
9,Connecticut,48,Texas,471,Walker County,45,0,45
9,Connecticut,48,Texas,473,Waller County,9,30,-21
9,Connecticut,48,Texas,485,Wichita County,0,39,-39
9,Connecticut,48,Texas,491,Williamson County,130,111,19
9,Connecticut,49,Utah,3,Box Elder County,0,24,-24
9,Connecticut,49,Utah,5,Cache County,0,34,-34
9,Connecticut,49,Utah,11,Davis County,0,29,-29
9,Connecticut,49,Utah,35,Salt Lake County,131,146,-15
9,Connecticut,49,Utah,43,Summit County,30,46,-16
9,Connecticut,49,Utah,49,Utah County,19,146,-127
9,Connecticut,5,Arkansas,5,Baxter County,73,0,73
9,Connecticut,5,Arkansas,7,Benton County,30,62,-32
9,Connecticut,5,Arkansas,45,Faulkner County,0,7,-7
9,Connecticut,5,Arkansas,69,Jefferson County,14,0,14
9,Connecticut,5,Arkansas,81,Little River County,87,0,87
9,Connecticut,5,Arkansas,89,Marion County,0,12,-12
9,Connecticut,5,Arkansas,115,Pope County,0,29,-29
9,Connecticut,5,Arkansas,119,Pulaski County,0,24,-24
9,Connecticut,5,Arkansas,143,Washington County,0,113,-113
9,Connecticut,50,Vermont,1,Addison County,17,75,-58
9,Connecticut,50,Vermont,3,Bennington County,24,20,4
9,Connecticut,50,Vermont,5,Caledonia County,33,143,-110
9,Connecticut,50,Vermont,7,Chittenden County,204,470,-266
9,Connecticut,50,Vermont,9,Essex County,25,1,24
9,Connecticut,50,Vermont,11,Franklin County,1,4,-3
9,Connecticut,50,Vermont,15,Lamoille County,27,39,-12
9,Connecticut,50,Vermont,17,Orange County,80,27,53
9,Connecticut,50,Vermont,19,Orleans County,16,41,-25
9,Connecticut,50,Vermont,21,Rutland County,43,79,-36
9,Connecticut,50,Vermont,23,Washington County,50,54,-4
9,Connecticut,50,Vermont,25,Windham County,8,97,-89
9,Connecticut,50,Vermont,27,Windsor County,76,95,-19
9,Connecticut,51,Virginia,1,Accomack County,18,0,18
9,Connecticut,51,Virginia,3,Albemarle County,30,96,-66
9,Connecticut,51,Virginia,13,Arlington County,207,234,-27
9,Connecticut,51,Virginia,15,Augusta County,126,0,126
9,Connecticut,51,Virginia,19,Bedford County,9,0,9
9,Connecticut,51,Virginia,41,Chesterfield County,27,164,-137
9,Connecticut,51,Virginia,49,Cumberland County,6,0,6
9,Connecticut,51,Virginia,53,Dinwiddie County,0,10,-10
9,Connecticut,51,Virginia,59,Fairfax County,567,434,133
9,Connecticut,51,Virginia,61,Fauquier County,0,7,-7
9,Connecticut,51,Virginia,67,Franklin County,0,9,-9
9,Connecticut,51,Virginia,75,Goochland County,24,0,24
9,Connecticut,51,Virginia,83,Halifax County,0,46,-46
9,Connecticut,51,Virginia,85,Hanover County,0,43,-43
9,Connecticut,51,Virginia,87,Henrico County,362,171,191
9,Connecticut,51,Virginia,93,Isle of Wight County,0,28,-28
9,Connecticut,51,Virginia,107,Loudoun County,11,15,-4
9,Connecticut,51,Virginia,117,Mecklenburg County,19,0,19
9,Connecticut,51,Virginia,121,Montgomery County,69,145,-76
9,Connecticut,51,Virginia,131,Northampton County,0,3,-3
9,Connecticut,51,Virginia,137,Orange County,16,13,3
9,Connecticut,51,Virginia,143,Pittsylvania County,16,0,16
9,Connecticut,51,Virginia,153,Prince William County,34,14,20
9,Connecticut,51,Virginia,161,Roanoke County,0,84,-84
9,Connecticut,51,Virginia,177,Spotsylvania County,0,12,-12
9,Connecticut,51,Virginia,179,Stafford County,6,227,-221
9,Connecticut,51,Virginia,187,Warren County,13,23,-10
9,Connecticut,51,Virginia,510,Alexandria city,58,160,-102
9,Connecticut,51,Virginia,520,Bristol city,0,8,-8
9,Connecticut,51,Virginia,540,Charlottesville city,15,15,0
9,Connecticut,51,Virginia,550,Chesapeake city,64,0,64
9,Connecticut,51,Virginia,595,Emporia city,0,6,-6
9,Connecticut,51,Virginia,600,Fairfax city,9,0,9
9,Connecticut,51,Virginia,630,Fredericksburg city,0,12,-12
9,Connecticut,51,Virginia,650,Hampton city,144,49,95
9,Connecticut,51,Virginia,660,Harrisonburg city,0,118,-118
9,Connecticut,51,Virginia,680,Lynchburg city,0,116,-116
9,Connecticut,51,Virginia,685,Manassas Park city,0,55,-55
9,Connecticut,51,Virginia,700,Newport News city,107,214,-107
9,Connecticut,51,Virginia,710,Norfolk city,76,344,-268
9,Connecticut,51,Virginia,730,Petersburg city,3,15,-12
9,Connecticut,51,Virginia,740,Portsmouth city,5,2,3
9,Connecticut,51,Virginia,760,Richmond city,131,104,27
9,Connecticut,51,Virginia,770,Roanoke city,16,25,-9
9,Connecticut,51,Virginia,775,Salem city,0,10,-10
9,Connecticut,51,Virginia,790,Staunton city,0,216,-216
9,Connecticut,51,Virginia,800,Suffolk city,76,3,73
9,Connecticut,51,Virginia,810,Virginia Beach city,235,475,-240
9,Connecticut,51,Virginia,830,Williamsburg city,0,17,-17
9,Connecticut,51,Virginia,840,Winchester city,15,0,15
9,Connecticut,53,Washington,5,Benton County,29,0,29
9,Connecticut,53,Washington,11,Clark County,33,0,33
9,Connecticut,53,Washington,29,Island County,10,0,10
9,Connecticut,53,Washington,31,Jefferson County,22,0,22
9,Connecticut,53,Washington,33,King County,341,397,-56
9,Connecticut,53,Washington,35,Kitsap County,41,498,-457
9,Connecticut,53,Washington,43,Lincoln County,0,8,-8
9,Connecticut,53,Washington,53,Pierce County,73,31,42
9,Connecticut,53,Washington,57,Skagit County,0,4,-4
9,Connecticut,53,Washington,61,Snohomish County,108,64,44
9,Connecticut,53,Washington,63,Spokane County,0,24,-24
9,Connecticut,53,Washington,67,Thurston County,31,43,-12
9,Connecticut,53,Washington,71,Walla Walla County,16,0,16
9,Connecticut,53,Washington,73,Whatcom County,0,11,-11
9,Connecticut,53,Washington,75,Whitman County,0,39,-39
9,Connecticut,53,Washington,77,Yakima County,0,8,-8
9,Connecticut,54,West Virginia,1,Barbour County,0,6,-6
9,Connecticut,54,West Virginia,3,Berkeley County,0,100,-100
9,Connecticut,54,West Virginia,11,Cabell County,8,0,8
9,Connecticut,54,West Virginia,25,Greenbrier County,0,52,-52
9,Connecticut,54,West Virginia,37,Jefferson County,0,18,-18
9,Connecticut,54,West Virginia,49,Marion County,21,19,2
9,Connecticut,54,West Virginia,55,Mercer County,0,5,-5
9,Connecticut,54,West Virginia,61,Monongalia County,9,127,-118
9,Connecticut,54,West Virginia,81,Raleigh County,9,10,-1
9,Connecticut,54,West Virginia,83,Randolph County,35,0,35
9,Connecticut,54,West Virginia,91,Taylor County,8,0,8
9,Connecticut,54,West Virginia,103,Wetzel County,0,9,-9
9,Connecticut,54,West Virginia,107,Wood County,0,6,-6
9,Connecticut,55,Wisconsin,9,Brown County,0,6,-6
9,Connecticut,55,Wisconsin,19,Clark County,24,0,24
9,Connecticut,55,Wisconsin,23,Crawford County,0,4,-4
9,Connecticut,55,Wisconsin,25,Dane County,102,39,63
9,Connecticut,55,Wisconsin,31,Douglas County,0,2,-2
9,Connecticut,55,Wisconsin,33,Dunn County,20,0,20
9,Connecticut,55,Wisconsin,49,Iowa County,0,3,-3
9,Connecticut,55,Wisconsin,59,Kenosha County,19,23,-4
9,Connecticut,55,Wisconsin,67,Langlade County,0,2,-2
9,Connecticut,55,Wisconsin,77,Marquette County,0,4,-4
9,Connecticut,55,Wisconsin,79,Milwaukee County,41,194,-153
9,Connecticut,55,Wisconsin,87,Outagamie County,28,3,25
9,Connecticut,55,Wisconsin,93,Pierce County,0,9,-9
9,Connecticut,55,Wisconsin,101,Racine County,0,21,-21
9,Connecticut,55,Wisconsin,105,Rock County,13,5,8
9,Connecticut,55,Wisconsin,115,Shawano County,8,0,8
9,Connecticut,55,Wisconsin,117,Sheboygan County,20,0,20
9,Connecticut,55,Wisconsin,121,Trempealeau County,0,14,-14
9,Connecticut,55,Wisconsin,133,Waukesha County,0,103,-103
9,Connecticut,56,Wyoming,1,Albany County,14,14,0
9,Connecticut,56,Wyoming,7,Carbon County,0,6,-6
9,Connecticut,56,Wyoming,13,Fremont County,0,5,-5
9,Connecticut,56,Wyoming,15,Goshen County,0,29,-29
9,Connecticut,56,Wyoming,19,Johnson County,36,0,36
9,Connecticut,56,Wyoming,21,Laramie County,25,33,-8
9,Connecticut,6,California,1,Alameda County,269,398,-129
9,Connecticut,6,California,7,Butte County,0,31,-31
9,Connecticut,6,California,13,Contra Costa County,27,98,-71
9,Connecticut,6,California,19,Fresno County,7,15,-8
9,Connecticut,6,California,23,Humboldt County,37,104,-67
9,Connecticut,6,California,27,Inyo County,7,0,7
9,Connecticut,6,California,29,Kern County,24,0,24
9,Connecticut,6,California,37,Los Angeles County,965,1386,-421
9,Connecticut,6,California,41,Marin County,112,0,112
9,Connecticut,6,California,47,Merced County,33,0,33
9,Connecticut,6,California,53,Monterey County,134,96,38
9,Connecticut,6,California,59,Orange County,138,525,-387
9,Connecticut,6,California,61,Placer County,0,37,-37
9,Connecticut,6,California,65,Riverside County,110,140,-30
9,Connecticut,6,California,67,Sacramento County,268,104,164
9,Connecticut,6,California,71,San Bernardino County,57,102,-45
9,Connecticut,6,California,73,San Diego County,746,869,-123
9,Connecticut,6,California,75,San Francisco County,327,328,-1
9,Connecticut,6,California,77,San Joaquin County,0,39,-39
9,Connecticut,6,California,79,San Luis Obispo County,0,10,-10
9,Connecticut,6,California,81,San Mateo County,65,8,57
9,Connecticut,6,California,83,Santa Barbara County,5,227,-222
9,Connecticut,6,California,85,Santa Clara County,283,359,-76
9,Connecticut,6,California,87,Santa Cruz County,32,71,-39
9,Connecticut,6,California,89,Shasta County,24,16,8
9,Connecticut,6,California,95,Solano County,91,0,91
9,Connecticut,6,California,97,Sonoma County,16,64,-48
9,Connecticut,6,California,99,Stanislaus County,14,26,-12
9,Connecticut,6,California,111,Ventura County,22,106,-84
9,Connecticut,72,Puerto Rico,3,Aguada Municipio,80,26,54
9,Connecticut,72,Puerto Rico,7,Aguas Buenas Municipio,113,0,113
9,Connecticut,72,Puerto Rico,9,Aibonito Municipio,53,58,-5
9,Connecticut,72,Puerto Rico,13,Arecibo Municipio,9,0,9
9,Connecticut,72,Puerto Rico,19,Barranquitas Municipio,20,0,20
9,Connecticut,72,Puerto Rico,21,Bayamón Municipio,127,40,87
9,Connecticut,72,Puerto Rico,25,Caguas Municipio,382,62,320
9,Connecticut,72,Puerto Rico,27,Camuy Municipio,64,0,64
9,Connecticut,72,Puerto Rico,29,Canóvanas Municipio,100,23,77
9,Connecticut,72,Puerto Rico,31,Carolina Municipio,71,229,-158
9,Connecticut,72,Puerto Rico,35,Cayey Municipio,6,23,-17
9,Connecticut,72,Puerto Rico,45,Comerío Municipio,304,0,304
9,Connecticut,72,Puerto Rico,51,Dorado Municipio,74,0,74
9,Connecticut,72,Puerto Rico,63,Gurabo Municipio,24,0,24
9,Connecticut,72,Puerto Rico,65,Hatillo Municipio,50,0,50
9,Connecticut,72,Puerto Rico,69,Humacao Municipio,27,0,27
9,Connecticut,72,Puerto Rico,71,Isabela Municipio,53,18,35
9,Connecticut,72,Puerto Rico,75,Juana Díaz Municipio,2,69,-67
9,Connecticut,72,Puerto Rico,77,Juncos Municipio,140,0,140
9,Connecticut,72,Puerto Rico,81,Lares Municipio,0,15,-15
9,Connecticut,72,Puerto Rico,85,Las Piedras Municipio,43,0,43
9,Connecticut,72,Puerto Rico,87,Loíza Municipio,0,5,-5
9,Connecticut,72,Puerto Rico,91,Manatí Municipio,63,0,63
9,Connecticut,72,Puerto Rico,93,Maricao Municipio,0,18,-18
9,Connecticut,72,Puerto Rico,95,Maunabo Municipio,39,0,39
9,Connecticut,72,Puerto Rico,97,Mayagüez Municipio,0,1,-1
9,Connecticut,72,Puerto Rico,103,Naguabo Municipio,279,0,279
9,Connecticut,72,Puerto Rico,107,Orocovis Municipio,10,99,-89
9,Connecticut,72,Puerto Rico,109,Patillas Municipio,30,0,30
9,Connecticut,72,Puerto Rico,111,Peñuelas Municipio,24,0,24
9,Connecticut,72,Puerto Rico,113,Ponce Municipio,142,11,131
9,Connecticut,72,Puerto Rico,117,Rincón Municipio,76,0,76
9,Connecticut,72,Puerto Rico,119,Río Grande Municipio,41,0,41
9,Connecticut,72,Puerto Rico,121,Sabana Grande Municipio,16,0,16
9,Connecticut,72,Puerto Rico,123,Salinas Municipio,40,0,40
9,Connecticut,72,Puerto Rico,125,San Germán Municipio,0,27,-27
9,Connecticut,72,Puerto Rico,127,San Juan Municipio,519,0,519
9,Connecticut,72,Puerto Rico,129,San Lorenzo Municipio,118,0,118
9,Connecticut,72,Puerto Rico,133,Santa Isabel Municipio,73,0,73
9,Connecticut,72,Puerto Rico,135,Toa Alta Municipio,52,0,52
9,Connecticut,72,Puerto Rico,145,Vega Baja Municipio,18,0,18
9,Connecticut,72,Puerto Rico,149,Villalba Municipio,56,0,56
9,Connecticut,72,Puerto Rico,151,Yabucoa Municipio,0,49,-49
9,Connecticut,8,Colorado,1,Adams County,131,45,86
9,Connecticut,8,Colorado,5,Arapahoe County,36,96,-60
9,Connecticut,8,Colorado,9,Baca County,0,5,-5
9,Connecticut,8,Colorado,13,Boulder County,0,282,-282
9,Connecticut,8,Colorado,14,Broomfield County,0,64,-64
9,Connecticut,8,Colorado,31,Denver County,104,567,-463
9,Connecticut,8,Colorado,35,Douglas County,16,138,-122
9,Connecticut,8,Colorado,37,Eagle County,43,0,43
9,Connecticut,8,Colorado,41,El Paso County,181,228,-47
9,Connecticut,8,Colorado,45,Garfield County,23,29,-6
9,Connecticut,8,Colorado,51,Gunnison County,0,14,-14
9,Connecticut,8,Colorado,59,Jefferson County,52,73,-21
9,Connecticut,8,Colorado,61,Kiowa County,0,1,-1
9,Connecticut,8,Colorado,67,La Plata County,13,7,6
9,Connecticut,8,Colorado,69,Larimer County,49,60,-11
9,Connecticut,8,Colorado,77,Mesa County,0,13,-13
9,Connecticut,8,Colorado,85,Montrose County,21,0,21
9,Connecticut,8,Colorado,97,Pitkin County,0,18,-18
9,Connecticut,8,Colorado,101,Pueblo County,1,0,1
9,Connecticut,8,Colorado,103,Rio Blanco County,0,12,-12
9,Connecticut,9,Connecticut,1,Fairfield County,13338,7907,5431
9,Connecticut,9,Connecticut,3,Hartford County,16577,15482,1095
9,Connecticut,9,Connecticut,5,Litchfield County,4383,4798,-415
9,Connecticut,9,Connecticut,7,Middlesex County,6118,5879,239
9,Connecticut,9,Connecticut,9,New Haven County,14169,14644,-475
9,Connecticut,9,Connecticut,11,New London County,5260,6071,-811
9,Connecticut,9,Connecticut,13,Tolland County,6131,10187,-4056
9,Connecticut,9,Connecticut,15,Windham County,3112,4120,-1008
9,Connecticut,AFR,Africa,,-,958,0,0
9,Connecticut,ASI,Asia,,-,9473,0,0
9,Connecticut,CAM,Central America,,-,1075,0,0
9,Connecticut,CAR,Caribbean,,-,1884,0,0
9,Connecticut,EUR,Europe,,-,4112,0,0
9,Connecticut,ISL,U.S. Island Areas,,-,189,0,0
9,Connecticut,NAM,Northern America,,-,814,0,0
9,Connecticut,OCE,Oceania and At Sea,,-,171,0,0
9,Connecticut,SAM,South America,,-,3290,0,0
10,Delaware,1,Alabama,21,Chilton County,16,0,16
10,Delaware,1,Alabama,49,DeKalb County,66,0,66
10,Delaware,1,Alabama,55,Etowah County,0,6,-6
10,Delaware,1,Alabama,69,Houston County,0,9,-9
10,Delaware,1,Alabama,73,Jefferson County,6,25,-19
10,Delaware,1,Alabama,77,Lauderdale County,9,0,9
10,Delaware,1,Alabama,89,Madison County,51,0,51
10,Delaware,1,Alabama,95,Marshall County,0,8,-8
10,Delaware,10,Delaware,1,Kent County,4007,3763,244
10,Delaware,10,Delaware,3,New Castle County,3461,3996,-535
10,Delaware,10,Delaware,5,Sussex County,2708,2417,291
10,Delaware,11,District of Columbia,1,District of Columbia,276,300,-24
10,Delaware,12,Florida,1,Alachua County,8,0,8
10,Delaware,12,Florida,5,Bay County,73,0,73
10,Delaware,12,Florida,9,Brevard County,80,154,-74
10,Delaware,12,Florida,11,Broward County,50,58,-8
10,Delaware,12,Florida,15,Charlotte County,25,0,25
10,Delaware,12,Florida,17,Citrus County,5,14,-9
10,Delaware,12,Florida,21,Collier County,32,23,9
10,Delaware,12,Florida,23,Columbia County,0,20,-20
10,Delaware,12,Florida,31,Duval County,0,100,-100
10,Delaware,12,Florida,33,Escambia County,21,13,8
10,Delaware,12,Florida,35,Flagler County,0,21,-21
10,Delaware,12,Florida,53,Hernando County,0,10,-10
10,Delaware,12,Florida,57,Hillsborough County,52,347,-295
10,Delaware,12,Florida,61,Indian River County,0,96,-96
10,Delaware,12,Florida,69,Lake County,10,81,-71
10,Delaware,12,Florida,71,Lee County,53,219,-166
10,Delaware,12,Florida,73,Leon County,0,78,-78
10,Delaware,12,Florida,75,Levy County,0,23,-23
10,Delaware,12,Florida,81,Manatee County,4,156,-152
10,Delaware,12,Florida,83,Marion County,0,47,-47
10,Delaware,12,Florida,85,Martin County,5,0,5
10,Delaware,12,Florida,86,Miami-Dade County,94,118,-24
10,Delaware,12,Florida,87,Monroe County,9,0,9
10,Delaware,12,Florida,91,Okaloosa County,6,16,-10
10,Delaware,12,Florida,93,Okeechobee County,0,6,-6
10,Delaware,12,Florida,95,Orange County,54,3,51
10,Delaware,12,Florida,97,Osceola County,30,30,0
10,Delaware,12,Florida,99,Palm Beach County,157,106,51
10,Delaware,12,Florida,101,Pasco County,7,23,-16
10,Delaware,12,Florida,103,Pinellas County,109,66,43
10,Delaware,12,Florida,105,Polk County,43,19,24
10,Delaware,12,Florida,109,St. Johns County,18,22,-4
10,Delaware,12,Florida,111,St. Lucie County,10,0,10
10,Delaware,12,Florida,115,Sarasota County,32,153,-121
10,Delaware,12,Florida,117,Seminole County,0,195,-195
10,Delaware,12,Florida,121,Suwannee County,0,1,-1
10,Delaware,12,Florida,123,Taylor County,0,17,-17
10,Delaware,12,Florida,127,Volusia County,70,82,-12
10,Delaware,13,Georgia,39,Camden County,0,5,-5
10,Delaware,13,Georgia,51,Chatham County,13,464,-451
10,Delaware,13,Georgia,57,Cherokee County,16,0,16
10,Delaware,13,Georgia,59,Clarke County,16,0,16
10,Delaware,13,Georgia,63,Clayton County,6,0,6
10,Delaware,13,Georgia,67,Cobb County,8,47,-39
10,Delaware,13,Georgia,71,Colquitt County,0,28,-28
10,Delaware,13,Georgia,77,Coweta County,0,12,-12
10,Delaware,13,Georgia,89,DeKalb County,7,347,-340
10,Delaware,13,Georgia,117,Forsyth County,4,22,-18
10,Delaware,13,Georgia,121,Fulton County,191,18,173
10,Delaware,13,Georgia,135,Gwinnett County,323,0,323
10,Delaware,13,Georgia,151,Henry County,0,152,-152
10,Delaware,13,Georgia,153,Houston County,6,20,-14
10,Delaware,13,Georgia,185,Lowndes County,31,3,28
10,Delaware,13,Georgia,217,Newton County,74,0,74
10,Delaware,13,Georgia,223,Paulding County,0,21,-21
10,Delaware,13,Georgia,245,Richmond County,49,0,49
10,Delaware,15,Hawaii,3,Honolulu County,47,25,22
10,Delaware,15,Hawaii,9,Maui County,0,3,-3
10,Delaware,16,Idaho,39,Elmore County,0,4,-4
10,Delaware,16,Idaho,65,Madison County,0,23,-23
10,Delaware,16,Idaho,83,Twin Falls County,6,0,6
10,Delaware,17,Illinois,31,Cook County,161,91,70
10,Delaware,17,Illinois,43,DuPage County,0,63,-63
10,Delaware,17,Illinois,91,Kankakee County,27,0,27
10,Delaware,17,Illinois,95,Knox County,186,0,186
10,Delaware,17,Illinois,97,Lake County,85,0,85
10,Delaware,17,Illinois,99,LaSalle County,0,6,-6
10,Delaware,17,Illinois,105,Livingston County,0,3,-3
10,Delaware,17,Illinois,167,Sangamon County,24,0,24
10,Delaware,17,Illinois,197,Will County,0,6,-6
10,Delaware,17,Illinois,201,Winnebago County,9,0,9
10,Delaware,18,Indiana,23,Clinton County,0,53,-53
10,Delaware,18,Indiana,69,Huntington County,0,9,-9
10,Delaware,18,Indiana,83,Knox County,0,6,-6
10,Delaware,18,Indiana,97,Marion County,28,0,28
10,Delaware,18,Indiana,105,Monroe County,0,14,-14
10,Delaware,18,Indiana,127,Porter County,19,0,19
10,Delaware,18,Indiana,141,St. Joseph County,0,28,-28
10,Delaware,18,Indiana,157,Tippecanoe County,5,0,5
10,Delaware,18,Indiana,173,Warrick County,0,16,-16
10,Delaware,19,Iowa,57,Des Moines County,16,0,16
10,Delaware,19,Iowa,143,Osceola County,0,17,-17
10,Delaware,19,Iowa,153,Polk County,0,112,-112
10,Delaware,2,Alaska,16,Aleutians West Census Area,0,7,-7
10,Delaware,2,Alaska,20,Anchorage Municipality,200,17,183
10,Delaware,2,Alaska,122,Kenai Peninsula Borough,0,11,-11
10,Delaware,2,Alaska,220,Sitka City and Borough,32,0,32
10,Delaware,20,Kansas,45,Douglas County,30,0,30
10,Delaware,20,Kansas,91,Johnson County,0,48,-48
10,Delaware,21,Kentucky,15,Boone County,0,17,-17
10,Delaware,21,Kentucky,47,Christian County,11,27,-16
10,Delaware,21,Kentucky,49,Clark County,0,16,-16
10,Delaware,21,Kentucky,67,Fayette County,14,0,14
10,Delaware,21,Kentucky,93,Hardin County,0,22,-22
10,Delaware,21,Kentucky,111,Jefferson County,33,22,11
10,Delaware,21,Kentucky,161,Mason County,19,50,-31
10,Delaware,21,Kentucky,163,Meade County,0,5,-5
10,Delaware,21,Kentucky,225,Union County,10,0,10
10,Delaware,22,Louisiana,3,Allen Parish,20,0,20
10,Delaware,22,Louisiana,11,Beauregard Parish,9,0,9
10,Delaware,22,Louisiana,15,Bossier Parish,0,3,-3
10,Delaware,22,Louisiana,33,East Baton Rouge Parish,15,17,-2
10,Delaware,22,Louisiana,39,Evangeline Parish,0,12,-12
10,Delaware,22,Louisiana,61,Lincoln Parish,8,0,8
10,Delaware,22,Louisiana,71,Orleans Parish,0,69,-69
10,Delaware,22,Louisiana,103,St. Tammany Parish,6,0,6
10,Delaware,23,Maine,1,Androscoggin County,0,7,-7
10,Delaware,23,Maine,5,Cumberland County,125,0,125
10,Delaware,23,Maine,9,Hancock County,0,5,-5
10,Delaware,23,Maine,11,Kennebec County,0,14,-14
10,Delaware,23,Maine,13,Knox County,18,0,18
10,Delaware,23,Maine,17,Oxford County,0,13,-13
10,Delaware,23,Maine,19,Penobscot County,22,34,-12
10,Delaware,23,Maine,27,Waldo County,0,5,-5
10,Delaware,23,Maine,29,Washington County,0,11,-11
10,Delaware,24,Maryland,1,Allegany County,34,0,34
10,Delaware,24,Maryland,3,Anne Arundel County,743,513,230
10,Delaware,24,Maryland,5,Baltimore County,552,343,209
10,Delaware,24,Maryland,9,Calvert County,133,55,78
10,Delaware,24,Maryland,11,Caroline County,228,88,140
10,Delaware,24,Maryland,13,Carroll County,210,100,110
10,Delaware,24,Maryland,15,Cecil County,1266,1350,-84
10,Delaware,24,Maryland,17,Charles County,52,8,44
10,Delaware,24,Maryland,19,Dorchester County,219,92,127
10,Delaware,24,Maryland,21,Frederick County,139,7,132
10,Delaware,24,Maryland,23,Garrett County,24,11,13
10,Delaware,24,Maryland,25,Harford County,344,133,211
10,Delaware,24,Maryland,27,Howard County,443,124,319
10,Delaware,24,Maryland,29,Kent County,125,111,14
10,Delaware,24,Maryland,31,Montgomery County,555,239,316
10,Delaware,24,Maryland,33,Prince George's County,430,167,263
10,Delaware,24,Maryland,35,Queen Anne's County,96,142,-46
10,Delaware,24,Maryland,37,St. Mary's County,55,6,49
10,Delaware,24,Maryland,39,Somerset County,77,75,2
10,Delaware,24,Maryland,41,Talbot County,71,145,-74
10,Delaware,24,Maryland,45,Wicomico County,992,1043,-51
10,Delaware,24,Maryland,47,Worcester County,668,234,434
10,Delaware,24,Maryland,510,Baltimore city,144,282,-138
10,Delaware,25,Massachusetts,1,Barnstable County,35,22,13
10,Delaware,25,Massachusetts,5,Bristol County,8,0,8
10,Delaware,25,Massachusetts,9,Essex County,52,28,24
10,Delaware,25,Massachusetts,13,Hampden County,91,11,80
10,Delaware,25,Massachusetts,15,Hampshire County,0,34,-34
10,Delaware,25,Massachusetts,17,Middlesex County,60,65,-5
10,Delaware,25,Massachusetts,19,Nantucket County,17,0,17
10,Delaware,25,Massachusetts,21,Norfolk County,69,102,-33
10,Delaware,25,Massachusetts,23,Plymouth County,11,0,11
10,Delaware,25,Massachusetts,25,Suffolk County,161,233,-72
10,Delaware,25,Massachusetts,27,Worcester County,64,13,51
10,Delaware,26,Michigan,1,Alcona County,0,6,-6
10,Delaware,26,Michigan,49,Genesee County,15,0,15
10,Delaware,26,Michigan,65,Ingham County,27,0,27
10,Delaware,26,Michigan,67,Ionia County,13,0,13
10,Delaware,26,Michigan,73,Isabella County,0,3,-3
10,Delaware,26,Michigan,91,Lenawee County,0,50,-50
10,Delaware,26,Michigan,99,Macomb County,4,8,-4
10,Delaware,26,Michigan,105,Mason County,0,3,-3
10,Delaware,26,Michigan,115,Monroe County,54,0,54
10,Delaware,26,Michigan,125,Oakland County,0,10,-10
10,Delaware,26,Michigan,139,Ottawa County,0,24,-24
10,Delaware,26,Michigan,145,Saginaw County,14,0,14
10,Delaware,26,Michigan,149,St. Joseph County,0,2,-2
10,Delaware,26,Michigan,161,Washtenaw County,0,8,-8
10,Delaware,26,Michigan,163,Wayne County,35,16,19
10,Delaware,27,Minnesota,35,Crow Wing County,10,0,10
10,Delaware,27,Minnesota,37,Dakota County,0,9,-9
10,Delaware,27,Minnesota,53,Hennepin County,183,55,128
10,Delaware,27,Minnesota,135,Roseau County,0,19,-19
10,Delaware,27,Minnesota,137,St. Louis County,0,16,-16
10,Delaware,27,Minnesota,163,Washington County,0,13,-13
10,Delaware,28,Mississippi,47,Harrison County,6,45,-39
10,Delaware,28,Mississippi,49,Hinds County,64,0,64
10,Delaware,28,Mississippi,67,Jones County,6,0,6
10,Delaware,28,Mississippi,121,Rankin County,0,19,-19
10,Delaware,29,Missouri,1,Adair County,0,43,-43
10,Delaware,29,Missouri,19,Boone County,28,24,4
10,Delaware,29,Missouri,47,Clay County,0,30,-30
10,Delaware,29,Missouri,77,Greene County,8,0,8
10,Delaware,29,Missouri,101,Johnson County,86,0,86
10,Delaware,29,Missouri,169,Pulaski County,0,19,-19
10,Delaware,29,Missouri,183,St. Charles County,62,0,62
10,Delaware,29,Missouri,187,St. Francois County,24,0,24
10,Delaware,29,Missouri,189,St. Louis County,4,0,4
10,Delaware,29,Missouri,510,St. Louis city,28,24,4
10,Delaware,30,Montana,13,Cascade County,29,0,29
10,Delaware,31,Nebraska,25,Cass County,0,2,-2
10,Delaware,31,Nebraska,43,Dakota County,0,2,-2
10,Delaware,31,Nebraska,55,Douglas County,27,0,27
10,Delaware,31,Nebraska,109,Lancaster County,0,6,-6
10,Delaware,31,Nebraska,151,Saline County,13,0,13
10,Delaware,31,Nebraska,153,Sarpy County,0,10,-10
10,Delaware,32,Nevada,3,Clark County,13,160,-147
10,Delaware,33,New Hampshire,11,Hillsborough County,74,42,32
10,Delaware,33,New Hampshire,15,Rockingham County,12,0,12
10,Delaware,33,New Hampshire,17,Strafford County,23,0,23
10,Delaware,34,New Jersey,1,Atlantic County,153,84,69
10,Delaware,34,New Jersey,3,Bergen County,175,115,60
10,Delaware,34,New Jersey,5,Burlington County,420,61,359
10,Delaware,34,New Jersey,7,Camden County,656,206,450
10,Delaware,34,New Jersey,9,Cape May County,59,32,27
10,Delaware,34,New Jersey,11,Cumberland County,77,52,25
10,Delaware,34,New Jersey,13,Essex County,201,57,144
10,Delaware,34,New Jersey,15,Gloucester County,253,294,-41
10,Delaware,34,New Jersey,17,Hudson County,96,74,22
10,Delaware,34,New Jersey,19,Hunterdon County,48,21,27
10,Delaware,34,New Jersey,21,Mercer County,228,52,176
10,Delaware,34,New Jersey,23,Middlesex County,647,67,580
10,Delaware,34,New Jersey,25,Monmouth County,415,9,406
10,Delaware,34,New Jersey,27,Morris County,189,166,23
10,Delaware,34,New Jersey,29,Ocean County,130,14,116
10,Delaware,34,New Jersey,31,Passaic County,238,0,238
10,Delaware,34,New Jersey,33,Salem County,164,153,11
10,Delaware,34,New Jersey,35,Somerset County,115,32,83
10,Delaware,34,New Jersey,37,Sussex County,53,0,53
10,Delaware,34,New Jersey,39,Union County,117,111,6
10,Delaware,34,New Jersey,41,Warren County,58,0,58
10,Delaware,35,New Mexico,1,Bernalillo County,122,9,113
10,Delaware,35,New Mexico,13,Doña Ana County,13,46,-33
10,Delaware,35,New Mexico,27,Lincoln County,2,0,2
10,Delaware,35,New Mexico,35,Otero County,0,49,-49
10,Delaware,35,New Mexico,43,Sandoval County,21,0,21
10,Delaware,35,New Mexico,61,Valencia County,11,0,11
10,Delaware,36,New York,1,Albany County,158,5,153
10,Delaware,36,New York,5,Bronx County,64,35,29
10,Delaware,36,New York,7,Broome County,10,22,-12
10,Delaware,36,New York,15,Chemung County,5,0,5
10,Delaware,36,New York,17,Chenango County,0,5,-5
10,Delaware,36,New York,27,Dutchess County,32,44,-12
10,Delaware,36,New York,29,Erie County,37,10,27
10,Delaware,36,New York,33,Franklin County,0,40,-40
10,Delaware,36,New York,39,Greene County,1,0,1
10,Delaware,36,New York,45,Jefferson County,8,2,6
10,Delaware,36,New York,47,Kings County,309,85,224
10,Delaware,36,New York,51,Livingston County,0,4,-4
10,Delaware,36,New York,55,Monroe County,9,19,-10
10,Delaware,36,New York,59,Nassau County,459,120,339
10,Delaware,36,New York,61,New York County,304,115,189
10,Delaware,36,New York,65,Oneida County,21,12,9
10,Delaware,36,New York,67,Onondaga County,26,26,0
10,Delaware,36,New York,69,Ontario County,6,0,6
10,Delaware,36,New York,71,Orange County,34,6,28
10,Delaware,36,New York,75,Oswego County,31,0,31
10,Delaware,36,New York,77,Otsego County,0,13,-13
10,Delaware,36,New York,79,Putnam County,12,0,12
10,Delaware,36,New York,81,Queens County,702,167,535
10,Delaware,36,New York,83,Rensselaer County,0,4,-4
10,Delaware,36,New York,85,Richmond County,132,49,83
10,Delaware,36,New York,87,Rockland County,24,17,7
10,Delaware,36,New York,89,St. Lawrence County,0,21,-21
10,Delaware,36,New York,91,Saratoga County,0,43,-43
10,Delaware,36,New York,103,Suffolk County,604,43,561
10,Delaware,36,New York,105,Sullivan County,15,11,4
10,Delaware,36,New York,109,Tompkins County,23,157,-134
10,Delaware,36,New York,111,Ulster County,0,121,-121
10,Delaware,36,New York,119,Westchester County,302,54,248
10,Delaware,36,New York,121,Wyoming County,0,4,-4
10,Delaware,37,North Carolina,13,Beaufort County,9,0,9
10,Delaware,37,North Carolina,19,Brunswick County,0,56,-56
10,Delaware,37,North Carolina,21,Buncombe County,0,6,-6
10,Delaware,37,North Carolina,25,Cabarrus County,0,94,-94
10,Delaware,37,North Carolina,31,Carteret County,0,16,-16
10,Delaware,37,North Carolina,45,Cleveland County,35,0,35
10,Delaware,37,North Carolina,49,Craven County,0,32,-32
10,Delaware,37,North Carolina,51,Cumberland County,40,183,-143
10,Delaware,37,North Carolina,55,Dare County,37,3,34
10,Delaware,37,North Carolina,57,Davidson County,0,28,-28
10,Delaware,37,North Carolina,63,Durham County,0,134,-134
10,Delaware,37,North Carolina,67,Forsyth County,265,0,265
10,Delaware,37,North Carolina,71,Gaston County,6,0,6
10,Delaware,37,North Carolina,81,Guilford County,66,51,15
10,Delaware,37,North Carolina,87,Haywood County,0,11,-11
10,Delaware,37,North Carolina,89,Henderson County,19,0,19
10,Delaware,37,North Carolina,93,Hoke County,42,0,42
10,Delaware,37,North Carolina,97,Iredell County,0,9,-9
10,Delaware,37,North Carolina,101,Johnston County,73,0,73
10,Delaware,37,North Carolina,105,Lee County,0,11,-11
10,Delaware,37,North Carolina,107,Lenoir County,55,36,19
10,Delaware,37,North Carolina,119,Mecklenburg County,24,83,-59
10,Delaware,37,North Carolina,129,New Hanover County,7,0,7
10,Delaware,37,North Carolina,133,Onslow County,148,24,124
10,Delaware,37,North Carolina,135,Orange County,60,35,25
10,Delaware,37,North Carolina,139,Pasquotank County,0,11,-11
10,Delaware,37,North Carolina,147,Pitt County,0,4,-4
10,Delaware,37,North Carolina,151,Randolph County,0,19,-19
10,Delaware,37,North Carolina,155,Robeson County,16,0,16
10,Delaware,37,North Carolina,159,Rowan County,0,16,-16
10,Delaware,37,North Carolina,183,Wake County,34,238,-204
10,Delaware,37,North Carolina,189,Watauga County,0,11,-11
10,Delaware,37,North Carolina,191,Wayne County,0,12,-12
10,Delaware,37,North Carolina,195,Wilson County,0,112,-112
10,Delaware,38,North Dakota,9,Bottineau County,0,9,-9
10,Delaware,38,North Dakota,17,Cass County,113,0,113
10,Delaware,38,North Dakota,25,Dunn County,0,17,-17
10,Delaware,39,Ohio,5,Ashland County,19,0,19
10,Delaware,39,Ohio,17,Butler County,0,22,-22
10,Delaware,39,Ohio,25,Clermont County,0,6,-6
10,Delaware,39,Ohio,35,Cuyahoga County,69,38,31
10,Delaware,39,Ohio,45,Fairfield County,0,17,-17
10,Delaware,39,Ohio,49,Franklin County,14,169,-155
10,Delaware,39,Ohio,57,Greene County,0,3,-3
10,Delaware,39,Ohio,61,Hamilton County,12,12,0
10,Delaware,39,Ohio,63,Hancock County,6,0,6
10,Delaware,39,Ohio,71,Highland County,0,14,-14
10,Delaware,39,Ohio,85,Lake County,10,0,10
10,Delaware,39,Ohio,101,Marion County,9,0,9
10,Delaware,39,Ohio,111,Monroe County,0,3,-3
10,Delaware,39,Ohio,113,Montgomery County,0,23,-23
10,Delaware,39,Ohio,127,Perry County,19,0,19
10,Delaware,39,Ohio,133,Portage County,0,13,-13
10,Delaware,39,Ohio,141,Ross County,0,10,-10
10,Delaware,39,Ohio,151,Stark County,12,0,12
10,Delaware,39,Ohio,155,Trumbull County,14,0,14
10,Delaware,39,Ohio,169,Wayne County,0,36,-36
10,Delaware,39,Ohio,173,Wood County,0,32,-32
10,Delaware,4,Arizona,3,Cochise County,0,32,-32
10,Delaware,4,Arizona,13,Maricopa County,117,204,-87
10,Delaware,4,Arizona,15,Mohave County,0,30,-30
10,Delaware,4,Arizona,19,Pima County,7,233,-226
10,Delaware,4,Arizona,21,Pinal County,0,78,-78
10,Delaware,4,Arizona,25,Yavapai County,17,36,-19
10,Delaware,40,Oklahoma,9,Beckham County,2,0,2
10,Delaware,40,Oklahoma,19,Carter County,0,8,-8
10,Delaware,40,Oklahoma,27,Cleveland County,0,14,-14
10,Delaware,40,Oklahoma,31,Comanche County,0,2,-2
10,Delaware,40,Oklahoma,41,Delaware County,0,3,-3
10,Delaware,40,Oklahoma,49,Garvin County,0,4,-4
10,Delaware,40,Oklahoma,65,Jackson County,0,65,-65
10,Delaware,40,Oklahoma,71,Kay County,29,0,29
10,Delaware,40,Oklahoma,81,Lincoln County,57,0,57
10,Delaware,40,Oklahoma,85,Love County,0,10,-10
10,Delaware,40,Oklahoma,109,Oklahoma County,0,44,-44
10,Delaware,40,Oklahoma,131,Rogers County,31,0,31
10,Delaware,40,Oklahoma,143,Tulsa County,23,21,2
10,Delaware,41,Oregon,3,Benton County,26,0,26
10,Delaware,41,Oregon,27,Hood River County,0,33,-33
10,Delaware,41,Oregon,29,Jackson County,0,14,-14
10,Delaware,41,Oregon,39,Lane County,0,43,-43
10,Delaware,41,Oregon,47,Marion County,2,0,2
10,Delaware,41,Oregon,67,Washington County,30,84,-54
10,Delaware,42,Pennsylvania,1,Adams County,7,71,-64
10,Delaware,42,Pennsylvania,3,Allegheny County,471,147,324
10,Delaware,42,Pennsylvania,7,Beaver County,0,41,-41
10,Delaware,42,Pennsylvania,11,Berks County,126,44,82
10,Delaware,42,Pennsylvania,13,Blair County,20,54,-34
10,Delaware,42,Pennsylvania,15,Bradford County,0,17,-17
10,Delaware,42,Pennsylvania,17,Bucks County,301,83,218
10,Delaware,42,Pennsylvania,19,Butler County,0,8,-8
10,Delaware,42,Pennsylvania,21,Cambria County,170,0,170
10,Delaware,42,Pennsylvania,25,Carbon County,14,11,3
10,Delaware,42,Pennsylvania,27,Centre County,174,59,115
10,Delaware,42,Pennsylvania,29,Chester County,1856,1617,239
10,Delaware,42,Pennsylvania,33,Clearfield County,9,0,9
10,Delaware,42,Pennsylvania,37,Columbia County,47,13,34
10,Delaware,42,Pennsylvania,39,Crawford County,19,0,19
10,Delaware,42,Pennsylvania,41,Cumberland County,37,120,-83
10,Delaware,42,Pennsylvania,43,Dauphin County,113,546,-433
10,Delaware,42,Pennsylvania,45,Delaware County,2373,1572,801
10,Delaware,42,Pennsylvania,49,Erie County,16,16,0
10,Delaware,42,Pennsylvania,55,Franklin County,28,5,23
10,Delaware,42,Pennsylvania,59,Greene County,0,4,-4
10,Delaware,42,Pennsylvania,61,Huntingdon County,33,24,9
10,Delaware,42,Pennsylvania,63,Indiana County,2,3,-1
10,Delaware,42,Pennsylvania,69,Lackawanna County,74,32,42
10,Delaware,42,Pennsylvania,71,Lancaster County,549,582,-33
10,Delaware,42,Pennsylvania,73,Lawrence County,16,5,11
10,Delaware,42,Pennsylvania,75,Lebanon County,9,57,-48
10,Delaware,42,Pennsylvania,77,Lehigh County,123,102,21
10,Delaware,42,Pennsylvania,79,Luzerne County,102,30,72
10,Delaware,42,Pennsylvania,81,Lycoming County,8,0,8
10,Delaware,42,Pennsylvania,83,McKean County,37,0,37
10,Delaware,42,Pennsylvania,85,Mercer County,1,0,1
10,Delaware,42,Pennsylvania,89,Monroe County,58,40,18
10,Delaware,42,Pennsylvania,91,Montgomery County,651,237,414
10,Delaware,42,Pennsylvania,93,Montour County,94,0,94
10,Delaware,42,Pennsylvania,95,Northampton County,42,35,7
10,Delaware,42,Pennsylvania,99,Perry County,25,0,25
10,Delaware,42,Pennsylvania,101,Philadelphia County,2298,992,1306
10,Delaware,42,Pennsylvania,103,Pike County,106,5,101
10,Delaware,42,Pennsylvania,105,Potter County,0,4,-4
10,Delaware,42,Pennsylvania,107,Schuylkill County,17,24,-7
10,Delaware,42,Pennsylvania,109,Snyder County,0,34,-34
10,Delaware,42,Pennsylvania,111,Somerset County,2,18,-16
10,Delaware,42,Pennsylvania,113,Sullivan County,0,9,-9
10,Delaware,42,Pennsylvania,115,Susquehanna County,5,3,2
10,Delaware,42,Pennsylvania,121,Venango County,0,1,-1
10,Delaware,42,Pennsylvania,125,Washington County,11,0,11
10,Delaware,42,Pennsylvania,127,Wayne County,3,0,3
10,Delaware,42,Pennsylvania,129,Westmoreland County,125,31,94
10,Delaware,42,Pennsylvania,131,Wyoming County,0,10,-10
10,Delaware,42,Pennsylvania,133,York County,307,124,183
10,Delaware,44,Rhode Island,1,Bristol County,3,0,3
10,Delaware,44,Rhode Island,3,Kent County,4,0,4
10,Delaware,44,Rhode Island,7,Providence County,0,82,-82
10,Delaware,45,South Carolina,3,Aiken County,4,0,4
10,Delaware,45,South Carolina,7,Anderson County,38,0,38
10,Delaware,45,South Carolina,13,Beaufort County,27,56,-29
10,Delaware,45,South Carolina,15,Berkeley County,14,54,-40
10,Delaware,45,South Carolina,19,Charleston County,24,58,-34
10,Delaware,45,South Carolina,21,Cherokee County,17,0,17
10,Delaware,45,South Carolina,31,Darlington County,3,0,3
10,Delaware,45,South Carolina,43,Georgetown County,23,0,23
10,Delaware,45,South Carolina,45,Greenville County,28,32,-4
10,Delaware,45,South Carolina,47,Greenwood County,0,14,-14
10,Delaware,45,South Carolina,51,Horry County,44,31,13
10,Delaware,45,South Carolina,53,Jasper County,10,0,10
10,Delaware,45,South Carolina,63,Lexington County,99,0,99
10,Delaware,45,South Carolina,67,Marion County,12,0,12
10,Delaware,45,South Carolina,73,Oconee County,0,11,-11
10,Delaware,45,South Carolina,77,Pickens County,0,17,-17
10,Delaware,45,South Carolina,79,Richland County,19,44,-25
10,Delaware,45,South Carolina,83,Spartanburg County,15,20,-5
10,Delaware,45,South Carolina,85,Sumter County,32,0,32
10,Delaware,45,South Carolina,89,Williamsburg County,0,14,-14
10,Delaware,46,South Dakota,99,Minnehaha County,6,0,6
10,Delaware,47,Tennessee,3,Bedford County,8,0,8
10,Delaware,47,Tennessee,9,Blount County,0,10,-10
10,Delaware,47,Tennessee,23,Chester County,0,3,-3
10,Delaware,47,Tennessee,35,Cumberland County,0,16,-16
10,Delaware,47,Tennessee,37,Davidson County,6,27,-21
10,Delaware,47,Tennessee,63,Hamblen County,91,0,91
10,Delaware,47,Tennessee,65,Hamilton County,97,22,75
10,Delaware,47,Tennessee,93,Knox County,0,67,-67
10,Delaware,47,Tennessee,125,Montgomery County,3,0,3
10,Delaware,47,Tennessee,143,Rhea County,0,14,-14
10,Delaware,47,Tennessee,149,Rutherford County,15,0,15
10,Delaware,47,Tennessee,163,Sullivan County,0,8,-8
10,Delaware,47,Tennessee,165,Sumner County,0,18,-18
10,Delaware,47,Tennessee,177,Warren County,0,132,-132
10,Delaware,47,Tennessee,189,Wilson County,0,68,-68
10,Delaware,48,Texas,27,Bell County,0,175,-175
10,Delaware,48,Texas,29,Bexar County,236,60,176
10,Delaware,48,Texas,39,Brazoria County,11,0,11
10,Delaware,48,Texas,85,Collin County,0,40,-40
10,Delaware,48,Texas,99,Coryell County,0,10,-10
10,Delaware,48,Texas,121,Denton County,21,28,-7
10,Delaware,48,Texas,141,El Paso County,6,0,6
10,Delaware,48,Texas,161,Freestone County,9,0,9
10,Delaware,48,Texas,181,Grayson County,0,6,-6
10,Delaware,48,Texas,201,Harris County,177,477,-300
10,Delaware,48,Texas,215,Hidalgo County,57,0,57
10,Delaware,48,Texas,291,Liberty County,0,13,-13
10,Delaware,48,Texas,337,Montague County,0,64,-64
10,Delaware,48,Texas,339,Montgomery County,52,60,-8
10,Delaware,48,Texas,355,Nueces County,9,112,-103
10,Delaware,48,Texas,401,Rusk County,0,5,-5
10,Delaware,48,Texas,403,Sabine County,0,60,-60
10,Delaware,48,Texas,439,Tarrant County,4,50,-46
10,Delaware,48,Texas,451,Tom Green County,4,22,-18
10,Delaware,48,Texas,453,Travis County,51,25,26
10,Delaware,48,Texas,473,Waller County,37,0,37
10,Delaware,48,Texas,485,Wichita County,18,12,6
10,Delaware,48,Texas,491,Williamson County,8,0,8
10,Delaware,49,Utah,5,Cache County,9,0,9
10,Delaware,49,Utah,11,Davis County,0,61,-61
10,Delaware,49,Utah,35,Salt Lake County,5,31,-26
10,Delaware,5,Arkansas,145,White County,0,5,-5
10,Delaware,50,Vermont,1,Addison County,10,9,1
10,Delaware,50,Vermont,5,Caledonia County,12,0,12
10,Delaware,50,Vermont,7,Chittenden County,5,8,-3
10,Delaware,50,Vermont,21,Rutland County,0,5,-5
10,Delaware,50,Vermont,23,Washington County,0,6,-6
10,Delaware,50,Vermont,25,Windham County,25,0,25
10,Delaware,50,Vermont,27,Windsor County,0,3,-3
10,Delaware,51,Virginia,1,Accomack County,0,59,-59
10,Delaware,51,Virginia,3,Albemarle County,0,11,-11
10,Delaware,51,Virginia,7,Amelia County,7,0,7
10,Delaware,51,Virginia,11,Appomattox County,0,16,-16
10,Delaware,51,Virginia,13,Arlington County,27,135,-108
10,Delaware,51,Virginia,23,Botetourt County,0,29,-29
10,Delaware,51,Virginia,27,Buchanan County,16,14,2
10,Delaware,51,Virginia,41,Chesterfield County,21,34,-13
10,Delaware,51,Virginia,47,Culpeper County,0,22,-22
10,Delaware,51,Virginia,59,Fairfax County,234,200,34
10,Delaware,51,Virginia,61,Fauquier County,28,0,28
10,Delaware,51,Virginia,65,Fluvanna County,0,5,-5
10,Delaware,51,Virginia,67,Franklin County,0,37,-37
10,Delaware,51,Virginia,77,Grayson County,0,14,-14
10,Delaware,51,Virginia,83,Halifax County,0,51,-51
10,Delaware,51,Virginia,87,Henrico County,54,30,24
10,Delaware,51,Virginia,93,Isle of Wight County,8,0,8
10,Delaware,51,Virginia,99,King George County,3,0,3
10,Delaware,51,Virginia,107,Loudoun County,11,8,3
10,Delaware,51,Virginia,121,Montgomery County,0,14,-14
10,Delaware,51,Virginia,127,New Kent County,0,20,-20
10,Delaware,51,Virginia,131,Northampton County,58,1,57
10,Delaware,51,Virginia,137,Orange County,10,0,10
10,Delaware,51,Virginia,145,Powhatan County,32,0,32
10,Delaware,51,Virginia,149,Prince George County,25,0,25
10,Delaware,51,Virginia,153,Prince William County,74,62,12
10,Delaware,51,Virginia,171,Shenandoah County,0,14,-14
10,Delaware,51,Virginia,177,Spotsylvania County,0,7,-7
10,Delaware,51,Virginia,179,Stafford County,15,48,-33
10,Delaware,51,Virginia,181,Surry County,0,24,-24
10,Delaware,51,Virginia,191,Washington County,8,0,8
10,Delaware,51,Virginia,199,York County,54,27,27
10,Delaware,51,Virginia,510,Alexandria city,41,14,27
10,Delaware,51,Virginia,540,Charlottesville city,6,8,-2
10,Delaware,51,Virginia,550,Chesapeake city,6,0,6
10,Delaware,51,Virginia,630,Fredericksburg city,13,4,9
10,Delaware,51,Virginia,650,Hampton city,67,22,45
10,Delaware,51,Virginia,660,Harrisonburg city,6,36,-30
10,Delaware,51,Virginia,680,Lynchburg city,34,131,-97
10,Delaware,51,Virginia,700,Newport News city,32,15,17
10,Delaware,51,Virginia,710,Norfolk city,218,66,152
10,Delaware,51,Virginia,740,Portsmouth city,12,23,-11
10,Delaware,51,Virginia,760,Richmond city,46,37,9
10,Delaware,51,Virginia,790,Staunton city,0,17,-17
10,Delaware,51,Virginia,800,Suffolk city,7,0,7
10,Delaware,51,Virginia,810,Virginia Beach city,21,28,-7
10,Delaware,53,Washington,11,Clark County,0,45,-45
10,Delaware,53,Washington,17,Douglas County,96,0,96
10,Delaware,53,Washington,27,Grays Harbor County,25,0,25
10,Delaware,53,Washington,29,Island County,0,7,-7
10,Delaware,53,Washington,33,King County,6,85,-79
10,Delaware,53,Washington,47,Okanogan County,6,0,6
10,Delaware,53,Washington,53,Pierce County,0,177,-177
10,Delaware,53,Washington,57,Skagit County,0,21,-21
10,Delaware,53,Washington,61,Snohomish County,0,38,-38
10,Delaware,53,Washington,63,Spokane County,74,20,54
10,Delaware,54,West Virginia,3,Berkeley County,0,22,-22
10,Delaware,54,West Virginia,11,Cabell County,4,7,-3
10,Delaware,54,West Virginia,19,Fayette County,0,2,-2
10,Delaware,54,West Virginia,25,Greenbrier County,76,0,76
10,Delaware,54,West Virginia,27,Hampshire County,0,27,-27
10,Delaware,54,West Virginia,31,Hardy County,0,5,-5
10,Delaware,54,West Virginia,37,Jefferson County,0,9,-9
10,Delaware,54,West Virginia,39,Kanawha County,37,36,1
10,Delaware,54,West Virginia,41,Lewis County,0,18,-18
10,Delaware,54,West Virginia,45,Logan County,10,0,10
10,Delaware,54,West Virginia,55,Mercer County,15,0,15
10,Delaware,54,West Virginia,57,Mineral County,0,18,-18
10,Delaware,54,West Virginia,61,Monongalia County,37,29,8
10,Delaware,54,West Virginia,69,Ohio County,0,3,-3
10,Delaware,54,West Virginia,87,Roane County,0,2,-2
10,Delaware,54,West Virginia,99,Wayne County,0,20,-20
10,Delaware,55,Wisconsin,13,Burnett County,0,2,-2
10,Delaware,55,Wisconsin,25,Dane County,28,8,20
10,Delaware,55,Wisconsin,37,Florence County,0,24,-24
10,Delaware,55,Wisconsin,45,Green County,32,0,32
10,Delaware,55,Wisconsin,79,Milwaukee County,40,0,40
10,Delaware,55,Wisconsin,85,Oneida County,0,26,-26
10,Delaware,55,Wisconsin,91,Pepin County,0,2,-2
10,Delaware,55,Wisconsin,101,Racine County,0,46,-46
10,Delaware,55,Wisconsin,107,Rusk County,0,11,-11
10,Delaware,55,Wisconsin,123,Vernon County,0,3,-3
10,Delaware,56,Wyoming,21,Laramie County,0,29,-29
10,Delaware,56,Wyoming,41,Uinta County,0,8,-8
10,Delaware,6,California,1,Alameda County,81,30,51
10,Delaware,6,California,7,Butte County,12,0,12
10,Delaware,6,California,13,Contra Costa County,36,45,-9
10,Delaware,6,California,19,Fresno County,0,2,-2
10,Delaware,6,California,23,Humboldt County,0,11,-11
10,Delaware,6,California,25,Imperial County,25,0,25
10,Delaware,6,California,29,Kern County,0,17,-17
10,Delaware,6,California,37,Los Angeles County,81,144,-63
10,Delaware,6,California,39,Madera County,20,49,-29
10,Delaware,6,California,53,Monterey County,7,79,-72
10,Delaware,6,California,59,Orange County,75,48,27
10,Delaware,6,California,61,Placer County,0,32,-32
10,Delaware,6,California,67,Sacramento County,34,16,18
10,Delaware,6,California,71,San Bernardino County,110,86,24
10,Delaware,6,California,73,San Diego County,63,87,-24
10,Delaware,6,California,75,San Francisco County,31,0,31
10,Delaware,6,California,77,San Joaquin County,0,72,-72
10,Delaware,6,California,81,San Mateo County,4,0,4
10,Delaware,6,California,83,Santa Barbara County,10,0,10
10,Delaware,6,California,85,Santa Clara County,44,63,-19
10,Delaware,6,California,95,Solano County,0,6,-6
10,Delaware,6,California,97,Sonoma County,0,39,-39
10,Delaware,6,California,113,Yolo County,0,27,-27
10,Delaware,72,Puerto Rico,21,Bayamón Municipio,21,0,21
10,Delaware,72,Puerto Rico,25,Caguas Municipio,57,0,57
10,Delaware,72,Puerto Rico,63,Gurabo Municipio,0,59,-59
10,Delaware,72,Puerto Rico,69,Humacao Municipio,14,0,14
10,Delaware,72,Puerto Rico,71,Isabela Municipio,0,40,-40
10,Delaware,72,Puerto Rico,75,Juana Díaz Municipio,0,17,-17
10,Delaware,72,Puerto Rico,127,San Juan Municipio,101,0,101
10,Delaware,8,Colorado,5,Arapahoe County,4,73,-69
10,Delaware,8,Colorado,13,Boulder County,9,85,-76
10,Delaware,8,Colorado,31,Denver County,5,56,-51
10,Delaware,8,Colorado,35,Douglas County,0,22,-22
10,Delaware,8,Colorado,41,El Paso County,28,21,7
10,Delaware,8,Colorado,59,Jefferson County,39,22,17
10,Delaware,8,Colorado,69,Larimer County,7,0,7
10,Delaware,8,Colorado,77,Mesa County,19,0,19
10,Delaware,8,Colorado,119,Teller County,3,0,3
10,Delaware,9,Connecticut,1,Fairfield County,288,130,158
10,Delaware,9,Connecticut,3,Hartford County,165,29,136
10,Delaware,9,Connecticut,5,Litchfield County,50,0,50
10,Delaware,9,Connecticut,7,Middlesex County,0,29,-29
10,Delaware,9,Connecticut,9,New Haven County,102,53,49
10,Delaware,9,Connecticut,11,New London County,44,12,32
10,Delaware,9,Connecticut,15,Windham County,0,158,-158
10,Delaware,AFR,Africa,,-,353,0,0
10,Delaware,ASI,Asia,,-,2765,0,0
10,Delaware,CAM,Central America,,-,345,0,0
10,Delaware,CAR,Caribbean,,-,311,0,0
10,Delaware,EUR,Europe,,-,455,0,0
10,Delaware,ISL,U.S. Island Areas,,-,13,0,0
10,Delaware,NAM,Northern America,,-,70,0,0
10,Delaware,OCE,Oceania and At Sea,,-,17,0,0
10,Delaware,SAM,South America,,-,327,0,0
11,District of Columbia,1,Alabama,3,Baldwin County,0,50,-50
11,District of Columbia,1,Alabama,43,Cullman County,2,0,2
11,District of Columbia,1,Alabama,47,Dallas County,20,0,20
11,District of Columbia,1,Alabama,65,Hale County,2,0,2
11,District of Columbia,1,Alabama,69,Houston County,0,2,-2
11,District of Columbia,1,Alabama,73,Jefferson County,19,96,-77
11,District of Columbia,1,Alabama,77,Lauderdale County,0,3,-3
11,District of Columbia,1,Alabama,81,Lee County,9,0,9
11,District of Columbia,1,Alabama,89,Madison County,16,0,16
11,District of Columbia,1,Alabama,97,Mobile County,25,7,18
11,District of Columbia,1,Alabama,101,Montgomery County,142,39,103
11,District of Columbia,1,Alabama,107,Pickens County,3,0,3
11,District of Columbia,1,Alabama,117,Shelby County,39,4,35
11,District of Columbia,1,Alabama,125,Tuscaloosa County,33,11,22
11,District of Columbia,10,Delaware,1,Kent County,6,138,-132
11,District of Columbia,10,Delaware,3,New Castle County,198,116,82
11,District of Columbia,10,Delaware,5,Sussex County,96,22,74
11,District of Columbia,12,Florida,1,Alachua County,95,0,95
11,District of Columbia,12,Florida,5,Bay County,0,18,-18
11,District of Columbia,12,Florida,9,Brevard County,56,10,46
11,District of Columbia,12,Florida,11,Broward County,164,103,61
11,District of Columbia,12,Florida,15,Charlotte County,1,0,1
11,District of Columbia,12,Florida,19,Clay County,0,271,-271
11,District of Columbia,12,Florida,21,Collier County,7,39,-32
11,District of Columbia,12,Florida,23,Columbia County,1,0,1
11,District of Columbia,12,Florida,31,Duval County,56,200,-144
11,District of Columbia,12,Florida,33,Escambia County,133,36,97
11,District of Columbia,12,Florida,53,Hernando County,0,10,-10
11,District of Columbia,12,Florida,57,Hillsborough County,175,94,81
11,District of Columbia,12,Florida,61,Indian River County,9,0,9
11,District of Columbia,12,Florida,69,Lake County,10,0,10
11,District of Columbia,12,Florida,71,Lee County,18,0,18
11,District of Columbia,12,Florida,73,Leon County,37,53,-16
11,District of Columbia,12,Florida,81,Manatee County,0,13,-13
11,District of Columbia,12,Florida,83,Marion County,0,10,-10
11,District of Columbia,12,Florida,85,Martin County,5,0,5
11,District of Columbia,12,Florida,86,Miami-Dade County,472,182,290
11,District of Columbia,12,Florida,87,Monroe County,0,11,-11
11,District of Columbia,12,Florida,89,Nassau County,1,16,-15
11,District of Columbia,12,Florida,91,Okaloosa County,32,38,-6
11,District of Columbia,12,Florida,93,Okeechobee County,1,0,1
11,District of Columbia,12,Florida,95,Orange County,108,97,11
11,District of Columbia,12,Florida,97,Osceola County,37,39,-2
11,District of Columbia,12,Florida,99,Palm Beach County,195,53,142
11,District of Columbia,12,Florida,101,Pasco County,29,0,29
11,District of Columbia,12,Florida,103,Pinellas County,79,5,74
11,District of Columbia,12,Florida,105,Polk County,52,0,52
11,District of Columbia,12,Florida,109,St. Johns County,25,56,-31
11,District of Columbia,12,Florida,111,St. Lucie County,10,0,10
11,District of Columbia,12,Florida,115,Sarasota County,32,28,4
11,District of Columbia,12,Florida,117,Seminole County,4,0,4
11,District of Columbia,12,Florida,119,Sumter County,2,0,2
11,District of Columbia,12,Florida,127,Volusia County,20,34,-14
11,District of Columbia,12,Florida,131,Walton County,17,0,17
11,District of Columbia,13,Georgia,21,Bibb County,12,0,12
11,District of Columbia,13,Georgia,25,Brantley County,5,0,5
11,District of Columbia,13,Georgia,31,Bulloch County,46,0,46
11,District of Columbia,13,Georgia,39,Camden County,0,91,-91
11,District of Columbia,13,Georgia,51,Chatham County,14,51,-37
11,District of Columbia,13,Georgia,53,Chattahoochee County,0,23,-23
11,District of Columbia,13,Georgia,57,Cherokee County,10,0,10
11,District of Columbia,13,Georgia,59,Clarke County,79,19,60
11,District of Columbia,13,Georgia,63,Clayton County,20,0,20
11,District of Columbia,13,Georgia,67,Cobb County,133,0,133
11,District of Columbia,13,Georgia,71,Colquitt County,0,33,-33
11,District of Columbia,13,Georgia,73,Columbia County,25,0,25
11,District of Columbia,13,Georgia,77,Coweta County,0,86,-86
11,District of Columbia,13,Georgia,89,DeKalb County,219,148,71
11,District of Columbia,13,Georgia,95,Dougherty County,8,0,8
11,District of Columbia,13,Georgia,97,Douglas County,15,0,15
11,District of Columbia,13,Georgia,113,Fayette County,12,16,-4
11,District of Columbia,13,Georgia,115,Floyd County,14,0,14
11,District of Columbia,13,Georgia,117,Forsyth County,6,0,6
11,District of Columbia,13,Georgia,121,Fulton County,283,351,-68
11,District of Columbia,13,Georgia,135,Gwinnett County,133,55,78
11,District of Columbia,13,Georgia,151,Henry County,42,0,42
11,District of Columbia,13,Georgia,153,Houston County,8,138,-130
11,District of Columbia,13,Georgia,179,Liberty County,12,0,12
11,District of Columbia,13,Georgia,191,McIntosh County,1,0,1
11,District of Columbia,13,Georgia,193,Macon County,10,0,10
11,District of Columbia,13,Georgia,217,Newton County,5,0,5
11,District of Columbia,13,Georgia,245,Richmond County,7,6,1
11,District of Columbia,13,Georgia,247,Rockdale County,17,0,17
11,District of Columbia,13,Georgia,263,Talbot County,23,0,23
11,District of Columbia,13,Georgia,295,Walker County,0,3,-3
11,District of Columbia,13,Georgia,317,Wilkes County,0,11,-11
11,District of Columbia,15,Hawaii,1,Hawaii County,0,217,-217
11,District of Columbia,15,Hawaii,3,Honolulu County,155,185,-30
11,District of Columbia,15,Hawaii,7,Kauai County,0,2,-2
11,District of Columbia,16,Idaho,1,Ada County,142,18,124
11,District of Columbia,16,Idaho,55,Kootenai County,2,0,2
11,District of Columbia,17,Illinois,19,Champaign County,35,52,-17
11,District of Columbia,17,Illinois,31,Cook County,1473,888,585
11,District of Columbia,17,Illinois,37,DeKalb County,6,0,6
11,District of Columbia,17,Illinois,43,DuPage County,91,13,78
11,District of Columbia,17,Illinois,57,Fulton County,0,16,-16
11,District of Columbia,17,Illinois,73,Henry County,0,53,-53
11,District of Columbia,17,Illinois,97,Lake County,13,44,-31
11,District of Columbia,17,Illinois,111,McHenry County,8,0,8
11,District of Columbia,17,Illinois,119,Madison County,20,0,20
11,District of Columbia,17,Illinois,163,St. Clair County,22,0,22
11,District of Columbia,17,Illinois,167,Sangamon County,17,0,17
11,District of Columbia,17,Illinois,183,Vermilion County,0,9,-9
11,District of Columbia,17,Illinois,197,Will County,15,6,9
11,District of Columbia,17,Illinois,201,Winnebago County,0,8,-8
11,District of Columbia,18,Indiana,3,Allen County,30,8,22
11,District of Columbia,18,Indiana,11,Boone County,9,0,9
11,District of Columbia,18,Indiana,39,Elkhart County,9,0,9
11,District of Columbia,18,Indiana,57,Hamilton County,5,0,5
11,District of Columbia,18,Indiana,59,Hancock County,6,0,6
11,District of Columbia,18,Indiana,63,Hendricks County,6,0,6
11,District of Columbia,18,Indiana,81,Johnson County,16,0,16
11,District of Columbia,18,Indiana,89,Lake County,36,0,36
11,District of Columbia,18,Indiana,91,LaPorte County,26,0,26
11,District of Columbia,18,Indiana,97,Marion County,145,311,-166
11,District of Columbia,18,Indiana,103,Miami County,0,1,-1
11,District of Columbia,18,Indiana,105,Monroe County,94,18,76
11,District of Columbia,18,Indiana,135,Randolph County,0,12,-12
11,District of Columbia,18,Indiana,141,St. Joseph County,142,29,113
11,District of Columbia,18,Indiana,157,Tippecanoe County,45,10,35
11,District of Columbia,18,Indiana,163,Vanderburgh County,0,6,-6
11,District of Columbia,18,Indiana,177,Wayne County,0,8,-8
11,District of Columbia,19,Iowa,1,Adair County,8,0,8
11,District of Columbia,19,Iowa,35,Cherokee County,0,1,-1
11,District of Columbia,19,Iowa,49,Dallas County,11,0,11
11,District of Columbia,19,Iowa,61,Dubuque County,8,0,8
11,District of Columbia,19,Iowa,101,Jefferson County,6,0,6
11,District of Columbia,19,Iowa,103,Johnson County,17,0,17
11,District of Columbia,19,Iowa,113,Linn County,4,0,4
11,District of Columbia,19,Iowa,125,Marion County,17,33,-16
11,District of Columbia,19,Iowa,153,Polk County,17,15,2
11,District of Columbia,2,Alaska,20,Anchorage Municipality,114,0,114
11,District of Columbia,2,Alaska,110,Juneau City and Borough,38,0,38
11,District of Columbia,2,Alaska,150,Kodiak Island Borough,30,0,30
11,District of Columbia,20,Kansas,45,Douglas County,9,0,9
11,District of Columbia,20,Kansas,91,Johnson County,18,15,3
11,District of Columbia,20,Kansas,153,Rawlins County,0,1,-1
11,District of Columbia,20,Kansas,173,Sedgwick County,8,0,8
11,District of Columbia,20,Kansas,177,Shawnee County,0,20,-20
11,District of Columbia,21,Kentucky,29,Bullitt County,0,5,-5
11,District of Columbia,21,Kentucky,61,Edmonson County,0,7,-7
11,District of Columbia,21,Kentucky,67,Fayette County,2,37,-35
11,District of Columbia,21,Kentucky,73,Franklin County,0,31,-31
11,District of Columbia,21,Kentucky,111,Jefferson County,90,74,16
11,District of Columbia,21,Kentucky,119,Knott County,0,2,-2
11,District of Columbia,21,Kentucky,147,McCreary County,77,6,71
11,District of Columbia,21,Kentucky,151,Madison County,12,0,12
11,District of Columbia,21,Kentucky,159,Martin County,34,0,34
11,District of Columbia,21,Kentucky,179,Nelson County,0,24,-24
11,District of Columbia,21,Kentucky,217,Taylor County,0,3,-3
11,District of Columbia,21,Kentucky,225,Union County,4,4,0
11,District of Columbia,21,Kentucky,227,Warren County,0,4,-4
11,District of Columbia,22,Louisiana,33,East Baton Rouge Parish,7,50,-43
11,District of Columbia,22,Louisiana,43,Grant Parish,8,0,8
11,District of Columbia,22,Louisiana,51,Jefferson Parish,55,0,55
11,District of Columbia,22,Louisiana,71,Orleans Parish,337,164,173
11,District of Columbia,22,Louisiana,73,Ouachita Parish,44,0,44
11,District of Columbia,22,Louisiana,75,Plaquemines Parish,48,0,48
11,District of Columbia,22,Louisiana,97,St. Landry Parish,11,0,11
11,District of Columbia,22,Louisiana,103,St. Tammany Parish,19,0,19
11,District of Columbia,23,Maine,5,Cumberland County,20,76,-56
11,District of Columbia,23,Maine,11,Kennebec County,20,20,0
11,District of Columbia,23,Maine,17,Oxford County,13,0,13
11,District of Columbia,23,Maine,19,Penobscot County,37,10,27
11,District of Columbia,23,Maine,27,Waldo County,13,8,5
11,District of Columbia,23,Maine,31,York County,42,0,42
11,District of Columbia,24,Maryland,1,Allegany County,41,61,-20
11,District of Columbia,24,Maryland,3,Anne Arundel County,554,454,100
11,District of Columbia,24,Maryland,5,Baltimore County,369,222,147
11,District of Columbia,24,Maryland,9,Calvert County,12,65,-53
11,District of Columbia,24,Maryland,11,Caroline County,0,18,-18
11,District of Columbia,24,Maryland,13,Carroll County,63,5,58
11,District of Columbia,24,Maryland,15,Cecil County,4,29,-25
11,District of Columbia,24,Maryland,17,Charles County,450,641,-191
11,District of Columbia,24,Maryland,19,Dorchester County,0,8,-8
11,District of Columbia,24,Maryland,21,Frederick County,84,157,-73
11,District of Columbia,24,Maryland,23,Garrett County,0,31,-31
11,District of Columbia,24,Maryland,25,Harford County,37,24,13
11,District of Columbia,24,Maryland,27,Howard County,483,96,387
11,District of Columbia,24,Maryland,29,Kent County,0,2,-2
11,District of Columbia,24,Maryland,31,Montgomery County,4334,5948,-1614
11,District of Columbia,24,Maryland,33,Prince George's County,5012,11018,-6006
11,District of Columbia,24,Maryland,35,Queen Anne's County,0,19,-19
11,District of Columbia,24,Maryland,37,St. Mary's County,77,18,59
11,District of Columbia,24,Maryland,39,Somerset County,0,56,-56
11,District of Columbia,24,Maryland,41,Talbot County,38,41,-3
11,District of Columbia,24,Maryland,43,Washington County,42,76,-34
11,District of Columbia,24,Maryland,45,Wicomico County,77,50,27
11,District of Columbia,24,Maryland,47,Worcester County,30,5,25
11,District of Columbia,24,Maryland,510,Baltimore city,580,940,-360
11,District of Columbia,25,Massachusetts,1,Barnstable County,33,90,-57
11,District of Columbia,25,Massachusetts,3,Berkshire County,27,16,11
11,District of Columbia,25,Massachusetts,5,Bristol County,52,25,27
11,District of Columbia,25,Massachusetts,7,Dukes County,0,6,-6
11,District of Columbia,25,Massachusetts,9,Essex County,149,59,90
11,District of Columbia,25,Massachusetts,11,Franklin County,25,5,20
11,District of Columbia,25,Massachusetts,13,Hampden County,63,18,45
11,District of Columbia,25,Massachusetts,15,Hampshire County,85,37,48
11,District of Columbia,25,Massachusetts,17,Middlesex County,711,576,135
11,District of Columbia,25,Massachusetts,21,Norfolk County,170,162,8
11,District of Columbia,25,Massachusetts,23,Plymouth County,75,32,43
11,District of Columbia,25,Massachusetts,25,Suffolk County,457,303,154
11,District of Columbia,25,Massachusetts,27,Worcester County,204,22,182
11,District of Columbia,26,Michigan,21,Berrien County,25,0,25
11,District of Columbia,26,Michigan,23,Branch County,0,5,-5
11,District of Columbia,26,Michigan,25,Calhoun County,0,8,-8
11,District of Columbia,26,Michigan,37,Clinton County,22,0,22
11,District of Columbia,26,Michigan,47,Emmet County,0,5,-5
11,District of Columbia,26,Michigan,55,Grand Traverse County,0,9,-9
11,District of Columbia,26,Michigan,59,Hillsdale County,6,0,6
11,District of Columbia,26,Michigan,63,Huron County,0,3,-3
11,District of Columbia,26,Michigan,65,Ingham County,56,47,9
11,District of Columbia,26,Michigan,73,Isabella County,0,10,-10
11,District of Columbia,26,Michigan,77,Kalamazoo County,4,0,4
11,District of Columbia,26,Michigan,81,Kent County,52,0,52
11,District of Columbia,26,Michigan,91,Lenawee County,6,0,6
11,District of Columbia,26,Michigan,93,Livingston County,27,0,27
11,District of Columbia,26,Michigan,99,Macomb County,6,0,6
11,District of Columbia,26,Michigan,111,Midland County,13,0,13
11,District of Columbia,26,Michigan,125,Oakland County,120,151,-31
11,District of Columbia,26,Michigan,139,Ottawa County,6,0,6
11,District of Columbia,26,Michigan,145,Saginaw County,18,0,18
11,District of Columbia,26,Michigan,147,St. Clair County,11,0,11
11,District of Columbia,26,Michigan,161,Washtenaw County,191,181,10
11,District of Columbia,26,Michigan,163,Wayne County,151,146,5
11,District of Columbia,27,Minnesota,3,Anoka County,12,0,12
11,District of Columbia,27,Minnesota,13,Blue Earth County,0,13,-13
11,District of Columbia,27,Minnesota,37,Dakota County,44,0,44
11,District of Columbia,27,Minnesota,53,Hennepin County,206,133,73
11,District of Columbia,27,Minnesota,109,Olmsted County,23,0,23
11,District of Columbia,27,Minnesota,123,Ramsey County,20,51,-31
11,District of Columbia,27,Minnesota,131,Rice County,27,0,27
11,District of Columbia,27,Minnesota,137,St. Louis County,0,40,-40
11,District of Columbia,27,Minnesota,171,Wright County,0,10,-10
11,District of Columbia,28,Mississippi,5,Amite County,7,0,7
11,District of Columbia,28,Mississippi,29,Copiah County,16,0,16
11,District of Columbia,28,Mississippi,33,DeSoto County,0,16,-16
11,District of Columbia,28,Mississippi,39,George County,0,5,-5
11,District of Columbia,28,Mississippi,47,Harrison County,17,0,17
11,District of Columbia,28,Mississippi,49,Hinds County,32,0,32
11,District of Columbia,28,Mississippi,71,Lafayette County,5,0,5
11,District of Columbia,28,Mississippi,73,Lamar County,7,0,7
11,District of Columbia,28,Mississippi,89,Madison County,34,0,34
11,District of Columbia,28,Mississippi,95,Monroe County,0,3,-3
11,District of Columbia,28,Mississippi,105,Oktibbeha County,21,0,21
11,District of Columbia,28,Mississippi,109,Pearl River County,0,1,-1
11,District of Columbia,29,Missouri,13,Bates County,0,9,-9
11,District of Columbia,29,Missouri,19,Boone County,22,0,22
11,District of Columbia,29,Missouri,37,Cass County,0,7,-7
11,District of Columbia,29,Missouri,51,Cole County,0,10,-10
11,District of Columbia,29,Missouri,79,Grundy County,7,0,7
11,District of Columbia,29,Missouri,95,Jackson County,69,79,-10
11,District of Columbia,29,Missouri,101,Johnson County,9,0,9
11,District of Columbia,29,Missouri,161,Phelps County,0,5,-5
11,District of Columbia,29,Missouri,165,Platte County,7,0,7
11,District of Columbia,29,Missouri,183,St. Charles County,18,82,-64
11,District of Columbia,29,Missouri,189,St. Louis County,84,67,17
11,District of Columbia,29,Missouri,510,St. Louis city,125,196,-71
11,District of Columbia,30,Montana,29,Flathead County,12,0,12
11,District of Columbia,30,Montana,49,Lewis and Clark County,12,10,2
11,District of Columbia,30,Montana,63,Missoula County,0,5,-5
11,District of Columbia,31,Nebraska,1,Adams County,5,0,5
11,District of Columbia,31,Nebraska,33,Cheyenne County,0,1,-1
11,District of Columbia,31,Nebraska,45,Dawes County,6,0,6
11,District of Columbia,31,Nebraska,55,Douglas County,107,1,106
11,District of Columbia,31,Nebraska,109,Lancaster County,92,0,92
11,District of Columbia,31,Nebraska,123,Morrill County,0,6,-6
11,District of Columbia,31,Nebraska,151,Saline County,0,8,-8
11,District of Columbia,31,Nebraska,153,Sarpy County,20,3,17
11,District of Columbia,31,Nebraska,179,Wayne County,0,13,-13
11,District of Columbia,32,Nevada,1,Churchill County,0,7,-7
11,District of Columbia,32,Nevada,3,Clark County,194,35,159
11,District of Columbia,32,Nevada,31,Washoe County,16,170,-154
11,District of Columbia,33,New Hampshire,1,Belknap County,0,6,-6
11,District of Columbia,33,New Hampshire,3,Carroll County,5,0,5
11,District of Columbia,33,New Hampshire,5,Cheshire County,0,19,-19
11,District of Columbia,33,New Hampshire,7,Coos County,0,23,-23
11,District of Columbia,33,New Hampshire,9,Grafton County,27,44,-17
11,District of Columbia,33,New Hampshire,11,Hillsborough County,5,6,-1
11,District of Columbia,33,New Hampshire,13,Merrimack County,13,15,-2
11,District of Columbia,33,New Hampshire,15,Rockingham County,27,36,-9
11,District of Columbia,33,New Hampshire,19,Sullivan County,5,0,5
11,District of Columbia,34,New Jersey,1,Atlantic County,5,0,5
11,District of Columbia,34,New Jersey,3,Bergen County,253,43,210
11,District of Columbia,34,New Jersey,5,Burlington County,138,0,138
11,District of Columbia,34,New Jersey,7,Camden County,136,35,101
11,District of Columbia,34,New Jersey,9,Cape May County,9,3,6
11,District of Columbia,34,New Jersey,11,Cumberland County,58,13,45
11,District of Columbia,34,New Jersey,13,Essex County,219,19,200
11,District of Columbia,34,New Jersey,17,Hudson County,64,297,-233
11,District of Columbia,34,New Jersey,19,Hunterdon County,223,15,208
11,District of Columbia,34,New Jersey,21,Mercer County,164,52,112
11,District of Columbia,34,New Jersey,23,Middlesex County,149,7,142
11,District of Columbia,34,New Jersey,25,Monmouth County,212,29,183
11,District of Columbia,34,New Jersey,27,Morris County,79,124,-45
11,District of Columbia,34,New Jersey,29,Ocean County,39,89,-50
11,District of Columbia,34,New Jersey,31,Passaic County,42,41,1
11,District of Columbia,34,New Jersey,33,Salem County,0,6,-6
11,District of Columbia,34,New Jersey,35,Somerset County,78,23,55
11,District of Columbia,34,New Jersey,37,Sussex County,5,0,5
11,District of Columbia,34,New Jersey,39,Union County,121,79,42
11,District of Columbia,35,New Mexico,1,Bernalillo County,18,82,-64
11,District of Columbia,35,New Mexico,31,McKinley County,9,0,9
11,District of Columbia,35,New Mexico,47,San Miguel County,82,0,82
11,District of Columbia,35,New Mexico,49,Santa Fe County,73,0,73
11,District of Columbia,36,New York,1,Albany County,83,141,-58
11,District of Columbia,36,New York,5,Bronx County,425,10,415
11,District of Columbia,36,New York,7,Broome County,12,0,12
11,District of Columbia,36,New York,19,Clinton County,58,0,58
11,District of Columbia,36,New York,27,Dutchess County,25,0,25
11,District of Columbia,36,New York,29,Erie County,50,127,-77
11,District of Columbia,36,New York,45,Jefferson County,42,10,32
11,District of Columbia,36,New York,47,Kings County,1049,913,136
11,District of Columbia,36,New York,55,Monroe County,68,11,57
11,District of Columbia,36,New York,59,Nassau County,141,121,20
11,District of Columbia,36,New York,61,New York County,1231,1837,-606
11,District of Columbia,36,New York,65,Oneida County,32,7,25
11,District of Columbia,36,New York,67,Onondaga County,110,67,43
11,District of Columbia,36,New York,69,Ontario County,0,10,-10
11,District of Columbia,36,New York,71,Orange County,7,22,-15
11,District of Columbia,36,New York,79,Putnam County,29,0,29
11,District of Columbia,36,New York,81,Queens County,138,136,2
11,District of Columbia,36,New York,85,Richmond County,13,12,1
11,District of Columbia,36,New York,87,Rockland County,21,0,21
11,District of Columbia,36,New York,89,St. Lawrence County,7,0,7
11,District of Columbia,36,New York,91,Saratoga County,33,10,23
11,District of Columbia,36,New York,93,Schenectady County,0,36,-36
11,District of Columbia,36,New York,95,Schoharie County,8,0,8
11,District of Columbia,36,New York,101,Steuben County,0,6,-6
11,District of Columbia,36,New York,103,Suffolk County,220,122,98
11,District of Columbia,36,New York,109,Tompkins County,154,47,107
11,District of Columbia,36,New York,111,Ulster County,50,43,7
11,District of Columbia,36,New York,115,Washington County,0,8,-8
11,District of Columbia,36,New York,119,Westchester County,333,163,170
11,District of Columbia,36,New York,123,Yates County,0,11,-11
11,District of Columbia,37,North Carolina,1,Alamance County,57,58,-1
11,District of Columbia,37,North Carolina,9,Ashe County,0,3,-3
11,District of Columbia,37,North Carolina,13,Beaufort County,0,2,-2
11,District of Columbia,37,North Carolina,15,Bertie County,21,0,21
11,District of Columbia,37,North Carolina,19,Brunswick County,2,1,1
11,District of Columbia,37,North Carolina,21,Buncombe County,18,8,10
11,District of Columbia,37,North Carolina,25,Cabarrus County,0,33,-33
11,District of Columbia,37,North Carolina,31,Carteret County,0,10,-10
11,District of Columbia,37,North Carolina,35,Catawba County,10,0,10
11,District of Columbia,37,North Carolina,45,Cleveland County,8,146,-138
11,District of Columbia,37,North Carolina,49,Craven County,16,0,16
11,District of Columbia,37,North Carolina,51,Cumberland County,16,75,-59
11,District of Columbia,37,North Carolina,53,Currituck County,0,3,-3
11,District of Columbia,37,North Carolina,63,Durham County,343,243,100
11,District of Columbia,37,North Carolina,67,Forsyth County,86,97,-11
11,District of Columbia,37,North Carolina,71,Gaston County,7,0,7
11,District of Columbia,37,North Carolina,77,Granville County,24,0,24
11,District of Columbia,37,North Carolina,81,Guilford County,55,226,-171
11,District of Columbia,37,North Carolina,85,Harnett County,52,65,-13
11,District of Columbia,37,North Carolina,87,Haywood County,7,0,7
11,District of Columbia,37,North Carolina,89,Henderson County,2,0,2
11,District of Columbia,37,North Carolina,91,Hertford County,52,155,-103
11,District of Columbia,37,North Carolina,93,Hoke County,18,0,18
11,District of Columbia,37,North Carolina,97,Iredell County,1,37,-36
11,District of Columbia,37,North Carolina,99,Jackson County,0,34,-34
11,District of Columbia,37,North Carolina,101,Johnston County,2,0,2
11,District of Columbia,37,North Carolina,113,Macon County,1,0,1
11,District of Columbia,37,North Carolina,119,Mecklenburg County,175,207,-32
11,District of Columbia,37,North Carolina,121,Mitchell County,2,0,2
11,District of Columbia,37,North Carolina,125,Moore County,6,7,-1
11,District of Columbia,37,North Carolina,127,Nash County,11,87,-76
11,District of Columbia,37,North Carolina,129,New Hanover County,6,30,-24
11,District of Columbia,37,North Carolina,131,Northampton County,0,47,-47
11,District of Columbia,37,North Carolina,133,Onslow County,55,91,-36
11,District of Columbia,37,North Carolina,135,Orange County,95,115,-20
11,District of Columbia,37,North Carolina,139,Pasquotank County,10,12,-2
11,District of Columbia,37,North Carolina,141,Pender County,2,0,2
11,District of Columbia,37,North Carolina,145,Person County,0,3,-3
11,District of Columbia,37,North Carolina,147,Pitt County,35,0,35
11,District of Columbia,37,North Carolina,151,Randolph County,0,28,-28
11,District of Columbia,37,North Carolina,155,Robeson County,1,6,-5
11,District of Columbia,37,North Carolina,159,Rowan County,0,54,-54
11,District of Columbia,37,North Carolina,163,Sampson County,9,23,-14
11,District of Columbia,37,North Carolina,165,Scotland County,9,0,9
11,District of Columbia,37,North Carolina,169,Stokes County,0,8,-8
11,District of Columbia,37,North Carolina,173,Swain County,0,8,-8
11,District of Columbia,37,North Carolina,179,Union County,7,0,7
11,District of Columbia,37,North Carolina,181,Vance County,0,56,-56
11,District of Columbia,37,North Carolina,183,Wake County,289,139,150
11,District of Columbia,37,North Carolina,189,Watauga County,11,0,11
11,District of Columbia,37,North Carolina,191,Wayne County,33,2,31
11,District of Columbia,37,North Carolina,193,Wilkes County,1,6,-5
11,District of Columbia,37,North Carolina,195,Wilson County,15,0,15
11,District of Columbia,38,North Dakota,15,Burleigh County,18,0,18
11,District of Columbia,38,North Dakota,17,Cass County,0,29,-29
11,District of Columbia,38,North Dakota,23,Divide County,4,0,4
11,District of Columbia,38,North Dakota,59,Morton County,6,0,6
11,District of Columbia,39,Ohio,9,Athens County,9,4,5
11,District of Columbia,39,Ohio,17,Butler County,45,0,45
11,District of Columbia,39,Ohio,21,Champaign County,106,0,106
11,District of Columbia,39,Ohio,25,Clermont County,0,178,-178
11,District of Columbia,39,Ohio,35,Cuyahoga County,105,118,-13
11,District of Columbia,39,Ohio,41,Delaware County,0,26,-26
11,District of Columbia,39,Ohio,45,Fairfield County,27,0,27
11,District of Columbia,39,Ohio,49,Franklin County,59,193,-134
11,District of Columbia,39,Ohio,55,Geauga County,12,48,-36
11,District of Columbia,39,Ohio,57,Greene County,0,4,-4
11,District of Columbia,39,Ohio,61,Hamilton County,104,129,-25
11,District of Columbia,39,Ohio,83,Knox County,0,18,-18
11,District of Columbia,39,Ohio,85,Lake County,7,0,7
11,District of Columbia,39,Ohio,89,Licking County,0,18,-18
11,District of Columbia,39,Ohio,93,Lorain County,19,0,19
11,District of Columbia,39,Ohio,95,Lucas County,8,16,-8
11,District of Columbia,39,Ohio,99,Mahoning County,0,24,-24
11,District of Columbia,39,Ohio,113,Montgomery County,16,0,16
11,District of Columbia,39,Ohio,133,Portage County,0,29,-29
11,District of Columbia,39,Ohio,147,Seneca County,0,31,-31
11,District of Columbia,39,Ohio,153,Summit County,42,11,31
11,District of Columbia,39,Ohio,165,Warren County,3,0,3
11,District of Columbia,39,Ohio,167,Washington County,13,0,13
11,District of Columbia,39,Ohio,169,Wayne County,90,25,65
11,District of Columbia,39,Ohio,173,Wood County,0,13,-13
11,District of Columbia,4,Arizona,1,Apache County,0,8,-8
11,District of Columbia,4,Arizona,13,Maricopa County,241,136,105
11,District of Columbia,4,Arizona,15,Mohave County,25,0,25
11,District of Columbia,4,Arizona,17,Navajo County,0,3,-3
11,District of Columbia,4,Arizona,19,Pima County,12,103,-91
11,District of Columbia,4,Arizona,21,Pinal County,7,0,7
11,District of Columbia,4,Arizona,23,Santa Cruz County,0,7,-7
11,District of Columbia,4,Arizona,27,Yuma County,41,0,41
11,District of Columbia,40,Oklahoma,13,Bryan County,19,0,19
11,District of Columbia,40,Oklahoma,27,Cleveland County,14,46,-32
11,District of Columbia,40,Oklahoma,31,Comanche County,0,59,-59
11,District of Columbia,40,Oklahoma,39,Custer County,9,0,9
11,District of Columbia,40,Oklahoma,81,Lincoln County,0,13,-13
11,District of Columbia,40,Oklahoma,109,Oklahoma County,0,42,-42
11,District of Columbia,40,Oklahoma,119,Payne County,0,27,-27
11,District of Columbia,40,Oklahoma,143,Tulsa County,57,16,41
11,District of Columbia,40,Oklahoma,145,Wagoner County,0,18,-18
11,District of Columbia,41,Oregon,3,Benton County,24,0,24
11,District of Columbia,41,Oregon,5,Clackamas County,0,82,-82
11,District of Columbia,41,Oregon,29,Jackson County,0,20,-20
11,District of Columbia,41,Oregon,31,Jefferson County,0,8,-8
11,District of Columbia,41,Oregon,37,Lake County,0,5,-5
11,District of Columbia,41,Oregon,39,Lane County,46,0,46
11,District of Columbia,41,Oregon,41,Lincoln County,0,13,-13
11,District of Columbia,41,Oregon,49,Morrow County,0,7,-7
11,District of Columbia,41,Oregon,51,Multnomah County,12,243,-231
11,District of Columbia,41,Oregon,59,Umatilla County,10,0,10
11,District of Columbia,41,Oregon,67,Washington County,42,20,22
11,District of Columbia,42,Pennsylvania,1,Adams County,10,22,-12
11,District of Columbia,42,Pennsylvania,3,Allegheny County,333,181,152
11,District of Columbia,42,Pennsylvania,11,Berks County,28,3,25
11,District of Columbia,42,Pennsylvania,13,Blair County,0,54,-54
11,District of Columbia,42,Pennsylvania,17,Bucks County,114,106,8
11,District of Columbia,42,Pennsylvania,19,Butler County,2,8,-6
11,District of Columbia,42,Pennsylvania,21,Cambria County,0,43,-43
11,District of Columbia,42,Pennsylvania,27,Centre County,86,23,63
11,District of Columbia,42,Pennsylvania,29,Chester County,34,116,-82
11,District of Columbia,42,Pennsylvania,37,Columbia County,62,8,54
11,District of Columbia,42,Pennsylvania,39,Crawford County,18,2,16
11,District of Columbia,42,Pennsylvania,41,Cumberland County,67,41,26
11,District of Columbia,42,Pennsylvania,43,Dauphin County,9,21,-12
11,District of Columbia,42,Pennsylvania,45,Delaware County,130,0,130
11,District of Columbia,42,Pennsylvania,49,Erie County,18,0,18
11,District of Columbia,42,Pennsylvania,53,Forest County,0,3,-3
11,District of Columbia,42,Pennsylvania,55,Franklin County,0,36,-36
11,District of Columbia,42,Pennsylvania,63,Indiana County,0,7,-7
11,District of Columbia,42,Pennsylvania,69,Lackawanna County,4,3,1
11,District of Columbia,42,Pennsylvania,71,Lancaster County,111,93,18
11,District of Columbia,42,Pennsylvania,77,Lehigh County,60,0,60
11,District of Columbia,42,Pennsylvania,79,Luzerne County,16,0,16
11,District of Columbia,42,Pennsylvania,81,Lycoming County,0,2,-2
11,District of Columbia,42,Pennsylvania,83,McKean County,0,5,-5
11,District of Columbia,42,Pennsylvania,89,Monroe County,14,0,14
11,District of Columbia,42,Pennsylvania,91,Montgomery County,224,150,74
11,District of Columbia,42,Pennsylvania,95,Northampton County,33,14,19
11,District of Columbia,42,Pennsylvania,97,Northumberland County,0,30,-30
11,District of Columbia,42,Pennsylvania,101,Philadelphia County,515,761,-246
11,District of Columbia,42,Pennsylvania,105,Potter County,0,11,-11
11,District of Columbia,42,Pennsylvania,107,Schuylkill County,36,0,36
11,District of Columbia,42,Pennsylvania,109,Snyder County,0,19,-19
11,District of Columbia,42,Pennsylvania,119,Union County,78,1,77
11,District of Columbia,42,Pennsylvania,125,Washington County,0,12,-12
11,District of Columbia,42,Pennsylvania,127,Wayne County,38,15,23
11,District of Columbia,42,Pennsylvania,129,Westmoreland County,0,47,-47
11,District of Columbia,42,Pennsylvania,133,York County,73,60,13
11,District of Columbia,44,Rhode Island,1,Bristol County,26,0,26
11,District of Columbia,44,Rhode Island,3,Kent County,34,3,31
11,District of Columbia,44,Rhode Island,5,Newport County,132,6,126
11,District of Columbia,44,Rhode Island,7,Providence County,248,17,231
11,District of Columbia,45,South Carolina,1,Abbeville County,0,3,-3
11,District of Columbia,45,South Carolina,11,Barnwell County,2,0,2
11,District of Columbia,45,South Carolina,13,Beaufort County,48,48,0
11,District of Columbia,45,South Carolina,15,Berkeley County,14,15,-1
11,District of Columbia,45,South Carolina,19,Charleston County,105,124,-19
11,District of Columbia,45,South Carolina,23,Chester County,0,26,-26
11,District of Columbia,45,South Carolina,25,Chesterfield County,0,2,-2
11,District of Columbia,45,South Carolina,27,Clarendon County,0,67,-67
11,District of Columbia,45,South Carolina,35,Dorchester County,136,0,136
11,District of Columbia,45,South Carolina,37,Edgefield County,1,0,1
11,District of Columbia,45,South Carolina,39,Fairfield County,16,0,16
11,District of Columbia,45,South Carolina,41,Florence County,10,0,10
11,District of Columbia,45,South Carolina,43,Georgetown County,0,70,-70
11,District of Columbia,45,South Carolina,45,Greenville County,11,50,-39
11,District of Columbia,45,South Carolina,47,Greenwood County,0,8,-8
11,District of Columbia,45,South Carolina,51,Horry County,22,0,22
11,District of Columbia,45,South Carolina,57,Lancaster County,7,0,7
11,District of Columbia,45,South Carolina,71,Newberry County,11,37,-26
11,District of Columbia,45,South Carolina,75,Orangeburg County,23,0,23
11,District of Columbia,45,South Carolina,79,Richland County,113,157,-44
11,District of Columbia,45,South Carolina,81,Saluda County,12,0,12
11,District of Columbia,45,South Carolina,83,Spartanburg County,13,0,13
11,District of Columbia,45,South Carolina,85,Sumter County,32,0,32
11,District of Columbia,45,South Carolina,89,Williamsburg County,0,23,-23
11,District of Columbia,46,South Dakota,11,Brookings County,0,5,-5
11,District of Columbia,46,South Dakota,99,Minnehaha County,3,0,3
11,District of Columbia,46,South Dakota,103,Pennington County,20,0,20
11,District of Columbia,47,Tennessee,1,Anderson County,0,6,-6
11,District of Columbia,47,Tennessee,9,Blount County,13,67,-54
11,District of Columbia,47,Tennessee,35,Cumberland County,38,0,38
11,District of Columbia,47,Tennessee,37,Davidson County,199,227,-28
11,District of Columbia,47,Tennessee,45,Dyer County,0,6,-6
11,District of Columbia,47,Tennessee,49,Fentress County,0,2,-2
11,District of Columbia,47,Tennessee,51,Franklin County,0,5,-5
11,District of Columbia,47,Tennessee,65,Hamilton County,56,35,21
11,District of Columbia,47,Tennessee,93,Knox County,13,52,-39
11,District of Columbia,47,Tennessee,103,Lincoln County,22,0,22
11,District of Columbia,47,Tennessee,107,McMinn County,0,1,-1
11,District of Columbia,47,Tennessee,123,Monroe County,0,13,-13
11,District of Columbia,47,Tennessee,125,Montgomery County,26,11,15
11,District of Columbia,47,Tennessee,129,Morgan County,0,1,-1
11,District of Columbia,47,Tennessee,143,Rhea County,9,0,9
11,District of Columbia,47,Tennessee,149,Rutherford County,6,16,-10
11,District of Columbia,47,Tennessee,155,Sevier County,0,48,-48
11,District of Columbia,47,Tennessee,157,Shelby County,222,56,166
11,District of Columbia,47,Tennessee,163,Sullivan County,12,2,10
11,District of Columbia,47,Tennessee,165,Sumner County,9,26,-17
11,District of Columbia,47,Tennessee,179,Washington County,7,0,7
11,District of Columbia,47,Tennessee,187,Williamson County,23,0,23
11,District of Columbia,48,Texas,25,Bee County,0,2,-2
11,District of Columbia,48,Texas,27,Bell County,48,18,30
11,District of Columbia,48,Texas,29,Bexar County,174,213,-39
11,District of Columbia,48,Texas,39,Brazoria County,7,0,7
11,District of Columbia,48,Texas,41,Brazos County,7,41,-34
11,District of Columbia,48,Texas,47,Brooks County,0,8,-8
11,District of Columbia,48,Texas,55,Caldwell County,0,6,-6
11,District of Columbia,48,Texas,73,Cherokee County,6,0,6
11,District of Columbia,48,Texas,85,Collin County,82,0,82
11,District of Columbia,48,Texas,99,Coryell County,5,11,-6
11,District of Columbia,48,Texas,113,Dallas County,321,258,63
11,District of Columbia,48,Texas,121,Denton County,37,14,23
11,District of Columbia,48,Texas,141,El Paso County,7,5,2
11,District of Columbia,48,Texas,157,Fort Bend County,55,0,55
11,District of Columbia,48,Texas,187,Guadalupe County,0,10,-10
11,District of Columbia,48,Texas,201,Harris County,357,311,46
11,District of Columbia,48,Texas,203,Harrison County,0,32,-32
11,District of Columbia,48,Texas,215,Hidalgo County,0,89,-89
11,District of Columbia,48,Texas,283,La Salle County,10,0,10
11,District of Columbia,48,Texas,309,McLennan County,0,9,-9
11,District of Columbia,48,Texas,325,Medina County,13,0,13
11,District of Columbia,48,Texas,339,Montgomery County,10,0,10
11,District of Columbia,48,Texas,355,Nueces County,47,61,-14
11,District of Columbia,48,Texas,381,Randall County,0,8,-8
11,District of Columbia,48,Texas,389,Reeves County,0,10,-10
11,District of Columbia,48,Texas,397,Rockwall County,43,0,43
11,District of Columbia,48,Texas,439,Tarrant County,150,72,78
11,District of Columbia,48,Texas,453,Travis County,437,209,228
11,District of Columbia,48,Texas,479,Webb County,0,14,-14
11,District of Columbia,48,Texas,491,Williamson County,34,24,10
11,District of Columbia,49,Utah,3,Box Elder County,18,0,18
11,District of Columbia,49,Utah,5,Cache County,0,28,-28
11,District of Columbia,49,Utah,11,Davis County,70,0,70
11,District of Columbia,49,Utah,35,Salt Lake County,80,214,-134
11,District of Columbia,49,Utah,49,Utah County,109,34,75
11,District of Columbia,49,Utah,53,Washington County,0,31,-31
11,District of Columbia,49,Utah,57,Weber County,0,5,-5
11,District of Columbia,5,Arkansas,7,Benton County,0,42,-42
11,District of Columbia,5,Arkansas,17,Chicot County,9,0,9
11,District of Columbia,5,Arkansas,31,Craighead County,26,0,26
11,District of Columbia,5,Arkansas,43,Drew County,0,20,-20
11,District of Columbia,5,Arkansas,45,Faulkner County,0,11,-11
11,District of Columbia,5,Arkansas,51,Garland County,0,5,-5
11,District of Columbia,5,Arkansas,57,Hempstead County,9,0,9
11,District of Columbia,5,Arkansas,85,Lonoke County,13,0,13
11,District of Columbia,5,Arkansas,119,Pulaski County,29,38,-9
11,District of Columbia,5,Arkansas,121,Randolph County,0,23,-23
11,District of Columbia,5,Arkansas,143,Washington County,0,17,-17
11,District of Columbia,50,Vermont,1,Addison County,2,3,-1
11,District of Columbia,50,Vermont,3,Bennington County,0,8,-8
11,District of Columbia,50,Vermont,5,Caledonia County,23,4,19
11,District of Columbia,50,Vermont,7,Chittenden County,55,68,-13
11,District of Columbia,50,Vermont,19,Orleans County,0,11,-11
11,District of Columbia,50,Vermont,21,Rutland County,0,14,-14
11,District of Columbia,50,Vermont,23,Washington County,0,10,-10
11,District of Columbia,50,Vermont,25,Windham County,0,4,-4
11,District of Columbia,50,Vermont,27,Windsor County,0,34,-34
11,District of Columbia,51,Virginia,1,Accomack County,0,198,-198
11,District of Columbia,51,Virginia,3,Albemarle County,57,50,7
11,District of Columbia,51,Virginia,9,Amherst County,0,8,-8
11,District of Columbia,51,Virginia,13,Arlington County,2795,3378,-583
11,District of Columbia,51,Virginia,15,Augusta County,9,7,2
11,District of Columbia,51,Virginia,25,Brunswick County,20,0,20
11,District of Columbia,51,Virginia,27,Buchanan County,1,0,1
11,District of Columbia,51,Virginia,29,Buckingham County,0,26,-26
11,District of Columbia,51,Virginia,33,Caroline County,1,7,-6
11,District of Columbia,51,Virginia,36,Charles City County,0,5,-5
11,District of Columbia,51,Virginia,41,Chesterfield County,34,102,-68
11,District of Columbia,51,Virginia,47,Culpeper County,0,10,-10
11,District of Columbia,51,Virginia,53,Dinwiddie County,9,0,9
11,District of Columbia,51,Virginia,57,Essex County,0,6,-6
11,District of Columbia,51,Virginia,59,Fairfax County,1996,2755,-759
11,District of Columbia,51,Virginia,61,Fauquier County,26,0,26
11,District of Columbia,51,Virginia,65,Fluvanna County,13,0,13
11,District of Columbia,51,Virginia,69,Frederick County,20,0,20
11,District of Columbia,51,Virginia,73,Gloucester County,49,0,49
11,District of Columbia,51,Virginia,75,Goochland County,1,16,-15
11,District of Columbia,51,Virginia,81,Greensville County,0,32,-32
11,District of Columbia,51,Virginia,85,Hanover County,0,89,-89
11,District of Columbia,51,Virginia,87,Henrico County,34,26,8
11,District of Columbia,51,Virginia,95,James City County,6,7,-1
11,District of Columbia,51,Virginia,99,King George County,14,0,14
11,District of Columbia,51,Virginia,103,Lancaster County,0,12,-12
11,District of Columbia,51,Virginia,105,Lee County,10,0,10
11,District of Columbia,51,Virginia,107,Loudoun County,310,300,10
11,District of Columbia,51,Virginia,109,Louisa County,15,0,15
11,District of Columbia,51,Virginia,115,Mathews County,0,16,-16
11,District of Columbia,51,Virginia,121,Montgomery County,41,30,11
11,District of Columbia,51,Virginia,139,Page County,0,8,-8
11,District of Columbia,51,Virginia,145,Powhatan County,0,6,-6
11,District of Columbia,51,Virginia,149,Prince George County,0,12,-12
11,District of Columbia,51,Virginia,153,Prince William County,327,175,152
11,District of Columbia,51,Virginia,159,Richmond County,0,19,-19
11,District of Columbia,51,Virginia,171,Shenandoah County,0,12,-12
11,District of Columbia,51,Virginia,177,Spotsylvania County,14,86,-72
11,District of Columbia,51,Virginia,179,Stafford County,30,65,-35
11,District of Columbia,51,Virginia,181,Surry County,1,0,1
11,District of Columbia,51,Virginia,187,Warren County,7,21,-14
11,District of Columbia,51,Virginia,191,Washington County,2,0,2
11,District of Columbia,51,Virginia,193,Westmoreland County,13,0,13
11,District of Columbia,51,Virginia,199,York County,39,22,17
11,District of Columbia,51,Virginia,510,Alexandria city,1277,1685,-408
11,District of Columbia,51,Virginia,520,Bristol city,0,27,-27
11,District of Columbia,51,Virginia,540,Charlottesville city,191,70,121
11,District of Columbia,51,Virginia,550,Chesapeake city,64,21,43
11,District of Columbia,51,Virginia,580,Covington city,0,4,-4
11,District of Columbia,51,Virginia,590,Danville city,29,26,3
11,District of Columbia,51,Virginia,600,Fairfax city,31,0,31
11,District of Columbia,51,Virginia,610,Falls Church city,38,73,-35
11,District of Columbia,51,Virginia,630,Fredericksburg city,86,129,-43
11,District of Columbia,51,Virginia,650,Hampton city,30,184,-154
11,District of Columbia,51,Virginia,660,Harrisonburg city,0,55,-55
11,District of Columbia,51,Virginia,670,Hopewell city,135,0,135
11,District of Columbia,51,Virginia,678,Lexington city,51,7,44
11,District of Columbia,51,Virginia,680,Lynchburg city,53,78,-25
11,District of Columbia,51,Virginia,683,Manassas city,49,0,49
11,District of Columbia,51,Virginia,700,Newport News city,16,39,-23
11,District of Columbia,51,Virginia,710,Norfolk city,77,314,-237
11,District of Columbia,51,Virginia,740,Portsmouth city,19,113,-94
11,District of Columbia,51,Virginia,760,Richmond city,190,161,29
11,District of Columbia,51,Virginia,770,Roanoke city,14,11,3
11,District of Columbia,51,Virginia,790,Staunton city,0,15,-15
11,District of Columbia,51,Virginia,800,Suffolk city,70,5,65
11,District of Columbia,51,Virginia,810,Virginia Beach city,186,64,122
11,District of Columbia,51,Virginia,820,Waynesboro city,0,25,-25
11,District of Columbia,51,Virginia,830,Williamsburg city,84,5,79
11,District of Columbia,51,Virginia,840,Winchester city,39,0,39
11,District of Columbia,53,Washington,11,Clark County,34,30,4
11,District of Columbia,53,Washington,29,Island County,0,22,-22
11,District of Columbia,53,Washington,31,Jefferson County,5,0,5
11,District of Columbia,53,Washington,33,King County,278,512,-234
11,District of Columbia,53,Washington,45,Mason County,0,9,-9
11,District of Columbia,53,Washington,47,Okanogan County,0,3,-3
11,District of Columbia,53,Washington,53,Pierce County,38,10,28
11,District of Columbia,53,Washington,55,San Juan County,0,8,-8
11,District of Columbia,53,Washington,61,Snohomish County,5,9,-4
11,District of Columbia,53,Washington,63,Spokane County,6,8,-2
11,District of Columbia,53,Washington,67,Thurston County,0,17,-17
11,District of Columbia,53,Washington,73,Whatcom County,5,0,5
11,District of Columbia,53,Washington,77,Yakima County,17,0,17
11,District of Columbia,54,West Virginia,3,Berkeley County,49,26,23
11,District of Columbia,54,West Virginia,9,Brooke County,0,4,-4
11,District of Columbia,54,West Virginia,11,Cabell County,10,28,-18
11,District of Columbia,54,West Virginia,21,Gilmer County,96,66,30
11,District of Columbia,54,West Virginia,25,Greenbrier County,4,5,-1
11,District of Columbia,54,West Virginia,31,Hardy County,0,11,-11
11,District of Columbia,54,West Virginia,33,Harrison County,0,3,-3
11,District of Columbia,54,West Virginia,37,Jefferson County,3,91,-88
11,District of Columbia,54,West Virginia,39,Kanawha County,110,184,-74
11,District of Columbia,54,West Virginia,43,Lincoln County,11,0,11
11,District of Columbia,54,West Virginia,47,McDowell County,8,0,8
11,District of Columbia,54,West Virginia,49,Marion County,0,18,-18
11,District of Columbia,54,West Virginia,57,Mineral County,0,35,-35
11,District of Columbia,54,West Virginia,59,Mingo County,2,0,2
11,District of Columbia,54,West Virginia,61,Monongalia County,6,19,-13
11,District of Columbia,54,West Virginia,77,Preston County,35,25,10
11,District of Columbia,54,West Virginia,81,Raleigh County,1,18,-17
11,District of Columbia,54,West Virginia,83,Randolph County,0,7,-7
11,District of Columbia,54,West Virginia,93,Tucker County,0,12,-12
11,District of Columbia,54,West Virginia,99,Wayne County,1,0,1
11,District of Columbia,54,West Virginia,107,Wood County,2,29,-27
11,District of Columbia,55,Wisconsin,5,Barron County,0,16,-16
11,District of Columbia,55,Wisconsin,9,Brown County,14,12,2
11,District of Columbia,55,Wisconsin,25,Dane County,72,183,-111
11,District of Columbia,55,Wisconsin,27,Dodge County,0,7,-7
11,District of Columbia,55,Wisconsin,55,Jefferson County,0,8,-8
11,District of Columbia,55,Wisconsin,73,Marathon County,21,18,3
11,District of Columbia,55,Wisconsin,79,Milwaukee County,70,14,56
11,District of Columbia,55,Wisconsin,101,Racine County,9,0,9
11,District of Columbia,55,Wisconsin,105,Rock County,13,0,13
11,District of Columbia,55,Wisconsin,133,Waukesha County,3,0,3
11,District of Columbia,55,Wisconsin,141,Wood County,32,2,30
11,District of Columbia,56,Wyoming,1,Albany County,2,0,2
11,District of Columbia,56,Wyoming,21,Laramie County,39,6,33
11,District of Columbia,6,California,1,Alameda County,358,536,-178
11,District of Columbia,6,California,7,Butte County,11,95,-84
11,District of Columbia,6,California,13,Contra Costa County,132,89,43
11,District of Columbia,6,California,19,Fresno County,8,0,8
11,District of Columbia,6,California,25,Imperial County,0,1,-1
11,District of Columbia,6,California,31,Kings County,49,44,5
11,District of Columbia,6,California,37,Los Angeles County,1175,1275,-100
11,District of Columbia,6,California,41,Marin County,70,23,47
11,District of Columbia,6,California,53,Monterey County,116,21,95
11,District of Columbia,6,California,55,Napa County,0,21,-21
11,District of Columbia,6,California,59,Orange County,271,93,178
11,District of Columbia,6,California,61,Placer County,57,0,57
11,District of Columbia,6,California,65,Riverside County,48,138,-90
11,District of Columbia,6,California,67,Sacramento County,160,158,2
11,District of Columbia,6,California,71,San Bernardino County,66,67,-1
11,District of Columbia,6,California,73,San Diego County,621,746,-125
11,District of Columbia,6,California,75,San Francisco County,214,662,-448
11,District of Columbia,6,California,77,San Joaquin County,18,0,18
11,District of Columbia,6,California,79,San Luis Obispo County,0,40,-40
11,District of Columbia,6,California,81,San Mateo County,38,164,-126
11,District of Columbia,6,California,83,Santa Barbara County,86,168,-82
11,District of Columbia,6,California,85,Santa Clara County,212,377,-165
11,District of Columbia,6,California,87,Santa Cruz County,69,92,-23
11,District of Columbia,6,California,89,Shasta County,0,9,-9
11,District of Columbia,6,California,91,Sierra County,0,1,-1
11,District of Columbia,6,California,95,Solano County,33,28,5
11,District of Columbia,6,California,97,Sonoma County,0,37,-37
11,District of Columbia,6,California,99,Stanislaus County,2,1,1
11,District of Columbia,6,California,107,Tulare County,0,20,-20
11,District of Columbia,6,California,111,Ventura County,28,55,-27
11,District of Columbia,6,California,113,Yolo County,20,42,-22
11,District of Columbia,72,Puerto Rico,31,Carolina Municipio,0,9,-9
11,District of Columbia,72,Puerto Rico,51,Dorado Municipio,48,0,48
11,District of Columbia,72,Puerto Rico,61,Guaynabo Municipio,8,0,8
11,District of Columbia,72,Puerto Rico,85,Las Piedras Municipio,6,0,6
11,District of Columbia,72,Puerto Rico,127,San Juan Municipio,108,7,101
11,District of Columbia,72,Puerto Rico,135,Toa Alta Municipio,12,0,12
11,District of Columbia,72,Puerto Rico,139,Trujillo Alto Municipio,0,9,-9
11,District of Columbia,8,Colorado,1,Adams County,0,37,-37
11,District of Columbia,8,Colorado,5,Arapahoe County,116,64,52
11,District of Columbia,8,Colorado,13,Boulder County,40,21,19
11,District of Columbia,8,Colorado,14,Broomfield County,0,19,-19
11,District of Columbia,8,Colorado,31,Denver County,191,493,-302
11,District of Columbia,8,Colorado,35,Douglas County,7,0,7
11,District of Columbia,8,Colorado,37,Eagle County,11,0,11
11,District of Columbia,8,Colorado,41,El Paso County,58,38,20
11,District of Columbia,8,Colorado,43,Fremont County,0,3,-3
11,District of Columbia,8,Colorado,59,Jefferson County,89,251,-162
11,District of Columbia,8,Colorado,69,Larimer County,8,38,-30
11,District of Columbia,8,Colorado,95,Phillips County,0,14,-14
11,District of Columbia,8,Colorado,97,Pitkin County,8,0,8
11,District of Columbia,8,Colorado,107,Routt County,59,0,59
11,District of Columbia,8,Colorado,123,Weld County,22,0,22
11,District of Columbia,9,Connecticut,1,Fairfield County,544,138,406
11,District of Columbia,9,Connecticut,3,Hartford County,216,72,144
11,District of Columbia,9,Connecticut,5,Litchfield County,34,0,34
11,District of Columbia,9,Connecticut,7,Middlesex County,83,71,12
11,District of Columbia,9,Connecticut,9,New Haven County,437,96,341
11,District of Columbia,9,Connecticut,11,New London County,34,6,28
11,District of Columbia,9,Connecticut,13,Tolland County,5,0,5
11,District of Columbia,9,Connecticut,15,Windham County,9,0,9
11,District of Columbia,AFR,Africa,,-,1309,0,0
11,District of Columbia,ASI,Asia,,-,3017,0,0
11,District of Columbia,CAM,Central America,,-,665,0,0
11,District of Columbia,CAR,Caribbean,,-,298,0,0
11,District of Columbia,EUR,Europe,,-,3700,0,0
11,District of Columbia,ISL,U.S. Island Areas,,-,77,0,0
11,District of Columbia,NAM,Northern America,,-,278,0,0
11,District of Columbia,OCE,Oceania and At Sea,,-,311,0,0
11,District of Columbia,SAM,South America,,-,963,0,0
12,Florida,1,Alabama,1,Autauga County,215,83,132
12,Florida,1,Alabama,3,Baldwin County,1329,1340,-11
12,Florida,1,Alabama,5,Barbour County,53,125,-72
12,Florida,1,Alabama,7,Bibb County,0,65,-65
12,Florida,1,Alabama,9,Blount County,148,77,71
12,Florida,1,Alabama,11,Bullock County,78,0,78
12,Florida,1,Alabama,13,Butler County,191,0,191
12,Florida,1,Alabama,15,Calhoun County,416,367,49
12,Florida,1,Alabama,17,Chambers County,21,88,-67
12,Florida,1,Alabama,19,Cherokee County,0,6,-6
12,Florida,1,Alabama,21,Chilton County,79,37,42
12,Florida,1,Alabama,23,Choctaw County,0,31,-31
12,Florida,1,Alabama,25,Clarke County,13,37,-24
12,Florida,1,Alabama,27,Clay County,6,0,6
12,Florida,1,Alabama,29,Cleburne County,0,8,-8
12,Florida,1,Alabama,31,Coffee County,217,262,-45
12,Florida,1,Alabama,33,Colbert County,147,10,137
12,Florida,1,Alabama,39,Covington County,104,303,-199
12,Florida,1,Alabama,41,Crenshaw County,0,9,-9
12,Florida,1,Alabama,43,Cullman County,35,23,12
12,Florida,1,Alabama,45,Dale County,319,297,22
12,Florida,1,Alabama,47,Dallas County,0,66,-66
12,Florida,1,Alabama,49,DeKalb County,130,71,59
12,Florida,1,Alabama,51,Elmore County,253,101,152
12,Florida,1,Alabama,53,Escambia County,430,407,23
12,Florida,1,Alabama,55,Etowah County,59,126,-67
12,Florida,1,Alabama,57,Fayette County,0,37,-37
12,Florida,1,Alabama,61,Geneva County,221,104,117
12,Florida,1,Alabama,67,Henry County,0,114,-114
12,Florida,1,Alabama,69,Houston County,856,881,-25
12,Florida,1,Alabama,71,Jackson County,0,59,-59
12,Florida,1,Alabama,73,Jefferson County,1009,1859,-850
12,Florida,1,Alabama,75,Lamar County,0,6,-6
12,Florida,1,Alabama,77,Lauderdale County,121,229,-108
12,Florida,1,Alabama,81,Lee County,305,1177,-872
12,Florida,1,Alabama,83,Limestone County,82,139,-57
12,Florida,1,Alabama,85,Lowndes County,0,6,-6
12,Florida,1,Alabama,87,Macon County,0,22,-22
12,Florida,1,Alabama,89,Madison County,656,1196,-540
12,Florida,1,Alabama,91,Marengo County,53,0,53
12,Florida,1,Alabama,93,Marion County,20,6,14
12,Florida,1,Alabama,95,Marshall County,211,130,81
12,Florida,1,Alabama,97,Mobile County,659,668,-9
12,Florida,1,Alabama,99,Monroe County,5,4,1
12,Florida,1,Alabama,101,Montgomery County,925,873,52
12,Florida,1,Alabama,103,Morgan County,32,153,-121
12,Florida,1,Alabama,105,Perry County,0,13,-13
12,Florida,1,Alabama,107,Pickens County,20,54,-34
12,Florida,1,Alabama,109,Pike County,140,406,-266
12,Florida,1,Alabama,111,Randolph County,68,103,-35
12,Florida,1,Alabama,113,Russell County,120,157,-37
12,Florida,1,Alabama,115,St. Clair County,91,91,0
12,Florida,1,Alabama,117,Shelby County,882,903,-21
12,Florida,1,Alabama,119,Sumter County,0,43,-43
12,Florida,1,Alabama,121,Talladega County,52,88,-36
12,Florida,1,Alabama,123,Tallapoosa County,40,28,12
12,Florida,1,Alabama,125,Tuscaloosa County,661,664,-3
12,Florida,1,Alabama,127,Walker County,52,100,-48
12,Florida,1,Alabama,129,Washington County,0,33,-33
12,Florida,1,Alabama,133,Winston County,0,77,-77
12,Florida,10,Delaware,1,Kent County,255,273,-18
12,Florida,10,Delaware,3,New Castle County,1215,577,638
12,Florida,10,Delaware,5,Sussex County,847,207,640
12,Florida,11,District of Columbia,1,District of Columbia,1416,1883,-467
12,Florida,12,Florida,1,Alachua County,15180,17369,-2189
12,Florida,12,Florida,3,Baker County,1357,2080,-723
12,Florida,12,Florida,5,Bay County,7727,4211,3516
12,Florida,12,Florida,7,Bradford County,1177,2008,-831
12,Florida,12,Florida,9,Brevard County,12034,12015,19
12,Florida,12,Florida,11,Broward County,50940,45077,5863
12,Florida,12,Florida,13,Calhoun County,1035,932,103
12,Florida,12,Florida,15,Charlotte County,5921,7521,-1600
12,Florida,12,Florida,17,Citrus County,4373,4641,-268
12,Florida,12,Florida,19,Clay County,8768,13439,-4671
12,Florida,12,Florida,21,Collier County,9473,8177,1296
12,Florida,12,Florida,23,Columbia County,3860,5736,-1876
12,Florida,12,Florida,27,DeSoto County,1250,2090,-840
12,Florida,12,Florida,29,Dixie County,705,1179,-474
12,Florida,12,Florida,31,Duval County,27432,23577,3855
12,Florida,12,Florida,33,Escambia County,7003,8339,-1336
12,Florida,12,Florida,35,Flagler County,3342,2637,705
12,Florida,12,Florida,37,Franklin County,824,1183,-359
12,Florida,12,Florida,39,Gadsden County,2952,3473,-521
12,Florida,12,Florida,41,Gilchrist County,1150,1434,-284
12,Florida,12,Florida,43,Glades County,636,706,-70
12,Florida,12,Florida,45,Gulf County,964,1480,-516
12,Florida,12,Florida,47,Hamilton County,1530,1901,-371
12,Florida,12,Florida,49,Hardee County,1590,743,847
12,Florida,12,Florida,51,Hendry County,1556,1413,143
12,Florida,12,Florida,53,Hernando County,6732,8292,-1560
12,Florida,12,Florida,55,Highlands County,3259,3000,259
12,Florida,12,Florida,57,Hillsborough County,39393,36411,2982
12,Florida,12,Florida,59,Holmes County,1358,1681,-323
12,Florida,12,Florida,61,Indian River County,3706,5444,-1738
12,Florida,12,Florida,63,Jackson County,2966,3821,-855
12,Florida,12,Florida,65,Jefferson County,958,1429,-471
12,Florida,12,Florida,67,Lafayette County,724,832,-108
12,Florida,12,Florida,69,Lake County,11865,16041,-4176
12,Florida,12,Florida,71,Lee County,16444,14475,1969
12,Florida,12,Florida,73,Leon County,12231,20355,-8124
12,Florida,12,Florida,75,Levy County,2208,2184,24
12,Florida,12,Florida,77,Liberty County,852,883,-31
12,Florida,12,Florida,79,Madison County,1207,1530,-323
12,Florida,12,Florida,81,Manatee County,9868,12725,-2857
12,Florida,12,Florida,83,Marion County,11649,12462,-813
12,Florida,12,Florida,85,Martin County,5943,8335,-2392
12,Florida,12,Florida,86,Miami-Dade County,54549,26660,27889
12,Florida,12,Florida,87,Monroe County,3165,2455,710
12,Florida,12,Florida,89,Nassau County,2398,3081,-683
12,Florida,12,Florida,91,Okaloosa County,7999,5309,2690
12,Florida,12,Florida,93,Okeechobee County,1310,1188,122
12,Florida,12,Florida,95,Orange County,47021,49794,-2773
12,Florida,12,Florida,97,Osceola County,12607,12005,602
12,Florida,12,Florida,99,Palm Beach County,31415,32404,-989
12,Florida,12,Florida,101,Pasco County,18556,17795,761
12,Florida,12,Florida,103,Pinellas County,24935,20587,4348
12,Florida,12,Florida,105,Polk County,20102,18281,1821
12,Florida,12,Florida,107,Putnam County,2386,2433,-47
12,Florida,12,Florida,109,St. Johns County,9179,13563,-4384
12,Florida,12,Florida,111,St. Lucie County,9033,12453,-3420
12,Florida,12,Florida,113,Santa Rosa County,8282,7844,438
12,Florida,12,Florida,115,Sarasota County,13011,11275,1736
12,Florida,12,Florida,117,Seminole County,22854,22689,165
12,Florida,12,Florida,119,Sumter County,3378,4216,-838
12,Florida,12,Florida,121,Suwannee County,2302,2704,-402
12,Florida,12,Florida,123,Taylor County,1214,2087,-873
12,Florida,12,Florida,125,Union County,1512,2534,-1022
12,Florida,12,Florida,127,Volusia County,11806,16555,-4749
12,Florida,12,Florida,129,Wakulla County,2320,2320,0
12,Florida,12,Florida,131,Walton County,1908,3272,-1364
12,Florida,12,Florida,133,Washington County,1611,2230,-619
12,Florida,13,Georgia,1,Appling County,73,11,62
12,Florida,13,Georgia,3,Atkinson County,44,34,10
12,Florida,13,Georgia,5,Bacon County,138,33,105
12,Florida,13,Georgia,9,Baldwin County,79,126,-47
12,Florida,13,Georgia,11,Banks County,0,75,-75
12,Florida,13,Georgia,13,Barrow County,251,347,-96
12,Florida,13,Georgia,15,Bartow County,341,219,122
12,Florida,13,Georgia,17,Ben Hill County,19,15,4
12,Florida,13,Georgia,19,Berrien County,15,90,-75
12,Florida,13,Georgia,21,Bibb County,317,609,-292
12,Florida,13,Georgia,23,Bleckley County,23,16,7
12,Florida,13,Georgia,25,Brantley County,217,497,-280
12,Florida,13,Georgia,27,Brooks County,44,112,-68
12,Florida,13,Georgia,29,Bryan County,361,97,264
12,Florida,13,Georgia,31,Bulloch County,326,302,24
12,Florida,13,Georgia,33,Burke County,0,69,-69
12,Florida,13,Georgia,35,Butts County,69,17,52
12,Florida,13,Georgia,37,Calhoun County,0,18,-18
12,Florida,13,Georgia,39,Camden County,1804,655,1149
12,Florida,13,Georgia,43,Candler County,5,62,-57
12,Florida,13,Georgia,45,Carroll County,144,135,9
12,Florida,13,Georgia,47,Catoosa County,15,227,-212
12,Florida,13,Georgia,49,Charlton County,219,429,-210
12,Florida,13,Georgia,51,Chatham County,2150,1303,847
12,Florida,13,Georgia,53,Chattahoochee County,46,102,-56
12,Florida,13,Georgia,55,Chattooga County,72,24,48
12,Florida,13,Georgia,57,Cherokee County,1082,1349,-267
12,Florida,13,Georgia,59,Clarke County,301,444,-143
12,Florida,13,Georgia,61,Clay County,11,135,-124
12,Florida,13,Georgia,63,Clayton County,763,1255,-492
12,Florida,13,Georgia,65,Clinch County,64,0,64
12,Florida,13,Georgia,67,Cobb County,2501,2865,-364
12,Florida,13,Georgia,69,Coffee County,314,265,49
12,Florida,13,Georgia,71,Colquitt County,76,463,-387
12,Florida,13,Georgia,73,Columbia County,495,314,181
12,Florida,13,Georgia,75,Cook County,0,73,-73
12,Florida,13,Georgia,77,Coweta County,468,403,65
12,Florida,13,Georgia,79,Crawford County,60,3,57
12,Florida,13,Georgia,81,Crisp County,54,47,7
12,Florida,13,Georgia,83,Dade County,0,35,-35
12,Florida,13,Georgia,85,Dawson County,9,31,-22
12,Florida,13,Georgia,87,Decatur County,397,333,64
12,Florida,13,Georgia,89,DeKalb County,2506,3012,-506
12,Florida,13,Georgia,91,Dodge County,0,12,-12
12,Florida,13,Georgia,93,Dooly County,0,4,-4
12,Florida,13,Georgia,95,Dougherty County,859,710,149
12,Florida,13,Georgia,97,Douglas County,268,428,-160
12,Florida,13,Georgia,99,Early County,193,45,148
12,Florida,13,Georgia,101,Echols County,17,0,17
12,Florida,13,Georgia,103,Effingham County,183,87,96
12,Florida,13,Georgia,107,Emanuel County,10,88,-78
12,Florida,13,Georgia,109,Evans County,4,26,-22
12,Florida,13,Georgia,111,Fannin County,208,209,-1
12,Florida,13,Georgia,113,Fayette County,807,551,256
12,Florida,13,Georgia,115,Floyd County,56,111,-55
12,Florida,13,Georgia,117,Forsyth County,1031,524,507
12,Florida,13,Georgia,119,Franklin County,95,41,54
12,Florida,13,Georgia,121,Fulton County,5946,5825,121
12,Florida,13,Georgia,123,Gilmer County,48,106,-58
12,Florida,13,Georgia,127,Glynn County,472,550,-78
12,Florida,13,Georgia,129,Gordon County,54,153,-99
12,Florida,13,Georgia,131,Grady County,149,404,-255
12,Florida,13,Georgia,133,Greene County,87,181,-94
12,Florida,13,Georgia,135,Gwinnett County,2065,2909,-844
12,Florida,13,Georgia,137,Habersham County,47,127,-80
12,Florida,13,Georgia,139,Hall County,349,532,-183
12,Florida,13,Georgia,141,Hancock County,35,0,35
12,Florida,13,Georgia,143,Haralson County,0,82,-82
12,Florida,13,Georgia,145,Harris County,119,12,107
12,Florida,13,Georgia,147,Hart County,69,73,-4
12,Florida,13,Georgia,149,Heard County,0,3,-3
12,Florida,13,Georgia,151,Henry County,657,1403,-746
12,Florida,13,Georgia,153,Houston County,816,976,-160
12,Florida,13,Georgia,155,Irwin County,26,7,19
12,Florida,13,Georgia,157,Jackson County,72,185,-113
12,Florida,13,Georgia,159,Jasper County,0,36,-36
12,Florida,13,Georgia,161,Jeff Davis County,0,7,-7
12,Florida,13,Georgia,163,Jefferson County,29,90,-61
12,Florida,13,Georgia,165,Jenkins County,0,62,-62
12,Florida,13,Georgia,167,Johnson County,10,194,-184
12,Florida,13,Georgia,169,Jones County,0,18,-18
12,Florida,13,Georgia,171,Lamar County,166,0,166
12,Florida,13,Georgia,173,Lanier County,29,57,-28
12,Florida,13,Georgia,175,Laurens County,38,197,-159
12,Florida,13,Georgia,177,Lee County,115,246,-131
12,Florida,13,Georgia,179,Liberty County,591,1138,-547
12,Florida,13,Georgia,181,Lincoln County,0,2,-2
12,Florida,13,Georgia,185,Lowndes County,1008,1670,-662
12,Florida,13,Georgia,187,Lumpkin County,38,88,-50
12,Florida,13,Georgia,189,McDuffie County,18,35,-17
12,Florida,13,Georgia,191,McIntosh County,7,80,-73
12,Florida,13,Georgia,193,Macon County,13,36,-23
12,Florida,13,Georgia,195,Madison County,0,66,-66
12,Florida,13,Georgia,197,Marion County,0,49,-49
12,Florida,13,Georgia,199,Meriwether County,0,6,-6
12,Florida,13,Georgia,201,Miller County,16,18,-2
12,Florida,13,Georgia,205,Mitchell County,66,45,21
12,Florida,13,Georgia,207,Monroe County,35,133,-98
12,Florida,13,Georgia,209,Montgomery County,0,9,-9
12,Florida,13,Georgia,211,Morgan County,24,39,-15
12,Florida,13,Georgia,213,Murray County,58,34,24
12,Florida,13,Georgia,215,Muscogee County,715,711,4
12,Florida,13,Georgia,217,Newton County,462,313,149
12,Florida,13,Georgia,219,Oconee County,18,124,-106
12,Florida,13,Georgia,221,Oglethorpe County,0,2,-2
12,Florida,13,Georgia,223,Paulding County,623,403,220
12,Florida,13,Georgia,225,Peach County,33,203,-170
12,Florida,13,Georgia,227,Pickens County,0,263,-263
12,Florida,13,Georgia,229,Pierce County,68,11,57
12,Florida,13,Georgia,231,Pike County,65,0,65
12,Florida,13,Georgia,233,Polk County,0,68,-68
12,Florida,13,Georgia,235,Pulaski County,28,0,28
12,Florida,13,Georgia,237,Putnam County,0,41,-41
12,Florida,13,Georgia,239,Quitman County,0,12,-12
12,Florida,13,Georgia,241,Rabun County,97,78,19
12,Florida,13,Georgia,243,Randolph County,95,10,85
12,Florida,13,Georgia,245,Richmond County,574,549,25
12,Florida,13,Georgia,247,Rockdale County,276,297,-21
12,Florida,13,Georgia,249,Schley County,0,9,-9
12,Florida,13,Georgia,251,Screven County,20,0,20
12,Florida,13,Georgia,253,Seminole County,88,0,88
12,Florida,13,Georgia,255,Spalding County,283,52,231
12,Florida,13,Georgia,257,Stephens County,46,132,-86
12,Florida,13,Georgia,259,Stewart County,0,38,-38
12,Florida,13,Georgia,261,Sumter County,54,0,54
12,Florida,13,Georgia,267,Tattnall County,0,54,-54
12,Florida,13,Georgia,269,Taylor County,0,36,-36
12,Florida,13,Georgia,271,Telfair County,8,22,-14
12,Florida,13,Georgia,273,Terrell County,101,22,79
12,Florida,13,Georgia,275,Thomas County,754,591,163
12,Florida,13,Georgia,277,Tift County,488,139,349
12,Florida,13,Georgia,279,Toombs County,34,0,34
12,Florida,13,Georgia,281,Towns County,12,116,-104
12,Florida,13,Georgia,283,Treutlen County,0,36,-36
12,Florida,13,Georgia,285,Troup County,115,127,-12
12,Florida,13,Georgia,287,Turner County,122,15,107
12,Florida,13,Georgia,291,Union County,312,233,79
12,Florida,13,Georgia,293,Upson County,10,90,-80
12,Florida,13,Georgia,295,Walker County,54,63,-9
12,Florida,13,Georgia,297,Walton County,191,148,43
12,Florida,13,Georgia,299,Ware County,478,311,167
12,Florida,13,Georgia,301,Warren County,0,1,-1
12,Florida,13,Georgia,303,Washington County,0,30,-30
12,Florida,13,Georgia,305,Wayne County,164,514,-350
12,Florida,13,Georgia,307,Webster County,0,36,-36
12,Florida,13,Georgia,309,Wheeler County,8,4,4
12,Florida,13,Georgia,311,White County,186,28,158
12,Florida,13,Georgia,313,Whitfield County,82,160,-78
12,Florida,13,Georgia,315,Wilcox County,0,8,-8
12,Florida,13,Georgia,317,Wilkes County,6,19,-13
12,Florida,13,Georgia,319,Wilkinson County,0,3,-3
12,Florida,13,Georgia,321,Worth County,8,44,-36
12,Florida,15,Hawaii,1,Hawaii County,134,96,38
12,Florida,15,Hawaii,3,Honolulu County,1394,1873,-479
12,Florida,15,Hawaii,7,Kauai County,26,76,-50
12,Florida,15,Hawaii,9,Maui County,142,295,-153
12,Florida,16,Idaho,1,Ada County,450,142,308
12,Florida,16,Idaho,5,Bannock County,0,64,-64
12,Florida,16,Idaho,11,Bingham County,0,34,-34
12,Florida,16,Idaho,13,Blaine County,0,8,-8
12,Florida,16,Idaho,19,Bonneville County,291,45,246
12,Florida,16,Idaho,21,Boundary County,0,38,-38
12,Florida,16,Idaho,23,Butte County,7,1,6
12,Florida,16,Idaho,27,Canyon County,32,18,14
12,Florida,16,Idaho,29,Caribou County,8,0,8
12,Florida,16,Idaho,39,Elmore County,17,91,-74
12,Florida,16,Idaho,45,Gem County,0,48,-48
12,Florida,16,Idaho,47,Gooding County,0,6,-6
12,Florida,16,Idaho,49,Idaho County,79,0,79
12,Florida,16,Idaho,51,Jefferson County,43,0,43
12,Florida,16,Idaho,55,Kootenai County,107,261,-154
12,Florida,16,Idaho,57,Latah County,97,8,89
12,Florida,16,Idaho,65,Madison County,33,78,-45
12,Florida,16,Idaho,67,Minidoka County,0,2,-2
12,Florida,16,Idaho,69,Nez Perce County,0,54,-54
12,Florida,16,Idaho,71,Oneida County,0,5,-5
12,Florida,16,Idaho,73,Owyhee County,0,3,-3
12,Florida,17,Illinois,1,Adams County,152,14,138
12,Florida,17,Illinois,5,Bond County,1,48,-47
12,Florida,17,Illinois,7,Boone County,26,57,-31
12,Florida,17,Illinois,11,Bureau County,153,24,129
12,Florida,17,Illinois,15,Carroll County,8,2,6
12,Florida,17,Illinois,17,Cass County,0,29,-29
12,Florida,17,Illinois,19,Champaign County,406,469,-63
12,Florida,17,Illinois,21,Christian County,6,12,-6
12,Florida,17,Illinois,23,Clark County,55,12,43
12,Florida,17,Illinois,27,Clinton County,52,3,49
12,Florida,17,Illinois,29,Coles County,3,0,3
12,Florida,17,Illinois,31,Cook County,8900,5118,3782
12,Florida,17,Illinois,33,Crawford County,183,39,144
12,Florida,17,Illinois,35,Cumberland County,0,25,-25
12,Florida,17,Illinois,37,DeKalb County,63,277,-214
12,Florida,17,Illinois,39,De Witt County,27,4,23
12,Florida,17,Illinois,43,DuPage County,2370,877,1493
12,Florida,17,Illinois,45,Edgar County,22,179,-157
12,Florida,17,Illinois,47,Edwards County,27,5,22
12,Florida,17,Illinois,49,Effingham County,0,79,-79
12,Florida,17,Illinois,51,Fayette County,10,10,0
12,Florida,17,Illinois,53,Ford County,9,10,-1
12,Florida,17,Illinois,55,Franklin County,27,10,17
12,Florida,17,Illinois,57,Fulton County,7,18,-11
12,Florida,17,Illinois,61,Greene County,0,7,-7
12,Florida,17,Illinois,63,Grundy County,55,0,55
12,Florida,17,Illinois,67,Hancock County,55,0,55
12,Florida,17,Illinois,73,Henry County,0,4,-4
12,Florida,17,Illinois,75,Iroquois County,0,145,-145
12,Florida,17,Illinois,77,Jackson County,383,106,277
12,Florida,17,Illinois,81,Jefferson County,128,43,85
12,Florida,17,Illinois,83,Jersey County,36,22,14
12,Florida,17,Illinois,85,Jo Daviess County,48,5,43
12,Florida,17,Illinois,87,Johnson County,191,2,189
12,Florida,17,Illinois,89,Kane County,992,359,633
12,Florida,17,Illinois,91,Kankakee County,173,123,50
12,Florida,17,Illinois,93,Kendall County,408,53,355
12,Florida,17,Illinois,95,Knox County,66,8,58
12,Florida,17,Illinois,97,Lake County,1437,1352,85
12,Florida,17,Illinois,99,LaSalle County,302,114,188
12,Florida,17,Illinois,101,Lawrence County,0,35,-35
12,Florida,17,Illinois,103,Lee County,19,50,-31
12,Florida,17,Illinois,105,Livingston County,0,19,-19
12,Florida,17,Illinois,107,Logan County,0,10,-10
12,Florida,17,Illinois,109,McDonough County,149,0,149
12,Florida,17,Illinois,111,McHenry County,441,335,106
12,Florida,17,Illinois,113,McLean County,546,105,441
12,Florida,17,Illinois,115,Macon County,292,110,182
12,Florida,17,Illinois,117,Macoupin County,14,18,-4
12,Florida,17,Illinois,119,Madison County,279,69,210
12,Florida,17,Illinois,121,Marion County,90,25,65
12,Florida,17,Illinois,123,Marshall County,27,5,22
12,Florida,17,Illinois,125,Mason County,0,14,-14
12,Florida,17,Illinois,127,Massac County,0,16,-16
12,Florida,17,Illinois,129,Menard County,49,38,11
12,Florida,17,Illinois,131,Mercer County,32,0,32
12,Florida,17,Illinois,133,Monroe County,0,45,-45
12,Florida,17,Illinois,135,Montgomery County,32,19,13
12,Florida,17,Illinois,137,Morgan County,209,4,205
12,Florida,17,Illinois,139,Moultrie County,15,13,2
12,Florida,17,Illinois,141,Ogle County,173,62,111
12,Florida,17,Illinois,143,Peoria County,684,316,368
12,Florida,17,Illinois,145,Perry County,6,0,6
12,Florida,17,Illinois,147,Piatt County,0,8,-8
12,Florida,17,Illinois,157,Randolph County,29,39,-10
12,Florida,17,Illinois,161,Rock Island County,250,253,-3
12,Florida,17,Illinois,163,St. Clair County,612,421,191
12,Florida,17,Illinois,165,Saline County,69,0,69
12,Florida,17,Illinois,167,Sangamon County,646,106,540
12,Florida,17,Illinois,173,Shelby County,9,32,-23
12,Florida,17,Illinois,177,Stephenson County,0,16,-16
12,Florida,17,Illinois,179,Tazewell County,184,156,28
12,Florida,17,Illinois,181,Union County,49,4,45
12,Florida,17,Illinois,183,Vermilion County,130,30,100
12,Florida,17,Illinois,187,Warren County,53,8,45
12,Florida,17,Illinois,189,Washington County,14,2,12
12,Florida,17,Illinois,191,Wayne County,0,166,-166
12,Florida,17,Illinois,193,White County,0,20,-20
12,Florida,17,Illinois,195,Whiteside County,255,81,174
12,Florida,17,Illinois,197,Will County,1148,259,889
12,Florida,17,Illinois,199,Williamson County,178,23,155
12,Florida,17,Illinois,201,Winnebago County,529,167,362
12,Florida,17,Illinois,203,Woodford County,120,4,116
12,Florida,18,Indiana,1,Adams County,43,13,30
12,Florida,18,Indiana,3,Allen County,787,648,139
12,Florida,18,Indiana,5,Bartholomew County,115,171,-56
12,Florida,18,Indiana,7,Benton County,0,2,-2
12,Florida,18,Indiana,9,Blackford County,240,19,221
12,Florida,18,Indiana,11,Boone County,104,183,-79
12,Florida,18,Indiana,13,Brown County,35,12,23
12,Florida,18,Indiana,15,Carroll County,8,0,8
12,Florida,18,Indiana,17,Cass County,0,12,-12
12,Florida,18,Indiana,19,Clark County,145,75,70
12,Florida,18,Indiana,21,Clay County,15,12,3
12,Florida,18,Indiana,23,Clinton County,5,2,3
12,Florida,18,Indiana,25,Crawford County,8,0,8
12,Florida,18,Indiana,27,Daviess County,0,52,-52
12,Florida,18,Indiana,29,Dearborn County,181,12,169
12,Florida,18,Indiana,31,Decatur County,109,13,96
12,Florida,18,Indiana,33,DeKalb County,15,47,-32
12,Florida,18,Indiana,35,Delaware County,281,133,148
12,Florida,18,Indiana,37,Dubois County,61,0,61
12,Florida,18,Indiana,39,Elkhart County,601,244,357
12,Florida,18,Indiana,41,Fayette County,7,26,-19
12,Florida,18,Indiana,43,Floyd County,191,17,174
12,Florida,18,Indiana,45,Fountain County,0,3,-3
12,Florida,18,Indiana,47,Franklin County,0,13,-13
12,Florida,18,Indiana,49,Fulton County,75,25,50
12,Florida,18,Indiana,51,Gibson County,88,9,79
12,Florida,18,Indiana,53,Grant County,149,135,14
12,Florida,18,Indiana,55,Greene County,0,30,-30
12,Florida,18,Indiana,57,Hamilton County,1129,816,313
12,Florida,18,Indiana,59,Hancock County,49,8,41
12,Florida,18,Indiana,61,Harrison County,0,100,-100
12,Florida,18,Indiana,63,Hendricks County,290,252,38
12,Florida,18,Indiana,65,Henry County,87,12,75
12,Florida,18,Indiana,67,Howard County,85,176,-91
12,Florida,18,Indiana,69,Huntington County,125,28,97
12,Florida,18,Indiana,71,Jackson County,0,13,-13
12,Florida,18,Indiana,73,Jasper County,68,18,50
12,Florida,18,Indiana,75,Jay County,85,0,85
12,Florida,18,Indiana,77,Jefferson County,108,34,74
12,Florida,18,Indiana,79,Jennings County,89,0,89
12,Florida,18,Indiana,81,Johnson County,232,139,93
12,Florida,18,Indiana,83,Knox County,17,113,-96
12,Florida,18,Indiana,85,Kosciusko County,116,126,-10
12,Florida,18,Indiana,87,LaGrange County,8,17,-9
12,Florida,18,Indiana,89,Lake County,1390,127,1263
12,Florida,18,Indiana,91,LaPorte County,47,158,-111
12,Florida,18,Indiana,93,Lawrence County,192,80,112
12,Florida,18,Indiana,95,Madison County,183,85,98
12,Florida,18,Indiana,97,Marion County,1902,1419,483
12,Florida,18,Indiana,99,Marshall County,48,132,-84
12,Florida,18,Indiana,103,Miami County,7,52,-45
12,Florida,18,Indiana,105,Monroe County,336,280,56
12,Florida,18,Indiana,107,Montgomery County,0,79,-79
12,Florida,18,Indiana,109,Morgan County,253,113,140
12,Florida,18,Indiana,111,Newton County,11,14,-3
12,Florida,18,Indiana,113,Noble County,5,40,-35
12,Florida,18,Indiana,117,Orange County,18,13,5
12,Florida,18,Indiana,119,Owen County,33,0,33
12,Florida,18,Indiana,121,Parke County,31,3,28
12,Florida,18,Indiana,123,Perry County,34,6,28
12,Florida,18,Indiana,125,Pike County,107,2,105
12,Florida,18,Indiana,127,Porter County,287,207,80
12,Florida,18,Indiana,129,Posey County,0,136,-136
12,Florida,18,Indiana,131,Pulaski County,8,2,6
12,Florida,18,Indiana,133,Putnam County,37,29,8
12,Florida,18,Indiana,135,Randolph County,72,16,56
12,Florida,18,Indiana,137,Ripley County,0,63,-63
12,Florida,18,Indiana,139,Rush County,25,0,25
12,Florida,18,Indiana,141,St. Joseph County,357,531,-174
12,Florida,18,Indiana,143,Scott County,34,105,-71
12,Florida,18,Indiana,145,Shelby County,0,26,-26
12,Florida,18,Indiana,147,Spencer County,27,0,27
12,Florida,18,Indiana,149,Starke County,25,31,-6
12,Florida,18,Indiana,151,Steuben County,101,12,89
12,Florida,18,Indiana,153,Sullivan County,54,0,54
12,Florida,18,Indiana,155,Switzerland County,0,17,-17
12,Florida,18,Indiana,157,Tippecanoe County,298,324,-26
12,Florida,18,Indiana,159,Tipton County,35,9,26
12,Florida,18,Indiana,161,Union County,12,89,-77
12,Florida,18,Indiana,163,Vanderburgh County,317,116,201
12,Florida,18,Indiana,165,Vermillion County,23,43,-20
12,Florida,18,Indiana,167,Vigo County,259,191,68
12,Florida,18,Indiana,169,Wabash County,24,40,-16
12,Florida,18,Indiana,171,Warren County,1,1,0
12,Florida,18,Indiana,173,Warrick County,144,101,43
12,Florida,18,Indiana,175,Washington County,137,58,79
12,Florida,18,Indiana,177,Wayne County,27,88,-61
12,Florida,18,Indiana,179,Wells County,53,25,28
12,Florida,18,Indiana,181,White County,51,0,51
12,Florida,18,Indiana,183,Whitley County,116,29,87
12,Florida,19,Iowa,1,Adair County,0,6,-6
12,Florida,19,Iowa,7,Appanoose County,0,1,-1
12,Florida,19,Iowa,11,Benton County,0,32,-32
12,Florida,19,Iowa,13,Black Hawk County,156,40,116
12,Florida,19,Iowa,15,Boone County,23,5,18
12,Florida,19,Iowa,17,Bremer County,140,0,140
12,Florida,19,Iowa,19,Buchanan County,0,7,-7
12,Florida,19,Iowa,21,Buena Vista County,0,91,-91
12,Florida,19,Iowa,23,Butler County,30,0,30
12,Florida,19,Iowa,25,Calhoun County,0,19,-19
12,Florida,19,Iowa,27,Carroll County,0,1,-1
12,Florida,19,Iowa,31,Cedar County,105,28,77
12,Florida,19,Iowa,33,Cerro Gordo County,24,25,-1
12,Florida,19,Iowa,39,Clarke County,19,0,19
12,Florida,19,Iowa,43,Clayton County,0,28,-28
12,Florida,19,Iowa,45,Clinton County,166,5,161
12,Florida,19,Iowa,49,Dallas County,44,20,24
12,Florida,19,Iowa,51,Davis County,62,0,62
12,Florida,19,Iowa,53,Decatur County,0,24,-24
12,Florida,19,Iowa,57,Des Moines County,304,38,266
12,Florida,19,Iowa,59,Dickinson County,143,0,143
12,Florida,19,Iowa,61,Dubuque County,42,167,-125
12,Florida,19,Iowa,63,Emmet County,0,19,-19
12,Florida,19,Iowa,65,Fayette County,0,11,-11
12,Florida,19,Iowa,71,Fremont County,11,5,6
12,Florida,19,Iowa,75,Grundy County,0,2,-2
12,Florida,19,Iowa,77,Guthrie County,0,2,-2
12,Florida,19,Iowa,81,Hancock County,43,3,40
12,Florida,19,Iowa,83,Hardin County,37,11,26
12,Florida,19,Iowa,85,Harrison County,0,21,-21
12,Florida,19,Iowa,87,Henry County,0,2,-2
12,Florida,19,Iowa,89,Howard County,30,0,30
12,Florida,19,Iowa,91,Humboldt County,36,0,36
12,Florida,19,Iowa,99,Jasper County,47,20,27
12,Florida,19,Iowa,101,Jefferson County,108,0,108
12,Florida,19,Iowa,103,Johnson County,189,72,117
12,Florida,19,Iowa,109,Kossuth County,0,27,-27
12,Florida,19,Iowa,111,Lee County,12,10,2
12,Florida,19,Iowa,113,Linn County,463,695,-232
12,Florida,19,Iowa,119,Lyon County,13,0,13
12,Florida,19,Iowa,121,Madison County,40,145,-105
12,Florida,19,Iowa,123,Mahaska County,0,49,-49
12,Florida,19,Iowa,125,Marion County,6,0,6
12,Florida,19,Iowa,127,Marshall County,5,28,-23
12,Florida,19,Iowa,129,Mills County,0,2,-2
12,Florida,19,Iowa,133,Monona County,0,1,-1
12,Florida,19,Iowa,135,Monroe County,14,0,14
12,Florida,19,Iowa,139,Muscatine County,25,17,8
12,Florida,19,Iowa,141,O'Brien County,0,5,-5
12,Florida,19,Iowa,143,Osceola County,176,0,176
12,Florida,19,Iowa,147,Palo Alto County,119,0,119
12,Florida,19,Iowa,149,Plymouth County,0,19,-19
12,Florida,19,Iowa,151,Pocahontas County,0,4,-4
12,Florida,19,Iowa,153,Polk County,507,763,-256
12,Florida,19,Iowa,155,Pottawattamie County,360,137,223
12,Florida,19,Iowa,157,Poweshiek County,20,4,16
12,Florida,19,Iowa,159,Ringgold County,0,3,-3
12,Florida,19,Iowa,163,Scott County,420,193,227
12,Florida,19,Iowa,167,Sioux County,12,50,-38
12,Florida,19,Iowa,169,Story County,59,80,-21
12,Florida,19,Iowa,181,Warren County,0,14,-14
12,Florida,19,Iowa,187,Webster County,44,0,44
12,Florida,19,Iowa,189,Winnebago County,13,9,4
12,Florida,19,Iowa,193,Woodbury County,206,43,163
12,Florida,19,Iowa,195,Worth County,0,4,-4
12,Florida,19,Iowa,197,Wright County,7,0,7
12,Florida,2,Alaska,13,Aleutians East Borough,0,5,-5
12,Florida,2,Alaska,16,Aleutians West Census Area,0,2,-2
12,Florida,2,Alaska,20,Anchorage Municipality,1934,368,1566
12,Florida,2,Alaska,50,Bethel Census Area,0,24,-24
12,Florida,2,Alaska,60,Bristol Bay Borough,0,1,-1
12,Florida,2,Alaska,68,Denali Borough,0,13,-13
12,Florida,2,Alaska,70,Dillingham Census Area,0,3,-3
12,Florida,2,Alaska,90,Fairbanks North Star Borough,281,454,-173
12,Florida,2,Alaska,110,Juneau City and Borough,23,110,-87
12,Florida,2,Alaska,122,Kenai Peninsula Borough,1054,97,957
12,Florida,2,Alaska,130,Ketchikan Gateway Borough,38,36,2
12,Florida,2,Alaska,150,Kodiak Island Borough,479,69,410
12,Florida,2,Alaska,170,Matanuska-Susitna Borough,282,143,139
12,Florida,2,Alaska,180,Nome Census Area,6,19,-13
12,Florida,2,Alaska,188,Northwest Arctic Borough,0,32,-32
12,Florida,2,Alaska,198,Prince of Wales-Hyder Census Area,10,3,7
12,Florida,2,Alaska,220,Sitka City and Borough,55,7,48
12,Florida,2,Alaska,230,Skagway Municipality,0,10,-10
12,Florida,2,Alaska,240,Southeast Fairbanks Census Area,0,25,-25
12,Florida,2,Alaska,261,Valdez-Cordova Census Area,551,134,417
12,Florida,2,Alaska,275,Wrangell City and Borough,0,6,-6
12,Florida,20,Kansas,1,Allen County,0,12,-12
12,Florida,20,Kansas,5,Atchison County,0,7,-7
12,Florida,20,Kansas,9,Barton County,0,48,-48
12,Florida,20,Kansas,11,Bourbon County,0,2,-2
12,Florida,20,Kansas,13,Brown County,0,14,-14
12,Florida,20,Kansas,15,Butler County,58,174,-116
12,Florida,20,Kansas,17,Chase County,0,6,-6
12,Florida,20,Kansas,21,Cherokee County,19,0,19
12,Florida,20,Kansas,25,Clark County,0,5,-5
12,Florida,20,Kansas,29,Cloud County,0,12,-12
12,Florida,20,Kansas,31,Coffey County,8,6,2
12,Florida,20,Kansas,35,Cowley County,91,0,91
12,Florida,20,Kansas,37,Crawford County,14,0,14
12,Florida,20,Kansas,39,Decatur County,0,30,-30
12,Florida,20,Kansas,45,Douglas County,94,73,21
12,Florida,20,Kansas,47,Edwards County,0,2,-2
12,Florida,20,Kansas,51,Ellis County,41,0,41
12,Florida,20,Kansas,55,Finney County,10,34,-24
12,Florida,20,Kansas,57,Ford County,53,85,-32
12,Florida,20,Kansas,59,Franklin County,30,0,30
12,Florida,20,Kansas,61,Geary County,65,117,-52
12,Florida,20,Kansas,67,Grant County,0,45,-45
12,Florida,20,Kansas,73,Greenwood County,0,13,-13
12,Florida,20,Kansas,81,Haskell County,0,4,-4
12,Florida,20,Kansas,87,Jefferson County,37,8,29
12,Florida,20,Kansas,91,Johnson County,952,461,491
12,Florida,20,Kansas,93,Kearny County,6,0,6
12,Florida,20,Kansas,101,Lane County,0,3,-3
12,Florida,20,Kansas,103,Leavenworth County,240,89,151
12,Florida,20,Kansas,111,Lyon County,30,0,30
12,Florida,20,Kansas,117,Marshall County,25,0,25
12,Florida,20,Kansas,119,Meade County,18,0,18
12,Florida,20,Kansas,121,Miami County,13,0,13
12,Florida,20,Kansas,123,Mitchell County,0,7,-7
12,Florida,20,Kansas,125,Montgomery County,48,9,39
12,Florida,20,Kansas,133,Neosho County,20,0,20
12,Florida,20,Kansas,137,Norton County,0,12,-12
12,Florida,20,Kansas,141,Osborne County,0,1,-1
12,Florida,20,Kansas,143,Ottawa County,30,6,24
12,Florida,20,Kansas,149,Pottawatomie County,0,18,-18
12,Florida,20,Kansas,151,Pratt County,13,0,13
12,Florida,20,Kansas,155,Reno County,52,78,-26
12,Florida,20,Kansas,161,Riley County,250,636,-386
12,Florida,20,Kansas,167,Russell County,0,3,-3
12,Florida,20,Kansas,173,Sedgwick County,381,577,-196
12,Florida,20,Kansas,175,Seward County,0,68,-68
12,Florida,20,Kansas,177,Shawnee County,247,232,15
12,Florida,20,Kansas,181,Sherman County,0,1,-1
12,Florida,20,Kansas,185,Stafford County,0,4,-4
12,Florida,20,Kansas,189,Stevens County,15,22,-7
12,Florida,20,Kansas,191,Sumner County,20,2,18
12,Florida,20,Kansas,197,Wabaunsee County,0,6,-6
12,Florida,20,Kansas,199,Wallace County,0,4,-4
12,Florida,20,Kansas,201,Washington County,0,2,-2
12,Florida,20,Kansas,205,Wilson County,0,7,-7
12,Florida,20,Kansas,209,Wyandotte County,136,161,-25
12,Florida,21,Kentucky,1,Adair County,0,6,-6
12,Florida,21,Kentucky,3,Allen County,37,21,16
12,Florida,21,Kentucky,5,Anderson County,0,9,-9
12,Florida,21,Kentucky,9,Barren County,11,30,-19
12,Florida,21,Kentucky,11,Bath County,0,1,-1
12,Florida,21,Kentucky,13,Bell County,19,10,9
12,Florida,21,Kentucky,15,Boone County,542,672,-130
12,Florida,21,Kentucky,17,Bourbon County,0,7,-7
12,Florida,21,Kentucky,19,Boyd County,52,136,-84
12,Florida,21,Kentucky,21,Boyle County,22,61,-39
12,Florida,21,Kentucky,25,Breathitt County,0,62,-62
12,Florida,21,Kentucky,27,Breckinridge County,98,0,98
12,Florida,21,Kentucky,29,Bullitt County,44,86,-42
12,Florida,21,Kentucky,31,Butler County,9,19,-10
12,Florida,21,Kentucky,35,Calloway County,68,0,68
12,Florida,21,Kentucky,37,Campbell County,173,159,14
12,Florida,21,Kentucky,41,Carroll County,61,65,-4
12,Florida,21,Kentucky,43,Carter County,0,4,-4
12,Florida,21,Kentucky,45,Casey County,0,50,-50
12,Florida,21,Kentucky,47,Christian County,322,412,-90
12,Florida,21,Kentucky,49,Clark County,20,66,-46
12,Florida,21,Kentucky,51,Clay County,0,4,-4
12,Florida,21,Kentucky,53,Clinton County,0,1,-1
12,Florida,21,Kentucky,55,Crittenden County,0,25,-25
12,Florida,21,Kentucky,59,Daviess County,27,101,-74
12,Florida,21,Kentucky,61,Edmonson County,23,51,-28
12,Florida,21,Kentucky,63,Elliott County,0,3,-3
12,Florida,21,Kentucky,67,Fayette County,884,841,43
12,Florida,21,Kentucky,69,Fleming County,127,5,122
12,Florida,21,Kentucky,71,Floyd County,49,116,-67
12,Florida,21,Kentucky,73,Franklin County,238,356,-118
12,Florida,21,Kentucky,75,Fulton County,15,10,5
12,Florida,21,Kentucky,77,Gallatin County,0,6,-6
12,Florida,21,Kentucky,79,Garrard County,0,25,-25
12,Florida,21,Kentucky,81,Grant County,39,0,39
12,Florida,21,Kentucky,83,Graves County,37,25,12
12,Florida,21,Kentucky,85,Grayson County,19,23,-4
12,Florida,21,Kentucky,89,Greenup County,41,0,41
12,Florida,21,Kentucky,91,Hancock County,0,5,-5
12,Florida,21,Kentucky,93,Hardin County,357,335,22
12,Florida,21,Kentucky,95,Harlan County,0,15,-15
12,Florida,21,Kentucky,99,Hart County,0,4,-4
12,Florida,21,Kentucky,101,Henderson County,39,165,-126
12,Florida,21,Kentucky,103,Henry County,20,32,-12
12,Florida,21,Kentucky,107,Hopkins County,0,5,-5
12,Florida,21,Kentucky,109,Jackson County,334,5,329
12,Florida,21,Kentucky,111,Jefferson County,2006,1330,676
12,Florida,21,Kentucky,113,Jessamine County,119,31,88
12,Florida,21,Kentucky,115,Johnson County,0,60,-60
12,Florida,21,Kentucky,117,Kenton County,266,207,59
12,Florida,21,Kentucky,119,Knott County,0,4,-4
12,Florida,21,Kentucky,121,Knox County,91,2,89
12,Florida,21,Kentucky,123,Larue County,0,2,-2
12,Florida,21,Kentucky,125,Laurel County,63,76,-13
12,Florida,21,Kentucky,129,Lee County,0,25,-25
12,Florida,21,Kentucky,131,Leslie County,15,0,15
12,Florida,21,Kentucky,133,Letcher County,0,6,-6
12,Florida,21,Kentucky,135,Lewis County,57,0,57
12,Florida,21,Kentucky,137,Lincoln County,68,7,61
12,Florida,21,Kentucky,139,Livingston County,0,5,-5
12,Florida,21,Kentucky,141,Logan County,25,0,25
12,Florida,21,Kentucky,143,Lyon County,21,14,7
12,Florida,21,Kentucky,145,McCracken County,117,35,82
12,Florida,21,Kentucky,147,McCreary County,34,69,-35
12,Florida,21,Kentucky,149,McLean County,51,3,48
12,Florida,21,Kentucky,151,Madison County,143,173,-30
12,Florida,21,Kentucky,153,Magoffin County,20,0,20
12,Florida,21,Kentucky,155,Marion County,18,4,14
12,Florida,21,Kentucky,157,Marshall County,55,6,49
12,Florida,21,Kentucky,159,Martin County,14,11,3
12,Florida,21,Kentucky,161,Mason County,43,21,22
12,Florida,21,Kentucky,163,Meade County,76,163,-87
12,Florida,21,Kentucky,167,Mercer County,13,42,-29
12,Florida,21,Kentucky,169,Metcalfe County,67,0,67
12,Florida,21,Kentucky,173,Montgomery County,14,8,6
12,Florida,21,Kentucky,175,Morgan County,0,11,-11
12,Florida,21,Kentucky,177,Muhlenberg County,14,84,-70
12,Florida,21,Kentucky,179,Nelson County,83,5,78
12,Florida,21,Kentucky,183,Ohio County,0,7,-7
12,Florida,21,Kentucky,185,Oldham County,107,60,47
12,Florida,21,Kentucky,191,Pendleton County,9,0,9
12,Florida,21,Kentucky,193,Perry County,89,0,89
12,Florida,21,Kentucky,195,Pike County,0,11,-11
12,Florida,21,Kentucky,197,Powell County,24,0,24
12,Florida,21,Kentucky,199,Pulaski County,27,141,-114
12,Florida,21,Kentucky,201,Robertson County,13,0,13
12,Florida,21,Kentucky,203,Rockcastle County,0,7,-7
12,Florida,21,Kentucky,205,Rowan County,39,0,39
12,Florida,21,Kentucky,207,Russell County,24,1,23
12,Florida,21,Kentucky,209,Scott County,466,85,381
12,Florida,21,Kentucky,211,Shelby County,53,86,-33
12,Florida,21,Kentucky,213,Simpson County,0,6,-6
12,Florida,21,Kentucky,217,Taylor County,0,156,-156
12,Florida,21,Kentucky,221,Trigg County,10,8,2
12,Florida,21,Kentucky,223,Trimble County,0,4,-4
12,Florida,21,Kentucky,225,Union County,0,172,-172
12,Florida,21,Kentucky,227,Warren County,316,175,141
12,Florida,21,Kentucky,229,Washington County,59,18,41
12,Florida,21,Kentucky,231,Wayne County,0,35,-35
12,Florida,21,Kentucky,235,Whitley County,31,90,-59
12,Florida,21,Kentucky,237,Wolfe County,33,0,33
12,Florida,21,Kentucky,239,Woodford County,81,36,45
12,Florida,22,Louisiana,1,Acadia Parish,0,21,-21
12,Florida,22,Louisiana,3,Allen Parish,12,29,-17
12,Florida,22,Louisiana,5,Ascension Parish,29,351,-322
12,Florida,22,Louisiana,9,Avoyelles Parish,19,15,4
12,Florida,22,Louisiana,15,Bossier Parish,166,483,-317
12,Florida,22,Louisiana,17,Caddo Parish,449,70,379
12,Florida,22,Louisiana,19,Calcasieu Parish,149,292,-143
12,Florida,22,Louisiana,23,Cameron Parish,0,5,-5
12,Florida,22,Louisiana,25,Catahoula Parish,0,7,-7
12,Florida,22,Louisiana,27,Claiborne Parish,0,7,-7
12,Florida,22,Louisiana,29,Concordia Parish,28,6,22
12,Florida,22,Louisiana,33,East Baton Rouge Parish,375,582,-207
12,Florida,22,Louisiana,37,East Feliciana Parish,0,5,-5
12,Florida,22,Louisiana,39,Evangeline Parish,0,9,-9
12,Florida,22,Louisiana,43,Grant Parish,0,15,-15
12,Florida,22,Louisiana,45,Iberia Parish,20,71,-51
12,Florida,22,Louisiana,47,Iberville Parish,10,53,-43
12,Florida,22,Louisiana,51,Jefferson Parish,764,467,297
12,Florida,22,Louisiana,53,Jefferson Davis Parish,0,27,-27
12,Florida,22,Louisiana,55,Lafayette Parish,687,509,178
12,Florida,22,Louisiana,57,Lafourche Parish,58,138,-80
12,Florida,22,Louisiana,61,Lincoln Parish,0,4,-4
12,Florida,22,Louisiana,63,Livingston Parish,103,437,-334
12,Florida,22,Louisiana,65,Madison Parish,0,6,-6
12,Florida,22,Louisiana,69,Natchitoches Parish,59,23,36
12,Florida,22,Louisiana,71,Orleans Parish,801,836,-35
12,Florida,22,Louisiana,73,Ouachita Parish,84,95,-11
12,Florida,22,Louisiana,75,Plaquemines Parish,32,87,-55
12,Florida,22,Louisiana,77,Pointe Coupee Parish,0,22,-22
12,Florida,22,Louisiana,79,Rapides Parish,203,65,138
12,Florida,22,Louisiana,83,Richland Parish,0,3,-3
12,Florida,22,Louisiana,85,Sabine Parish,19,7,12
12,Florida,22,Louisiana,89,St. Charles Parish,31,51,-20
12,Florida,22,Louisiana,95,St. John the Baptist Parish,34,0,34
12,Florida,22,Louisiana,97,St. Landry Parish,14,0,14
12,Florida,22,Louisiana,99,St. Martin Parish,71,40,31
12,Florida,22,Louisiana,101,St. Mary Parish,47,0,47
12,Florida,22,Louisiana,103,St. Tammany Parish,410,319,91
12,Florida,22,Louisiana,105,Tangipahoa Parish,439,250,189
12,Florida,22,Louisiana,109,Terrebonne Parish,98,10,88
12,Florida,22,Louisiana,113,Vermilion Parish,43,44,-1
12,Florida,22,Louisiana,115,Vernon Parish,292,154,138
12,Florida,22,Louisiana,117,Washington Parish,136,0,136
12,Florida,22,Louisiana,121,West Baton Rouge Parish,0,15,-15
12,Florida,22,Louisiana,127,Winn Parish,90,0,90
12,Florida,23,Maine,1,Androscoggin County,234,159,75
12,Florida,23,Maine,3,Aroostook County,276,116,160
12,Florida,23,Maine,5,Cumberland County,1081,964,117
12,Florida,23,Maine,7,Franklin County,0,49,-49
12,Florida,23,Maine,9,Hancock County,205,143,62
12,Florida,23,Maine,11,Kennebec County,233,140,93
12,Florida,23,Maine,13,Knox County,85,88,-3
12,Florida,23,Maine,15,Lincoln County,45,26,19
12,Florida,23,Maine,17,Oxford County,145,132,13
12,Florida,23,Maine,19,Penobscot County,257,244,13
12,Florida,23,Maine,21,Piscataquis County,141,6,135
12,Florida,23,Maine,23,Sagadahoc County,38,11,27
12,Florida,23,Maine,25,Somerset County,202,26,176
12,Florida,23,Maine,27,Waldo County,188,118,70
12,Florida,23,Maine,29,Washington County,90,21,69
12,Florida,23,Maine,31,York County,393,397,-4
12,Florida,24,Maryland,1,Allegany County,32,121,-89
12,Florida,24,Maryland,3,Anne Arundel County,3651,1595,2056
12,Florida,24,Maryland,5,Baltimore County,1644,942,702
12,Florida,24,Maryland,9,Calvert County,458,439,19
12,Florida,24,Maryland,11,Caroline County,0,22,-22
12,Florida,24,Maryland,13,Carroll County,263,142,121
12,Florida,24,Maryland,15,Cecil County,310,109,201
12,Florida,24,Maryland,17,Charles County,632,402,230
12,Florida,24,Maryland,19,Dorchester County,25,18,7
12,Florida,24,Maryland,21,Frederick County,450,354,96
12,Florida,24,Maryland,23,Garrett County,0,30,-30
12,Florida,24,Maryland,25,Harford County,505,394,111
12,Florida,24,Maryland,27,Howard County,1090,349,741
12,Florida,24,Maryland,29,Kent County,34,24,10
12,Florida,24,Maryland,31,Montgomery County,3237,1568,1669
12,Florida,24,Maryland,33,Prince George's County,1130,1184,-54
12,Florida,24,Maryland,35,Queen Anne's County,0,6,-6
12,Florida,24,Maryland,37,St. Mary's County,512,360,152
12,Florida,24,Maryland,39,Somerset County,19,11,8
12,Florida,24,Maryland,41,Talbot County,116,90,26
12,Florida,24,Maryland,43,Washington County,684,190,494
12,Florida,24,Maryland,45,Wicomico County,152,118,34
12,Florida,24,Maryland,47,Worcester County,289,51,238
12,Florida,24,Maryland,510,Baltimore city,1053,897,156
12,Florida,25,Massachusetts,1,Barnstable County,851,484,367
12,Florida,25,Massachusetts,3,Berkshire County,421,278,143
12,Florida,25,Massachusetts,5,Bristol County,1755,1102,653
12,Florida,25,Massachusetts,7,Dukes County,118,1,117
12,Florida,25,Massachusetts,9,Essex County,2331,757,1574
12,Florida,25,Massachusetts,11,Franklin County,114,84,30
12,Florida,25,Massachusetts,13,Hampden County,1135,820,315
12,Florida,25,Massachusetts,15,Hampshire County,353,223,130
12,Florida,25,Massachusetts,17,Middlesex County,3209,2133,1076
12,Florida,25,Massachusetts,19,Nantucket County,27,4,23
12,Florida,25,Massachusetts,21,Norfolk County,1806,735,1071
12,Florida,25,Massachusetts,23,Plymouth County,1172,1036,136
12,Florida,25,Massachusetts,25,Suffolk County,2362,1921,441
12,Florida,25,Massachusetts,27,Worcester County,2192,1119,1073
12,Florida,26,Michigan,1,Alcona County,35,49,-14
12,Florida,26,Michigan,3,Alger County,16,0,16
12,Florida,26,Michigan,5,Allegan County,239,42,197
12,Florida,26,Michigan,7,Alpena County,113,12,101
12,Florida,26,Michigan,9,Antrim County,42,26,16
12,Florida,26,Michigan,11,Arenac County,52,18,34
12,Florida,26,Michigan,13,Baraga County,0,1,-1
12,Florida,26,Michigan,15,Barry County,50,140,-90
12,Florida,26,Michigan,17,Bay County,136,39,97
12,Florida,26,Michigan,19,Benzie County,21,32,-11
12,Florida,26,Michigan,21,Berrien County,212,393,-181
12,Florida,26,Michigan,23,Branch County,181,48,133
12,Florida,26,Michigan,25,Calhoun County,198,216,-18
12,Florida,26,Michigan,27,Cass County,292,13,279
12,Florida,26,Michigan,29,Charlevoix County,16,31,-15
12,Florida,26,Michigan,31,Cheboygan County,223,31,192
12,Florida,26,Michigan,33,Chippewa County,173,35,138
12,Florida,26,Michigan,35,Clare County,163,70,93
12,Florida,26,Michigan,37,Clinton County,157,59,98
12,Florida,26,Michigan,39,Crawford County,35,16,19
12,Florida,26,Michigan,41,Delta County,179,50,129
12,Florida,26,Michigan,45,Eaton County,247,59,188
12,Florida,26,Michigan,47,Emmet County,61,50,11
12,Florida,26,Michigan,49,Genesee County,942,437,505
12,Florida,26,Michigan,51,Gladwin County,63,26,37
12,Florida,26,Michigan,53,Gogebic County,0,26,-26
12,Florida,26,Michigan,55,Grand Traverse County,397,67,330
12,Florida,26,Michigan,57,Gratiot County,73,53,20
12,Florida,26,Michigan,59,Hillsdale County,65,8,57
12,Florida,26,Michigan,61,Houghton County,45,142,-97
12,Florida,26,Michigan,63,Huron County,57,12,45
12,Florida,26,Michigan,65,Ingham County,757,580,177
12,Florida,26,Michigan,67,Ionia County,164,33,131
12,Florida,26,Michigan,69,Iosco County,45,216,-171
12,Florida,26,Michigan,71,Iron County,31,8,23
12,Florida,26,Michigan,73,Isabella County,91,69,22
12,Florida,26,Michigan,75,Jackson County,98,274,-176
12,Florida,26,Michigan,77,Kalamazoo County,226,204,22
12,Florida,26,Michigan,79,Kalkaska County,47,37,10
12,Florida,26,Michigan,81,Kent County,1208,790,418
12,Florida,26,Michigan,85,Lake County,9,0,9
12,Florida,26,Michigan,87,Lapeer County,151,88,63
12,Florida,26,Michigan,89,Leelanau County,0,23,-23
12,Florida,26,Michigan,91,Lenawee County,149,109,40
12,Florida,26,Michigan,93,Livingston County,543,385,158
12,Florida,26,Michigan,95,Luce County,8,0,8
12,Florida,26,Michigan,97,Mackinac County,15,17,-2
12,Florida,26,Michigan,99,Macomb County,1815,830,985
12,Florida,26,Michigan,101,Manistee County,30,55,-25
12,Florida,26,Michigan,103,Marquette County,71,53,18
12,Florida,26,Michigan,105,Mason County,222,30,192
12,Florida,26,Michigan,107,Mecosta County,32,23,9
12,Florida,26,Michigan,109,Menominee County,52,5,47
12,Florida,26,Michigan,111,Midland County,110,49,61
12,Florida,26,Michigan,113,Missaukee County,0,50,-50
12,Florida,26,Michigan,115,Monroe County,455,239,216
12,Florida,26,Michigan,117,Montcalm County,177,27,150
12,Florida,26,Michigan,119,Montmorency County,0,10,-10
12,Florida,26,Michigan,121,Muskegon County,510,167,343
12,Florida,26,Michigan,123,Newaygo County,79,48,31
12,Florida,26,Michigan,125,Oakland County,3250,1565,1685
12,Florida,26,Michigan,127,Oceana County,120,20,100
12,Florida,26,Michigan,129,Ogemaw County,133,2,131
12,Florida,26,Michigan,131,Ontonagon County,0,7,-7
12,Florida,26,Michigan,133,Osceola County,100,16,84
12,Florida,26,Michigan,135,Oscoda County,0,9,-9
12,Florida,26,Michigan,137,Otsego County,111,10,101
12,Florida,26,Michigan,139,Ottawa County,332,392,-60
12,Florida,26,Michigan,141,Presque Isle County,69,24,45
12,Florida,26,Michigan,143,Roscommon County,81,169,-88
12,Florida,26,Michigan,145,Saginaw County,260,332,-72
12,Florida,26,Michigan,147,St. Clair County,365,504,-139
12,Florida,26,Michigan,149,St. Joseph County,176,71,105
12,Florida,26,Michigan,151,Sanilac County,172,32,140
12,Florida,26,Michigan,153,Schoolcraft County,0,4,-4
12,Florida,26,Michigan,155,Shiawassee County,236,78,158
12,Florida,26,Michigan,157,Tuscola County,225,62,163
12,Florida,26,Michigan,159,Van Buren County,175,84,91
12,Florida,26,Michigan,161,Washtenaw County,720,523,197
12,Florida,26,Michigan,163,Wayne County,3532,2161,1371
12,Florida,26,Michigan,165,Wexford County,24,68,-44
12,Florida,27,Minnesota,1,Aitkin County,27,2,25
12,Florida,27,Minnesota,3,Anoka County,407,118,289
12,Florida,27,Minnesota,5,Becker County,22,12,10
12,Florida,27,Minnesota,7,Beltrami County,20,0,20
12,Florida,27,Minnesota,9,Benton County,22,0,22
12,Florida,27,Minnesota,13,Blue Earth County,120,17,103
12,Florida,27,Minnesota,17,Carlton County,76,0,76
12,Florida,27,Minnesota,19,Carver County,107,196,-89
12,Florida,27,Minnesota,21,Cass County,25,23,2
12,Florida,27,Minnesota,23,Chippewa County,0,5,-5
12,Florida,27,Minnesota,25,Chisago County,154,0,154
12,Florida,27,Minnesota,27,Clay County,16,23,-7
12,Florida,27,Minnesota,31,Cook County,0,14,-14
12,Florida,27,Minnesota,35,Crow Wing County,70,111,-41
12,Florida,27,Minnesota,37,Dakota County,375,243,132
12,Florida,27,Minnesota,39,Dodge County,31,2,29
12,Florida,27,Minnesota,43,Faribault County,15,0,15
12,Florida,27,Minnesota,45,Fillmore County,0,80,-80
12,Florida,27,Minnesota,47,Freeborn County,26,0,26
12,Florida,27,Minnesota,49,Goodhue County,74,4,70
12,Florida,27,Minnesota,51,Grant County,0,4,-4
12,Florida,27,Minnesota,53,Hennepin County,2352,1097,1255
12,Florida,27,Minnesota,55,Houston County,0,1,-1
12,Florida,27,Minnesota,57,Hubbard County,0,13,-13
12,Florida,27,Minnesota,59,Isanti County,0,14,-14
12,Florida,27,Minnesota,61,Itasca County,41,9,32
12,Florida,27,Minnesota,69,Kittson County,0,18,-18
12,Florida,27,Minnesota,71,Koochiching County,28,0,28
12,Florida,27,Minnesota,75,Lake County,0,12,-12
12,Florida,27,Minnesota,77,Lake of the Woods County,17,0,17
12,Florida,27,Minnesota,79,Le Sueur County,0,41,-41
12,Florida,27,Minnesota,85,McLeod County,0,40,-40
12,Florida,27,Minnesota,89,Marshall County,0,3,-3
12,Florida,27,Minnesota,91,Martin County,4,14,-10
12,Florida,27,Minnesota,95,Mille Lacs County,0,32,-32
12,Florida,27,Minnesota,97,Morrison County,0,2,-2
12,Florida,27,Minnesota,99,Mower County,0,23,-23
12,Florida,27,Minnesota,109,Olmsted County,155,64,91
12,Florida,27,Minnesota,111,Otter Tail County,82,41,41
12,Florida,27,Minnesota,113,Pennington County,0,125,-125
12,Florida,27,Minnesota,115,Pine County,64,24,40
12,Florida,27,Minnesota,119,Polk County,0,21,-21
12,Florida,27,Minnesota,123,Ramsey County,439,242,197
12,Florida,27,Minnesota,129,Renville County,0,3,-3
12,Florida,27,Minnesota,131,Rice County,0,33,-33
12,Florida,27,Minnesota,135,Roseau County,23,3,20
12,Florida,27,Minnesota,137,St. Louis County,244,203,41
12,Florida,27,Minnesota,139,Scott County,282,24,258
12,Florida,27,Minnesota,141,Sherburne County,86,27,59
12,Florida,27,Minnesota,143,Sibley County,0,2,-2
12,Florida,27,Minnesota,145,Stearns County,104,85,19
12,Florida,27,Minnesota,149,Stevens County,0,10,-10
12,Florida,27,Minnesota,151,Swift County,22,3,19
12,Florida,27,Minnesota,153,Todd County,113,3,110
12,Florida,27,Minnesota,155,Traverse County,20,0,20
12,Florida,27,Minnesota,157,Wabasha County,0,7,-7
12,Florida,27,Minnesota,159,Wadena County,0,3,-3
12,Florida,27,Minnesota,161,Waseca County,0,55,-55
12,Florida,27,Minnesota,163,Washington County,367,138,229
12,Florida,27,Minnesota,169,Winona County,0,5,-5
12,Florida,27,Minnesota,171,Wright County,82,32,50
12,Florida,28,Mississippi,1,Adams County,135,15,120
12,Florida,28,Mississippi,3,Alcorn County,33,41,-8
12,Florida,28,Mississippi,5,Amite County,3,0,3
12,Florida,28,Mississippi,7,Attala County,0,106,-106
12,Florida,28,Mississippi,9,Benton County,0,2,-2
12,Florida,28,Mississippi,11,Bolivar County,0,45,-45
12,Florida,28,Mississippi,13,Calhoun County,0,11,-11
12,Florida,28,Mississippi,17,Chickasaw County,0,87,-87
12,Florida,28,Mississippi,19,Choctaw County,0,37,-37
12,Florida,28,Mississippi,21,Claiborne County,0,7,-7
12,Florida,28,Mississippi,25,Clay County,29,0,29
12,Florida,28,Mississippi,27,Coahoma County,0,9,-9
12,Florida,28,Mississippi,29,Copiah County,0,60,-60
12,Florida,28,Mississippi,31,Covington County,10,0,10
12,Florida,28,Mississippi,33,DeSoto County,58,183,-125
12,Florida,28,Mississippi,35,Forrest County,357,193,164
12,Florida,28,Mississippi,41,Greene County,0,56,-56
12,Florida,28,Mississippi,45,Hancock County,71,118,-47
12,Florida,28,Mississippi,47,Harrison County,1425,1222,203
12,Florida,28,Mississippi,49,Hinds County,87,223,-136
12,Florida,28,Mississippi,59,Jackson County,634,330,304
12,Florida,28,Mississippi,65,Jefferson Davis County,15,9,6
12,Florida,28,Mississippi,67,Jones County,12,17,-5
12,Florida,28,Mississippi,69,Kemper County,42,3,39
12,Florida,28,Mississippi,71,Lafayette County,353,263,90
12,Florida,28,Mississippi,73,Lamar County,9,205,-196
12,Florida,28,Mississippi,75,Lauderdale County,376,318,58
12,Florida,28,Mississippi,77,Lawrence County,18,0,18
12,Florida,28,Mississippi,79,Leake County,9,0,9
12,Florida,28,Mississippi,81,Lee County,72,71,1
12,Florida,28,Mississippi,83,Leflore County,250,16,234
12,Florida,28,Mississippi,85,Lincoln County,24,0,24
12,Florida,28,Mississippi,87,Lowndes County,32,125,-93
12,Florida,28,Mississippi,89,Madison County,484,172,312
12,Florida,28,Mississippi,91,Marion County,0,18,-18
12,Florida,28,Mississippi,93,Marshall County,0,127,-127
12,Florida,28,Mississippi,95,Monroe County,24,8,16
12,Florida,28,Mississippi,97,Montgomery County,61,4,57
12,Florida,28,Mississippi,99,Neshoba County,5,0,5
12,Florida,28,Mississippi,103,Noxubee County,8,0,8
12,Florida,28,Mississippi,105,Oktibbeha County,173,358,-185
12,Florida,28,Mississippi,107,Panola County,45,13,32
12,Florida,28,Mississippi,109,Pearl River County,134,65,69
12,Florida,28,Mississippi,111,Perry County,0,8,-8
12,Florida,28,Mississippi,113,Pike County,27,5,22
12,Florida,28,Mississippi,115,Pontotoc County,0,227,-227
12,Florida,28,Mississippi,117,Prentiss County,0,3,-3
12,Florida,28,Mississippi,121,Rankin County,216,125,91
12,Florida,28,Mississippi,123,Scott County,0,14,-14
12,Florida,28,Mississippi,127,Simpson County,6,12,-6
12,Florida,28,Mississippi,131,Stone County,7,36,-29
12,Florida,28,Mississippi,133,Sunflower County,0,29,-29
12,Florida,28,Mississippi,135,Tallahatchie County,2,0,2
12,Florida,28,Mississippi,139,Tippah County,44,0,44
12,Florida,28,Mississippi,149,Warren County,37,37,0
12,Florida,28,Mississippi,151,Washington County,64,1,63
12,Florida,28,Mississippi,159,Winston County,74,0,74
12,Florida,28,Mississippi,163,Yazoo County,65,101,-36
12,Florida,29,Missouri,1,Adair County,54,12,42
12,Florida,29,Missouri,3,Andrew County,31,6,25
12,Florida,29,Missouri,7,Audrain County,14,0,14
12,Florida,29,Missouri,9,Barry County,52,0,52
12,Florida,29,Missouri,11,Barton County,19,0,19
12,Florida,29,Missouri,15,Benton County,18,26,-8
12,Florida,29,Missouri,19,Boone County,364,299,65
12,Florida,29,Missouri,21,Buchanan County,193,120,73
12,Florida,29,Missouri,23,Butler County,197,48,149
12,Florida,29,Missouri,27,Callaway County,165,49,116
12,Florida,29,Missouri,29,Camden County,0,88,-88
12,Florida,29,Missouri,31,Cape Girardeau County,179,63,116
12,Florida,29,Missouri,37,Cass County,88,156,-68
12,Florida,29,Missouri,43,Christian County,99,185,-86
12,Florida,29,Missouri,45,Clark County,32,9,23
12,Florida,29,Missouri,47,Clay County,216,155,61
12,Florida,29,Missouri,49,Clinton County,70,0,70
12,Florida,29,Missouri,51,Cole County,60,4,56
12,Florida,29,Missouri,53,Cooper County,60,8,52
12,Florida,29,Missouri,55,Crawford County,10,0,10
12,Florida,29,Missouri,57,Dade County,22,0,22
12,Florida,29,Missouri,61,Daviess County,0,13,-13
12,Florida,29,Missouri,69,Dunklin County,0,89,-89
12,Florida,29,Missouri,71,Franklin County,132,43,89
12,Florida,29,Missouri,77,Greene County,490,325,165
12,Florida,29,Missouri,81,Harrison County,0,8,-8
12,Florida,29,Missouri,83,Henry County,189,20,169
12,Florida,29,Missouri,85,Hickory County,0,6,-6
12,Florida,29,Missouri,87,Holt County,138,0,138
12,Florida,29,Missouri,89,Howard County,43,6,37
12,Florida,29,Missouri,91,Howell County,25,0,25
12,Florida,29,Missouri,93,Iron County,39,12,27
12,Florida,29,Missouri,95,Jackson County,851,440,411
12,Florida,29,Missouri,97,Jasper County,410,0,410
12,Florida,29,Missouri,99,Jefferson County,249,153,96
12,Florida,29,Missouri,101,Johnson County,205,247,-42
12,Florida,29,Missouri,103,Knox County,0,6,-6
12,Florida,29,Missouri,105,Laclede County,12,0,12
12,Florida,29,Missouri,107,Lafayette County,0,67,-67
12,Florida,29,Missouri,109,Lawrence County,12,9,3
12,Florida,29,Missouri,111,Lewis County,39,12,27
12,Florida,29,Missouri,113,Lincoln County,98,0,98
12,Florida,29,Missouri,115,Linn County,0,2,-2
12,Florida,29,Missouri,117,Livingston County,0,2,-2
12,Florida,29,Missouri,125,Maries County,124,0,124
12,Florida,29,Missouri,127,Marion County,0,9,-9
12,Florida,29,Missouri,131,Miller County,25,69,-44
12,Florida,29,Missouri,135,Moniteau County,32,4,28
12,Florida,29,Missouri,141,Morgan County,0,33,-33
12,Florida,29,Missouri,143,New Madrid County,20,0,20
12,Florida,29,Missouri,145,Newton County,48,177,-129
12,Florida,29,Missouri,147,Nodaway County,0,1,-1
12,Florida,29,Missouri,149,Oregon County,0,7,-7
12,Florida,29,Missouri,151,Osage County,0,19,-19
12,Florida,29,Missouri,153,Ozark County,0,3,-3
12,Florida,29,Missouri,155,Pemiscot County,0,13,-13
12,Florida,29,Missouri,157,Perry County,0,31,-31
12,Florida,29,Missouri,159,Pettis County,144,119,25
12,Florida,29,Missouri,161,Phelps County,30,7,23
12,Florida,29,Missouri,165,Platte County,74,482,-408
12,Florida,29,Missouri,167,Polk County,32,0,32
12,Florida,29,Missouri,169,Pulaski County,30,415,-385
12,Florida,29,Missouri,171,Putnam County,46,21,25
12,Florida,29,Missouri,175,Randolph County,0,6,-6
12,Florida,29,Missouri,177,Ray County,0,10,-10
12,Florida,29,Missouri,179,Reynolds County,5,0,5
12,Florida,29,Missouri,183,St. Charles County,939,228,711
12,Florida,29,Missouri,185,St. Clair County,0,34,-34
12,Florida,29,Missouri,187,St. Francois County,127,7,120
12,Florida,29,Missouri,189,St. Louis County,2249,851,1398
12,Florida,29,Missouri,195,Saline County,50,20,30
12,Florida,29,Missouri,199,Scotland County,0,10,-10
12,Florida,29,Missouri,201,Scott County,11,38,-27
12,Florida,29,Missouri,205,Shelby County,0,31,-31
12,Florida,29,Missouri,209,Stone County,55,131,-76
12,Florida,29,Missouri,211,Sullivan County,29,0,29
12,Florida,29,Missouri,213,Taney County,104,156,-52
12,Florida,29,Missouri,215,Texas County,10,0,10
12,Florida,29,Missouri,217,Vernon County,68,0,68
12,Florida,29,Missouri,219,Warren County,9,67,-58
12,Florida,29,Missouri,225,Webster County,0,55,-55
12,Florida,29,Missouri,229,Wright County,0,19,-19
12,Florida,29,Missouri,510,St. Louis city,504,249,255
12,Florida,30,Montana,3,Big Horn County,0,21,-21
12,Florida,30,Montana,5,Blaine County,77,0,77
12,Florida,30,Montana,13,Cascade County,22,45,-23
12,Florida,30,Montana,23,Deer Lodge County,0,14,-14
12,Florida,30,Montana,29,Flathead County,123,80,43
12,Florida,30,Montana,31,Gallatin County,109,170,-61
12,Florida,30,Montana,35,Glacier County,0,26,-26
12,Florida,30,Montana,39,Granite County,0,13,-13
12,Florida,30,Montana,47,Lake County,0,25,-25
12,Florida,30,Montana,49,Lewis and Clark County,146,132,14
12,Florida,30,Montana,57,Madison County,0,1,-1
12,Florida,30,Montana,63,Missoula County,0,11,-11
12,Florida,30,Montana,67,Park County,0,6,-6
12,Florida,30,Montana,73,Pondera County,11,0,11
12,Florida,30,Montana,77,Powell County,0,14,-14
12,Florida,30,Montana,79,Prairie County,0,1,-1
12,Florida,30,Montana,81,Ravalli County,54,10,44
12,Florida,30,Montana,89,Sanders County,0,13,-13
12,Florida,30,Montana,93,Silver Bow County,14,15,-1
12,Florida,30,Montana,101,Toole County,13,23,-10
12,Florida,30,Montana,111,Yellowstone County,115,195,-80
12,Florida,31,Nebraska,1,Adams County,101,0,101
12,Florida,31,Nebraska,11,Boone County,0,2,-2
12,Florida,31,Nebraska,19,Buffalo County,64,52,12
12,Florida,31,Nebraska,21,Burt County,0,3,-3
12,Florida,31,Nebraska,31,Cherry County,20,0,20
12,Florida,31,Nebraska,45,Dawes County,0,48,-48
12,Florida,31,Nebraska,53,Dodge County,0,9,-9
12,Florida,31,Nebraska,55,Douglas County,730,553,177
12,Florida,31,Nebraska,65,Furnas County,0,13,-13
12,Florida,31,Nebraska,67,Gage County,0,17,-17
12,Florida,31,Nebraska,79,Hall County,56,135,-79
12,Florida,31,Nebraska,83,Harlan County,0,2,-2
12,Florida,31,Nebraska,87,Hitchcock County,0,3,-3
12,Florida,31,Nebraska,89,Holt County,0,2,-2
12,Florida,31,Nebraska,95,Jefferson County,64,0,64
12,Florida,31,Nebraska,99,Kearney County,0,4,-4
12,Florida,31,Nebraska,101,Keith County,0,45,-45
12,Florida,31,Nebraska,105,Kimball County,11,1,10
12,Florida,31,Nebraska,109,Lancaster County,235,305,-70
12,Florida,31,Nebraska,111,Lincoln County,28,157,-129
12,Florida,31,Nebraska,119,Madison County,0,6,-6
12,Florida,31,Nebraska,125,Nance County,0,10,-10
12,Florida,31,Nebraska,141,Platte County,20,27,-7
12,Florida,31,Nebraska,143,Polk County,0,5,-5
12,Florida,31,Nebraska,147,Richardson County,11,0,11
12,Florida,31,Nebraska,149,Rock County,0,1,-1
12,Florida,31,Nebraska,153,Sarpy County,308,608,-300
12,Florida,31,Nebraska,155,Saunders County,0,21,-21
12,Florida,31,Nebraska,157,Scotts Bluff County,0,14,-14
12,Florida,31,Nebraska,161,Sheridan County,0,5,-5
12,Florida,31,Nebraska,169,Thayer County,18,0,18
12,Florida,32,Nevada,1,Churchill County,120,70,50
12,Florida,32,Nevada,3,Clark County,3861,4742,-881
12,Florida,32,Nevada,5,Douglas County,18,7,11
12,Florida,32,Nevada,19,Lyon County,0,49,-49
12,Florida,32,Nevada,23,Nye County,5,39,-34
12,Florida,32,Nevada,27,Pershing County,0,6,-6
12,Florida,32,Nevada,31,Washoe County,746,616,130
12,Florida,32,Nevada,510,Carson City,36,47,-11
12,Florida,33,New Hampshire,1,Belknap County,260,131,129
12,Florida,33,New Hampshire,3,Carroll County,125,220,-95
12,Florida,33,New Hampshire,5,Cheshire County,413,70,343
12,Florida,33,New Hampshire,7,Coos County,181,43,138
12,Florida,33,New Hampshire,9,Grafton County,306,184,122
12,Florida,33,New Hampshire,11,Hillsborough County,1494,567,927
12,Florida,33,New Hampshire,13,Merrimack County,386,266,120
12,Florida,33,New Hampshire,15,Rockingham County,1388,594,794
12,Florida,33,New Hampshire,17,Strafford County,343,140,203
12,Florida,33,New Hampshire,19,Sullivan County,105,160,-55
12,Florida,34,New Jersey,1,Atlantic County,1161,552,609
12,Florida,34,New Jersey,3,Bergen County,3304,1041,2263
12,Florida,34,New Jersey,5,Burlington County,1921,711,1210
12,Florida,34,New Jersey,7,Camden County,1527,583,944
12,Florida,34,New Jersey,9,Cape May County,615,253,362
12,Florida,34,New Jersey,11,Cumberland County,220,288,-68
12,Florida,34,New Jersey,13,Essex County,2455,557,1898
12,Florida,34,New Jersey,15,Gloucester County,785,188,597
12,Florida,34,New Jersey,17,Hudson County,1988,766,1222
12,Florida,34,New Jersey,19,Hunterdon County,195,207,-12
12,Florida,34,New Jersey,21,Mercer County,953,793,160
12,Florida,34,New Jersey,23,Middlesex County,3100,660,2440
12,Florida,34,New Jersey,25,Monmouth County,1888,943,945
12,Florida,34,New Jersey,27,Morris County,1850,378,1472
12,Florida,34,New Jersey,29,Ocean County,2965,1150,1815
12,Florida,34,New Jersey,31,Passaic County,1308,232,1076
12,Florida,34,New Jersey,33,Salem County,92,65,27
12,Florida,34,New Jersey,35,Somerset County,1143,163,980
12,Florida,34,New Jersey,37,Sussex County,235,234,1
12,Florida,34,New Jersey,39,Union County,1758,589,1169
12,Florida,34,New Jersey,41,Warren County,313,91,222
12,Florida,35,New Mexico,1,Bernalillo County,1472,692,780
12,Florida,35,New Mexico,5,Chaves County,28,39,-11
12,Florida,35,New Mexico,6,Cibola County,38,3,35
12,Florida,35,New Mexico,7,Colfax County,0,2,-2
12,Florida,35,New Mexico,9,Curry County,137,286,-149
12,Florida,35,New Mexico,13,Doña Ana County,127,161,-34
12,Florida,35,New Mexico,15,Eddy County,53,131,-78
12,Florida,35,New Mexico,17,Grant County,27,9,18
12,Florida,35,New Mexico,23,Hidalgo County,0,31,-31
12,Florida,35,New Mexico,25,Lea County,12,18,-6
12,Florida,35,New Mexico,28,Los Alamos County,0,2,-2
12,Florida,35,New Mexico,29,Luna County,33,0,33
12,Florida,35,New Mexico,35,Otero County,475,168,307
12,Florida,35,New Mexico,39,Rio Arriba County,0,2,-2
12,Florida,35,New Mexico,41,Roosevelt County,16,11,5
12,Florida,35,New Mexico,43,Sandoval County,96,141,-45
12,Florida,35,New Mexico,45,San Juan County,66,25,41
12,Florida,35,New Mexico,47,San Miguel County,8,0,8
12,Florida,35,New Mexico,49,Santa Fe County,68,169,-101
12,Florida,35,New Mexico,51,Sierra County,5,0,5
12,Florida,35,New Mexico,53,Socorro County,25,4,21
12,Florida,35,New Mexico,55,Taos County,0,35,-35
12,Florida,35,New Mexico,57,Torrance County,0,19,-19
12,Florida,35,New Mexico,61,Valencia County,47,47,0
12,Florida,36,New York,1,Albany County,543,626,-83
12,Florida,36,New York,3,Allegany County,191,27,164
12,Florida,36,New York,5,Bronx County,4266,1287,2979
12,Florida,36,New York,7,Broome County,383,44,339
12,Florida,36,New York,9,Cattaraugus County,104,89,15
12,Florida,36,New York,11,Cayuga County,286,104,182
12,Florida,36,New York,13,Chautauqua County,558,339,219
12,Florida,36,New York,15,Chemung County,137,56,81
12,Florida,36,New York,17,Chenango County,129,102,27
12,Florida,36,New York,19,Clinton County,186,235,-49
12,Florida,36,New York,21,Columbia County,113,76,37
12,Florida,36,New York,23,Cortland County,29,38,-9
12,Florida,36,New York,25,Delaware County,34,57,-23
12,Florida,36,New York,27,Dutchess County,1291,553,738
12,Florida,36,New York,29,Erie County,2103,1354,749
12,Florida,36,New York,31,Essex County,84,51,33
12,Florida,36,New York,33,Franklin County,71,130,-59
12,Florida,36,New York,35,Fulton County,57,158,-101
12,Florida,36,New York,37,Genesee County,538,104,434
12,Florida,36,New York,39,Greene County,193,0,193
12,Florida,36,New York,41,Hamilton County,14,0,14
12,Florida,36,New York,43,Herkimer County,54,137,-83
12,Florida,36,New York,45,Jefferson County,714,579,135
12,Florida,36,New York,47,Kings County,7198,2858,4340
12,Florida,36,New York,49,Lewis County,116,82,34
12,Florida,36,New York,51,Livingston County,73,107,-34
12,Florida,36,New York,53,Madison County,234,108,126
12,Florida,36,New York,55,Monroe County,2765,1587,1178
12,Florida,36,New York,57,Montgomery County,178,71,107
12,Florida,36,New York,59,Nassau County,4662,1108,3554
12,Florida,36,New York,61,New York County,5872,3985,1887
12,Florida,36,New York,63,Niagara County,517,180,337
12,Florida,36,New York,65,Oneida County,283,286,-3
12,Florida,36,New York,67,Onondaga County,1902,706,1196
12,Florida,36,New York,69,Ontario County,336,272,64
12,Florida,36,New York,71,Orange County,1485,399,1086
12,Florida,36,New York,73,Orleans County,60,50,10
12,Florida,36,New York,75,Oswego County,430,222,208
12,Florida,36,New York,77,Otsego County,307,69,238
12,Florida,36,New York,79,Putnam County,342,46,296
12,Florida,36,New York,81,Queens County,8026,2205,5821
12,Florida,36,New York,83,Rensselaer County,346,420,-74
12,Florida,36,New York,85,Richmond County,1133,315,818
12,Florida,36,New York,87,Rockland County,805,310,495
12,Florida,36,New York,89,St. Lawrence County,210,123,87
12,Florida,36,New York,91,Saratoga County,1022,359,663
12,Florida,36,New York,93,Schenectady County,512,267,245
12,Florida,36,New York,95,Schoharie County,82,180,-98
12,Florida,36,New York,97,Schuyler County,14,20,-6
12,Florida,36,New York,99,Seneca County,152,44,108
12,Florida,36,New York,101,Steuben County,249,111,138
12,Florida,36,New York,103,Suffolk County,6090,1876,4214
12,Florida,36,New York,105,Sullivan County,184,47,137
12,Florida,36,New York,107,Tioga County,30,17,13
12,Florida,36,New York,109,Tompkins County,198,265,-67
12,Florida,36,New York,111,Ulster County,544,213,331
12,Florida,36,New York,113,Warren County,210,134,76
12,Florida,36,New York,115,Washington County,178,133,45
12,Florida,36,New York,117,Wayne County,320,62,258
12,Florida,36,New York,119,Westchester County,2381,674,1707
12,Florida,36,New York,121,Wyoming County,216,49,167
12,Florida,36,New York,123,Yates County,27,168,-141
12,Florida,37,North Carolina,1,Alamance County,110,189,-79
12,Florida,37,North Carolina,3,Alexander County,18,68,-50
12,Florida,37,North Carolina,5,Alleghany County,66,0,66
12,Florida,37,North Carolina,7,Anson County,10,19,-9
12,Florida,37,North Carolina,9,Ashe County,48,11,37
12,Florida,37,North Carolina,11,Avery County,5,78,-73
12,Florida,37,North Carolina,13,Beaufort County,0,12,-12
12,Florida,37,North Carolina,15,Bertie County,0,37,-37
12,Florida,37,North Carolina,17,Bladen County,0,98,-98
12,Florida,37,North Carolina,19,Brunswick County,204,234,-30
12,Florida,37,North Carolina,21,Buncombe County,1275,1360,-85
12,Florida,37,North Carolina,23,Burke County,61,183,-122
12,Florida,37,North Carolina,25,Cabarrus County,676,434,242
12,Florida,37,North Carolina,27,Caldwell County,191,181,10
12,Florida,37,North Carolina,29,Camden County,57,73,-16
12,Florida,37,North Carolina,31,Carteret County,229,125,104
12,Florida,37,North Carolina,33,Caswell County,0,17,-17
12,Florida,37,North Carolina,35,Catawba County,465,152,313
12,Florida,37,North Carolina,37,Chatham County,52,110,-58
12,Florida,37,North Carolina,39,Cherokee County,367,718,-351
12,Florida,37,North Carolina,41,Chowan County,22,0,22
12,Florida,37,North Carolina,43,Clay County,33,258,-225
12,Florida,37,North Carolina,45,Cleveland County,47,135,-88
12,Florida,37,North Carolina,47,Columbus County,74,56,18
12,Florida,37,North Carolina,49,Craven County,377,965,-588
12,Florida,37,North Carolina,51,Cumberland County,1945,1496,449
12,Florida,37,North Carolina,53,Currituck County,17,45,-28
12,Florida,37,North Carolina,55,Dare County,213,155,58
12,Florida,37,North Carolina,57,Davidson County,173,372,-199
12,Florida,37,North Carolina,59,Davie County,68,160,-92
12,Florida,37,North Carolina,61,Duplin County,43,153,-110
12,Florida,37,North Carolina,63,Durham County,450,500,-50
12,Florida,37,North Carolina,65,Edgecombe County,22,0,22
12,Florida,37,North Carolina,67,Forsyth County,1503,969,534
12,Florida,37,North Carolina,69,Franklin County,100,94,6
12,Florida,37,North Carolina,71,Gaston County,464,650,-186
12,Florida,37,North Carolina,75,Graham County,8,8,0
12,Florida,37,North Carolina,77,Granville County,70,264,-194
12,Florida,37,North Carolina,79,Greene County,0,36,-36
12,Florida,37,North Carolina,81,Guilford County,1015,966,49
12,Florida,37,North Carolina,83,Halifax County,52,0,52
12,Florida,37,North Carolina,85,Harnett County,793,200,593
12,Florida,37,North Carolina,87,Haywood County,618,536,82
12,Florida,37,North Carolina,89,Henderson County,518,1031,-513
12,Florida,37,North Carolina,91,Hertford County,0,25,-25
12,Florida,37,North Carolina,93,Hoke County,179,269,-90
12,Florida,37,North Carolina,97,Iredell County,182,613,-431
12,Florida,37,North Carolina,99,Jackson County,78,123,-45
12,Florida,37,North Carolina,101,Johnston County,357,299,58
12,Florida,37,North Carolina,103,Jones County,84,10,74
12,Florida,37,North Carolina,105,Lee County,304,42,262
12,Florida,37,North Carolina,107,Lenoir County,0,97,-97
12,Florida,37,North Carolina,109,Lincoln County,354,192,162
12,Florida,37,North Carolina,111,McDowell County,72,20,52
12,Florida,37,North Carolina,113,Macon County,329,554,-225
12,Florida,37,North Carolina,115,Madison County,17,75,-58
12,Florida,37,North Carolina,117,Martin County,0,36,-36
12,Florida,37,North Carolina,119,Mecklenburg County,2780,3562,-782
12,Florida,37,North Carolina,121,Mitchell County,54,9,45
12,Florida,37,North Carolina,123,Montgomery County,0,5,-5
12,Florida,37,North Carolina,125,Moore County,133,228,-95
12,Florida,37,North Carolina,127,Nash County,115,137,-22
12,Florida,37,North Carolina,129,New Hanover County,269,444,-175
12,Florida,37,North Carolina,131,Northampton County,0,39,-39
12,Florida,37,North Carolina,133,Onslow County,1369,1752,-383
12,Florida,37,North Carolina,135,Orange County,375,609,-234
12,Florida,37,North Carolina,137,Pamlico County,41,23,18
12,Florida,37,North Carolina,139,Pasquotank County,139,72,67
12,Florida,37,North Carolina,141,Pender County,192,58,134
12,Florida,37,North Carolina,143,Perquimans County,44,2,42
12,Florida,37,North Carolina,145,Person County,8,37,-29
12,Florida,37,North Carolina,147,Pitt County,416,154,262
12,Florida,37,North Carolina,149,Polk County,0,64,-64
12,Florida,37,North Carolina,151,Randolph County,278,60,218
12,Florida,37,North Carolina,153,Richmond County,41,5,36
12,Florida,37,North Carolina,155,Robeson County,49,20,29
12,Florida,37,North Carolina,157,Rockingham County,44,104,-60
12,Florida,37,North Carolina,159,Rowan County,277,144,133
12,Florida,37,North Carolina,161,Rutherford County,131,162,-31
12,Florida,37,North Carolina,163,Sampson County,12,211,-199
12,Florida,37,North Carolina,165,Scotland County,130,8,122
12,Florida,37,North Carolina,167,Stanly County,91,64,27
12,Florida,37,North Carolina,169,Stokes County,23,40,-17
12,Florida,37,North Carolina,171,Surry County,64,140,-76
12,Florida,37,North Carolina,173,Swain County,72,66,6
12,Florida,37,North Carolina,175,Transylvania County,74,275,-201
12,Florida,37,North Carolina,179,Union County,201,377,-176
12,Florida,37,North Carolina,183,Wake County,3253,2989,264
12,Florida,37,North Carolina,185,Warren County,39,17,22
12,Florida,37,North Carolina,187,Washington County,0,33,-33
12,Florida,37,North Carolina,189,Watauga County,191,201,-10
12,Florida,37,North Carolina,191,Wayne County,558,407,151
12,Florida,37,North Carolina,193,Wilkes County,29,68,-39
12,Florida,37,North Carolina,195,Wilson County,182,22,160
12,Florida,37,North Carolina,197,Yadkin County,18,2,16
12,Florida,37,North Carolina,199,Yancey County,30,100,-70
12,Florida,38,North Dakota,3,Barnes County,124,1,123
12,Florida,38,North Dakota,9,Bottineau County,0,14,-14
12,Florida,38,North Dakota,15,Burleigh County,38,36,2
12,Florida,38,North Dakota,17,Cass County,79,171,-92
12,Florida,38,North Dakota,19,Cavalier County,0,6,-6
12,Florida,38,North Dakota,21,Dickey County,0,6,-6
12,Florida,38,North Dakota,25,Dunn County,20,0,20
12,Florida,38,North Dakota,35,Grand Forks County,38,89,-51
12,Florida,38,North Dakota,37,Grant County,0,4,-4
12,Florida,38,North Dakota,45,LaMoure County,0,8,-8
12,Florida,38,North Dakota,51,McIntosh County,0,3,-3
12,Florida,38,North Dakota,57,Mercer County,0,2,-2
12,Florida,38,North Dakota,59,Morton County,0,15,-15
12,Florida,38,North Dakota,61,Mountrail County,44,43,1
12,Florida,38,North Dakota,71,Ramsey County,0,27,-27
12,Florida,38,North Dakota,73,Ransom County,0,21,-21
12,Florida,38,North Dakota,75,Renville County,0,3,-3
12,Florida,38,North Dakota,77,Richland County,12,8,4
12,Florida,38,North Dakota,81,Sargent County,24,0,24
12,Florida,38,North Dakota,89,Stark County,40,69,-29
12,Florida,38,North Dakota,93,Stutsman County,33,32,1
12,Florida,38,North Dakota,97,Traill County,0,16,-16
12,Florida,38,North Dakota,99,Walsh County,0,6,-6
12,Florida,38,North Dakota,101,Ward County,244,430,-186
12,Florida,38,North Dakota,105,Williams County,37,0,37
12,Florida,39,Ohio,1,Adams County,88,11,77
12,Florida,39,Ohio,3,Allen County,149,147,2
12,Florida,39,Ohio,5,Ashland County,28,55,-27
12,Florida,39,Ohio,7,Ashtabula County,243,24,219
12,Florida,39,Ohio,9,Athens County,189,129,60
12,Florida,39,Ohio,11,Auglaize County,44,55,-11
12,Florida,39,Ohio,13,Belmont County,113,73,40
12,Florida,39,Ohio,15,Brown County,29,31,-2
12,Florida,39,Ohio,17,Butler County,709,564,145
12,Florida,39,Ohio,19,Carroll County,0,48,-48
12,Florida,39,Ohio,21,Champaign County,174,41,133
12,Florida,39,Ohio,23,Clark County,99,196,-97
12,Florida,39,Ohio,25,Clermont County,623,285,338
12,Florida,39,Ohio,27,Clinton County,25,28,-3
12,Florida,39,Ohio,29,Columbiana County,161,132,29
12,Florida,39,Ohio,31,Coshocton County,7,36,-29
12,Florida,39,Ohio,33,Crawford County,43,26,17
12,Florida,39,Ohio,35,Cuyahoga County,2561,1813,748
12,Florida,39,Ohio,37,Darke County,53,8,45
12,Florida,39,Ohio,39,Defiance County,0,44,-44
12,Florida,39,Ohio,41,Delaware County,646,382,264
12,Florida,39,Ohio,43,Erie County,330,64,266
12,Florida,39,Ohio,45,Fairfield County,637,79,558
12,Florida,39,Ohio,47,Fayette County,0,12,-12
12,Florida,39,Ohio,49,Franklin County,2509,1701,808
12,Florida,39,Ohio,51,Fulton County,58,0,58
12,Florida,39,Ohio,53,Gallia County,102,8,94
12,Florida,39,Ohio,55,Geauga County,228,9,219
12,Florida,39,Ohio,57,Greene County,835,351,484
12,Florida,39,Ohio,59,Guernsey County,131,111,20
12,Florida,39,Ohio,61,Hamilton County,1723,1223,500
12,Florida,39,Ohio,63,Hancock County,66,201,-135
12,Florida,39,Ohio,65,Hardin County,14,0,14
12,Florida,39,Ohio,67,Harrison County,85,28,57
12,Florida,39,Ohio,69,Henry County,0,4,-4
12,Florida,39,Ohio,71,Highland County,117,20,97
12,Florida,39,Ohio,73,Hocking County,350,8,342
12,Florida,39,Ohio,75,Holmes County,91,0,91
12,Florida,39,Ohio,77,Huron County,189,152,37
12,Florida,39,Ohio,79,Jackson County,0,30,-30
12,Florida,39,Ohio,81,Jefferson County,106,132,-26
12,Florida,39,Ohio,83,Knox County,90,170,-80
12,Florida,39,Ohio,85,Lake County,253,185,68
12,Florida,39,Ohio,87,Lawrence County,107,28,79
12,Florida,39,Ohio,89,Licking County,430,172,258
12,Florida,39,Ohio,91,Logan County,117,54,63
12,Florida,39,Ohio,93,Lorain County,736,227,509
12,Florida,39,Ohio,95,Lucas County,1277,528,749
12,Florida,39,Ohio,97,Madison County,153,12,141
12,Florida,39,Ohio,99,Mahoning County,538,540,-2
12,Florida,39,Ohio,101,Marion County,221,65,156
12,Florida,39,Ohio,103,Medina County,360,250,110
12,Florida,39,Ohio,105,Meigs County,100,32,68
12,Florida,39,Ohio,107,Mercer County,51,0,51
12,Florida,39,Ohio,109,Miami County,161,47,114
12,Florida,39,Ohio,111,Monroe County,71,0,71
12,Florida,39,Ohio,113,Montgomery County,1803,993,810
12,Florida,39,Ohio,117,Morrow County,11,13,-2
12,Florida,39,Ohio,119,Muskingum County,122,88,34
12,Florida,39,Ohio,121,Noble County,0,15,-15
12,Florida,39,Ohio,123,Ottawa County,137,107,30
12,Florida,39,Ohio,125,Paulding County,76,19,57
12,Florida,39,Ohio,127,Perry County,79,7,72
12,Florida,39,Ohio,129,Pickaway County,92,75,17
12,Florida,39,Ohio,131,Pike County,39,2,37
12,Florida,39,Ohio,133,Portage County,123,324,-201
12,Florida,39,Ohio,135,Preble County,24,27,-3
12,Florida,39,Ohio,137,Putnam County,179,18,161
12,Florida,39,Ohio,139,Richland County,212,139,73
12,Florida,39,Ohio,141,Ross County,108,78,30
12,Florida,39,Ohio,143,Sandusky County,90,99,-9
12,Florida,39,Ohio,145,Scioto County,270,81,189
12,Florida,39,Ohio,147,Seneca County,0,30,-30
12,Florida,39,Ohio,149,Shelby County,18,41,-23
12,Florida,39,Ohio,151,Stark County,1235,693,542
12,Florida,39,Ohio,153,Summit County,1010,686,324
12,Florida,39,Ohio,155,Trumbull County,342,343,-1
12,Florida,39,Ohio,157,Tuscarawas County,110,12,98
12,Florida,39,Ohio,159,Union County,87,115,-28
12,Florida,39,Ohio,161,Van Wert County,55,0,55
12,Florida,39,Ohio,165,Warren County,599,112,487
12,Florida,39,Ohio,167,Washington County,132,8,124
12,Florida,39,Ohio,169,Wayne County,148,106,42
12,Florida,39,Ohio,171,Williams County,63,57,6
12,Florida,39,Ohio,173,Wood County,260,92,168
12,Florida,39,Ohio,175,Wyandot County,0,21,-21
12,Florida,4,Arizona,1,Apache County,0,5,-5
12,Florida,4,Arizona,3,Cochise County,446,301,145
12,Florida,4,Arizona,5,Coconino County,188,167,21
12,Florida,4,Arizona,7,Gila County,21,18,3
12,Florida,4,Arizona,9,Graham County,0,17,-17
12,Florida,4,Arizona,12,La Paz County,151,0,151
12,Florida,4,Arizona,13,Maricopa County,4275,4573,-298
12,Florida,4,Arizona,15,Mohave County,165,129,36
12,Florida,4,Arizona,17,Navajo County,36,263,-227
12,Florida,4,Arizona,19,Pima County,1638,1991,-353
12,Florida,4,Arizona,21,Pinal County,307,267,40
12,Florida,4,Arizona,23,Santa Cruz County,0,33,-33
12,Florida,4,Arizona,25,Yavapai County,305,306,-1
12,Florida,4,Arizona,27,Yuma County,294,245,49
12,Florida,40,Oklahoma,1,Adair County,0,3,-3
12,Florida,40,Oklahoma,5,Atoka County,0,23,-23
12,Florida,40,Oklahoma,9,Beckham County,4,0,4
12,Florida,40,Oklahoma,11,Blaine County,0,20,-20
12,Florida,40,Oklahoma,13,Bryan County,56,40,16
12,Florida,40,Oklahoma,17,Canadian County,192,163,29
12,Florida,40,Oklahoma,19,Carter County,34,0,34
12,Florida,40,Oklahoma,21,Cherokee County,248,17,231
12,Florida,40,Oklahoma,27,Cleveland County,220,484,-264
12,Florida,40,Oklahoma,29,Coal County,0,9,-9
12,Florida,40,Oklahoma,31,Comanche County,306,332,-26
12,Florida,40,Oklahoma,35,Craig County,0,15,-15
12,Florida,40,Oklahoma,37,Creek County,140,47,93
12,Florida,40,Oklahoma,39,Custer County,0,1,-1
12,Florida,40,Oklahoma,41,Delaware County,0,56,-56
12,Florida,40,Oklahoma,47,Garfield County,64,64,0
12,Florida,40,Oklahoma,51,Grady County,0,14,-14
12,Florida,40,Oklahoma,55,Greer County,0,19,-19
12,Florida,40,Oklahoma,57,Harmon County,5,0,5
12,Florida,40,Oklahoma,61,Haskell County,41,0,41
12,Florida,40,Oklahoma,65,Jackson County,36,45,-9
12,Florida,40,Oklahoma,69,Johnston County,0,33,-33
12,Florida,40,Oklahoma,71,Kay County,175,6,169
12,Florida,40,Oklahoma,77,Latimer County,0,6,-6
12,Florida,40,Oklahoma,79,Le Flore County,0,13,-13
12,Florida,40,Oklahoma,81,Lincoln County,34,0,34
12,Florida,40,Oklahoma,83,Logan County,39,0,39
12,Florida,40,Oklahoma,89,McCurtain County,15,0,15
12,Florida,40,Oklahoma,95,Marshall County,0,16,-16
12,Florida,40,Oklahoma,99,Murray County,21,0,21
12,Florida,40,Oklahoma,101,Muskogee County,32,125,-93
12,Florida,40,Oklahoma,103,Noble County,36,46,-10
12,Florida,40,Oklahoma,105,Nowata County,66,0,66
12,Florida,40,Oklahoma,107,Okfuskee County,0,1,-1
12,Florida,40,Oklahoma,109,Oklahoma County,1178,882,296
12,Florida,40,Oklahoma,113,Osage County,0,72,-72
12,Florida,40,Oklahoma,115,Ottawa County,99,9,90
12,Florida,40,Oklahoma,119,Payne County,0,18,-18
12,Florida,40,Oklahoma,121,Pittsburg County,0,41,-41
12,Florida,40,Oklahoma,125,Pottawatomie County,28,30,-2
12,Florida,40,Oklahoma,127,Pushmataha County,0,5,-5
12,Florida,40,Oklahoma,131,Rogers County,63,136,-73
12,Florida,40,Oklahoma,133,Seminole County,0,27,-27
12,Florida,40,Oklahoma,135,Sequoyah County,38,0,38
12,Florida,40,Oklahoma,137,Stephens County,2,46,-44
12,Florida,40,Oklahoma,139,Texas County,64,21,43
12,Florida,40,Oklahoma,143,Tulsa County,678,820,-142
12,Florida,40,Oklahoma,145,Wagoner County,24,17,7
12,Florida,40,Oklahoma,147,Washington County,141,6,135
12,Florida,40,Oklahoma,149,Washita County,58,0,58
12,Florida,40,Oklahoma,153,Woodward County,17,0,17
12,Florida,41,Oregon,1,Baker County,31,15,16
12,Florida,41,Oregon,3,Benton County,102,40,62
12,Florida,41,Oregon,5,Clackamas County,297,207,90
12,Florida,41,Oregon,7,Clatsop County,52,46,6
12,Florida,41,Oregon,9,Columbia County,14,0,14
12,Florida,41,Oregon,11,Coos County,0,16,-16
12,Florida,41,Oregon,13,Crook County,30,0,30
12,Florida,41,Oregon,17,Deschutes County,57,125,-68
12,Florida,41,Oregon,19,Douglas County,61,0,61
12,Florida,41,Oregon,21,Gilliam County,0,5,-5
12,Florida,41,Oregon,23,Grant County,12,0,12
12,Florida,41,Oregon,27,Hood River County,0,103,-103
12,Florida,41,Oregon,29,Jackson County,15,135,-120
12,Florida,41,Oregon,33,Josephine County,7,81,-74
12,Florida,41,Oregon,35,Klamath County,42,6,36
12,Florida,41,Oregon,39,Lane County,95,367,-272
12,Florida,41,Oregon,41,Lincoln County,0,16,-16
12,Florida,41,Oregon,43,Linn County,172,23,149
12,Florida,41,Oregon,45,Malheur County,0,3,-3
12,Florida,41,Oregon,47,Marion County,82,554,-472
12,Florida,41,Oregon,51,Multnomah County,587,674,-87
12,Florida,41,Oregon,53,Polk County,20,22,-2
12,Florida,41,Oregon,55,Sherman County,0,4,-4
12,Florida,41,Oregon,57,Tillamook County,14,0,14
12,Florida,41,Oregon,59,Umatilla County,11,0,11
12,Florida,41,Oregon,61,Union County,83,0,83
12,Florida,41,Oregon,65,Wasco County,6,26,-20
12,Florida,41,Oregon,67,Washington County,199,360,-161
12,Florida,41,Oregon,71,Yamhill County,40,90,-50
12,Florida,42,Pennsylvania,1,Adams County,184,57,127
12,Florida,42,Pennsylvania,3,Allegheny County,3344,1623,1721
12,Florida,42,Pennsylvania,5,Armstrong County,89,52,37
12,Florida,42,Pennsylvania,7,Beaver County,400,181,219
12,Florida,42,Pennsylvania,9,Bedford County,0,23,-23
12,Florida,42,Pennsylvania,11,Berks County,1317,779,538
12,Florida,42,Pennsylvania,13,Blair County,265,48,217
12,Florida,42,Pennsylvania,15,Bradford County,259,145,114
12,Florida,42,Pennsylvania,17,Bucks County,1767,1067,700
12,Florida,42,Pennsylvania,19,Butler County,263,182,81
12,Florida,42,Pennsylvania,21,Cambria County,314,71,243
12,Florida,42,Pennsylvania,23,Cameron County,0,6,-6
12,Florida,42,Pennsylvania,25,Carbon County,163,54,109
12,Florida,42,Pennsylvania,27,Centre County,909,218,691
12,Florida,42,Pennsylvania,29,Chester County,1303,383,920
12,Florida,42,Pennsylvania,31,Clarion County,0,19,-19
12,Florida,42,Pennsylvania,33,Clearfield County,161,44,117
12,Florida,42,Pennsylvania,35,Clinton County,0,4,-4
12,Florida,42,Pennsylvania,37,Columbia County,54,64,-10
12,Florida,42,Pennsylvania,39,Crawford County,34,51,-17
12,Florida,42,Pennsylvania,41,Cumberland County,830,589,241
12,Florida,42,Pennsylvania,43,Dauphin County,696,582,114
12,Florida,42,Pennsylvania,45,Delaware County,997,608,389
12,Florida,42,Pennsylvania,47,Elk County,0,3,-3
12,Florida,42,Pennsylvania,49,Erie County,707,588,119
12,Florida,42,Pennsylvania,51,Fayette County,268,240,28
12,Florida,42,Pennsylvania,53,Forest County,16,20,-4
12,Florida,42,Pennsylvania,55,Franklin County,319,153,166
12,Florida,42,Pennsylvania,57,Fulton County,0,10,-10
12,Florida,42,Pennsylvania,59,Greene County,203,0,203
12,Florida,42,Pennsylvania,61,Huntingdon County,24,24,0
12,Florida,42,Pennsylvania,63,Indiana County,102,83,19
12,Florida,42,Pennsylvania,65,Jefferson County,11,19,-8
12,Florida,42,Pennsylvania,67,Juniata County,0,25,-25
12,Florida,42,Pennsylvania,69,Lackawanna County,360,190,170
12,Florida,42,Pennsylvania,71,Lancaster County,807,311,496
12,Florida,42,Pennsylvania,73,Lawrence County,98,202,-104
12,Florida,42,Pennsylvania,75,Lebanon County,42,84,-42
12,Florida,42,Pennsylvania,77,Lehigh County,1006,409,597
12,Florida,42,Pennsylvania,79,Luzerne County,1138,347,791
12,Florida,42,Pennsylvania,81,Lycoming County,83,107,-24
12,Florida,42,Pennsylvania,83,McKean County,26,88,-62
12,Florida,42,Pennsylvania,85,Mercer County,246,211,35
12,Florida,42,Pennsylvania,87,Mifflin County,0,4,-4
12,Florida,42,Pennsylvania,89,Monroe County,442,66,376
12,Florida,42,Pennsylvania,91,Montgomery County,2590,1156,1434
12,Florida,42,Pennsylvania,93,Montour County,17,8,9
12,Florida,42,Pennsylvania,95,Northampton County,728,345,383
12,Florida,42,Pennsylvania,97,Northumberland County,159,42,117
12,Florida,42,Pennsylvania,99,Perry County,122,14,108
12,Florida,42,Pennsylvania,101,Philadelphia County,3018,1771,1247
12,Florida,42,Pennsylvania,103,Pike County,635,71,564
12,Florida,42,Pennsylvania,105,Potter County,103,14,89
12,Florida,42,Pennsylvania,107,Schuylkill County,183,138,45
12,Florida,42,Pennsylvania,109,Snyder County,17,43,-26
12,Florida,42,Pennsylvania,111,Somerset County,111,25,86
12,Florida,42,Pennsylvania,113,Sullivan County,0,16,-16
12,Florida,42,Pennsylvania,115,Susquehanna County,50,38,12
12,Florida,42,Pennsylvania,117,Tioga County,141,48,93
12,Florida,42,Pennsylvania,119,Union County,144,59,85
12,Florida,42,Pennsylvania,121,Venango County,134,41,93
12,Florida,42,Pennsylvania,123,Warren County,164,39,125
12,Florida,42,Pennsylvania,125,Washington County,417,177,240
12,Florida,42,Pennsylvania,127,Wayne County,123,46,77
12,Florida,42,Pennsylvania,129,Westmoreland County,701,200,501
12,Florida,42,Pennsylvania,131,Wyoming County,77,12,65
12,Florida,42,Pennsylvania,133,York County,974,422,552
12,Florida,44,Rhode Island,1,Bristol County,140,152,-12
12,Florida,44,Rhode Island,3,Kent County,806,127,679
12,Florida,44,Rhode Island,5,Newport County,367,740,-373
12,Florida,44,Rhode Island,7,Providence County,1741,1314,427
12,Florida,44,Rhode Island,9,Washington County,312,369,-57
12,Florida,45,South Carolina,1,Abbeville County,59,14,45
12,Florida,45,South Carolina,3,Aiken County,327,411,-84
12,Florida,45,South Carolina,7,Anderson County,772,448,324
12,Florida,45,South Carolina,9,Bamberg County,0,42,-42
12,Florida,45,South Carolina,11,Barnwell County,147,223,-76
12,Florida,45,South Carolina,13,Beaufort County,1340,1270,70
12,Florida,45,South Carolina,15,Berkeley County,791,517,274
12,Florida,45,South Carolina,17,Calhoun County,0,11,-11
12,Florida,45,South Carolina,19,Charleston County,871,1182,-311
12,Florida,45,South Carolina,21,Cherokee County,95,246,-151
12,Florida,45,South Carolina,23,Chester County,31,113,-82
12,Florida,45,South Carolina,25,Chesterfield County,129,29,100
12,Florida,45,South Carolina,27,Clarendon County,8,197,-189
12,Florida,45,South Carolina,29,Colleton County,20,0,20
12,Florida,45,South Carolina,31,Darlington County,133,168,-35
12,Florida,45,South Carolina,33,Dillon County,14,53,-39
12,Florida,45,South Carolina,35,Dorchester County,775,810,-35
12,Florida,45,South Carolina,37,Edgefield County,21,85,-64
12,Florida,45,South Carolina,39,Fairfield County,8,22,-14
12,Florida,45,South Carolina,41,Florence County,517,188,329
12,Florida,45,South Carolina,43,Georgetown County,45,196,-151
12,Florida,45,South Carolina,45,Greenville County,1383,1852,-469
12,Florida,45,South Carolina,47,Greenwood County,166,266,-100
12,Florida,45,South Carolina,49,Hampton County,45,40,5
12,Florida,45,South Carolina,51,Horry County,867,536,331
12,Florida,45,South Carolina,53,Jasper County,252,98,154
12,Florida,45,South Carolina,55,Kershaw County,118,36,82
12,Florida,45,South Carolina,57,Lancaster County,17,392,-375
12,Florida,45,South Carolina,59,Laurens County,51,50,1
12,Florida,45,South Carolina,63,Lexington County,527,631,-104
12,Florida,45,South Carolina,65,McCormick County,0,11,-11
12,Florida,45,South Carolina,67,Marion County,0,5,-5
12,Florida,45,South Carolina,69,Marlboro County,0,9,-9
12,Florida,45,South Carolina,71,Newberry County,23,13,10
12,Florida,45,South Carolina,73,Oconee County,85,148,-63
12,Florida,45,South Carolina,75,Orangeburg County,35,111,-76
12,Florida,45,South Carolina,77,Pickens County,140,265,-125
12,Florida,45,South Carolina,79,Richland County,1315,2054,-739
12,Florida,45,South Carolina,81,Saluda County,33,61,-28
12,Florida,45,South Carolina,83,Spartanburg County,372,544,-172
12,Florida,45,South Carolina,85,Sumter County,177,126,51
12,Florida,45,South Carolina,87,Union County,34,13,21
12,Florida,45,South Carolina,89,Williamsburg County,63,10,53
12,Florida,45,South Carolina,91,York County,841,769,72
12,Florida,46,South Dakota,5,Beadle County,10,0,10
12,Florida,46,South Dakota,7,Bennett County,0,2,-2
12,Florida,46,South Dakota,9,Bon Homme County,0,3,-3
12,Florida,46,South Dakota,13,Brown County,0,111,-111
12,Florida,46,South Dakota,15,Brule County,0,5,-5
12,Florida,46,South Dakota,19,Butte County,2,0,2
12,Florida,46,South Dakota,47,Fall River County,102,15,87
12,Florida,46,South Dakota,53,Gregory County,0,6,-6
12,Florida,46,South Dakota,57,Hamlin County,0,9,-9
12,Florida,46,South Dakota,79,Lake County,0,10,-10
12,Florida,46,South Dakota,81,Lawrence County,0,3,-3
12,Florida,46,South Dakota,83,Lincoln County,46,0,46
12,Florida,46,South Dakota,87,McCook County,0,41,-41
12,Florida,46,South Dakota,93,Meade County,0,33,-33
12,Florida,46,South Dakota,99,Minnehaha County,50,87,-37
12,Florida,46,South Dakota,101,Moody County,36,0,36
12,Florida,46,South Dakota,103,Pennington County,532,72,460
12,Florida,46,South Dakota,109,Roberts County,0,5,-5
12,Florida,46,South Dakota,115,Spink County,0,29,-29
12,Florida,46,South Dakota,125,Turner County,0,1,-1
12,Florida,46,South Dakota,127,Union County,0,11,-11
12,Florida,46,South Dakota,135,Yankton County,35,0,35
12,Florida,47,Tennessee,1,Anderson County,30,154,-124
12,Florida,47,Tennessee,3,Bedford County,144,79,65
12,Florida,47,Tennessee,5,Benton County,16,20,-4
12,Florida,47,Tennessee,7,Bledsoe County,18,43,-25
12,Florida,47,Tennessee,9,Blount County,327,421,-94
12,Florida,47,Tennessee,11,Bradley County,318,395,-77
12,Florida,47,Tennessee,13,Campbell County,79,30,49
12,Florida,47,Tennessee,15,Cannon County,84,44,40
12,Florida,47,Tennessee,17,Carroll County,0,42,-42
12,Florida,47,Tennessee,19,Carter County,340,90,250
12,Florida,47,Tennessee,21,Cheatham County,110,133,-23
12,Florida,47,Tennessee,25,Claiborne County,28,140,-112
12,Florida,47,Tennessee,27,Clay County,60,0,60
12,Florida,47,Tennessee,29,Cocke County,31,180,-149
12,Florida,47,Tennessee,31,Coffee County,299,184,115
12,Florida,47,Tennessee,33,Crockett County,8,3,5
12,Florida,47,Tennessee,35,Cumberland County,153,263,-110
12,Florida,47,Tennessee,37,Davidson County,1406,2632,-1226
12,Florida,47,Tennessee,41,DeKalb County,33,61,-28
12,Florida,47,Tennessee,43,Dickson County,302,58,244
12,Florida,47,Tennessee,45,Dyer County,30,60,-30
12,Florida,47,Tennessee,47,Fayette County,30,15,15
12,Florida,47,Tennessee,49,Fentress County,0,103,-103
12,Florida,47,Tennessee,51,Franklin County,0,76,-76
12,Florida,47,Tennessee,53,Gibson County,18,30,-12
12,Florida,47,Tennessee,55,Giles County,40,42,-2
12,Florida,47,Tennessee,57,Grainger County,136,115,21
12,Florida,47,Tennessee,59,Greene County,92,239,-147
12,Florida,47,Tennessee,61,Grundy County,49,0,49
12,Florida,47,Tennessee,63,Hamblen County,191,42,149
12,Florida,47,Tennessee,65,Hamilton County,579,1086,-507
12,Florida,47,Tennessee,67,Hancock County,15,0,15
12,Florida,47,Tennessee,69,Hardeman County,20,0,20
12,Florida,47,Tennessee,71,Hardin County,0,13,-13
12,Florida,47,Tennessee,73,Hawkins County,74,80,-6
12,Florida,47,Tennessee,75,Haywood County,12,9,3
12,Florida,47,Tennessee,77,Henderson County,40,0,40
12,Florida,47,Tennessee,79,Henry County,160,6,154
12,Florida,47,Tennessee,81,Hickman County,0,75,-75
12,Florida,47,Tennessee,85,Humphreys County,23,0,23
12,Florida,47,Tennessee,87,Jackson County,0,15,-15
12,Florida,47,Tennessee,89,Jefferson County,184,200,-16
12,Florida,47,Tennessee,91,Johnson County,0,98,-98
12,Florida,47,Tennessee,93,Knox County,924,1463,-539
12,Florida,47,Tennessee,95,Lake County,18,0,18
12,Florida,47,Tennessee,97,Lauderdale County,0,21,-21
12,Florida,47,Tennessee,99,Lawrence County,61,67,-6
12,Florida,47,Tennessee,101,Lewis County,0,10,-10
12,Florida,47,Tennessee,103,Lincoln County,25,21,4
12,Florida,47,Tennessee,105,Loudon County,135,121,14
12,Florida,47,Tennessee,107,McMinn County,180,137,43
12,Florida,47,Tennessee,109,McNairy County,18,131,-113
12,Florida,47,Tennessee,111,Macon County,62,32,30
12,Florida,47,Tennessee,113,Madison County,109,118,-9
12,Florida,47,Tennessee,115,Marion County,132,6,126
12,Florida,47,Tennessee,117,Marshall County,0,48,-48
12,Florida,47,Tennessee,119,Maury County,212,439,-227
12,Florida,47,Tennessee,123,Monroe County,26,346,-320
12,Florida,47,Tennessee,125,Montgomery County,912,551,361
12,Florida,47,Tennessee,129,Morgan County,43,83,-40
12,Florida,47,Tennessee,131,Obion County,1,12,-11
12,Florida,47,Tennessee,133,Overton County,86,70,16
12,Florida,47,Tennessee,137,Pickett County,0,6,-6
12,Florida,47,Tennessee,139,Polk County,36,153,-117
12,Florida,47,Tennessee,141,Putnam County,384,228,156
12,Florida,47,Tennessee,143,Rhea County,54,69,-15
12,Florida,47,Tennessee,145,Roane County,19,476,-457
12,Florida,47,Tennessee,147,Robertson County,425,177,248
12,Florida,47,Tennessee,149,Rutherford County,1032,1365,-333
12,Florida,47,Tennessee,151,Scott County,61,0,61
12,Florida,47,Tennessee,153,Sequatchie County,0,51,-51
12,Florida,47,Tennessee,155,Sevier County,410,452,-42
12,Florida,47,Tennessee,157,Shelby County,2138,1258,880
12,Florida,47,Tennessee,159,Smith County,66,0,66
12,Florida,47,Tennessee,161,Stewart County,21,0,21
12,Florida,47,Tennessee,163,Sullivan County,246,216,30
12,Florida,47,Tennessee,165,Sumner County,314,413,-99
12,Florida,47,Tennessee,167,Tipton County,156,184,-28
12,Florida,47,Tennessee,169,Trousdale County,21,0,21
12,Florida,47,Tennessee,171,Unicoi County,48,27,21
12,Florida,47,Tennessee,177,Warren County,14,5,9
12,Florida,47,Tennessee,179,Washington County,344,430,-86
12,Florida,47,Tennessee,183,Weakley County,77,40,37
12,Florida,47,Tennessee,185,White County,0,2,-2
12,Florida,47,Tennessee,187,Williamson County,492,680,-188
12,Florida,47,Tennessee,189,Wilson County,301,313,-12
12,Florida,48,Texas,1,Anderson County,54,23,31
12,Florida,48,Texas,3,Andrews County,0,24,-24
12,Florida,48,Texas,5,Angelina County,0,121,-121
12,Florida,48,Texas,13,Atascosa County,0,21,-21
12,Florida,48,Texas,15,Austin County,0,10,-10
12,Florida,48,Texas,19,Bandera County,0,12,-12
12,Florida,48,Texas,21,Bastrop County,301,3,298
12,Florida,48,Texas,23,Baylor County,14,20,-6
12,Florida,48,Texas,27,Bell County,763,1178,-415
12,Florida,48,Texas,29,Bexar County,2917,2552,365
12,Florida,48,Texas,31,Blanco County,0,59,-59
12,Florida,48,Texas,35,Bosque County,0,3,-3
12,Florida,48,Texas,37,Bowie County,155,30,125
12,Florida,48,Texas,39,Brazoria County,188,424,-236
12,Florida,48,Texas,41,Brazos County,436,108,328
12,Florida,48,Texas,43,Brewster County,66,0,66
12,Florida,48,Texas,45,Briscoe County,0,49,-49
12,Florida,48,Texas,49,Brown County,0,13,-13
12,Florida,48,Texas,51,Burleson County,36,52,-16
12,Florida,48,Texas,55,Caldwell County,5,0,5
12,Florida,48,Texas,59,Callahan County,0,13,-13
12,Florida,48,Texas,61,Cameron County,333,426,-93
12,Florida,48,Texas,65,Carson County,0,1,-1
12,Florida,48,Texas,67,Cass County,33,23,10
12,Florida,48,Texas,71,Chambers County,0,13,-13
12,Florida,48,Texas,73,Cherokee County,0,33,-33
12,Florida,48,Texas,75,Childress County,6,0,6
12,Florida,48,Texas,77,Clay County,0,18,-18
12,Florida,48,Texas,85,Collin County,1318,1163,155
12,Florida,48,Texas,91,Comal County,200,125,75
12,Florida,48,Texas,97,Cooke County,0,39,-39
12,Florida,48,Texas,99,Coryell County,250,303,-53
12,Florida,48,Texas,111,Dallam County,10,0,10
12,Florida,48,Texas,113,Dallas County,1799,2343,-544
12,Florida,48,Texas,117,Deaf Smith County,0,19,-19
12,Florida,48,Texas,121,Denton County,938,887,51
12,Florida,48,Texas,123,DeWitt County,0,34,-34
12,Florida,48,Texas,127,Dimmit County,0,27,-27
12,Florida,48,Texas,129,Donley County,0,9,-9
12,Florida,48,Texas,133,Eastland County,0,23,-23
12,Florida,48,Texas,135,Ector County,39,45,-6
12,Florida,48,Texas,139,Ellis County,177,302,-125
12,Florida,48,Texas,141,El Paso County,1282,1103,179
12,Florida,48,Texas,143,Erath County,3,0,3
12,Florida,48,Texas,147,Fannin County,0,43,-43
12,Florida,48,Texas,149,Fayette County,0,22,-22
12,Florida,48,Texas,157,Fort Bend County,288,496,-208
12,Florida,48,Texas,165,Gaines County,20,0,20
12,Florida,48,Texas,167,Galveston County,473,337,136
12,Florida,48,Texas,171,Gillespie County,26,32,-6
12,Florida,48,Texas,177,Gonzales County,119,0,119
12,Florida,48,Texas,181,Grayson County,236,224,12
12,Florida,48,Texas,183,Gregg County,99,177,-78
12,Florida,48,Texas,187,Guadalupe County,48,196,-148
12,Florida,48,Texas,189,Hale County,0,16,-16
12,Florida,48,Texas,199,Hardin County,48,0,48
12,Florida,48,Texas,201,Harris County,4229,6883,-2654
12,Florida,48,Texas,203,Harrison County,0,16,-16
12,Florida,48,Texas,205,Hartley County,0,17,-17
12,Florida,48,Texas,207,Haskell County,0,4,-4
12,Florida,48,Texas,209,Hays County,387,451,-64
12,Florida,48,Texas,213,Henderson County,10,80,-70
12,Florida,48,Texas,215,Hidalgo County,318,283,35
12,Florida,48,Texas,217,Hill County,8,18,-10
12,Florida,48,Texas,221,Hood County,128,38,90
12,Florida,48,Texas,223,Hopkins County,65,8,57
12,Florida,48,Texas,227,Howard County,31,67,-36
12,Florida,48,Texas,231,Hunt County,145,91,54
12,Florida,48,Texas,233,Hutchinson County,0,7,-7
12,Florida,48,Texas,239,Jackson County,0,55,-55
12,Florida,48,Texas,241,Jasper County,0,1,-1
12,Florida,48,Texas,245,Jefferson County,255,162,93
12,Florida,48,Texas,251,Johnson County,66,220,-154
12,Florida,48,Texas,255,Karnes County,64,0,64
12,Florida,48,Texas,257,Kaufman County,55,56,-1
12,Florida,48,Texas,259,Kendall County,83,28,55
12,Florida,48,Texas,263,Kent County,0,1,-1
12,Florida,48,Texas,265,Kerr County,14,46,-32
12,Florida,48,Texas,273,Kleberg County,19,144,-125
12,Florida,48,Texas,275,Knox County,0,10,-10
12,Florida,48,Texas,277,Lamar County,46,0,46
12,Florida,48,Texas,279,Lamb County,0,7,-7
12,Florida,48,Texas,281,Lampasas County,0,21,-21
12,Florida,48,Texas,291,Liberty County,57,16,41
12,Florida,48,Texas,293,Limestone County,0,32,-32
12,Florida,48,Texas,295,Lipscomb County,0,13,-13
12,Florida,48,Texas,297,Live Oak County,88,0,88
12,Florida,48,Texas,299,Llano County,0,21,-21
12,Florida,48,Texas,303,Lubbock County,112,228,-116
12,Florida,48,Texas,305,Lynn County,15,0,15
12,Florida,48,Texas,309,McLennan County,63,128,-65
12,Florida,48,Texas,321,Matagorda County,37,36,1
12,Florida,48,Texas,323,Maverick County,34,1,33
12,Florida,48,Texas,325,Medina County,7,0,7
12,Florida,48,Texas,329,Midland County,61,296,-235
12,Florida,48,Texas,331,Milam County,0,38,-38
12,Florida,48,Texas,339,Montgomery County,589,1387,-798
12,Florida,48,Texas,343,Morris County,52,21,31
12,Florida,48,Texas,347,Nacogdoches County,0,15,-15
12,Florida,48,Texas,349,Navarro County,48,31,17
12,Florida,48,Texas,353,Nolan County,20,0,20
12,Florida,48,Texas,355,Nueces County,897,963,-66
12,Florida,48,Texas,361,Orange County,11,84,-73
12,Florida,48,Texas,363,Palo Pinto County,26,4,22
12,Florida,48,Texas,365,Panola County,8,22,-14
12,Florida,48,Texas,367,Parker County,92,210,-118
12,Florida,48,Texas,369,Parmer County,0,14,-14
12,Florida,48,Texas,373,Polk County,94,0,94
12,Florida,48,Texas,375,Potter County,172,15,157
12,Florida,48,Texas,381,Randall County,84,17,67
12,Florida,48,Texas,383,Reagan County,0,56,-56
12,Florida,48,Texas,387,Red River County,14,5,9
12,Florida,48,Texas,389,Reeves County,0,5,-5
12,Florida,48,Texas,395,Robertson County,91,0,91
12,Florida,48,Texas,397,Rockwall County,183,129,54
12,Florida,48,Texas,401,Rusk County,0,23,-23
12,Florida,48,Texas,407,San Jacinto County,7,0,7
12,Florida,48,Texas,409,San Patricio County,0,10,-10
12,Florida,48,Texas,411,San Saba County,0,47,-47
12,Florida,48,Texas,423,Smith County,184,230,-46
12,Florida,48,Texas,429,Stephens County,0,5,-5
12,Florida,48,Texas,433,Stonewall County,0,4,-4
12,Florida,48,Texas,439,Tarrant County,2807,2284,523
12,Florida,48,Texas,441,Taylor County,422,381,41
12,Florida,48,Texas,445,Terry County,0,17,-17
12,Florida,48,Texas,449,Titus County,77,70,7
12,Florida,48,Texas,451,Tom Green County,164,354,-190
12,Florida,48,Texas,453,Travis County,1822,2206,-384
12,Florida,48,Texas,455,Trinity County,10,0,10
12,Florida,48,Texas,463,Uvalde County,12,0,12
12,Florida,48,Texas,465,Val Verde County,79,103,-24
12,Florida,48,Texas,467,Van Zandt County,88,92,-4
12,Florida,48,Texas,469,Victoria County,32,109,-77
12,Florida,48,Texas,471,Walker County,21,100,-79
12,Florida,48,Texas,473,Waller County,7,79,-72
12,Florida,48,Texas,475,Ward County,0,30,-30
12,Florida,48,Texas,479,Webb County,56,34,22
12,Florida,48,Texas,481,Wharton County,16,0,16
12,Florida,48,Texas,485,Wichita County,730,475,255
12,Florida,48,Texas,491,Williamson County,379,1232,-853
12,Florida,48,Texas,495,Winkler County,0,44,-44
12,Florida,48,Texas,497,Wise County,57,13,44
12,Florida,48,Texas,499,Wood County,0,48,-48
12,Florida,48,Texas,505,Zapata County,0,19,-19
12,Florida,49,Utah,3,Box Elder County,59,22,37
12,Florida,49,Utah,5,Cache County,9,32,-23
12,Florida,49,Utah,11,Davis County,412,255,157
12,Florida,49,Utah,13,Duchesne County,0,2,-2
12,Florida,49,Utah,15,Emery County,0,4,-4
12,Florida,49,Utah,17,Garfield County,0,6,-6
12,Florida,49,Utah,21,Iron County,0,4,-4
12,Florida,49,Utah,29,Morgan County,32,0,32
12,Florida,49,Utah,35,Salt Lake County,1546,1421,125
12,Florida,49,Utah,39,Sanpete County,64,87,-23
12,Florida,49,Utah,41,Sevier County,0,5,-5
12,Florida,49,Utah,43,Summit County,49,50,-1
12,Florida,49,Utah,45,Tooele County,0,7,-7
12,Florida,49,Utah,47,Uintah County,73,0,73
12,Florida,49,Utah,49,Utah County,748,313,435
12,Florida,49,Utah,53,Washington County,271,49,222
12,Florida,49,Utah,57,Weber County,46,171,-125
12,Florida,5,Arkansas,5,Baxter County,74,14,60
12,Florida,5,Arkansas,7,Benton County,254,342,-88
12,Florida,5,Arkansas,13,Calhoun County,141,10,131
12,Florida,5,Arkansas,15,Carroll County,14,6,8
12,Florida,5,Arkansas,17,Chicot County,17,0,17
12,Florida,5,Arkansas,19,Clark County,17,2,15
12,Florida,5,Arkansas,23,Cleburne County,25,13,12
12,Florida,5,Arkansas,27,Columbia County,140,0,140
12,Florida,5,Arkansas,29,Conway County,10,0,10
12,Florida,5,Arkansas,31,Craighead County,112,0,112
12,Florida,5,Arkansas,33,Crawford County,44,12,32
12,Florida,5,Arkansas,35,Crittenden County,0,47,-47
12,Florida,5,Arkansas,37,Cross County,0,32,-32
12,Florida,5,Arkansas,43,Drew County,30,0,30
12,Florida,5,Arkansas,45,Faulkner County,76,24,52
12,Florida,5,Arkansas,47,Franklin County,0,44,-44
12,Florida,5,Arkansas,49,Fulton County,0,24,-24
12,Florida,5,Arkansas,51,Garland County,9,71,-62
12,Florida,5,Arkansas,55,Greene County,73,41,32
12,Florida,5,Arkansas,57,Hempstead County,0,31,-31
12,Florida,5,Arkansas,63,Independence County,132,68,64
12,Florida,5,Arkansas,65,Izard County,0,18,-18
12,Florida,5,Arkansas,69,Jefferson County,0,6,-6
12,Florida,5,Arkansas,71,Johnson County,0,11,-11
12,Florida,5,Arkansas,75,Lawrence County,0,32,-32
12,Florida,5,Arkansas,77,Lee County,14,0,14
12,Florida,5,Arkansas,79,Lincoln County,0,16,-16
12,Florida,5,Arkansas,81,Little River County,0,10,-10
12,Florida,5,Arkansas,85,Lonoke County,322,62,260
12,Florida,5,Arkansas,87,Madison County,13,0,13
12,Florida,5,Arkansas,89,Marion County,0,29,-29
12,Florida,5,Arkansas,91,Miller County,109,0,109
12,Florida,5,Arkansas,97,Montgomery County,146,0,146
12,Florida,5,Arkansas,103,Ouachita County,164,0,164
12,Florida,5,Arkansas,105,Perry County,0,9,-9
12,Florida,5,Arkansas,107,Phillips County,0,4,-4
12,Florida,5,Arkansas,111,Poinsett County,159,0,159
12,Florida,5,Arkansas,113,Polk County,36,0,36
12,Florida,5,Arkansas,115,Pope County,49,56,-7
12,Florida,5,Arkansas,119,Pulaski County,658,291,367
12,Florida,5,Arkansas,123,St. Francis County,0,14,-14
12,Florida,5,Arkansas,125,Saline County,232,7,225
12,Florida,5,Arkansas,131,Sebastian County,81,63,18
12,Florida,5,Arkansas,133,Sevier County,0,37,-37
12,Florida,5,Arkansas,135,Sharp County,23,4,19
12,Florida,5,Arkansas,139,Union County,0,6,-6
12,Florida,5,Arkansas,141,Van Buren County,0,32,-32
12,Florida,5,Arkansas,143,Washington County,159,245,-86
12,Florida,5,Arkansas,145,White County,120,158,-38
12,Florida,5,Arkansas,149,Yell County,0,12,-12
12,Florida,50,Vermont,1,Addison County,13,32,-19
12,Florida,50,Vermont,3,Bennington County,63,43,20
12,Florida,50,Vermont,5,Caledonia County,56,5,51
12,Florida,50,Vermont,7,Chittenden County,554,296,258
12,Florida,50,Vermont,9,Essex County,0,4,-4
12,Florida,50,Vermont,11,Franklin County,298,58,240
12,Florida,50,Vermont,13,Grand Isle County,31,21,10
12,Florida,50,Vermont,15,Lamoille County,95,101,-6
12,Florida,50,Vermont,17,Orange County,157,61,96
12,Florida,50,Vermont,19,Orleans County,47,58,-11
12,Florida,50,Vermont,21,Rutland County,146,28,118
12,Florida,50,Vermont,23,Washington County,173,72,101
12,Florida,50,Vermont,25,Windham County,101,65,36
12,Florida,50,Vermont,27,Windsor County,238,79,159
12,Florida,51,Virginia,1,Accomack County,74,20,54
12,Florida,51,Virginia,3,Albemarle County,281,246,35
12,Florida,51,Virginia,5,Alleghany County,24,0,24
12,Florida,51,Virginia,9,Amherst County,15,50,-35
12,Florida,51,Virginia,11,Appomattox County,28,77,-49
12,Florida,51,Virginia,13,Arlington County,871,441,430
12,Florida,51,Virginia,15,Augusta County,3,201,-198
12,Florida,51,Virginia,17,Bath County,0,65,-65
12,Florida,51,Virginia,19,Bedford County,146,65,81
12,Florida,51,Virginia,23,Botetourt County,38,0,38
12,Florida,51,Virginia,25,Brunswick County,19,8,11
12,Florida,51,Virginia,27,Buchanan County,0,6,-6
12,Florida,51,Virginia,29,Buckingham County,17,0,17
12,Florida,51,Virginia,31,Campbell County,96,58,38
12,Florida,51,Virginia,33,Caroline County,91,151,-60
12,Florida,51,Virginia,35,Carroll County,0,28,-28
12,Florida,51,Virginia,37,Charlotte County,0,48,-48
12,Florida,51,Virginia,41,Chesterfield County,507,932,-425
12,Florida,51,Virginia,43,Clarke County,44,0,44
12,Florida,51,Virginia,47,Culpeper County,152,31,121
12,Florida,51,Virginia,49,Cumberland County,56,17,39
12,Florida,51,Virginia,51,Dickenson County,46,11,35
12,Florida,51,Virginia,59,Fairfax County,3160,2742,418
12,Florida,51,Virginia,61,Fauquier County,198,157,41
12,Florida,51,Virginia,63,Floyd County,61,0,61
12,Florida,51,Virginia,67,Franklin County,69,39,30
12,Florida,51,Virginia,69,Frederick County,148,96,52
12,Florida,51,Virginia,71,Giles County,19,61,-42
12,Florida,51,Virginia,73,Gloucester County,82,82,0
12,Florida,51,Virginia,77,Grayson County,0,9,-9
12,Florida,51,Virginia,79,Greene County,115,0,115
12,Florida,51,Virginia,81,Greensville County,14,0,14
12,Florida,51,Virginia,83,Halifax County,0,17,-17
12,Florida,51,Virginia,85,Hanover County,176,192,-16
12,Florida,51,Virginia,87,Henrico County,715,601,114
12,Florida,51,Virginia,89,Henry County,0,420,-420
12,Florida,51,Virginia,91,Highland County,0,3,-3
12,Florida,51,Virginia,93,Isle of Wight County,60,73,-13
12,Florida,51,Virginia,95,James City County,111,94,17
12,Florida,51,Virginia,99,King George County,153,119,34
12,Florida,51,Virginia,101,King William County,16,18,-2
12,Florida,51,Virginia,103,Lancaster County,342,5,337
12,Florida,51,Virginia,105,Lee County,6,0,6
12,Florida,51,Virginia,107,Loudoun County,1271,739,532
12,Florida,51,Virginia,109,Louisa County,11,70,-59
12,Florida,51,Virginia,115,Mathews County,162,5,157
12,Florida,51,Virginia,117,Mecklenburg County,66,18,48
12,Florida,51,Virginia,119,Middlesex County,40,0,40
12,Florida,51,Virginia,121,Montgomery County,219,588,-369
12,Florida,51,Virginia,125,Nelson County,29,2,27
12,Florida,51,Virginia,127,New Kent County,8,0,8
12,Florida,51,Virginia,131,Northampton County,0,16,-16
12,Florida,51,Virginia,133,Northumberland County,0,3,-3
12,Florida,51,Virginia,135,Nottoway County,33,29,4
12,Florida,51,Virginia,137,Orange County,11,18,-7
12,Florida,51,Virginia,139,Page County,29,19,10
12,Florida,51,Virginia,141,Patrick County,0,4,-4
12,Florida,51,Virginia,143,Pittsylvania County,0,59,-59
12,Florida,51,Virginia,145,Powhatan County,33,5,28
12,Florida,51,Virginia,147,Prince Edward County,4,107,-103
12,Florida,51,Virginia,149,Prince George County,93,197,-104
12,Florida,51,Virginia,153,Prince William County,1339,1076,263
12,Florida,51,Virginia,161,Roanoke County,395,220,175
12,Florida,51,Virginia,163,Rockbridge County,40,24,16
12,Florida,51,Virginia,165,Rockingham County,58,59,-1
12,Florida,51,Virginia,167,Russell County,84,32,52
12,Florida,51,Virginia,171,Shenandoah County,19,392,-373
12,Florida,51,Virginia,173,Smyth County,24,23,1
12,Florida,51,Virginia,177,Spotsylvania County,227,113,114
12,Florida,51,Virginia,179,Stafford County,776,624,152
12,Florida,51,Virginia,183,Sussex County,0,8,-8
12,Florida,51,Virginia,185,Tazewell County,50,23,27
12,Florida,51,Virginia,187,Warren County,78,93,-15
12,Florida,51,Virginia,191,Washington County,192,58,134
12,Florida,51,Virginia,193,Westmoreland County,19,25,-6
12,Florida,51,Virginia,195,Wise County,308,48,260
12,Florida,51,Virginia,199,York County,887,510,377
12,Florida,51,Virginia,510,Alexandria city,466,611,-145
12,Florida,51,Virginia,520,Bristol city,57,68,-11
12,Florida,51,Virginia,530,Buena Vista city,10,28,-18
12,Florida,51,Virginia,540,Charlottesville city,196,140,56
12,Florida,51,Virginia,550,Chesapeake city,1303,1047,256
12,Florida,51,Virginia,570,Colonial Heights city,48,19,29
12,Florida,51,Virginia,590,Danville city,0,12,-12
12,Florida,51,Virginia,600,Fairfax city,223,116,107
12,Florida,51,Virginia,610,Falls Church city,44,24,20
12,Florida,51,Virginia,630,Fredericksburg city,89,42,47
12,Florida,51,Virginia,640,Galax city,0,16,-16
12,Florida,51,Virginia,650,Hampton city,460,570,-110
12,Florida,51,Virginia,660,Harrisonburg city,15,62,-47
12,Florida,51,Virginia,670,Hopewell city,9,0,9
12,Florida,51,Virginia,678,Lexington city,32,51,-19
12,Florida,51,Virginia,680,Lynchburg city,205,249,-44
12,Florida,51,Virginia,683,Manassas city,108,78,30
12,Florida,51,Virginia,690,Martinsville city,17,0,17
12,Florida,51,Virginia,700,Newport News city,914,609,305
12,Florida,51,Virginia,710,Norfolk city,1110,1659,-549
12,Florida,51,Virginia,730,Petersburg city,116,74,42
12,Florida,51,Virginia,740,Portsmouth city,227,205,22
12,Florida,51,Virginia,760,Richmond city,607,452,155
12,Florida,51,Virginia,770,Roanoke city,229,341,-112
12,Florida,51,Virginia,775,Salem city,167,18,149
12,Florida,51,Virginia,790,Staunton city,6,100,-94
12,Florida,51,Virginia,800,Suffolk city,91,53,38
12,Florida,51,Virginia,810,Virginia Beach city,3412,1752,1660
12,Florida,51,Virginia,820,Waynesboro city,48,0,48
12,Florida,51,Virginia,830,Williamsburg city,149,108,41
12,Florida,51,Virginia,840,Winchester city,67,108,-41
12,Florida,53,Washington,5,Benton County,62,65,-3
12,Florida,53,Washington,7,Chelan County,0,30,-30
12,Florida,53,Washington,9,Clallam County,0,59,-59
12,Florida,53,Washington,11,Clark County,241,405,-164
12,Florida,53,Washington,15,Cowlitz County,60,42,18
12,Florida,53,Washington,21,Franklin County,0,65,-65
12,Florida,53,Washington,25,Grant County,208,18,190
12,Florida,53,Washington,27,Grays Harbor County,63,125,-62
12,Florida,53,Washington,29,Island County,265,485,-220
12,Florida,53,Washington,31,Jefferson County,0,248,-248
12,Florida,53,Washington,33,King County,1748,3226,-1478
12,Florida,53,Washington,35,Kitsap County,521,679,-158
12,Florida,53,Washington,37,Kittitas County,17,79,-62
12,Florida,53,Washington,39,Klickitat County,12,0,12
12,Florida,53,Washington,41,Lewis County,20,54,-34
12,Florida,53,Washington,45,Mason County,0,16,-16
12,Florida,53,Washington,47,Okanogan County,8,9,-1
12,Florida,53,Washington,49,Pacific County,0,15,-15
12,Florida,53,Washington,51,Pend Oreille County,0,42,-42
12,Florida,53,Washington,53,Pierce County,579,865,-286
12,Florida,53,Washington,55,San Juan County,44,12,32
12,Florida,53,Washington,57,Skagit County,124,179,-55
12,Florida,53,Washington,59,Skamania County,0,13,-13
12,Florida,53,Washington,61,Snohomish County,557,668,-111
12,Florida,53,Washington,63,Spokane County,263,360,-97
12,Florida,53,Washington,65,Stevens County,59,1,58
12,Florida,53,Washington,67,Thurston County,352,357,-5
12,Florida,53,Washington,69,Wahkiakum County,0,1,-1
12,Florida,53,Washington,71,Walla Walla County,0,192,-192
12,Florida,53,Washington,73,Whatcom County,179,110,69
12,Florida,53,Washington,75,Whitman County,43,84,-41
12,Florida,53,Washington,77,Yakima County,78,136,-58
12,Florida,54,West Virginia,1,Barbour County,0,3,-3
12,Florida,54,West Virginia,3,Berkeley County,84,292,-208
12,Florida,54,West Virginia,5,Boone County,24,0,24
12,Florida,54,West Virginia,7,Braxton County,58,1,57
12,Florida,54,West Virginia,9,Brooke County,84,37,47
12,Florida,54,West Virginia,11,Cabell County,225,76,149
12,Florida,54,West Virginia,17,Doddridge County,0,7,-7
12,Florida,54,West Virginia,19,Fayette County,124,23,101
12,Florida,54,West Virginia,21,Gilmer County,7,8,-1
12,Florida,54,West Virginia,23,Grant County,27,0,27
12,Florida,54,West Virginia,25,Greenbrier County,0,75,-75
12,Florida,54,West Virginia,27,Hampshire County,33,0,33
12,Florida,54,West Virginia,29,Hancock County,161,15,146
12,Florida,54,West Virginia,31,Hardy County,18,9,9
12,Florida,54,West Virginia,33,Harrison County,201,109,92
12,Florida,54,West Virginia,35,Jackson County,0,13,-13
12,Florida,54,West Virginia,37,Jefferson County,101,92,9
12,Florida,54,West Virginia,39,Kanawha County,480,302,178
12,Florida,54,West Virginia,41,Lewis County,193,61,132
12,Florida,54,West Virginia,43,Lincoln County,13,0,13
12,Florida,54,West Virginia,45,Logan County,0,4,-4
12,Florida,54,West Virginia,47,McDowell County,16,26,-10
12,Florida,54,West Virginia,49,Marion County,30,201,-171
12,Florida,54,West Virginia,51,Marshall County,0,1,-1
12,Florida,54,West Virginia,55,Mercer County,97,151,-54
12,Florida,54,West Virginia,57,Mineral County,28,13,15
12,Florida,54,West Virginia,59,Mingo County,7,0,7
12,Florida,54,West Virginia,61,Monongalia County,263,227,36
12,Florida,54,West Virginia,65,Morgan County,3,7,-4
12,Florida,54,West Virginia,67,Nicholas County,26,64,-38
12,Florida,54,West Virginia,69,Ohio County,141,17,124
12,Florida,54,West Virginia,71,Pendleton County,0,9,-9
12,Florida,54,West Virginia,73,Pleasants County,12,0,12
12,Florida,54,West Virginia,77,Preston County,47,9,38
12,Florida,54,West Virginia,79,Putnam County,220,60,160
12,Florida,54,West Virginia,81,Raleigh County,195,119,76
12,Florida,54,West Virginia,83,Randolph County,0,102,-102
12,Florida,54,West Virginia,85,Ritchie County,0,14,-14
12,Florida,54,West Virginia,89,Summers County,9,66,-57
12,Florida,54,West Virginia,91,Taylor County,39,29,10
12,Florida,54,West Virginia,93,Tucker County,0,9,-9
12,Florida,54,West Virginia,95,Tyler County,0,17,-17
12,Florida,54,West Virginia,97,Upshur County,34,93,-59
12,Florida,54,West Virginia,99,Wayne County,8,37,-29
12,Florida,54,West Virginia,105,Wirt County,10,26,-16
12,Florida,54,West Virginia,107,Wood County,148,172,-24
12,Florida,55,Wisconsin,1,Adams County,40,14,26
12,Florida,55,Wisconsin,3,Ashland County,6,0,6
12,Florida,55,Wisconsin,5,Barron County,45,18,27
12,Florida,55,Wisconsin,7,Bayfield County,0,3,-3
12,Florida,55,Wisconsin,9,Brown County,442,327,115
12,Florida,55,Wisconsin,11,Buffalo County,0,2,-2
12,Florida,55,Wisconsin,13,Burnett County,0,14,-14
12,Florida,55,Wisconsin,15,Calumet County,68,25,43
12,Florida,55,Wisconsin,17,Chippewa County,63,36,27
12,Florida,55,Wisconsin,19,Clark County,0,3,-3
12,Florida,55,Wisconsin,21,Columbia County,117,29,88
12,Florida,55,Wisconsin,23,Crawford County,0,42,-42
12,Florida,55,Wisconsin,25,Dane County,1060,528,532
12,Florida,55,Wisconsin,27,Dodge County,63,38,25
12,Florida,55,Wisconsin,29,Door County,91,120,-29
12,Florida,55,Wisconsin,31,Douglas County,71,5,66
12,Florida,55,Wisconsin,33,Dunn County,0,51,-51
12,Florida,55,Wisconsin,35,Eau Claire County,19,22,-3
12,Florida,55,Wisconsin,39,Fond du Lac County,0,3,-3
12,Florida,55,Wisconsin,41,Forest County,19,6,13
12,Florida,55,Wisconsin,43,Grant County,4,11,-7
12,Florida,55,Wisconsin,45,Green County,0,18,-18
12,Florida,55,Wisconsin,47,Green Lake County,16,3,13
12,Florida,55,Wisconsin,49,Iowa County,0,3,-3
12,Florida,55,Wisconsin,51,Iron County,70,22,48
12,Florida,55,Wisconsin,53,Jackson County,0,10,-10
12,Florida,55,Wisconsin,55,Jefferson County,82,108,-26
12,Florida,55,Wisconsin,57,Juneau County,32,18,14
12,Florida,55,Wisconsin,59,Kenosha County,308,33,275
12,Florida,55,Wisconsin,61,Kewaunee County,32,0,32
12,Florida,55,Wisconsin,63,La Crosse County,208,57,151
12,Florida,55,Wisconsin,65,Lafayette County,0,4,-4
12,Florida,55,Wisconsin,67,Langlade County,49,15,34
12,Florida,55,Wisconsin,69,Lincoln County,14,9,5
12,Florida,55,Wisconsin,71,Manitowoc County,176,105,71
12,Florida,55,Wisconsin,73,Marathon County,90,59,31
12,Florida,55,Wisconsin,75,Marinette County,34,35,-1
12,Florida,55,Wisconsin,77,Marquette County,0,3,-3
12,Florida,55,Wisconsin,79,Milwaukee County,1352,727,625
12,Florida,55,Wisconsin,81,Monroe County,86,12,74
12,Florida,55,Wisconsin,83,Oconto County,37,3,34
12,Florida,55,Wisconsin,85,Oneida County,46,47,-1
12,Florida,55,Wisconsin,87,Outagamie County,260,55,205
12,Florida,55,Wisconsin,89,Ozaukee County,189,123,66
12,Florida,55,Wisconsin,93,Pierce County,0,34,-34
12,Florida,55,Wisconsin,95,Polk County,35,23,12
12,Florida,55,Wisconsin,97,Portage County,44,37,7
12,Florida,55,Wisconsin,101,Racine County,352,233,119
12,Florida,55,Wisconsin,103,Richland County,0,39,-39
12,Florida,55,Wisconsin,105,Rock County,292,205,87
12,Florida,55,Wisconsin,107,Rusk County,15,5,10
12,Florida,55,Wisconsin,109,St. Croix County,78,33,45
12,Florida,55,Wisconsin,111,Sauk County,30,23,7
12,Florida,55,Wisconsin,113,Sawyer County,20,13,7
12,Florida,55,Wisconsin,115,Shawano County,60,0,60
12,Florida,55,Wisconsin,117,Sheboygan County,524,16,508
12,Florida,55,Wisconsin,119,Taylor County,0,5,-5
12,Florida,55,Wisconsin,123,Vernon County,0,2,-2
12,Florida,55,Wisconsin,125,Vilas County,19,12,7
12,Florida,55,Wisconsin,127,Walworth County,119,87,32
12,Florida,55,Wisconsin,131,Washington County,296,24,272
12,Florida,55,Wisconsin,133,Waukesha County,888,560,328
12,Florida,55,Wisconsin,135,Waupaca County,27,12,15
12,Florida,55,Wisconsin,137,Waushara County,12,21,-9
12,Florida,55,Wisconsin,139,Winnebago County,370,144,226
12,Florida,55,Wisconsin,141,Wood County,71,11,60
12,Florida,56,Wyoming,1,Albany County,27,4,23
12,Florida,56,Wyoming,5,Campbell County,34,1,33
12,Florida,56,Wyoming,7,Carbon County,8,79,-71
12,Florida,56,Wyoming,13,Fremont County,14,4,10
12,Florida,56,Wyoming,17,Hot Springs County,0,8,-8
12,Florida,56,Wyoming,21,Laramie County,185,94,91
12,Florida,56,Wyoming,23,Lincoln County,95,1,94
12,Florida,56,Wyoming,25,Natrona County,14,0,14
12,Florida,56,Wyoming,29,Park County,16,15,1
12,Florida,56,Wyoming,31,Platte County,19,0,19
12,Florida,56,Wyoming,35,Sublette County,0,378,-378
12,Florida,56,Wyoming,37,Sweetwater County,24,3,21
12,Florida,56,Wyoming,39,Teton County,4,17,-13
12,Florida,6,California,1,Alameda County,896,1129,-233
12,Florida,6,California,7,Butte County,79,91,-12
12,Florida,6,California,9,Calaveras County,31,0,31
12,Florida,6,California,13,Contra Costa County,687,434,253
12,Florida,6,California,15,Del Norte County,0,60,-60
12,Florida,6,California,17,El Dorado County,121,40,81
12,Florida,6,California,19,Fresno County,280,268,12
12,Florida,6,California,23,Humboldt County,154,106,48
12,Florida,6,California,25,Imperial County,120,10,110
12,Florida,6,California,27,Inyo County,210,0,210
12,Florida,6,California,29,Kern County,980,492,488
12,Florida,6,California,31,Kings County,171,485,-314
12,Florida,6,California,33,Lake County,0,100,-100
12,Florida,6,California,35,Lassen County,24,9,15
12,Florida,6,California,37,Los Angeles County,6254,5498,756
12,Florida,6,California,39,Madera County,15,0,15
12,Florida,6,California,41,Marin County,134,248,-114
12,Florida,6,California,43,Mariposa County,40,0,40
12,Florida,6,California,45,Mendocino County,9,0,9
12,Florida,6,California,47,Merced County,102,16,86
12,Florida,6,California,51,Mono County,0,3,-3
12,Florida,6,California,53,Monterey County,212,440,-228
12,Florida,6,California,55,Napa County,225,282,-57
12,Florida,6,California,57,Nevada County,79,62,17
12,Florida,6,California,59,Orange County,1784,1651,133
12,Florida,6,California,61,Placer County,145,172,-27
12,Florida,6,California,63,Plumas County,226,0,226
12,Florida,6,California,65,Riverside County,1102,1227,-125
12,Florida,6,California,67,Sacramento County,844,708,136
12,Florida,6,California,69,San Benito County,17,35,-18
12,Florida,6,California,71,San Bernardino County,1540,930,610
12,Florida,6,California,73,San Diego County,4452,4611,-159
12,Florida,6,California,75,San Francisco County,688,888,-200
12,Florida,6,California,77,San Joaquin County,360,309,51
12,Florida,6,California,79,San Luis Obispo County,58,97,-39
12,Florida,6,California,81,San Mateo County,466,475,-9
12,Florida,6,California,83,Santa Barbara County,526,387,139
12,Florida,6,California,85,Santa Clara County,1359,1755,-396
12,Florida,6,California,87,Santa Cruz County,86,139,-53
12,Florida,6,California,89,Shasta County,14,37,-23
12,Florida,6,California,93,Siskiyou County,46,85,-39
12,Florida,6,California,95,Solano County,417,309,108
12,Florida,6,California,97,Sonoma County,289,194,95
12,Florida,6,California,99,Stanislaus County,54,120,-66
12,Florida,6,California,101,Sutter County,20,0,20
12,Florida,6,California,103,Tehama County,52,0,52
12,Florida,6,California,105,Trinity County,0,69,-69
12,Florida,6,California,107,Tulare County,49,120,-71
12,Florida,6,California,109,Tuolumne County,0,83,-83
12,Florida,6,California,111,Ventura County,692,716,-24
12,Florida,6,California,113,Yolo County,36,27,9
12,Florida,6,California,115,Yuba County,178,141,37
12,Florida,72,Puerto Rico,1,Adjuntas Municipio,0,22,-22
12,Florida,72,Puerto Rico,3,Aguada Municipio,74,0,74
12,Florida,72,Puerto Rico,5,Aguadilla Municipio,119,77,42
12,Florida,72,Puerto Rico,7,Aguas Buenas Municipio,137,12,125
12,Florida,72,Puerto Rico,9,Aibonito Municipio,85,0,85
12,Florida,72,Puerto Rico,11,Añasco Municipio,133,52,81
12,Florida,72,Puerto Rico,13,Arecibo Municipio,440,202,238
12,Florida,72,Puerto Rico,15,Arroyo Municipio,62,0,62
12,Florida,72,Puerto Rico,17,Barceloneta Municipio,441,0,441
12,Florida,72,Puerto Rico,19,Barranquitas Municipio,640,5,635
12,Florida,72,Puerto Rico,21,Bayamón Municipio,2170,421,1749
12,Florida,72,Puerto Rico,23,Cabo Rojo Municipio,159,0,159
12,Florida,72,Puerto Rico,25,Caguas Municipio,2256,282,1974
12,Florida,72,Puerto Rico,27,Camuy Municipio,148,40,108
12,Florida,72,Puerto Rico,29,Canóvanas Municipio,898,34,864
12,Florida,72,Puerto Rico,31,Carolina Municipio,1582,203,1379
12,Florida,72,Puerto Rico,33,Cataño Municipio,41,42,-1
12,Florida,72,Puerto Rico,35,Cayey Municipio,151,72,79
12,Florida,72,Puerto Rico,37,Ceiba Municipio,91,1,90
12,Florida,72,Puerto Rico,39,Ciales Municipio,0,25,-25
12,Florida,72,Puerto Rico,41,Cidra Municipio,511,0,511
12,Florida,72,Puerto Rico,43,Coamo Municipio,39,64,-25
12,Florida,72,Puerto Rico,45,Comerío Municipio,67,62,5
12,Florida,72,Puerto Rico,47,Corozal Municipio,22,93,-71
12,Florida,72,Puerto Rico,49,Culebra Municipio,133,0,133
12,Florida,72,Puerto Rico,51,Dorado Municipio,254,92,162
12,Florida,72,Puerto Rico,53,Fajardo Municipio,754,107,647
12,Florida,72,Puerto Rico,55,Guánica Municipio,48,0,48
12,Florida,72,Puerto Rico,57,Guayama Municipio,417,10,407
12,Florida,72,Puerto Rico,59,Guayanilla Municipio,19,13,6
12,Florida,72,Puerto Rico,61,Guaynabo Municipio,242,165,77
12,Florida,72,Puerto Rico,63,Gurabo Municipio,508,12,496
12,Florida,72,Puerto Rico,65,Hatillo Municipio,85,0,85
12,Florida,72,Puerto Rico,67,Hormigueros Municipio,80,19,61
12,Florida,72,Puerto Rico,69,Humacao Municipio,312,20,292
12,Florida,72,Puerto Rico,71,Isabela Municipio,137,27,110
12,Florida,72,Puerto Rico,73,Jayuya Municipio,76,0,76
12,Florida,72,Puerto Rico,75,Juana Díaz Municipio,366,93,273
12,Florida,72,Puerto Rico,77,Juncos Municipio,407,0,407
12,Florida,72,Puerto Rico,79,Lajas Municipio,17,0,17
12,Florida,72,Puerto Rico,81,Lares Municipio,227,0,227
12,Florida,72,Puerto Rico,85,Las Piedras Municipio,467,46,421
12,Florida,72,Puerto Rico,87,Loíza Municipio,0,55,-55
12,Florida,72,Puerto Rico,89,Luquillo Municipio,138,104,34
12,Florida,72,Puerto Rico,91,Manatí Municipio,174,127,47
12,Florida,72,Puerto Rico,95,Maunabo Municipio,61,0,61
12,Florida,72,Puerto Rico,97,Mayagüez Municipio,602,36,566
12,Florida,72,Puerto Rico,99,Moca Municipio,233,0,233
12,Florida,72,Puerto Rico,101,Morovis Municipio,279,66,213
12,Florida,72,Puerto Rico,103,Naguabo Municipio,219,0,219
12,Florida,72,Puerto Rico,105,Naranjito Municipio,20,37,-17
12,Florida,72,Puerto Rico,107,Orocovis Municipio,0,14,-14
12,Florida,72,Puerto Rico,109,Patillas Municipio,28,18,10
12,Florida,72,Puerto Rico,111,Peñuelas Municipio,0,70,-70
12,Florida,72,Puerto Rico,113,Ponce Municipio,1111,226,885
12,Florida,72,Puerto Rico,115,Quebradillas Municipio,274,0,274
12,Florida,72,Puerto Rico,117,Rincón Municipio,195,0,195
12,Florida,72,Puerto Rico,119,Río Grande Municipio,521,78,443
12,Florida,72,Puerto Rico,121,Sabana Grande Municipio,344,23,321
12,Florida,72,Puerto Rico,123,Salinas Municipio,0,63,-63
12,Florida,72,Puerto Rico,125,San Germán Municipio,153,64,89
12,Florida,72,Puerto Rico,127,San Juan Municipio,2642,565,2077
12,Florida,72,Puerto Rico,129,San Lorenzo Municipio,65,37,28
12,Florida,72,Puerto Rico,131,San Sebastián Municipio,757,130,627
12,Florida,72,Puerto Rico,133,Santa Isabel Municipio,280,0,280
12,Florida,72,Puerto Rico,135,Toa Alta Municipio,376,31,345
12,Florida,72,Puerto Rico,137,Toa Baja Municipio,476,179,297
12,Florida,72,Puerto Rico,139,Trujillo Alto Municipio,1060,84,976
12,Florida,72,Puerto Rico,141,Utuado Municipio,195,0,195
12,Florida,72,Puerto Rico,143,Vega Alta Municipio,94,0,94
12,Florida,72,Puerto Rico,145,Vega Baja Municipio,236,68,168
12,Florida,72,Puerto Rico,147,Vieques Municipio,294,0,294
12,Florida,72,Puerto Rico,149,Villalba Municipio,72,24,48
12,Florida,72,Puerto Rico,151,Yabucoa Municipio,187,28,159
12,Florida,72,Puerto Rico,153,Yauco Municipio,85,50,35
12,Florida,8,Colorado,1,Adams County,791,384,407
12,Florida,8,Colorado,3,Alamosa County,0,3,-3
12,Florida,8,Colorado,5,Arapahoe County,1245,1555,-310
12,Florida,8,Colorado,7,Archuleta County,0,12,-12
12,Florida,8,Colorado,9,Baca County,0,3,-3
12,Florida,8,Colorado,11,Bent County,0,7,-7
12,Florida,8,Colorado,13,Boulder County,414,738,-324
12,Florida,8,Colorado,14,Broomfield County,214,95,119
12,Florida,8,Colorado,15,Chaffee County,72,10,62
12,Florida,8,Colorado,27,Custer County,80,0,80
12,Florida,8,Colorado,29,Delta County,41,54,-13
12,Florida,8,Colorado,31,Denver County,782,2047,-1265
12,Florida,8,Colorado,35,Douglas County,769,828,-59
12,Florida,8,Colorado,37,Eagle County,111,131,-20
12,Florida,8,Colorado,39,Elbert County,70,0,70
12,Florida,8,Colorado,41,El Paso County,1927,2022,-95
12,Florida,8,Colorado,43,Fremont County,33,51,-18
12,Florida,8,Colorado,45,Garfield County,91,145,-54
12,Florida,8,Colorado,47,Gilpin County,0,92,-92
12,Florida,8,Colorado,49,Grand County,62,57,5
12,Florida,8,Colorado,51,Gunnison County,22,27,-5
12,Florida,8,Colorado,55,Huerfano County,0,5,-5
12,Florida,8,Colorado,59,Jefferson County,872,824,48
12,Florida,8,Colorado,63,Kit Carson County,0,3,-3
12,Florida,8,Colorado,67,La Plata County,120,69,51
12,Florida,8,Colorado,69,Larimer County,598,291,307
12,Florida,8,Colorado,71,Las Animas County,0,14,-14
12,Florida,8,Colorado,75,Logan County,44,85,-41
12,Florida,8,Colorado,77,Mesa County,217,182,35
12,Florida,8,Colorado,83,Montezuma County,19,26,-7
12,Florida,8,Colorado,85,Montrose County,64,110,-46
12,Florida,8,Colorado,89,Otero County,0,7,-7
12,Florida,8,Colorado,93,Park County,0,5,-5
12,Florida,8,Colorado,97,Pitkin County,47,0,47
12,Florida,8,Colorado,99,Prowers County,10,4,6
12,Florida,8,Colorado,101,Pueblo County,119,261,-142
12,Florida,8,Colorado,105,Rio Grande County,28,0,28
12,Florida,8,Colorado,107,Routt County,0,74,-74
12,Florida,8,Colorado,113,San Miguel County,54,71,-17
12,Florida,8,Colorado,117,Summit County,148,184,-36
12,Florida,8,Colorado,119,Teller County,0,148,-148
12,Florida,8,Colorado,121,Washington County,0,2,-2
12,Florida,8,Colorado,123,Weld County,176,422,-246
12,Florida,8,Colorado,125,Yuma County,10,0,10
12,Florida,9,Connecticut,1,Fairfield County,3044,1444,1600
12,Florida,9,Connecticut,3,Hartford County,3295,1413,1882
12,Florida,9,Connecticut,5,Litchfield County,824,191,633
12,Florida,9,Connecticut,7,Middlesex County,751,203,548
12,Florida,9,Connecticut,9,New Haven County,2936,1300,1636
12,Florida,9,Connecticut,11,New London County,896,926,-30
12,Florida,9,Connecticut,13,Tolland County,712,296,416
12,Florida,9,Connecticut,15,Windham County,214,287,-73
12,Florida,AFR,Africa,,-,4164,0,0
12,Florida,ASI,Asia,,-,28769,0,0
12,Florida,CAM,Central America,,-,17760,0,0
12,Florida,CAR,Caribbean,,-,45529,0,0
12,Florida,EUR,Europe,,-,23952,0,0
12,Florida,ISL,U.S. Island Areas,,-,2405,0,0
12,Florida,NAM,Northern America,,-,20293,0,0
12,Florida,OCE,Oceania and At Sea,,-,1534,0,0
12,Florida,SAM,South America,,-,41503,0,0
13,Georgia,1,Alabama,1,Autauga County,71,93,-22
13,Georgia,1,Alabama,3,Baldwin County,384,563,-179
13,Georgia,1,Alabama,5,Barbour County,199,88,111
13,Georgia,1,Alabama,7,Bibb County,8,0,8
13,Georgia,1,Alabama,9,Blount County,39,189,-150
13,Georgia,1,Alabama,11,Bullock County,0,63,-63
13,Georgia,1,Alabama,13,Butler County,16,52,-36
13,Georgia,1,Alabama,15,Calhoun County,779,818,-39
13,Georgia,1,Alabama,17,Chambers County,513,295,218
13,Georgia,1,Alabama,19,Cherokee County,226,310,-84
13,Georgia,1,Alabama,21,Chilton County,22,82,-60
13,Georgia,1,Alabama,23,Choctaw County,0,44,-44
13,Georgia,1,Alabama,25,Clarke County,0,14,-14
13,Georgia,1,Alabama,27,Clay County,26,36,-10
13,Georgia,1,Alabama,29,Cleburne County,281,547,-266
13,Georgia,1,Alabama,31,Coffee County,55,166,-111
13,Georgia,1,Alabama,33,Colbert County,40,20,20
13,Georgia,1,Alabama,35,Conecuh County,0,25,-25
13,Georgia,1,Alabama,37,Coosa County,0,11,-11
13,Georgia,1,Alabama,39,Covington County,36,45,-9
13,Georgia,1,Alabama,41,Crenshaw County,19,10,9
13,Georgia,1,Alabama,43,Cullman County,41,237,-196
13,Georgia,1,Alabama,45,Dale County,187,237,-50
13,Georgia,1,Alabama,47,Dallas County,111,140,-29
13,Georgia,1,Alabama,49,DeKalb County,403,552,-149
13,Georgia,1,Alabama,51,Elmore County,252,228,24
13,Georgia,1,Alabama,53,Escambia County,142,43,99
13,Georgia,1,Alabama,55,Etowah County,268,454,-186
13,Georgia,1,Alabama,57,Fayette County,19,17,2
13,Georgia,1,Alabama,59,Franklin County,37,15,22
13,Georgia,1,Alabama,61,Geneva County,97,7,90
13,Georgia,1,Alabama,65,Hale County,37,5,32
13,Georgia,1,Alabama,67,Henry County,34,30,4
13,Georgia,1,Alabama,69,Houston County,312,645,-333
13,Georgia,1,Alabama,71,Jackson County,61,101,-40
13,Georgia,1,Alabama,73,Jefferson County,1990,1868,122
13,Georgia,1,Alabama,75,Lamar County,0,11,-11
13,Georgia,1,Alabama,77,Lauderdale County,233,136,97
13,Georgia,1,Alabama,79,Lawrence County,29,4,25
13,Georgia,1,Alabama,81,Lee County,1860,3342,-1482
13,Georgia,1,Alabama,83,Limestone County,89,296,-207
13,Georgia,1,Alabama,85,Lowndes County,42,7,35
13,Georgia,1,Alabama,87,Macon County,72,306,-234
13,Georgia,1,Alabama,89,Madison County,1006,1176,-170
13,Georgia,1,Alabama,91,Marengo County,27,13,14
13,Georgia,1,Alabama,93,Marion County,2,0,2
13,Georgia,1,Alabama,95,Marshall County,50,98,-48
13,Georgia,1,Alabama,97,Mobile County,653,710,-57
13,Georgia,1,Alabama,99,Monroe County,104,29,75
13,Georgia,1,Alabama,101,Montgomery County,1392,1094,298
13,Georgia,1,Alabama,103,Morgan County,97,252,-155
13,Georgia,1,Alabama,105,Perry County,266,12,254
13,Georgia,1,Alabama,107,Pickens County,5,12,-7
13,Georgia,1,Alabama,109,Pike County,252,87,165
13,Georgia,1,Alabama,111,Randolph County,404,281,123
13,Georgia,1,Alabama,113,Russell County,1908,2523,-615
13,Georgia,1,Alabama,115,St. Clair County,74,111,-37
13,Georgia,1,Alabama,117,Shelby County,555,1243,-688
13,Georgia,1,Alabama,119,Sumter County,0,14,-14
13,Georgia,1,Alabama,121,Talladega County,209,286,-77
13,Georgia,1,Alabama,123,Tallapoosa County,384,208,176
13,Georgia,1,Alabama,125,Tuscaloosa County,601,894,-293
13,Georgia,1,Alabama,127,Walker County,87,213,-126
13,Georgia,1,Alabama,131,Wilcox County,15,0,15
13,Georgia,1,Alabama,133,Winston County,10,9,1
13,Georgia,10,Delaware,1,Kent County,105,466,-361
13,Georgia,10,Delaware,3,New Castle County,985,252,733
13,Georgia,10,Delaware,5,Sussex County,49,26,23
13,Georgia,11,District of Columbia,1,District of Columbia,1031,1159,-128
13,Georgia,12,Florida,1,Alachua County,812,911,-99
13,Georgia,12,Florida,3,Baker County,85,101,-16
13,Georgia,12,Florida,5,Bay County,1181,875,306
13,Georgia,12,Florida,7,Bradford County,107,31,76
13,Georgia,12,Florida,9,Brevard County,1191,1309,-118
13,Georgia,12,Florida,11,Broward County,4295,2379,1916
13,Georgia,12,Florida,13,Calhoun County,88,28,60
13,Georgia,12,Florida,15,Charlotte County,111,359,-248
13,Georgia,12,Florida,17,Citrus County,245,124,121
13,Georgia,12,Florida,19,Clay County,275,448,-173
13,Georgia,12,Florida,21,Collier County,524,299,225
13,Georgia,12,Florida,23,Columbia County,117,432,-315
13,Georgia,12,Florida,27,DeSoto County,40,120,-80
13,Georgia,12,Florida,29,Dixie County,30,17,13
13,Georgia,12,Florida,31,Duval County,3502,3954,-452
13,Georgia,12,Florida,33,Escambia County,651,1047,-396
13,Georgia,12,Florida,35,Flagler County,187,449,-262
13,Georgia,12,Florida,37,Franklin County,10,91,-81
13,Georgia,12,Florida,39,Gadsden County,174,70,104
13,Georgia,12,Florida,41,Gilchrist County,0,12,-12
13,Georgia,12,Florida,43,Glades County,5,0,5
13,Georgia,12,Florida,45,Gulf County,21,155,-134
13,Georgia,12,Florida,47,Hamilton County,51,16,35
13,Georgia,12,Florida,49,Hardee County,0,13,-13
13,Georgia,12,Florida,51,Hendry County,35,118,-83
13,Georgia,12,Florida,53,Hernando County,146,348,-202
13,Georgia,12,Florida,55,Highlands County,278,198,80
13,Georgia,12,Florida,57,Hillsborough County,2488,2149,339
13,Georgia,12,Florida,59,Holmes County,0,137,-137
13,Georgia,12,Florida,61,Indian River County,298,279,19
13,Georgia,12,Florida,63,Jackson County,160,85,75
13,Georgia,12,Florida,65,Jefferson County,40,82,-42
13,Georgia,12,Florida,67,Lafayette County,0,10,-10
13,Georgia,12,Florida,69,Lake County,394,855,-461
13,Georgia,12,Florida,71,Lee County,1092,1027,65
13,Georgia,12,Florida,73,Leon County,1615,2041,-426
13,Georgia,12,Florida,75,Levy County,18,58,-40
13,Georgia,12,Florida,77,Liberty County,13,0,13
13,Georgia,12,Florida,79,Madison County,165,35,130
13,Georgia,12,Florida,81,Manatee County,702,778,-76
13,Georgia,12,Florida,83,Marion County,414,695,-281
13,Georgia,12,Florida,85,Martin County,332,215,117
13,Georgia,12,Florida,86,Miami-Dade County,4836,1381,3455
13,Georgia,12,Florida,87,Monroe County,135,210,-75
13,Georgia,12,Florida,89,Nassau County,667,651,16
13,Georgia,12,Florida,91,Okaloosa County,767,892,-125
13,Georgia,12,Florida,93,Okeechobee County,33,24,9
13,Georgia,12,Florida,95,Orange County,2844,2517,327
13,Georgia,12,Florida,97,Osceola County,500,636,-136
13,Georgia,12,Florida,99,Palm Beach County,2748,2089,659
13,Georgia,12,Florida,101,Pasco County,830,430,400
13,Georgia,12,Florida,103,Pinellas County,1501,1493,8
13,Georgia,12,Florida,105,Polk County,1040,857,183
13,Georgia,12,Florida,107,Putnam County,87,404,-317
13,Georgia,12,Florida,109,St. Johns County,677,1274,-597
13,Georgia,12,Florida,111,St. Lucie County,997,149,848
13,Georgia,12,Florida,113,Santa Rosa County,523,880,-357
13,Georgia,12,Florida,115,Sarasota County,530,570,-40
13,Georgia,12,Florida,117,Seminole County,609,753,-144
13,Georgia,12,Florida,119,Sumter County,420,332,88
13,Georgia,12,Florida,121,Suwannee County,205,39,166
13,Georgia,12,Florida,123,Taylor County,87,0,87
13,Georgia,12,Florida,125,Union County,21,0,21
13,Georgia,12,Florida,127,Volusia County,1129,1072,57
13,Georgia,12,Florida,129,Wakulla County,135,39,96
13,Georgia,12,Florida,131,Walton County,287,489,-202
13,Georgia,12,Florida,133,Washington County,36,23,13
13,Georgia,13,Georgia,1,Appling County,1848,566,1282
13,Georgia,13,Georgia,3,Atkinson County,722,215,507
13,Georgia,13,Georgia,5,Bacon County,280,650,-370
13,Georgia,13,Georgia,7,Baker County,120,101,19
13,Georgia,13,Georgia,9,Baldwin County,2751,3783,-1032
13,Georgia,13,Georgia,11,Banks County,846,698,148
13,Georgia,13,Georgia,13,Barrow County,3405,3050,355
13,Georgia,13,Georgia,15,Bartow County,4569,4929,-360
13,Georgia,13,Georgia,17,Ben Hill County,837,385,452
13,Georgia,13,Georgia,19,Berrien County,965,652,313
13,Georgia,13,Georgia,21,Bibb County,6317,7366,-1049
13,Georgia,13,Georgia,23,Bleckley County,649,1048,-399
13,Georgia,13,Georgia,25,Brantley County,699,999,-300
13,Georgia,13,Georgia,27,Brooks County,558,525,33
13,Georgia,13,Georgia,29,Bryan County,1597,2734,-1137
13,Georgia,13,Georgia,31,Bulloch County,4165,7405,-3240
13,Georgia,13,Georgia,33,Burke County,973,648,325
13,Georgia,13,Georgia,35,Butts County,3035,2462,573
13,Georgia,13,Georgia,37,Calhoun County,572,976,-404
13,Georgia,13,Georgia,39,Camden County,825,1837,-1012
13,Georgia,13,Georgia,43,Candler County,754,444,310
13,Georgia,13,Georgia,45,Carroll County,4470,7161,-2691
13,Georgia,13,Georgia,47,Catoosa County,1918,1753,165
13,Georgia,13,Georgia,49,Charlton County,256,212,44
13,Georgia,13,Georgia,51,Chatham County,9765,10212,-447
13,Georgia,13,Georgia,53,Chattahoochee County,1129,700,429
13,Georgia,13,Georgia,55,Chattooga County,1400,453,947
13,Georgia,13,Georgia,57,Cherokee County,9945,10465,-520
13,Georgia,13,Georgia,59,Clarke County,6830,14325,-7495
13,Georgia,13,Georgia,61,Clay County,24,98,-74
13,Georgia,13,Georgia,63,Clayton County,17763,20035,-2272
13,Georgia,13,Georgia,65,Clinch County,211,411,-200
13,Georgia,13,Georgia,67,Cobb County,33012,33109,-97
13,Georgia,13,Georgia,69,Coffee County,1902,1286,616
13,Georgia,13,Georgia,71,Colquitt County,1524,1392,132
13,Georgia,13,Georgia,73,Columbia County,4212,3682,530
13,Georgia,13,Georgia,75,Cook County,881,735,146
13,Georgia,13,Georgia,77,Coweta County,4760,5761,-1001
13,Georgia,13,Georgia,79,Crawford County,740,552,188
13,Georgia,13,Georgia,81,Crisp County,806,1225,-419
13,Georgia,13,Georgia,83,Dade County,298,397,-99
13,Georgia,13,Georgia,85,Dawson County,881,1682,-801
13,Georgia,13,Georgia,87,Decatur County,1364,872,492
13,Georgia,13,Georgia,89,DeKalb County,37076,39612,-2536
13,Georgia,13,Georgia,91,Dodge County,715,868,-153
13,Georgia,13,Georgia,93,Dooly County,530,986,-456
13,Georgia,13,Georgia,95,Dougherty County,3932,4562,-630
13,Georgia,13,Georgia,97,Douglas County,8098,7518,580
13,Georgia,13,Georgia,99,Early County,535,195,340
13,Georgia,13,Georgia,101,Echols County,131,107,24
13,Georgia,13,Georgia,103,Effingham County,2152,2220,-68
13,Georgia,13,Georgia,105,Elbert County,633,354,279
13,Georgia,13,Georgia,107,Emanuel County,1348,1416,-68
13,Georgia,13,Georgia,109,Evans County,837,690,147
13,Georgia,13,Georgia,111,Fannin County,573,887,-314
13,Georgia,13,Georgia,113,Fayette County,6503,4120,2383
13,Georgia,13,Georgia,115,Floyd County,3203,3509,-306
13,Georgia,13,Georgia,117,Forsyth County,8154,9816,-1662
13,Georgia,13,Georgia,119,Franklin County,1638,1256,382
13,Georgia,13,Georgia,121,Fulton County,58884,47503,11381
13,Georgia,13,Georgia,123,Gilmer County,718,1346,-628
13,Georgia,13,Georgia,125,Glascock County,130,62,68
13,Georgia,13,Georgia,127,Glynn County,3281,3780,-499
13,Georgia,13,Georgia,129,Gordon County,2053,2149,-96
13,Georgia,13,Georgia,131,Grady County,639,735,-96
13,Georgia,13,Georgia,133,Greene County,814,547,267
13,Georgia,13,Georgia,135,Gwinnett County,31599,27008,4591
13,Georgia,13,Georgia,137,Habersham County,1195,1992,-797
13,Georgia,13,Georgia,139,Hall County,6934,7468,-534
13,Georgia,13,Georgia,141,Hancock County,849,896,-47
13,Georgia,13,Georgia,143,Haralson County,1793,1833,-40
13,Georgia,13,Georgia,145,Harris County,1974,1832,142
13,Georgia,13,Georgia,147,Hart County,796,896,-100
13,Georgia,13,Georgia,149,Heard County,457,751,-294
13,Georgia,13,Georgia,151,Henry County,10279,11930,-1651
13,Georgia,13,Georgia,153,Houston County,6563,5346,1217
13,Georgia,13,Georgia,155,Irwin County,512,225,287
13,Georgia,13,Georgia,157,Jackson County,2836,2519,317
13,Georgia,13,Georgia,159,Jasper County,603,821,-218
13,Georgia,13,Georgia,161,Jeff Davis County,502,456,46
13,Georgia,13,Georgia,163,Jefferson County,1174,790,384
13,Georgia,13,Georgia,165,Jenkins County,570,345,225
13,Georgia,13,Georgia,167,Johnson County,880,421,459
13,Georgia,13,Georgia,169,Jones County,1509,1365,144
13,Georgia,13,Georgia,171,Lamar County,618,1440,-822
13,Georgia,13,Georgia,173,Lanier County,412,875,-463
13,Georgia,13,Georgia,175,Laurens County,2538,1013,1525
13,Georgia,13,Georgia,177,Lee County,1707,1637,70
13,Georgia,13,Georgia,179,Liberty County,4797,3471,1326
13,Georgia,13,Georgia,181,Lincoln County,239,204,35
13,Georgia,13,Georgia,183,Long County,1252,2031,-779
13,Georgia,13,Georgia,185,Lowndes County,4101,4120,-19
13,Georgia,13,Georgia,187,Lumpkin County,1537,2059,-522
13,Georgia,13,Georgia,189,McDuffie County,801,943,-142
13,Georgia,13,Georgia,191,McIntosh County,717,803,-86
13,Georgia,13,Georgia,193,Macon County,822,826,-4
13,Georgia,13,Georgia,195,Madison County,813,1668,-855
13,Georgia,13,Georgia,197,Marion County,126,452,-326
13,Georgia,13,Georgia,199,Meriwether County,1325,829,496
13,Georgia,13,Georgia,201,Miller County,309,163,146
13,Georgia,13,Georgia,205,Mitchell County,1054,1200,-146
13,Georgia,13,Georgia,207,Monroe County,1710,1763,-53
13,Georgia,13,Georgia,209,Montgomery County,792,852,-60
13,Georgia,13,Georgia,211,Morgan County,917,823,94
13,Georgia,13,Georgia,213,Murray County,1293,1133,160
13,Georgia,13,Georgia,215,Muscogee County,5704,6908,-1204
13,Georgia,13,Georgia,217,Newton County,6557,5260,1297
13,Georgia,13,Georgia,219,Oconee County,1111,1679,-568
13,Georgia,13,Georgia,221,Oglethorpe County,820,780,40
13,Georgia,13,Georgia,223,Paulding County,7482,7707,-225
13,Georgia,13,Georgia,225,Peach County,1591,2212,-621
13,Georgia,13,Georgia,227,Pickens County,2146,1599,547
13,Georgia,13,Georgia,229,Pierce County,1020,335,685
13,Georgia,13,Georgia,231,Pike County,689,1159,-470
13,Georgia,13,Georgia,233,Polk County,2030,1832,198
13,Georgia,13,Georgia,235,Pulaski County,330,540,-210
13,Georgia,13,Georgia,237,Putnam County,746,990,-244
13,Georgia,13,Georgia,239,Quitman County,25,60,-35
13,Georgia,13,Georgia,241,Rabun County,700,299,401
13,Georgia,13,Georgia,243,Randolph County,488,363,125
13,Georgia,13,Georgia,245,Richmond County,6856,6230,626
13,Georgia,13,Georgia,247,Rockdale County,6884,4991,1893
13,Georgia,13,Georgia,249,Schley County,171,386,-215
13,Georgia,13,Georgia,251,Screven County,798,568,230
13,Georgia,13,Georgia,253,Seminole County,260,236,24
13,Georgia,13,Georgia,255,Spalding County,3791,2984,807
13,Georgia,13,Georgia,257,Stephens County,840,1168,-328
13,Georgia,13,Georgia,259,Stewart County,217,601,-384
13,Georgia,13,Georgia,261,Sumter County,1453,1614,-161
13,Georgia,13,Georgia,263,Talbot County,432,285,147
13,Georgia,13,Georgia,265,Taliaferro County,41,45,-4
13,Georgia,13,Georgia,267,Tattnall County,1425,3550,-2125
13,Georgia,13,Georgia,269,Taylor County,268,579,-311
13,Georgia,13,Georgia,271,Telfair County,805,178,627
13,Georgia,13,Georgia,273,Terrell County,458,563,-105
13,Georgia,13,Georgia,275,Thomas County,1462,1826,-364
13,Georgia,13,Georgia,277,Tift County,1836,986,850
13,Georgia,13,Georgia,279,Toombs County,1352,955,397
13,Georgia,13,Georgia,281,Towns County,489,325,164
13,Georgia,13,Georgia,283,Treutlen County,641,432,209
13,Georgia,13,Georgia,285,Troup County,2370,2461,-91
13,Georgia,13,Georgia,287,Turner County,393,417,-24
13,Georgia,13,Georgia,289,Twiggs County,1193,224,969
13,Georgia,13,Georgia,291,Union County,473,808,-335
13,Georgia,13,Georgia,293,Upson County,1578,714,864
13,Georgia,13,Georgia,295,Walker County,1992,2451,-459
13,Georgia,13,Georgia,297,Walton County,4470,3277,1193
13,Georgia,13,Georgia,299,Ware County,1892,1857,35
13,Georgia,13,Georgia,301,Warren County,313,138,175
13,Georgia,13,Georgia,303,Washington County,950,1389,-439
13,Georgia,13,Georgia,305,Wayne County,1387,759,628
13,Georgia,13,Georgia,307,Webster County,93,56,37
13,Georgia,13,Georgia,309,Wheeler County,744,160,584
13,Georgia,13,Georgia,311,White County,1195,1512,-317
13,Georgia,13,Georgia,313,Whitfield County,2919,2363,556
13,Georgia,13,Georgia,315,Wilcox County,741,704,37
13,Georgia,13,Georgia,317,Wilkes County,196,338,-142
13,Georgia,13,Georgia,319,Wilkinson County,336,249,87
13,Georgia,13,Georgia,321,Worth County,1161,844,317
13,Georgia,15,Hawaii,1,Hawaii County,48,45,3
13,Georgia,15,Hawaii,3,Honolulu County,1191,1911,-720
13,Georgia,15,Hawaii,9,Maui County,78,34,44
13,Georgia,16,Idaho,1,Ada County,366,51,315
13,Georgia,16,Idaho,5,Bannock County,37,19,18
13,Georgia,16,Idaho,11,Bingham County,0,20,-20
13,Georgia,16,Idaho,19,Bonneville County,58,70,-12
13,Georgia,16,Idaho,27,Canyon County,11,116,-105
13,Georgia,16,Idaho,31,Cassia County,0,14,-14
13,Georgia,16,Idaho,39,Elmore County,17,5,12
13,Georgia,16,Idaho,43,Fremont County,18,0,18
13,Georgia,16,Idaho,47,Gooding County,0,11,-11
13,Georgia,16,Idaho,49,Idaho County,0,6,-6
13,Georgia,16,Idaho,53,Jerome County,0,13,-13
13,Georgia,16,Idaho,55,Kootenai County,32,16,16
13,Georgia,16,Idaho,57,Latah County,0,27,-27
13,Georgia,16,Idaho,65,Madison County,170,60,110
13,Georgia,16,Idaho,69,Nez Perce County,9,6,3
13,Georgia,16,Idaho,73,Owyhee County,0,25,-25
13,Georgia,16,Idaho,79,Shoshone County,14,0,14
13,Georgia,16,Idaho,83,Twin Falls County,20,22,-2
13,Georgia,16,Idaho,87,Washington County,0,7,-7
13,Georgia,17,Illinois,1,Adams County,51,16,35
13,Georgia,17,Illinois,7,Boone County,0,4,-4
13,Georgia,17,Illinois,11,Bureau County,0,1,-1
13,Georgia,17,Illinois,15,Carroll County,0,6,-6
13,Georgia,17,Illinois,19,Champaign County,84,105,-21
13,Georgia,17,Illinois,21,Christian County,30,0,30
13,Georgia,17,Illinois,23,Clark County,0,5,-5
13,Georgia,17,Illinois,25,Clay County,0,25,-25
13,Georgia,17,Illinois,29,Coles County,44,0,44
13,Georgia,17,Illinois,31,Cook County,4818,2645,2173
13,Georgia,17,Illinois,33,Crawford County,0,5,-5
13,Georgia,17,Illinois,37,DeKalb County,21,14,7
13,Georgia,17,Illinois,39,De Witt County,0,7,-7
13,Georgia,17,Illinois,43,DuPage County,521,282,239
13,Georgia,17,Illinois,45,Edgar County,2,0,2
13,Georgia,17,Illinois,53,Ford County,21,0,21
13,Georgia,17,Illinois,55,Franklin County,0,16,-16
13,Georgia,17,Illinois,63,Grundy County,10,63,-53
13,Georgia,17,Illinois,67,Hancock County,0,2,-2
13,Georgia,17,Illinois,73,Henry County,0,47,-47
13,Georgia,17,Illinois,75,Iroquois County,0,4,-4
13,Georgia,17,Illinois,77,Jackson County,0,53,-53
13,Georgia,17,Illinois,81,Jefferson County,37,0,37
13,Georgia,17,Illinois,83,Jersey County,0,81,-81
13,Georgia,17,Illinois,85,Jo Daviess County,15,0,15
13,Georgia,17,Illinois,89,Kane County,214,332,-118
13,Georgia,17,Illinois,91,Kankakee County,75,28,47
13,Georgia,17,Illinois,93,Kendall County,45,22,23
13,Georgia,17,Illinois,95,Knox County,104,14,90
13,Georgia,17,Illinois,97,Lake County,525,454,71
13,Georgia,17,Illinois,99,LaSalle County,148,6,142
13,Georgia,17,Illinois,103,Lee County,22,4,18
13,Georgia,17,Illinois,105,Livingston County,10,12,-2
13,Georgia,17,Illinois,111,McHenry County,234,33,201
13,Georgia,17,Illinois,113,McLean County,184,57,127
13,Georgia,17,Illinois,115,Macon County,15,15,0
13,Georgia,17,Illinois,117,Macoupin County,61,16,45
13,Georgia,17,Illinois,119,Madison County,87,184,-97
13,Georgia,17,Illinois,121,Marion County,0,46,-46
13,Georgia,17,Illinois,123,Marshall County,29,0,29
13,Georgia,17,Illinois,133,Monroe County,13,0,13
13,Georgia,17,Illinois,137,Morgan County,0,4,-4
13,Georgia,17,Illinois,141,Ogle County,74,0,74
13,Georgia,17,Illinois,143,Peoria County,189,14,175
13,Georgia,17,Illinois,145,Perry County,11,28,-17
13,Georgia,17,Illinois,147,Piatt County,21,1,20
13,Georgia,17,Illinois,155,Putnam County,13,0,13
13,Georgia,17,Illinois,157,Randolph County,0,5,-5
13,Georgia,17,Illinois,159,Richland County,0,11,-11
13,Georgia,17,Illinois,161,Rock Island County,61,64,-3
13,Georgia,17,Illinois,163,St. Clair County,178,48,130
13,Georgia,17,Illinois,167,Sangamon County,154,0,154
13,Georgia,17,Illinois,171,Scott County,0,4,-4
13,Georgia,17,Illinois,173,Shelby County,0,3,-3
13,Georgia,17,Illinois,179,Tazewell County,12,15,-3
13,Georgia,17,Illinois,181,Union County,19,0,19
13,Georgia,17,Illinois,183,Vermilion County,29,14,15
13,Georgia,17,Illinois,187,Warren County,0,23,-23
13,Georgia,17,Illinois,197,Will County,305,339,-34
13,Georgia,17,Illinois,199,Williamson County,144,33,111
13,Georgia,17,Illinois,201,Winnebago County,56,73,-17
13,Georgia,17,Illinois,203,Woodford County,0,1,-1
13,Georgia,18,Indiana,1,Adams County,0,62,-62
13,Georgia,18,Indiana,3,Allen County,199,126,73
13,Georgia,18,Indiana,5,Bartholomew County,42,61,-19
13,Georgia,18,Indiana,11,Boone County,77,11,66
13,Georgia,18,Indiana,13,Brown County,0,3,-3
13,Georgia,18,Indiana,19,Clark County,53,29,24
13,Georgia,18,Indiana,23,Clinton County,116,0,116
13,Georgia,18,Indiana,25,Crawford County,0,31,-31
13,Georgia,18,Indiana,31,Decatur County,0,11,-11
13,Georgia,18,Indiana,33,DeKalb County,24,5,19
13,Georgia,18,Indiana,35,Delaware County,43,82,-39
13,Georgia,18,Indiana,37,Dubois County,0,6,-6
13,Georgia,18,Indiana,39,Elkhart County,52,62,-10
13,Georgia,18,Indiana,43,Floyd County,86,24,62
13,Georgia,18,Indiana,45,Fountain County,10,28,-18
13,Georgia,18,Indiana,51,Gibson County,16,0,16
13,Georgia,18,Indiana,53,Grant County,102,26,76
13,Georgia,18,Indiana,55,Greene County,0,4,-4
13,Georgia,18,Indiana,57,Hamilton County,97,516,-419
13,Georgia,18,Indiana,59,Hancock County,0,29,-29
13,Georgia,18,Indiana,61,Harrison County,24,0,24
13,Georgia,18,Indiana,63,Hendricks County,59,37,22
13,Georgia,18,Indiana,65,Henry County,13,11,2
13,Georgia,18,Indiana,67,Howard County,23,0,23
13,Georgia,18,Indiana,69,Huntington County,14,15,-1
13,Georgia,18,Indiana,71,Jackson County,6,0,6
13,Georgia,18,Indiana,79,Jennings County,73,45,28
13,Georgia,18,Indiana,81,Johnson County,95,49,46
13,Georgia,18,Indiana,83,Knox County,0,23,-23
13,Georgia,18,Indiana,85,Kosciusko County,45,19,26
13,Georgia,18,Indiana,87,LaGrange County,0,26,-26
13,Georgia,18,Indiana,89,Lake County,137,146,-9
13,Georgia,18,Indiana,91,LaPorte County,125,15,110
13,Georgia,18,Indiana,97,Marion County,532,459,73
13,Georgia,18,Indiana,101,Martin County,9,16,-7
13,Georgia,18,Indiana,105,Monroe County,150,321,-171
13,Georgia,18,Indiana,113,Noble County,0,1,-1
13,Georgia,18,Indiana,127,Porter County,126,193,-67
13,Georgia,18,Indiana,129,Posey County,0,10,-10
13,Georgia,18,Indiana,131,Pulaski County,7,0,7
13,Georgia,18,Indiana,135,Randolph County,17,1,16
13,Georgia,18,Indiana,137,Ripley County,4,3,1
13,Georgia,18,Indiana,141,St. Joseph County,656,421,235
13,Georgia,18,Indiana,145,Shelby County,23,0,23
13,Georgia,18,Indiana,151,Steuben County,0,10,-10
13,Georgia,18,Indiana,153,Sullivan County,19,0,19
13,Georgia,18,Indiana,157,Tippecanoe County,156,312,-156
13,Georgia,18,Indiana,159,Tipton County,0,34,-34
13,Georgia,18,Indiana,163,Vanderburgh County,192,171,21
13,Georgia,18,Indiana,165,Vermillion County,4,3,1
13,Georgia,18,Indiana,167,Vigo County,5,192,-187
13,Georgia,18,Indiana,173,Warrick County,67,34,33
13,Georgia,18,Indiana,175,Washington County,0,6,-6
13,Georgia,18,Indiana,177,Wayne County,24,0,24
13,Georgia,18,Indiana,181,White County,0,13,-13
13,Georgia,19,Iowa,11,Benton County,4,0,4
13,Georgia,19,Iowa,13,Black Hawk County,57,67,-10
13,Georgia,19,Iowa,15,Boone County,0,1,-1
13,Georgia,19,Iowa,17,Bremer County,0,25,-25
13,Georgia,19,Iowa,29,Cass County,2,0,2
13,Georgia,19,Iowa,31,Cedar County,0,5,-5
13,Georgia,19,Iowa,33,Cerro Gordo County,0,47,-47
13,Georgia,19,Iowa,43,Clayton County,17,0,17
13,Georgia,19,Iowa,45,Clinton County,0,29,-29
13,Georgia,19,Iowa,47,Crawford County,0,8,-8
13,Georgia,19,Iowa,49,Dallas County,0,33,-33
13,Georgia,19,Iowa,53,Decatur County,35,0,35
13,Georgia,19,Iowa,55,Delaware County,2,0,2
13,Georgia,19,Iowa,61,Dubuque County,9,38,-29
13,Georgia,19,Iowa,65,Fayette County,0,8,-8
13,Georgia,19,Iowa,67,Floyd County,18,7,11
13,Georgia,19,Iowa,83,Hardin County,9,0,9
13,Georgia,19,Iowa,87,Henry County,6,45,-39
13,Georgia,19,Iowa,91,Humboldt County,0,2,-2
13,Georgia,19,Iowa,103,Johnson County,91,47,44
13,Georgia,19,Iowa,107,Keokuk County,0,21,-21
13,Georgia,19,Iowa,111,Lee County,0,2,-2
13,Georgia,19,Iowa,113,Linn County,110,148,-38
13,Georgia,19,Iowa,121,Madison County,32,2,30
13,Georgia,19,Iowa,123,Mahaska County,76,64,12
13,Georgia,19,Iowa,129,Mills County,1,0,1
13,Georgia,19,Iowa,131,Mitchell County,32,0,32
13,Georgia,19,Iowa,135,Monroe County,26,0,26
13,Georgia,19,Iowa,139,Muscatine County,62,0,62
13,Georgia,19,Iowa,141,O'Brien County,12,0,12
13,Georgia,19,Iowa,149,Plymouth County,0,3,-3
13,Georgia,19,Iowa,153,Polk County,391,386,5
13,Georgia,19,Iowa,155,Pottawattamie County,24,24,0
13,Georgia,19,Iowa,163,Scott County,66,106,-40
13,Georgia,19,Iowa,167,Sioux County,27,0,27
13,Georgia,19,Iowa,169,Story County,30,54,-24
13,Georgia,19,Iowa,171,Tama County,9,0,9
13,Georgia,19,Iowa,179,Wapello County,294,0,294
13,Georgia,19,Iowa,181,Warren County,24,17,7
13,Georgia,19,Iowa,183,Washington County,2,8,-6
13,Georgia,19,Iowa,187,Webster County,0,36,-36
13,Georgia,19,Iowa,189,Winnebago County,0,4,-4
13,Georgia,19,Iowa,193,Woodbury County,0,31,-31
13,Georgia,2,Alaska,16,Aleutians West Census Area,0,8,-8
13,Georgia,2,Alaska,20,Anchorage Municipality,880,280,600
13,Georgia,2,Alaska,50,Bethel Census Area,0,3,-3
13,Georgia,2,Alaska,90,Fairbanks North Star Borough,662,640,22
13,Georgia,2,Alaska,110,Juneau City and Borough,0,3,-3
13,Georgia,2,Alaska,122,Kenai Peninsula Borough,0,41,-41
13,Georgia,2,Alaska,130,Ketchikan Gateway Borough,0,5,-5
13,Georgia,2,Alaska,170,Matanuska-Susitna Borough,30,98,-68
13,Georgia,2,Alaska,180,Nome Census Area,0,27,-27
13,Georgia,2,Alaska,185,North Slope Borough,92,0,92
13,Georgia,2,Alaska,188,Northwest Arctic Borough,319,7,312
13,Georgia,2,Alaska,230,Skagway Municipality,0,2,-2
13,Georgia,2,Alaska,240,Southeast Fairbanks Census Area,10,12,-2
13,Georgia,20,Kansas,5,Atchison County,0,5,-5
13,Georgia,20,Kansas,15,Butler County,0,20,-20
13,Georgia,20,Kansas,25,Clark County,0,1,-1
13,Georgia,20,Kansas,35,Cowley County,21,25,-4
13,Georgia,20,Kansas,37,Crawford County,17,0,17
13,Georgia,20,Kansas,43,Doniphan County,0,1,-1
13,Georgia,20,Kansas,45,Douglas County,59,53,6
13,Georgia,20,Kansas,49,Elk County,30,0,30
13,Georgia,20,Kansas,55,Finney County,4,0,4
13,Georgia,20,Kansas,61,Geary County,273,302,-29
13,Georgia,20,Kansas,79,Harvey County,0,27,-27
13,Georgia,20,Kansas,81,Haskell County,0,26,-26
13,Georgia,20,Kansas,85,Jackson County,61,1,60
13,Georgia,20,Kansas,87,Jefferson County,5,0,5
13,Georgia,20,Kansas,91,Johnson County,379,363,16
13,Georgia,20,Kansas,103,Leavenworth County,349,240,109
13,Georgia,20,Kansas,111,Lyon County,0,203,-203
13,Georgia,20,Kansas,115,Marion County,0,14,-14
13,Georgia,20,Kansas,117,Marshall County,0,3,-3
13,Georgia,20,Kansas,125,Montgomery County,0,21,-21
13,Georgia,20,Kansas,127,Morris County,0,8,-8
13,Georgia,20,Kansas,133,Neosho County,0,7,-7
13,Georgia,20,Kansas,137,Norton County,0,6,-6
13,Georgia,20,Kansas,139,Osage County,0,9,-9
13,Georgia,20,Kansas,149,Pottawatomie County,17,64,-47
13,Georgia,20,Kansas,151,Pratt County,0,3,-3
13,Georgia,20,Kansas,155,Reno County,37,16,21
13,Georgia,20,Kansas,161,Riley County,334,435,-101
13,Georgia,20,Kansas,169,Saline County,106,6,100
13,Georgia,20,Kansas,173,Sedgwick County,1313,309,1004
13,Georgia,20,Kansas,175,Seward County,0,3,-3
13,Georgia,20,Kansas,177,Shawnee County,166,86,80
13,Georgia,20,Kansas,209,Wyandotte County,91,103,-12
13,Georgia,21,Kentucky,1,Adair County,0,28,-28
13,Georgia,21,Kentucky,3,Allen County,8,0,8
13,Georgia,21,Kentucky,7,Ballard County,0,101,-101
13,Georgia,21,Kentucky,9,Barren County,24,0,24
13,Georgia,21,Kentucky,11,Bath County,0,2,-2
13,Georgia,21,Kentucky,13,Bell County,20,45,-25
13,Georgia,21,Kentucky,15,Boone County,80,103,-23
13,Georgia,21,Kentucky,17,Bourbon County,24,0,24
13,Georgia,21,Kentucky,19,Boyd County,0,22,-22
13,Georgia,21,Kentucky,21,Boyle County,88,29,59
13,Georgia,21,Kentucky,25,Breathitt County,11,0,11
13,Georgia,21,Kentucky,27,Breckinridge County,0,16,-16
13,Georgia,21,Kentucky,31,Butler County,3,0,3
13,Georgia,21,Kentucky,37,Campbell County,34,0,34
13,Georgia,21,Kentucky,43,Carter County,0,28,-28
13,Georgia,21,Kentucky,45,Casey County,0,216,-216
13,Georgia,21,Kentucky,47,Christian County,290,380,-90
13,Georgia,21,Kentucky,49,Clark County,0,6,-6
13,Georgia,21,Kentucky,51,Clay County,61,0,61
13,Georgia,21,Kentucky,53,Clinton County,0,15,-15
13,Georgia,21,Kentucky,57,Cumberland County,0,3,-3
13,Georgia,21,Kentucky,59,Daviess County,21,7,14
13,Georgia,21,Kentucky,61,Edmonson County,0,34,-34
13,Georgia,21,Kentucky,63,Elliott County,15,0,15
13,Georgia,21,Kentucky,67,Fayette County,587,460,127
13,Georgia,21,Kentucky,71,Floyd County,9,9,0
13,Georgia,21,Kentucky,73,Franklin County,17,0,17
13,Georgia,21,Kentucky,79,Garrard County,0,12,-12
13,Georgia,21,Kentucky,83,Graves County,0,20,-20
13,Georgia,21,Kentucky,89,Greenup County,31,5,26
13,Georgia,21,Kentucky,91,Hancock County,0,10,-10
13,Georgia,21,Kentucky,93,Hardin County,494,455,39
13,Georgia,21,Kentucky,95,Harlan County,6,0,6
13,Georgia,21,Kentucky,99,Hart County,28,0,28
13,Georgia,21,Kentucky,101,Henderson County,0,71,-71
13,Georgia,21,Kentucky,103,Henry County,0,1,-1
13,Georgia,21,Kentucky,107,Hopkins County,61,39,22
13,Georgia,21,Kentucky,109,Jackson County,0,2,-2
13,Georgia,21,Kentucky,111,Jefferson County,1023,565,458
13,Georgia,21,Kentucky,113,Jessamine County,43,17,26
13,Georgia,21,Kentucky,115,Johnson County,0,7,-7
13,Georgia,21,Kentucky,117,Kenton County,59,18,41
13,Georgia,21,Kentucky,119,Knott County,0,15,-15
13,Georgia,21,Kentucky,121,Knox County,0,175,-175
13,Georgia,21,Kentucky,123,Larue County,0,21,-21
13,Georgia,21,Kentucky,125,Laurel County,44,0,44
13,Georgia,21,Kentucky,133,Letcher County,15,0,15
13,Georgia,21,Kentucky,139,Livingston County,0,1,-1
13,Georgia,21,Kentucky,141,Logan County,9,0,9
13,Georgia,21,Kentucky,145,McCracken County,177,27,150
13,Georgia,21,Kentucky,147,McCreary County,24,48,-24
13,Georgia,21,Kentucky,151,Madison County,37,58,-21
13,Georgia,21,Kentucky,157,Marshall County,19,0,19
13,Georgia,21,Kentucky,159,Martin County,0,23,-23
13,Georgia,21,Kentucky,163,Meade County,53,488,-435
13,Georgia,21,Kentucky,173,Montgomery County,0,38,-38
13,Georgia,21,Kentucky,177,Muhlenberg County,0,18,-18
13,Georgia,21,Kentucky,185,Oldham County,72,29,43
13,Georgia,21,Kentucky,187,Owen County,0,18,-18
13,Georgia,21,Kentucky,191,Pendleton County,18,0,18
13,Georgia,21,Kentucky,193,Perry County,0,22,-22
13,Georgia,21,Kentucky,195,Pike County,40,51,-11
13,Georgia,21,Kentucky,199,Pulaski County,0,59,-59
13,Georgia,21,Kentucky,205,Rowan County,25,18,7
13,Georgia,21,Kentucky,209,Scott County,17,203,-186
13,Georgia,21,Kentucky,211,Shelby County,0,45,-45
13,Georgia,21,Kentucky,215,Spencer County,3,16,-13
13,Georgia,21,Kentucky,217,Taylor County,0,20,-20
13,Georgia,21,Kentucky,219,Todd County,0,5,-5
13,Georgia,21,Kentucky,221,Trigg County,0,3,-3
13,Georgia,21,Kentucky,225,Union County,0,87,-87
13,Georgia,21,Kentucky,227,Warren County,65,104,-39
13,Georgia,21,Kentucky,229,Washington County,0,52,-52
13,Georgia,21,Kentucky,233,Webster County,0,9,-9
13,Georgia,21,Kentucky,235,Whitley County,79,207,-128
13,Georgia,21,Kentucky,237,Wolfe County,0,6,-6
13,Georgia,21,Kentucky,239,Woodford County,0,18,-18
13,Georgia,22,Louisiana,1,Acadia Parish,0,270,-270
13,Georgia,22,Louisiana,3,Allen Parish,10,33,-23
13,Georgia,22,Louisiana,5,Ascension Parish,154,21,133
13,Georgia,22,Louisiana,11,Beauregard Parish,27,21,6
13,Georgia,22,Louisiana,15,Bossier Parish,87,113,-26
13,Georgia,22,Louisiana,17,Caddo Parish,785,152,633
13,Georgia,22,Louisiana,19,Calcasieu Parish,101,254,-153
13,Georgia,22,Louisiana,33,East Baton Rouge Parish,432,464,-32
13,Georgia,22,Louisiana,35,East Carroll Parish,0,56,-56
13,Georgia,22,Louisiana,37,East Feliciana Parish,0,23,-23
13,Georgia,22,Louisiana,43,Grant Parish,18,0,18
13,Georgia,22,Louisiana,49,Jackson Parish,0,6,-6
13,Georgia,22,Louisiana,51,Jefferson Parish,567,522,45
13,Georgia,22,Louisiana,55,Lafayette Parish,82,213,-131
13,Georgia,22,Louisiana,57,Lafourche Parish,22,0,22
13,Georgia,22,Louisiana,61,Lincoln Parish,0,29,-29
13,Georgia,22,Louisiana,63,Livingston Parish,48,55,-7
13,Georgia,22,Louisiana,65,Madison Parish,15,0,15
13,Georgia,22,Louisiana,67,Morehouse Parish,11,26,-15
13,Georgia,22,Louisiana,71,Orleans Parish,725,855,-130
13,Georgia,22,Louisiana,73,Ouachita Parish,422,86,336
13,Georgia,22,Louisiana,79,Rapides Parish,218,110,108
13,Georgia,22,Louisiana,83,Richland Parish,19,0,19
13,Georgia,22,Louisiana,85,Sabine Parish,21,0,21
13,Georgia,22,Louisiana,87,St. Bernard Parish,86,0,86
13,Georgia,22,Louisiana,89,St. Charles Parish,0,112,-112
13,Georgia,22,Louisiana,95,St. John the Baptist Parish,7,0,7
13,Georgia,22,Louisiana,97,St. Landry Parish,50,3,47
13,Georgia,22,Louisiana,99,St. Martin Parish,9,0,9
13,Georgia,22,Louisiana,101,St. Mary Parish,10,0,10
13,Georgia,22,Louisiana,103,St. Tammany Parish,405,216,189
13,Georgia,22,Louisiana,105,Tangipahoa Parish,19,146,-127
13,Georgia,22,Louisiana,107,Tensas Parish,0,3,-3
13,Georgia,22,Louisiana,109,Terrebonne Parish,183,299,-116
13,Georgia,22,Louisiana,113,Vermilion Parish,10,44,-34
13,Georgia,22,Louisiana,115,Vernon Parish,464,280,184
13,Georgia,22,Louisiana,117,Washington Parish,0,17,-17
13,Georgia,22,Louisiana,121,West Baton Rouge Parish,13,6,7
13,Georgia,22,Louisiana,125,West Feliciana Parish,15,0,15
13,Georgia,22,Louisiana,127,Winn Parish,0,12,-12
13,Georgia,23,Maine,1,Androscoggin County,63,21,42
13,Georgia,23,Maine,3,Aroostook County,29,49,-20
13,Georgia,23,Maine,5,Cumberland County,193,36,157
13,Georgia,23,Maine,9,Hancock County,44,5,39
13,Georgia,23,Maine,11,Kennebec County,100,133,-33
13,Georgia,23,Maine,13,Knox County,0,50,-50
13,Georgia,23,Maine,15,Lincoln County,0,6,-6
13,Georgia,23,Maine,17,Oxford County,32,10,22
13,Georgia,23,Maine,19,Penobscot County,33,56,-23
13,Georgia,23,Maine,21,Piscataquis County,0,3,-3
13,Georgia,23,Maine,23,Sagadahoc County,37,7,30
13,Georgia,23,Maine,25,Somerset County,24,12,12
13,Georgia,23,Maine,27,Waldo County,0,12,-12
13,Georgia,23,Maine,31,York County,12,35,-23
13,Georgia,24,Maryland,1,Allegany County,19,15,4
13,Georgia,24,Maryland,3,Anne Arundel County,738,1045,-307
13,Georgia,24,Maryland,5,Baltimore County,532,485,47
13,Georgia,24,Maryland,9,Calvert County,83,119,-36
13,Georgia,24,Maryland,13,Carroll County,172,80,92
13,Georgia,24,Maryland,15,Cecil County,11,19,-8
13,Georgia,24,Maryland,17,Charles County,65,90,-25
13,Georgia,24,Maryland,21,Frederick County,287,230,57
13,Georgia,24,Maryland,23,Garrett County,0,1,-1
13,Georgia,24,Maryland,25,Harford County,243,243,0
13,Georgia,24,Maryland,27,Howard County,319,290,29
13,Georgia,24,Maryland,29,Kent County,0,61,-61
13,Georgia,24,Maryland,31,Montgomery County,692,1411,-719
13,Georgia,24,Maryland,33,Prince George's County,749,729,20
13,Georgia,24,Maryland,35,Queen Anne's County,69,1,68
13,Georgia,24,Maryland,37,St. Mary's County,112,165,-53
13,Georgia,24,Maryland,39,Somerset County,0,177,-177
13,Georgia,24,Maryland,41,Talbot County,11,10,1
13,Georgia,24,Maryland,43,Washington County,61,131,-70
13,Georgia,24,Maryland,45,Wicomico County,31,113,-82
13,Georgia,24,Maryland,47,Worcester County,13,29,-16
13,Georgia,24,Maryland,510,Baltimore city,684,490,194
13,Georgia,25,Massachusetts,1,Barnstable County,72,41,31
13,Georgia,25,Massachusetts,3,Berkshire County,90,79,11
13,Georgia,25,Massachusetts,5,Bristol County,95,15,80
13,Georgia,25,Massachusetts,9,Essex County,108,103,5
13,Georgia,25,Massachusetts,11,Franklin County,94,2,92
13,Georgia,25,Massachusetts,13,Hampden County,213,359,-146
13,Georgia,25,Massachusetts,15,Hampshire County,95,32,63
13,Georgia,25,Massachusetts,17,Middlesex County,855,820,35
13,Georgia,25,Massachusetts,21,Norfolk County,700,561,139
13,Georgia,25,Massachusetts,23,Plymouth County,108,204,-96
13,Georgia,25,Massachusetts,25,Suffolk County,345,834,-489
13,Georgia,25,Massachusetts,27,Worcester County,746,38,708
13,Georgia,26,Michigan,1,Alcona County,0,5,-5
13,Georgia,26,Michigan,5,Allegan County,0,116,-116
13,Georgia,26,Michigan,7,Alpena County,29,0,29
13,Georgia,26,Michigan,9,Antrim County,0,34,-34
13,Georgia,26,Michigan,13,Baraga County,18,0,18
13,Georgia,26,Michigan,15,Barry County,8,0,8
13,Georgia,26,Michigan,17,Bay County,64,0,64
13,Georgia,26,Michigan,19,Benzie County,0,8,-8
13,Georgia,26,Michigan,21,Berrien County,143,39,104
13,Georgia,26,Michigan,23,Branch County,30,5,25
13,Georgia,26,Michigan,25,Calhoun County,24,127,-103
13,Georgia,26,Michigan,27,Cass County,93,38,55
13,Georgia,26,Michigan,29,Charlevoix County,3,11,-8
13,Georgia,26,Michigan,33,Chippewa County,0,92,-92
13,Georgia,26,Michigan,35,Clare County,9,10,-1
13,Georgia,26,Michigan,39,Crawford County,0,2,-2
13,Georgia,26,Michigan,45,Eaton County,76,41,35
13,Georgia,26,Michigan,49,Genesee County,628,122,506
13,Georgia,26,Michigan,55,Grand Traverse County,17,38,-21
13,Georgia,26,Michigan,59,Hillsdale County,23,108,-85
13,Georgia,26,Michigan,61,Houghton County,48,0,48
13,Georgia,26,Michigan,63,Huron County,0,13,-13
13,Georgia,26,Michigan,65,Ingham County,112,472,-360
13,Georgia,26,Michigan,67,Ionia County,0,88,-88
13,Georgia,26,Michigan,69,Iosco County,0,7,-7
13,Georgia,26,Michigan,71,Iron County,0,3,-3
13,Georgia,26,Michigan,73,Isabella County,28,37,-9
13,Georgia,26,Michigan,75,Jackson County,0,60,-60
13,Georgia,26,Michigan,77,Kalamazoo County,217,134,83
13,Georgia,26,Michigan,81,Kent County,222,514,-292
13,Georgia,26,Michigan,87,Lapeer County,5,0,5
13,Georgia,26,Michigan,91,Lenawee County,55,29,26
13,Georgia,26,Michigan,93,Livingston County,20,28,-8
13,Georgia,26,Michigan,97,Mackinac County,0,7,-7
13,Georgia,26,Michigan,99,Macomb County,761,312,449
13,Georgia,26,Michigan,101,Manistee County,0,32,-32
13,Georgia,26,Michigan,105,Mason County,10,6,4
13,Georgia,26,Michigan,107,Mecosta County,38,0,38
13,Georgia,26,Michigan,111,Midland County,198,31,167
13,Georgia,26,Michigan,113,Missaukee County,0,3,-3
13,Georgia,26,Michigan,115,Monroe County,137,20,117
13,Georgia,26,Michigan,117,Montcalm County,41,85,-44
13,Georgia,26,Michigan,119,Montmorency County,0,28,-28
13,Georgia,26,Michigan,121,Muskegon County,13,0,13
13,Georgia,26,Michigan,123,Newaygo County,20,68,-48
13,Georgia,26,Michigan,125,Oakland County,743,555,188
13,Georgia,26,Michigan,127,Oceana County,0,7,-7
13,Georgia,26,Michigan,129,Ogemaw County,0,9,-9
13,Georgia,26,Michigan,137,Otsego County,13,0,13
13,Georgia,26,Michigan,139,Ottawa County,107,102,5
13,Georgia,26,Michigan,145,Saginaw County,118,140,-22
13,Georgia,26,Michigan,147,St. Clair County,93,159,-66
13,Georgia,26,Michigan,149,St. Joseph County,6,0,6
13,Georgia,26,Michigan,151,Sanilac County,26,11,15
13,Georgia,26,Michigan,155,Shiawassee County,97,0,97
13,Georgia,26,Michigan,157,Tuscola County,0,4,-4
13,Georgia,26,Michigan,159,Van Buren County,0,11,-11
13,Georgia,26,Michigan,161,Washtenaw County,551,335,216
13,Georgia,26,Michigan,163,Wayne County,1719,1565,154
13,Georgia,26,Michigan,165,Wexford County,0,4,-4
13,Georgia,27,Minnesota,3,Anoka County,202,123,79
13,Georgia,27,Minnesota,5,Becker County,61,0,61
13,Georgia,27,Minnesota,9,Benton County,0,25,-25
13,Georgia,27,Minnesota,13,Blue Earth County,0,97,-97
13,Georgia,27,Minnesota,15,Brown County,0,31,-31
13,Georgia,27,Minnesota,17,Carlton County,18,16,2
13,Georgia,27,Minnesota,19,Carver County,74,5,69
13,Georgia,27,Minnesota,21,Cass County,0,2,-2
13,Georgia,27,Minnesota,25,Chisago County,174,8,166
13,Georgia,27,Minnesota,27,Clay County,0,24,-24
13,Georgia,27,Minnesota,35,Crow Wing County,24,11,13
13,Georgia,27,Minnesota,37,Dakota County,106,141,-35
13,Georgia,27,Minnesota,47,Freeborn County,0,8,-8
13,Georgia,27,Minnesota,49,Goodhue County,2,0,2
13,Georgia,27,Minnesota,53,Hennepin County,644,1041,-397
13,Georgia,27,Minnesota,55,Houston County,0,1,-1
13,Georgia,27,Minnesota,59,Isanti County,17,3,14
13,Georgia,27,Minnesota,61,Itasca County,0,1,-1
13,Georgia,27,Minnesota,67,Kandiyohi County,18,0,18
13,Georgia,27,Minnesota,75,Lake County,0,8,-8
13,Georgia,27,Minnesota,79,Le Sueur County,0,44,-44
13,Georgia,27,Minnesota,83,Lyon County,4,0,4
13,Georgia,27,Minnesota,89,Marshall County,31,0,31
13,Georgia,27,Minnesota,93,Meeker County,0,2,-2
13,Georgia,27,Minnesota,95,Mille Lacs County,25,0,25
13,Georgia,27,Minnesota,99,Mower County,8,7,1
13,Georgia,27,Minnesota,103,Nicollet County,3,77,-74
13,Georgia,27,Minnesota,109,Olmsted County,43,32,11
13,Georgia,27,Minnesota,111,Otter Tail County,119,4,115
13,Georgia,27,Minnesota,115,Pine County,4,0,4
13,Georgia,27,Minnesota,123,Ramsey County,232,354,-122
13,Georgia,27,Minnesota,131,Rice County,17,5,12
13,Georgia,27,Minnesota,137,St. Louis County,0,39,-39
13,Georgia,27,Minnesota,139,Scott County,38,32,6
13,Georgia,27,Minnesota,145,Stearns County,39,14,25
13,Georgia,27,Minnesota,157,Wabasha County,29,3,26
13,Georgia,27,Minnesota,161,Waseca County,0,3,-3
13,Georgia,27,Minnesota,163,Washington County,82,0,82
13,Georgia,27,Minnesota,165,Watonwan County,25,2,23
13,Georgia,27,Minnesota,169,Winona County,0,129,-129
13,Georgia,27,Minnesota,171,Wright County,0,20,-20
13,Georgia,27,Minnesota,173,Yellow Medicine County,0,6,-6
13,Georgia,28,Mississippi,1,Adams County,11,54,-43
13,Georgia,28,Mississippi,3,Alcorn County,0,108,-108
13,Georgia,28,Mississippi,7,Attala County,0,3,-3
13,Georgia,28,Mississippi,9,Benton County,0,2,-2
13,Georgia,28,Mississippi,11,Bolivar County,100,19,81
13,Georgia,28,Mississippi,13,Calhoun County,0,2,-2
13,Georgia,28,Mississippi,15,Carroll County,0,6,-6
13,Georgia,28,Mississippi,17,Chickasaw County,0,22,-22
13,Georgia,28,Mississippi,19,Choctaw County,0,15,-15
13,Georgia,28,Mississippi,21,Claiborne County,0,2,-2
13,Georgia,28,Mississippi,25,Clay County,6,6,0
13,Georgia,28,Mississippi,27,Coahoma County,0,40,-40
13,Georgia,28,Mississippi,29,Copiah County,0,24,-24
13,Georgia,28,Mississippi,31,Covington County,0,15,-15
13,Georgia,28,Mississippi,33,DeSoto County,83,356,-273
13,Georgia,28,Mississippi,35,Forrest County,188,155,33
13,Georgia,28,Mississippi,41,Greene County,0,2,-2
13,Georgia,28,Mississippi,43,Grenada County,2,0,2
13,Georgia,28,Mississippi,45,Hancock County,105,89,16
13,Georgia,28,Mississippi,47,Harrison County,604,755,-151
13,Georgia,28,Mississippi,49,Hinds County,364,298,66
13,Georgia,28,Mississippi,57,Itawamba County,21,39,-18
13,Georgia,28,Mississippi,59,Jackson County,299,97,202
13,Georgia,28,Mississippi,61,Jasper County,46,26,20
13,Georgia,28,Mississippi,63,Jefferson County,0,7,-7
13,Georgia,28,Mississippi,65,Jefferson Davis County,14,9,5
13,Georgia,28,Mississippi,67,Jones County,46,17,29
13,Georgia,28,Mississippi,69,Kemper County,0,3,-3
13,Georgia,28,Mississippi,71,Lafayette County,99,460,-361
13,Georgia,28,Mississippi,73,Lamar County,35,290,-255
13,Georgia,28,Mississippi,75,Lauderdale County,116,69,47
13,Georgia,28,Mississippi,79,Leake County,6,45,-39
13,Georgia,28,Mississippi,81,Lee County,683,127,556
13,Georgia,28,Mississippi,83,Leflore County,165,43,122
13,Georgia,28,Mississippi,85,Lincoln County,0,14,-14
13,Georgia,28,Mississippi,87,Lowndes County,128,6,122
13,Georgia,28,Mississippi,89,Madison County,307,13,294
13,Georgia,28,Mississippi,93,Marshall County,0,6,-6
13,Georgia,28,Mississippi,97,Montgomery County,0,45,-45
13,Georgia,28,Mississippi,101,Newton County,0,4,-4
13,Georgia,28,Mississippi,103,Noxubee County,0,40,-40
13,Georgia,28,Mississippi,105,Oktibbeha County,243,126,117
13,Georgia,28,Mississippi,107,Panola County,0,4,-4
13,Georgia,28,Mississippi,109,Pearl River County,12,62,-50
13,Georgia,28,Mississippi,113,Pike County,5,22,-17
13,Georgia,28,Mississippi,115,Pontotoc County,44,0,44
13,Georgia,28,Mississippi,121,Rankin County,358,99,259
13,Georgia,28,Mississippi,123,Scott County,0,40,-40
13,Georgia,28,Mississippi,127,Simpson County,0,10,-10
13,Georgia,28,Mississippi,131,Stone County,39,5,34
13,Georgia,28,Mississippi,135,Tallahatchie County,69,0,69
13,Georgia,28,Mississippi,137,Tate County,49,10,39
13,Georgia,28,Mississippi,139,Tippah County,0,85,-85
13,Georgia,28,Mississippi,141,Tishomingo County,26,0,26
13,Georgia,28,Mississippi,145,Union County,9,11,-2
13,Georgia,28,Mississippi,147,Walthall County,37,0,37
13,Georgia,28,Mississippi,149,Warren County,213,63,150
13,Georgia,28,Mississippi,151,Washington County,78,15,63
13,Georgia,28,Mississippi,155,Webster County,0,4,-4
13,Georgia,28,Mississippi,157,Wilkinson County,0,32,-32
13,Georgia,28,Mississippi,159,Winston County,143,0,143
13,Georgia,28,Mississippi,161,Yalobusha County,19,6,13
13,Georgia,28,Mississippi,163,Yazoo County,14,156,-142
13,Georgia,29,Missouri,5,Atchison County,0,4,-4
13,Georgia,29,Missouri,7,Audrain County,0,15,-15
13,Georgia,29,Missouri,9,Barry County,0,11,-11
13,Georgia,29,Missouri,19,Boone County,439,143,296
13,Georgia,29,Missouri,21,Buchanan County,15,8,7
13,Georgia,29,Missouri,23,Butler County,0,13,-13
13,Georgia,29,Missouri,25,Caldwell County,11,1,10
13,Georgia,29,Missouri,27,Callaway County,27,0,27
13,Georgia,29,Missouri,29,Camden County,38,0,38
13,Georgia,29,Missouri,31,Cape Girardeau County,61,18,43
13,Georgia,29,Missouri,37,Cass County,0,4,-4
13,Georgia,29,Missouri,39,Cedar County,0,8,-8
13,Georgia,29,Missouri,43,Christian County,9,39,-30
13,Georgia,29,Missouri,47,Clay County,101,152,-51
13,Georgia,29,Missouri,51,Cole County,17,87,-70
13,Georgia,29,Missouri,59,Dallas County,0,1,-1
13,Georgia,29,Missouri,63,DeKalb County,0,7,-7
13,Georgia,29,Missouri,67,Douglas County,30,0,30
13,Georgia,29,Missouri,71,Franklin County,21,115,-94
13,Georgia,29,Missouri,77,Greene County,88,159,-71
13,Georgia,29,Missouri,83,Henry County,0,5,-5
13,Georgia,29,Missouri,85,Hickory County,2,0,2
13,Georgia,29,Missouri,89,Howard County,0,2,-2
13,Georgia,29,Missouri,91,Howell County,56,16,40
13,Georgia,29,Missouri,95,Jackson County,373,185,188
13,Georgia,29,Missouri,97,Jasper County,14,0,14
13,Georgia,29,Missouri,99,Jefferson County,57,17,40
13,Georgia,29,Missouri,101,Johnson County,0,77,-77
13,Georgia,29,Missouri,105,Laclede County,41,0,41
13,Georgia,29,Missouri,107,Lafayette County,0,8,-8
13,Georgia,29,Missouri,111,Lewis County,0,24,-24
13,Georgia,29,Missouri,113,Lincoln County,16,0,16
13,Georgia,29,Missouri,121,Macon County,0,10,-10
13,Georgia,29,Missouri,123,Madison County,0,2,-2
13,Georgia,29,Missouri,127,Marion County,60,0,60
13,Georgia,29,Missouri,131,Miller County,0,41,-41
13,Georgia,29,Missouri,135,Moniteau County,0,4,-4
13,Georgia,29,Missouri,141,Morgan County,146,0,146
13,Georgia,29,Missouri,147,Nodaway County,0,6,-6
13,Georgia,29,Missouri,151,Osage County,3,0,3
13,Georgia,29,Missouri,159,Pettis County,38,17,21
13,Georgia,29,Missouri,161,Phelps County,58,42,16
13,Georgia,29,Missouri,165,Platte County,14,40,-26
13,Georgia,29,Missouri,169,Pulaski County,172,520,-348
13,Georgia,29,Missouri,175,Randolph County,78,0,78
13,Georgia,29,Missouri,177,Ray County,0,62,-62
13,Georgia,29,Missouri,179,Reynolds County,17,0,17
13,Georgia,29,Missouri,181,Ripley County,0,9,-9
13,Georgia,29,Missouri,183,St. Charles County,93,127,-34
13,Georgia,29,Missouri,185,St. Clair County,0,4,-4
13,Georgia,29,Missouri,187,St. Francois County,0,25,-25
13,Georgia,29,Missouri,189,St. Louis County,380,586,-206
13,Georgia,29,Missouri,195,Saline County,0,9,-9
13,Georgia,29,Missouri,201,Scott County,63,0,63
13,Georgia,29,Missouri,207,Stoddard County,0,28,-28
13,Georgia,29,Missouri,209,Stone County,0,1,-1
13,Georgia,29,Missouri,213,Taney County,3,0,3
13,Georgia,29,Missouri,215,Texas County,52,0,52
13,Georgia,29,Missouri,217,Vernon County,0,22,-22
13,Georgia,29,Missouri,223,Wayne County,18,0,18
13,Georgia,29,Missouri,225,Webster County,56,0,56
13,Georgia,29,Missouri,229,Wright County,0,12,-12
13,Georgia,29,Missouri,510,St. Louis city,411,247,164
13,Georgia,30,Montana,5,Blaine County,0,14,-14
13,Georgia,30,Montana,9,Carbon County,0,5,-5
13,Georgia,30,Montana,13,Cascade County,0,10,-10
13,Georgia,30,Montana,23,Deer Lodge County,0,4,-4
13,Georgia,30,Montana,29,Flathead County,29,132,-103
13,Georgia,30,Montana,31,Gallatin County,8,18,-10
13,Georgia,30,Montana,47,Lake County,0,13,-13
13,Georgia,30,Montana,49,Lewis and Clark County,31,11,20
13,Georgia,30,Montana,53,Lincoln County,12,0,12
13,Georgia,30,Montana,61,Mineral County,0,2,-2
13,Georgia,30,Montana,63,Missoula County,55,50,5
13,Georgia,30,Montana,75,Powder River County,0,7,-7
13,Georgia,30,Montana,81,Ravalli County,0,4,-4
13,Georgia,30,Montana,93,Silver Bow County,12,13,-1
13,Georgia,30,Montana,97,Sweet Grass County,0,14,-14
13,Georgia,30,Montana,111,Yellowstone County,49,10,39
13,Georgia,31,Nebraska,3,Antelope County,63,0,63
13,Georgia,31,Nebraska,19,Buffalo County,0,8,-8
13,Georgia,31,Nebraska,25,Cass County,11,0,11
13,Georgia,31,Nebraska,31,Cherry County,1,0,1
13,Georgia,31,Nebraska,33,Cheyenne County,0,58,-58
13,Georgia,31,Nebraska,37,Colfax County,2,0,2
13,Georgia,31,Nebraska,41,Custer County,61,0,61
13,Georgia,31,Nebraska,45,Dawes County,0,40,-40
13,Georgia,31,Nebraska,47,Dawson County,7,0,7
13,Georgia,31,Nebraska,53,Dodge County,17,0,17
13,Georgia,31,Nebraska,55,Douglas County,365,264,101
13,Georgia,31,Nebraska,65,Furnas County,0,6,-6
13,Georgia,31,Nebraska,79,Hall County,15,0,15
13,Georgia,31,Nebraska,81,Hamilton County,0,25,-25
13,Georgia,31,Nebraska,107,Knox County,0,1,-1
13,Georgia,31,Nebraska,109,Lancaster County,41,171,-130
13,Georgia,31,Nebraska,111,Lincoln County,7,0,7
13,Georgia,31,Nebraska,127,Nemaha County,0,20,-20
13,Georgia,31,Nebraska,137,Phelps County,0,7,-7
13,Georgia,31,Nebraska,149,Rock County,0,14,-14
13,Georgia,31,Nebraska,153,Sarpy County,102,221,-119
13,Georgia,31,Nebraska,157,Scotts Bluff County,0,9,-9
13,Georgia,31,Nebraska,159,Seward County,0,5,-5
13,Georgia,31,Nebraska,173,Thurston County,0,19,-19
13,Georgia,31,Nebraska,175,Valley County,0,1,-1
13,Georgia,31,Nebraska,179,Wayne County,0,5,-5
13,Georgia,31,Nebraska,181,Webster County,0,3,-3
13,Georgia,31,Nebraska,185,York County,0,5,-5
13,Georgia,32,Nevada,3,Clark County,1104,1293,-189
13,Georgia,32,Nevada,5,Douglas County,15,3,12
13,Georgia,32,Nevada,19,Lyon County,39,0,39
13,Georgia,32,Nevada,27,Pershing County,0,16,-16
13,Georgia,32,Nevada,31,Washoe County,308,136,172
13,Georgia,32,Nevada,33,White Pine County,0,9,-9
13,Georgia,32,Nevada,510,Carson City,49,0,49
13,Georgia,33,New Hampshire,1,Belknap County,41,0,41
13,Georgia,33,New Hampshire,3,Carroll County,27,46,-19
13,Georgia,33,New Hampshire,5,Cheshire County,56,42,14
13,Georgia,33,New Hampshire,7,Coos County,33,12,21
13,Georgia,33,New Hampshire,9,Grafton County,19,42,-23
13,Georgia,33,New Hampshire,11,Hillsborough County,127,115,12
13,Georgia,33,New Hampshire,13,Merrimack County,21,56,-35
13,Georgia,33,New Hampshire,15,Rockingham County,219,112,107
13,Georgia,33,New Hampshire,17,Strafford County,30,18,12
13,Georgia,33,New Hampshire,19,Sullivan County,7,0,7
13,Georgia,34,New Jersey,1,Atlantic County,76,61,15
13,Georgia,34,New Jersey,3,Bergen County,586,76,510
13,Georgia,34,New Jersey,5,Burlington County,483,193,290
13,Georgia,34,New Jersey,7,Camden County,133,306,-173
13,Georgia,34,New Jersey,9,Cape May County,70,47,23
13,Georgia,34,New Jersey,11,Cumberland County,136,0,136
13,Georgia,34,New Jersey,13,Essex County,617,818,-201
13,Georgia,34,New Jersey,15,Gloucester County,40,69,-29
13,Georgia,34,New Jersey,17,Hudson County,607,140,467
13,Georgia,34,New Jersey,19,Hunterdon County,78,6,72
13,Georgia,34,New Jersey,21,Mercer County,338,261,77
13,Georgia,34,New Jersey,23,Middlesex County,1046,531,515
13,Georgia,34,New Jersey,25,Monmouth County,212,101,111
13,Georgia,34,New Jersey,27,Morris County,210,155,55
13,Georgia,34,New Jersey,29,Ocean County,358,101,257
13,Georgia,34,New Jersey,31,Passaic County,425,82,343
13,Georgia,34,New Jersey,33,Salem County,2,15,-13
13,Georgia,34,New Jersey,35,Somerset County,252,178,74
13,Georgia,34,New Jersey,37,Sussex County,27,0,27
13,Georgia,34,New Jersey,39,Union County,318,107,211
13,Georgia,34,New Jersey,41,Warren County,2,0,2
13,Georgia,35,New Mexico,1,Bernalillo County,682,273,409
13,Georgia,35,New Mexico,5,Chaves County,17,86,-69
13,Georgia,35,New Mexico,6,Cibola County,2,0,2
13,Georgia,35,New Mexico,9,Curry County,30,51,-21
13,Georgia,35,New Mexico,11,De Baca County,0,1,-1
13,Georgia,35,New Mexico,13,Doña Ana County,130,90,40
13,Georgia,35,New Mexico,21,Harding County,99,0,99
13,Georgia,35,New Mexico,28,Los Alamos County,10,0,10
13,Georgia,35,New Mexico,31,McKinley County,0,3,-3
13,Georgia,35,New Mexico,35,Otero County,125,49,76
13,Georgia,35,New Mexico,41,Roosevelt County,0,82,-82
13,Georgia,35,New Mexico,43,Sandoval County,87,10,77
13,Georgia,35,New Mexico,45,San Juan County,91,29,62
13,Georgia,35,New Mexico,49,Santa Fe County,93,78,15
13,Georgia,35,New Mexico,51,Sierra County,7,0,7
13,Georgia,35,New Mexico,53,Socorro County,8,0,8
13,Georgia,35,New Mexico,61,Valencia County,2,30,-28
13,Georgia,36,New York,1,Albany County,216,76,140
13,Georgia,36,New York,3,Allegany County,34,23,11
13,Georgia,36,New York,5,Bronx County,894,417,477
13,Georgia,36,New York,7,Broome County,110,118,-8
13,Georgia,36,New York,9,Cattaraugus County,0,90,-90
13,Georgia,36,New York,11,Cayuga County,54,10,44
13,Georgia,36,New York,13,Chautauqua County,46,36,10
13,Georgia,36,New York,15,Chemung County,8,35,-27
13,Georgia,36,New York,17,Chenango County,38,0,38
13,Georgia,36,New York,19,Clinton County,27,19,8
13,Georgia,36,New York,21,Columbia County,45,53,-8
13,Georgia,36,New York,23,Cortland County,19,43,-24
13,Georgia,36,New York,25,Delaware County,15,10,5
13,Georgia,36,New York,27,Dutchess County,117,43,74
13,Georgia,36,New York,29,Erie County,619,321,298
13,Georgia,36,New York,35,Fulton County,194,24,170
13,Georgia,36,New York,37,Genesee County,3,0,3
13,Georgia,36,New York,39,Greene County,11,0,11
13,Georgia,36,New York,43,Herkimer County,58,63,-5
13,Georgia,36,New York,45,Jefferson County,604,648,-44
13,Georgia,36,New York,47,Kings County,3348,1083,2265
13,Georgia,36,New York,49,Lewis County,2,28,-26
13,Georgia,36,New York,51,Livingston County,0,31,-31
13,Georgia,36,New York,53,Madison County,84,31,53
13,Georgia,36,New York,55,Monroe County,559,386,173
13,Georgia,36,New York,57,Montgomery County,8,0,8
13,Georgia,36,New York,59,Nassau County,1074,160,914
13,Georgia,36,New York,61,New York County,2000,1274,726
13,Georgia,36,New York,63,Niagara County,121,61,60
13,Georgia,36,New York,65,Oneida County,204,91,113
13,Georgia,36,New York,67,Onondaga County,592,178,414
13,Georgia,36,New York,69,Ontario County,374,163,211
13,Georgia,36,New York,71,Orange County,500,87,413
13,Georgia,36,New York,73,Orleans County,9,2,7
13,Georgia,36,New York,75,Oswego County,30,19,11
13,Georgia,36,New York,77,Otsego County,144,37,107
13,Georgia,36,New York,79,Putnam County,64,39,25
13,Georgia,36,New York,81,Queens County,1561,596,965
13,Georgia,36,New York,83,Rensselaer County,32,117,-85
13,Georgia,36,New York,85,Richmond County,515,35,480
13,Georgia,36,New York,87,Rockland County,175,59,116
13,Georgia,36,New York,89,St. Lawrence County,0,5,-5
13,Georgia,36,New York,91,Saratoga County,180,38,142
13,Georgia,36,New York,93,Schenectady County,16,158,-142
13,Georgia,36,New York,95,Schoharie County,11,13,-2
13,Georgia,36,New York,101,Steuben County,337,7,330
13,Georgia,36,New York,103,Suffolk County,715,219,496
13,Georgia,36,New York,105,Sullivan County,21,0,21
13,Georgia,36,New York,107,Tioga County,28,11,17
13,Georgia,36,New York,109,Tompkins County,57,190,-133
13,Georgia,36,New York,111,Ulster County,20,53,-33
13,Georgia,36,New York,115,Washington County,40,29,11
13,Georgia,36,New York,117,Wayne County,40,107,-67
13,Georgia,36,New York,119,Westchester County,717,162,555
13,Georgia,36,New York,121,Wyoming County,59,0,59
13,Georgia,37,North Carolina,1,Alamance County,181,164,17
13,Georgia,37,North Carolina,3,Alexander County,83,22,61
13,Georgia,37,North Carolina,7,Anson County,0,17,-17
13,Georgia,37,North Carolina,9,Ashe County,0,22,-22
13,Georgia,37,North Carolina,11,Avery County,0,93,-93
13,Georgia,37,North Carolina,13,Beaufort County,18,70,-52
13,Georgia,37,North Carolina,15,Bertie County,0,1,-1
13,Georgia,37,North Carolina,17,Bladen County,0,60,-60
13,Georgia,37,North Carolina,19,Brunswick County,127,78,49
13,Georgia,37,North Carolina,21,Buncombe County,680,589,91
13,Georgia,37,North Carolina,23,Burke County,0,113,-113
13,Georgia,37,North Carolina,25,Cabarrus County,170,450,-280
13,Georgia,37,North Carolina,27,Caldwell County,9,73,-64
13,Georgia,37,North Carolina,29,Camden County,2,0,2
13,Georgia,37,North Carolina,31,Carteret County,46,120,-74
13,Georgia,37,North Carolina,33,Caswell County,0,49,-49
13,Georgia,37,North Carolina,35,Catawba County,104,438,-334
13,Georgia,37,North Carolina,37,Chatham County,0,17,-17
13,Georgia,37,North Carolina,39,Cherokee County,148,223,-75
13,Georgia,37,North Carolina,41,Chowan County,0,17,-17
13,Georgia,37,North Carolina,43,Clay County,132,172,-40
13,Georgia,37,North Carolina,45,Cleveland County,44,104,-60
13,Georgia,37,North Carolina,47,Columbus County,59,68,-9
13,Georgia,37,North Carolina,49,Craven County,422,213,209
13,Georgia,37,North Carolina,51,Cumberland County,1871,1947,-76
13,Georgia,37,North Carolina,53,Currituck County,60,33,27
13,Georgia,37,North Carolina,55,Dare County,0,1,-1
13,Georgia,37,North Carolina,57,Davidson County,46,239,-193
13,Georgia,37,North Carolina,61,Duplin County,29,3,26
13,Georgia,37,North Carolina,63,Durham County,444,447,-3
13,Georgia,37,North Carolina,65,Edgecombe County,0,56,-56
13,Georgia,37,North Carolina,67,Forsyth County,563,687,-124
13,Georgia,37,North Carolina,69,Franklin County,0,76,-76
13,Georgia,37,North Carolina,71,Gaston County,21,243,-222
13,Georgia,37,North Carolina,73,Gates County,0,7,-7
13,Georgia,37,North Carolina,75,Graham County,0,3,-3
13,Georgia,37,North Carolina,77,Granville County,7,120,-113
13,Georgia,37,North Carolina,79,Greene County,0,44,-44
13,Georgia,37,North Carolina,81,Guilford County,1398,470,928
13,Georgia,37,North Carolina,83,Halifax County,0,35,-35
13,Georgia,37,North Carolina,85,Harnett County,97,759,-662
13,Georgia,37,North Carolina,87,Haywood County,76,127,-51
13,Georgia,37,North Carolina,89,Henderson County,73,392,-319
13,Georgia,37,North Carolina,91,Hertford County,0,11,-11
13,Georgia,37,North Carolina,93,Hoke County,218,206,12
13,Georgia,37,North Carolina,97,Iredell County,183,279,-96
13,Georgia,37,North Carolina,99,Jackson County,90,122,-32
13,Georgia,37,North Carolina,101,Johnston County,127,89,38
13,Georgia,37,North Carolina,103,Jones County,0,34,-34
13,Georgia,37,North Carolina,105,Lee County,196,49,147
13,Georgia,37,North Carolina,107,Lenoir County,63,98,-35
13,Georgia,37,North Carolina,109,Lincoln County,70,143,-73
13,Georgia,37,North Carolina,111,McDowell County,27,0,27
13,Georgia,37,North Carolina,113,Macon County,170,354,-184
13,Georgia,37,North Carolina,115,Madison County,5,14,-9
13,Georgia,37,North Carolina,117,Martin County,0,2,-2
13,Georgia,37,North Carolina,119,Mecklenburg County,2451,3145,-694
13,Georgia,37,North Carolina,121,Mitchell County,16,0,16
13,Georgia,37,North Carolina,123,Montgomery County,0,5,-5
13,Georgia,37,North Carolina,125,Moore County,181,90,91
13,Georgia,37,North Carolina,127,Nash County,308,125,183
13,Georgia,37,North Carolina,129,New Hanover County,412,115,297
13,Georgia,37,North Carolina,131,Northampton County,0,6,-6
13,Georgia,37,North Carolina,133,Onslow County,987,1124,-137
13,Georgia,37,North Carolina,135,Orange County,538,170,368
13,Georgia,37,North Carolina,137,Pamlico County,0,6,-6
13,Georgia,37,North Carolina,139,Pasquotank County,0,14,-14
13,Georgia,37,North Carolina,141,Pender County,0,55,-55
13,Georgia,37,North Carolina,145,Person County,6,5,1
13,Georgia,37,North Carolina,147,Pitt County,21,512,-491
13,Georgia,37,North Carolina,149,Polk County,8,41,-33
13,Georgia,37,North Carolina,151,Randolph County,48,57,-9
13,Georgia,37,North Carolina,153,Richmond County,48,2,46
13,Georgia,37,North Carolina,155,Robeson County,13,46,-33
13,Georgia,37,North Carolina,157,Rockingham County,30,121,-91
13,Georgia,37,North Carolina,159,Rowan County,29,184,-155
13,Georgia,37,North Carolina,161,Rutherford County,10,96,-86
13,Georgia,37,North Carolina,163,Sampson County,0,37,-37
13,Georgia,37,North Carolina,165,Scotland County,0,20,-20
13,Georgia,37,North Carolina,167,Stanly County,21,15,6
13,Georgia,37,North Carolina,169,Stokes County,0,7,-7
13,Georgia,37,North Carolina,171,Surry County,18,21,-3
13,Georgia,37,North Carolina,173,Swain County,0,44,-44
13,Georgia,37,North Carolina,175,Transylvania County,59,154,-95
13,Georgia,37,North Carolina,179,Union County,342,275,67
13,Georgia,37,North Carolina,181,Vance County,90,8,82
13,Georgia,37,North Carolina,183,Wake County,2055,1899,156
13,Georgia,37,North Carolina,185,Warren County,0,27,-27
13,Georgia,37,North Carolina,187,Washington County,39,88,-49
13,Georgia,37,North Carolina,189,Watauga County,33,105,-72
13,Georgia,37,North Carolina,191,Wayne County,253,235,18
13,Georgia,37,North Carolina,193,Wilkes County,23,59,-36
13,Georgia,37,North Carolina,195,Wilson County,16,79,-63
13,Georgia,37,North Carolina,197,Yadkin County,0,9,-9
13,Georgia,37,North Carolina,199,Yancey County,14,20,-6
13,Georgia,38,North Dakota,15,Burleigh County,15,12,3
13,Georgia,38,North Dakota,17,Cass County,18,42,-24
13,Georgia,38,North Dakota,19,Cavalier County,0,8,-8
13,Georgia,38,North Dakota,35,Grand Forks County,0,10,-10
13,Georgia,38,North Dakota,37,Grant County,0,2,-2
13,Georgia,38,North Dakota,43,Kidder County,11,0,11
13,Georgia,38,North Dakota,53,McKenzie County,0,16,-16
13,Georgia,38,North Dakota,59,Morton County,0,2,-2
13,Georgia,38,North Dakota,61,Mountrail County,0,1,-1
13,Georgia,38,North Dakota,67,Pembina County,15,0,15
13,Georgia,38,North Dakota,73,Ransom County,0,2,-2
13,Georgia,38,North Dakota,75,Renville County,0,4,-4
13,Georgia,38,North Dakota,77,Richland County,0,15,-15
13,Georgia,38,North Dakota,89,Stark County,0,21,-21
13,Georgia,38,North Dakota,93,Stutsman County,19,0,19
13,Georgia,38,North Dakota,97,Traill County,0,14,-14
13,Georgia,38,North Dakota,101,Ward County,88,111,-23
13,Georgia,38,North Dakota,105,Williams County,9,41,-32
13,Georgia,39,Ohio,3,Allen County,43,25,18
13,Georgia,39,Ohio,5,Ashland County,24,0,24
13,Georgia,39,Ohio,7,Ashtabula County,0,35,-35
13,Georgia,39,Ohio,9,Athens County,31,96,-65
13,Georgia,39,Ohio,11,Auglaize County,0,7,-7
13,Georgia,39,Ohio,13,Belmont County,118,7,111
13,Georgia,39,Ohio,15,Brown County,71,0,71
13,Georgia,39,Ohio,17,Butler County,223,350,-127
13,Georgia,39,Ohio,19,Carroll County,9,0,9
13,Georgia,39,Ohio,21,Champaign County,9,7,2
13,Georgia,39,Ohio,23,Clark County,34,49,-15
13,Georgia,39,Ohio,25,Clermont County,137,82,55
13,Georgia,39,Ohio,27,Clinton County,24,0,24
13,Georgia,39,Ohio,29,Columbiana County,29,20,9
13,Georgia,39,Ohio,31,Coshocton County,6,0,6
13,Georgia,39,Ohio,33,Crawford County,30,0,30
13,Georgia,39,Ohio,35,Cuyahoga County,1060,756,304
13,Georgia,39,Ohio,37,Darke County,9,74,-65
13,Georgia,39,Ohio,39,Defiance County,35,34,1
13,Georgia,39,Ohio,41,Delaware County,55,43,12
13,Georgia,39,Ohio,43,Erie County,33,19,14
13,Georgia,39,Ohio,45,Fairfield County,95,91,4
13,Georgia,39,Ohio,47,Fayette County,0,34,-34
13,Georgia,39,Ohio,49,Franklin County,1784,525,1259
13,Georgia,39,Ohio,51,Fulton County,15,0,15
13,Georgia,39,Ohio,53,Gallia County,8,0,8
13,Georgia,39,Ohio,55,Geauga County,284,0,284
13,Georgia,39,Ohio,57,Greene County,286,167,119
13,Georgia,39,Ohio,61,Hamilton County,1114,405,709
13,Georgia,39,Ohio,63,Hancock County,21,0,21
13,Georgia,39,Ohio,67,Harrison County,55,0,55
13,Georgia,39,Ohio,77,Huron County,9,0,9
13,Georgia,39,Ohio,81,Jefferson County,0,42,-42
13,Georgia,39,Ohio,85,Lake County,138,43,95
13,Georgia,39,Ohio,87,Lawrence County,13,53,-40
13,Georgia,39,Ohio,89,Licking County,228,0,228
13,Georgia,39,Ohio,93,Lorain County,169,146,23
13,Georgia,39,Ohio,95,Lucas County,150,210,-60
13,Georgia,39,Ohio,97,Madison County,0,24,-24
13,Georgia,39,Ohio,99,Mahoning County,162,27,135
13,Georgia,39,Ohio,101,Marion County,16,0,16
13,Georgia,39,Ohio,103,Medina County,33,41,-8
13,Georgia,39,Ohio,105,Meigs County,0,1,-1
13,Georgia,39,Ohio,107,Mercer County,0,2,-2
13,Georgia,39,Ohio,109,Miami County,46,45,1
13,Georgia,39,Ohio,113,Montgomery County,651,348,303
13,Georgia,39,Ohio,119,Muskingum County,8,13,-5
13,Georgia,39,Ohio,121,Noble County,0,7,-7
13,Georgia,39,Ohio,129,Pickaway County,23,64,-41
13,Georgia,39,Ohio,133,Portage County,59,39,20
13,Georgia,39,Ohio,139,Richland County,200,22,178
13,Georgia,39,Ohio,141,Ross County,9,8,1
13,Georgia,39,Ohio,143,Sandusky County,0,26,-26
13,Georgia,39,Ohio,145,Scioto County,48,32,16
13,Georgia,39,Ohio,147,Seneca County,0,24,-24
13,Georgia,39,Ohio,151,Stark County,61,83,-22
13,Georgia,39,Ohio,153,Summit County,303,199,104
13,Georgia,39,Ohio,155,Trumbull County,57,61,-4
13,Georgia,39,Ohio,157,Tuscarawas County,40,12,28
13,Georgia,39,Ohio,159,Union County,0,11,-11
13,Georgia,39,Ohio,161,Van Wert County,9,0,9
13,Georgia,39,Ohio,163,Vinton County,0,6,-6
13,Georgia,39,Ohio,165,Warren County,337,50,287
13,Georgia,39,Ohio,167,Washington County,142,45,97
13,Georgia,39,Ohio,169,Wayne County,69,46,23
13,Georgia,39,Ohio,171,Williams County,13,0,13
13,Georgia,39,Ohio,173,Wood County,230,102,128
13,Georgia,4,Arizona,3,Cochise County,608,318,290
13,Georgia,4,Arizona,5,Coconino County,128,80,48
13,Georgia,4,Arizona,12,La Paz County,0,11,-11
13,Georgia,4,Arizona,13,Maricopa County,2348,2403,-55
13,Georgia,4,Arizona,15,Mohave County,20,127,-107
13,Georgia,4,Arizona,17,Navajo County,50,20,30
13,Georgia,4,Arizona,19,Pima County,739,717,22
13,Georgia,4,Arizona,21,Pinal County,365,47,318
13,Georgia,4,Arizona,25,Yavapai County,65,16,49
13,Georgia,4,Arizona,27,Yuma County,102,53,49
13,Georgia,40,Oklahoma,1,Adair County,3,0,3
13,Georgia,40,Oklahoma,3,Alfalfa County,0,13,-13
13,Georgia,40,Oklahoma,5,Atoka County,0,1,-1
13,Georgia,40,Oklahoma,11,Blaine County,8,16,-8
13,Georgia,40,Oklahoma,13,Bryan County,18,0,18
13,Georgia,40,Oklahoma,15,Caddo County,0,20,-20
13,Georgia,40,Oklahoma,17,Canadian County,34,170,-136
13,Georgia,40,Oklahoma,19,Carter County,33,0,33
13,Georgia,40,Oklahoma,21,Cherokee County,0,34,-34
13,Georgia,40,Oklahoma,27,Cleveland County,191,206,-15
13,Georgia,40,Oklahoma,31,Comanche County,420,606,-186
13,Georgia,40,Oklahoma,33,Cotton County,0,12,-12
13,Georgia,40,Oklahoma,35,Craig County,0,1,-1
13,Georgia,40,Oklahoma,37,Creek County,40,0,40
13,Georgia,40,Oklahoma,41,Delaware County,76,0,76
13,Georgia,40,Oklahoma,47,Garfield County,58,82,-24
13,Georgia,40,Oklahoma,51,Grady County,59,71,-12
13,Georgia,40,Oklahoma,61,Haskell County,0,1,-1
13,Georgia,40,Oklahoma,65,Jackson County,0,12,-12
13,Georgia,40,Oklahoma,71,Kay County,5,34,-29
13,Georgia,40,Oklahoma,81,Lincoln County,8,0,8
13,Georgia,40,Oklahoma,83,Logan County,75,25,50
13,Georgia,40,Oklahoma,85,Love County,8,0,8
13,Georgia,40,Oklahoma,87,McClain County,9,0,9
13,Georgia,40,Oklahoma,97,Mayes County,0,5,-5
13,Georgia,40,Oklahoma,101,Muskogee County,69,24,45
13,Georgia,40,Oklahoma,109,Oklahoma County,515,449,66
13,Georgia,40,Oklahoma,115,Ottawa County,6,18,-12
13,Georgia,40,Oklahoma,119,Payne County,71,17,54
13,Georgia,40,Oklahoma,121,Pittsburg County,63,41,22
13,Georgia,40,Oklahoma,123,Pontotoc County,8,0,8
13,Georgia,40,Oklahoma,125,Pottawatomie County,26,0,26
13,Georgia,40,Oklahoma,129,Roger Mills County,21,0,21
13,Georgia,40,Oklahoma,131,Rogers County,59,0,59
13,Georgia,40,Oklahoma,133,Seminole County,0,1,-1
13,Georgia,40,Oklahoma,135,Sequoyah County,0,69,-69
13,Georgia,40,Oklahoma,137,Stephens County,5,16,-11
13,Georgia,40,Oklahoma,143,Tulsa County,134,316,-182
13,Georgia,40,Oklahoma,145,Wagoner County,0,81,-81
13,Georgia,40,Oklahoma,147,Washington County,22,25,-3
13,Georgia,40,Oklahoma,149,Washita County,15,0,15
13,Georgia,41,Oregon,3,Benton County,0,33,-33
13,Georgia,41,Oregon,5,Clackamas County,112,65,47
13,Georgia,41,Oregon,7,Clatsop County,54,7,47
13,Georgia,41,Oregon,11,Coos County,0,31,-31
13,Georgia,41,Oregon,17,Deschutes County,0,76,-76
13,Georgia,41,Oregon,19,Douglas County,0,7,-7
13,Georgia,41,Oregon,27,Hood River County,18,7,11
13,Georgia,41,Oregon,29,Jackson County,110,0,110
13,Georgia,41,Oregon,33,Josephine County,17,13,4
13,Georgia,41,Oregon,35,Klamath County,0,2,-2
13,Georgia,41,Oregon,37,Lake County,10,0,10
13,Georgia,41,Oregon,39,Lane County,139,72,67
13,Georgia,41,Oregon,41,Lincoln County,0,27,-27
13,Georgia,41,Oregon,43,Linn County,0,9,-9
13,Georgia,41,Oregon,47,Marion County,43,95,-52
13,Georgia,41,Oregon,51,Multnomah County,237,260,-23
13,Georgia,41,Oregon,67,Washington County,151,255,-104
13,Georgia,41,Oregon,71,Yamhill County,67,37,30
13,Georgia,42,Pennsylvania,1,Adams County,23,15,8
13,Georgia,42,Pennsylvania,3,Allegheny County,836,852,-16
13,Georgia,42,Pennsylvania,5,Armstrong County,193,15,178
13,Georgia,42,Pennsylvania,7,Beaver County,49,133,-84
13,Georgia,42,Pennsylvania,9,Bedford County,0,1,-1
13,Georgia,42,Pennsylvania,11,Berks County,381,168,213
13,Georgia,42,Pennsylvania,13,Blair County,96,5,91
13,Georgia,42,Pennsylvania,17,Bucks County,41,356,-315
13,Georgia,42,Pennsylvania,19,Butler County,115,109,6
13,Georgia,42,Pennsylvania,21,Cambria County,4,51,-47
13,Georgia,42,Pennsylvania,25,Carbon County,0,37,-37
13,Georgia,42,Pennsylvania,27,Centre County,36,221,-185
13,Georgia,42,Pennsylvania,29,Chester County,275,239,36
13,Georgia,42,Pennsylvania,31,Clarion County,28,0,28
13,Georgia,42,Pennsylvania,33,Clearfield County,152,17,135
13,Georgia,42,Pennsylvania,35,Clinton County,0,2,-2
13,Georgia,42,Pennsylvania,37,Columbia County,34,53,-19
13,Georgia,42,Pennsylvania,39,Crawford County,0,8,-8
13,Georgia,42,Pennsylvania,41,Cumberland County,428,36,392
13,Georgia,42,Pennsylvania,43,Dauphin County,355,259,96
13,Georgia,42,Pennsylvania,45,Delaware County,121,140,-19
13,Georgia,42,Pennsylvania,49,Erie County,191,144,47
13,Georgia,42,Pennsylvania,51,Fayette County,14,29,-15
13,Georgia,42,Pennsylvania,55,Franklin County,0,182,-182
13,Georgia,42,Pennsylvania,61,Huntingdon County,66,2,64
13,Georgia,42,Pennsylvania,63,Indiana County,14,78,-64
13,Georgia,42,Pennsylvania,67,Juniata County,22,0,22
13,Georgia,42,Pennsylvania,69,Lackawanna County,105,21,84
13,Georgia,42,Pennsylvania,71,Lancaster County,158,201,-43
13,Georgia,42,Pennsylvania,73,Lawrence County,15,49,-34
13,Georgia,42,Pennsylvania,75,Lebanon County,38,42,-4
13,Georgia,42,Pennsylvania,77,Lehigh County,246,131,115
13,Georgia,42,Pennsylvania,79,Luzerne County,83,134,-51
13,Georgia,42,Pennsylvania,81,Lycoming County,0,9,-9
13,Georgia,42,Pennsylvania,83,McKean County,0,1,-1
13,Georgia,42,Pennsylvania,85,Mercer County,25,29,-4
13,Georgia,42,Pennsylvania,89,Monroe County,192,25,167
13,Georgia,42,Pennsylvania,91,Montgomery County,273,384,-111
13,Georgia,42,Pennsylvania,95,Northampton County,72,89,-17
13,Georgia,42,Pennsylvania,97,Northumberland County,19,0,19
13,Georgia,42,Pennsylvania,99,Perry County,23,7,16
13,Georgia,42,Pennsylvania,101,Philadelphia County,1971,608,1363
13,Georgia,42,Pennsylvania,103,Pike County,53,0,53
13,Georgia,42,Pennsylvania,107,Schuylkill County,13,10,3
13,Georgia,42,Pennsylvania,109,Snyder County,0,4,-4
13,Georgia,42,Pennsylvania,111,Somerset County,40,9,31
13,Georgia,42,Pennsylvania,113,Sullivan County,0,12,-12
13,Georgia,42,Pennsylvania,115,Susquehanna County,20,7,13
13,Georgia,42,Pennsylvania,117,Tioga County,14,7,7
13,Georgia,42,Pennsylvania,119,Union County,0,44,-44
13,Georgia,42,Pennsylvania,121,Venango County,83,7,76
13,Georgia,42,Pennsylvania,125,Washington County,37,68,-31
13,Georgia,42,Pennsylvania,127,Wayne County,12,0,12
13,Georgia,42,Pennsylvania,129,Westmoreland County,52,285,-233
13,Georgia,42,Pennsylvania,133,York County,106,135,-29
13,Georgia,44,Rhode Island,1,Bristol County,17,67,-50
13,Georgia,44,Rhode Island,3,Kent County,30,30,0
13,Georgia,44,Rhode Island,5,Newport County,75,350,-275
13,Georgia,44,Rhode Island,7,Providence County,323,266,57
13,Georgia,44,Rhode Island,9,Washington County,32,6,26
13,Georgia,45,South Carolina,1,Abbeville County,0,179,-179
13,Georgia,45,South Carolina,3,Aiken County,1423,1716,-293
13,Georgia,45,South Carolina,5,Allendale County,0,5,-5
13,Georgia,45,South Carolina,7,Anderson County,342,631,-289
13,Georgia,45,South Carolina,9,Bamberg County,0,143,-143
13,Georgia,45,South Carolina,11,Barnwell County,193,80,113
13,Georgia,45,South Carolina,13,Beaufort County,1069,1364,-295
13,Georgia,45,South Carolina,15,Berkeley County,628,864,-236
13,Georgia,45,South Carolina,17,Calhoun County,0,35,-35
13,Georgia,45,South Carolina,19,Charleston County,2100,1141,959
13,Georgia,45,South Carolina,21,Cherokee County,0,78,-78
13,Georgia,45,South Carolina,23,Chester County,48,0,48
13,Georgia,45,South Carolina,25,Chesterfield County,294,37,257
13,Georgia,45,South Carolina,27,Clarendon County,23,63,-40
13,Georgia,45,South Carolina,29,Colleton County,144,153,-9
13,Georgia,45,South Carolina,31,Darlington County,31,43,-12
13,Georgia,45,South Carolina,33,Dillon County,0,124,-124
13,Georgia,45,South Carolina,35,Dorchester County,738,330,408
13,Georgia,45,South Carolina,37,Edgefield County,76,199,-123
13,Georgia,45,South Carolina,39,Fairfield County,6,0,6
13,Georgia,45,South Carolina,41,Florence County,373,99,274
13,Georgia,45,South Carolina,43,Georgetown County,139,107,32
13,Georgia,45,South Carolina,45,Greenville County,1074,1173,-99
13,Georgia,45,South Carolina,47,Greenwood County,48,153,-105
13,Georgia,45,South Carolina,49,Hampton County,30,169,-139
13,Georgia,45,South Carolina,51,Horry County,1210,331,879
13,Georgia,45,South Carolina,53,Jasper County,246,248,-2
13,Georgia,45,South Carolina,55,Kershaw County,40,17,23
13,Georgia,45,South Carolina,57,Lancaster County,34,109,-75
13,Georgia,45,South Carolina,59,Laurens County,160,65,95
13,Georgia,45,South Carolina,61,Lee County,17,11,6
13,Georgia,45,South Carolina,63,Lexington County,744,592,152
13,Georgia,45,South Carolina,65,McCormick County,89,99,-10
13,Georgia,45,South Carolina,69,Marlboro County,52,32,20
13,Georgia,45,South Carolina,71,Newberry County,24,71,-47
13,Georgia,45,South Carolina,73,Oconee County,151,294,-143
13,Georgia,45,South Carolina,75,Orangeburg County,285,81,204
13,Georgia,45,South Carolina,77,Pickens County,373,743,-370
13,Georgia,45,South Carolina,79,Richland County,1772,2008,-236
13,Georgia,45,South Carolina,81,Saluda County,14,75,-61
13,Georgia,45,South Carolina,83,Spartanburg County,357,836,-479
13,Georgia,45,South Carolina,85,Sumter County,419,180,239
13,Georgia,45,South Carolina,87,Union County,0,2,-2
13,Georgia,45,South Carolina,89,Williamsburg County,11,23,-12
13,Georgia,45,South Carolina,91,York County,429,570,-141
13,Georgia,46,South Dakota,5,Beadle County,0,7,-7
13,Georgia,46,South Dakota,27,Clay County,0,20,-20
13,Georgia,46,South Dakota,47,Fall River County,0,18,-18
13,Georgia,46,South Dakota,65,Hughes County,3,0,3
13,Georgia,46,South Dakota,81,Lawrence County,0,5,-5
13,Georgia,46,South Dakota,83,Lincoln County,50,0,50
13,Georgia,46,South Dakota,87,McCook County,0,14,-14
13,Georgia,46,South Dakota,93,Meade County,0,58,-58
13,Georgia,46,South Dakota,99,Minnehaha County,36,14,22
13,Georgia,46,South Dakota,103,Pennington County,58,71,-13
13,Georgia,46,South Dakota,115,Spink County,18,0,18
13,Georgia,46,South Dakota,125,Turner County,0,6,-6
13,Georgia,46,South Dakota,135,Yankton County,20,0,20
13,Georgia,47,Tennessee,1,Anderson County,66,43,23
13,Georgia,47,Tennessee,3,Bedford County,5,0,5
13,Georgia,47,Tennessee,5,Benton County,0,5,-5
13,Georgia,47,Tennessee,7,Bledsoe County,11,79,-68
13,Georgia,47,Tennessee,9,Blount County,140,36,104
13,Georgia,47,Tennessee,11,Bradley County,519,610,-91
13,Georgia,47,Tennessee,13,Campbell County,0,104,-104
13,Georgia,47,Tennessee,15,Cannon County,16,0,16
13,Georgia,47,Tennessee,19,Carter County,73,26,47
13,Georgia,47,Tennessee,21,Cheatham County,32,0,32
13,Georgia,47,Tennessee,23,Chester County,0,35,-35
13,Georgia,47,Tennessee,25,Claiborne County,31,42,-11
13,Georgia,47,Tennessee,27,Clay County,62,0,62
13,Georgia,47,Tennessee,29,Cocke County,20,0,20
13,Georgia,47,Tennessee,31,Coffee County,168,71,97
13,Georgia,47,Tennessee,35,Cumberland County,39,177,-138
13,Georgia,47,Tennessee,37,Davidson County,1505,2543,-1038
13,Georgia,47,Tennessee,39,Decatur County,5,15,-10
13,Georgia,47,Tennessee,41,DeKalb County,0,22,-22
13,Georgia,47,Tennessee,43,Dickson County,0,1,-1
13,Georgia,47,Tennessee,47,Fayette County,36,0,36
13,Georgia,47,Tennessee,49,Fentress County,135,0,135
13,Georgia,47,Tennessee,51,Franklin County,33,106,-73
13,Georgia,47,Tennessee,55,Giles County,123,65,58
13,Georgia,47,Tennessee,57,Grainger County,7,2,5
13,Georgia,47,Tennessee,59,Greene County,96,72,24
13,Georgia,47,Tennessee,61,Grundy County,24,0,24
13,Georgia,47,Tennessee,63,Hamblen County,191,107,84
13,Georgia,47,Tennessee,65,Hamilton County,4693,3235,1458
13,Georgia,47,Tennessee,69,Hardeman County,35,0,35
13,Georgia,47,Tennessee,71,Hardin County,39,0,39
13,Georgia,47,Tennessee,73,Hawkins County,10,48,-38
13,Georgia,47,Tennessee,77,Henderson County,44,3,41
13,Georgia,47,Tennessee,79,Henry County,49,17,32
13,Georgia,47,Tennessee,81,Hickman County,0,44,-44
13,Georgia,47,Tennessee,83,Houston County,0,17,-17
13,Georgia,47,Tennessee,85,Humphreys County,125,23,102
13,Georgia,47,Tennessee,87,Jackson County,47,16,31
13,Georgia,47,Tennessee,89,Jefferson County,0,224,-224
13,Georgia,47,Tennessee,91,Johnson County,2,178,-176
13,Georgia,47,Tennessee,93,Knox County,1593,1107,486
13,Georgia,47,Tennessee,99,Lawrence County,0,13,-13
13,Georgia,47,Tennessee,101,Lewis County,0,6,-6
13,Georgia,47,Tennessee,103,Lincoln County,137,4,133
13,Georgia,47,Tennessee,105,Loudon County,59,37,22
13,Georgia,47,Tennessee,107,McMinn County,65,90,-25
13,Georgia,47,Tennessee,109,McNairy County,26,115,-89
13,Georgia,47,Tennessee,113,Madison County,182,61,121
13,Georgia,47,Tennessee,115,Marion County,139,177,-38
13,Georgia,47,Tennessee,119,Maury County,169,111,58
13,Georgia,47,Tennessee,121,Meigs County,56,6,50
13,Georgia,47,Tennessee,123,Monroe County,45,329,-284
13,Georgia,47,Tennessee,125,Montgomery County,1450,1299,151
13,Georgia,47,Tennessee,127,Moore County,0,24,-24
13,Georgia,47,Tennessee,129,Morgan County,0,2,-2
13,Georgia,47,Tennessee,131,Obion County,3,0,3
13,Georgia,47,Tennessee,133,Overton County,0,19,-19
13,Georgia,47,Tennessee,135,Perry County,5,3,2
13,Georgia,47,Tennessee,139,Polk County,144,166,-22
13,Georgia,47,Tennessee,141,Putnam County,2,136,-134
13,Georgia,47,Tennessee,143,Rhea County,238,91,147
13,Georgia,47,Tennessee,145,Roane County,35,30,5
13,Georgia,47,Tennessee,147,Robertson County,64,195,-131
13,Georgia,47,Tennessee,149,Rutherford County,420,848,-428
13,Georgia,47,Tennessee,151,Scott County,35,0,35
13,Georgia,47,Tennessee,153,Sequatchie County,7,0,7
13,Georgia,47,Tennessee,155,Sevier County,121,418,-297
13,Georgia,47,Tennessee,157,Shelby County,2199,1027,1172
13,Georgia,47,Tennessee,159,Smith County,30,0,30
13,Georgia,47,Tennessee,161,Stewart County,0,11,-11
13,Georgia,47,Tennessee,163,Sullivan County,261,275,-14
13,Georgia,47,Tennessee,165,Sumner County,161,171,-10
13,Georgia,47,Tennessee,167,Tipton County,42,21,21
13,Georgia,47,Tennessee,177,Warren County,0,7,-7
13,Georgia,47,Tennessee,179,Washington County,347,366,-19
13,Georgia,47,Tennessee,183,Weakley County,40,14,26
13,Georgia,47,Tennessee,185,White County,33,5,28
13,Georgia,47,Tennessee,187,Williamson County,433,470,-37
13,Georgia,47,Tennessee,189,Wilson County,174,40,134
13,Georgia,48,Texas,5,Angelina County,18,0,18
13,Georgia,48,Texas,17,Bailey County,0,15,-15
13,Georgia,48,Texas,19,Bandera County,14,0,14
13,Georgia,48,Texas,21,Bastrop County,0,82,-82
13,Georgia,48,Texas,25,Bee County,17,0,17
13,Georgia,48,Texas,27,Bell County,1203,1737,-534
13,Georgia,48,Texas,29,Bexar County,1269,2211,-942
13,Georgia,48,Texas,31,Blanco County,0,6,-6
13,Georgia,48,Texas,37,Bowie County,27,19,8
13,Georgia,48,Texas,39,Brazoria County,222,42,180
13,Georgia,48,Texas,41,Brazos County,167,96,71
13,Georgia,48,Texas,43,Brewster County,10,0,10
13,Georgia,48,Texas,53,Burnet County,6,0,6
13,Georgia,48,Texas,61,Cameron County,93,62,31
13,Georgia,48,Texas,67,Cass County,2,27,-25
13,Georgia,48,Texas,71,Chambers County,16,0,16
13,Georgia,48,Texas,73,Cherokee County,3,0,3
13,Georgia,48,Texas,75,Childress County,7,0,7
13,Georgia,48,Texas,85,Collin County,511,954,-443
13,Georgia,48,Texas,89,Colorado County,0,11,-11
13,Georgia,48,Texas,91,Comal County,15,2,13
13,Georgia,48,Texas,95,Concho County,35,0,35
13,Georgia,48,Texas,97,Cooke County,6,0,6
13,Georgia,48,Texas,99,Coryell County,298,519,-221
13,Georgia,48,Texas,111,Dallam County,0,5,-5
13,Georgia,48,Texas,113,Dallas County,1907,2167,-260
13,Georgia,48,Texas,121,Denton County,541,733,-192
13,Georgia,48,Texas,123,DeWitt County,97,0,97
13,Georgia,48,Texas,135,Ector County,174,16,158
13,Georgia,48,Texas,139,Ellis County,16,18,-2
13,Georgia,48,Texas,141,El Paso County,1228,684,544
13,Georgia,48,Texas,143,Erath County,543,0,543
13,Georgia,48,Texas,147,Fannin County,17,0,17
13,Georgia,48,Texas,157,Fort Bend County,151,224,-73
13,Georgia,48,Texas,161,Freestone County,0,18,-18
13,Georgia,48,Texas,165,Gaines County,0,148,-148
13,Georgia,48,Texas,167,Galveston County,57,268,-211
13,Georgia,48,Texas,169,Garza County,0,61,-61
13,Georgia,48,Texas,171,Gillespie County,0,59,-59
13,Georgia,48,Texas,175,Goliad County,0,4,-4
13,Georgia,48,Texas,179,Gray County,6,0,6
13,Georgia,48,Texas,181,Grayson County,3,18,-15
13,Georgia,48,Texas,183,Gregg County,70,73,-3
13,Georgia,48,Texas,185,Grimes County,72,0,72
13,Georgia,48,Texas,187,Guadalupe County,36,178,-142
13,Georgia,48,Texas,189,Hale County,76,0,76
13,Georgia,48,Texas,193,Hamilton County,18,0,18
13,Georgia,48,Texas,201,Harris County,2265,2282,-17
13,Georgia,48,Texas,203,Harrison County,2,0,2
13,Georgia,48,Texas,209,Hays County,348,28,320
13,Georgia,48,Texas,211,Hemphill County,0,18,-18
13,Georgia,48,Texas,213,Henderson County,72,239,-167
13,Georgia,48,Texas,215,Hidalgo County,97,290,-193
13,Georgia,48,Texas,217,Hill County,9,0,9
13,Georgia,48,Texas,219,Hockley County,0,54,-54
13,Georgia,48,Texas,221,Hood County,0,18,-18
13,Georgia,48,Texas,223,Hopkins County,56,0,56
13,Georgia,48,Texas,225,Houston County,0,6,-6
13,Georgia,48,Texas,227,Howard County,0,16,-16
13,Georgia,48,Texas,231,Hunt County,1,75,-74
13,Georgia,48,Texas,243,Jeff Davis County,0,4,-4
13,Georgia,48,Texas,245,Jefferson County,76,69,7
13,Georgia,48,Texas,251,Johnson County,0,52,-52
13,Georgia,48,Texas,253,Jones County,67,0,67
13,Georgia,48,Texas,255,Karnes County,27,10,17
13,Georgia,48,Texas,257,Kaufman County,10,172,-162
13,Georgia,48,Texas,259,Kendall County,82,0,82
13,Georgia,48,Texas,273,Kleberg County,0,8,-8
13,Georgia,48,Texas,281,Lampasas County,73,0,73
13,Georgia,48,Texas,287,Lee County,12,0,12
13,Georgia,48,Texas,291,Liberty County,0,31,-31
13,Georgia,48,Texas,297,Live Oak County,22,0,22
13,Georgia,48,Texas,299,Llano County,0,67,-67
13,Georgia,48,Texas,303,Lubbock County,488,141,347
13,Georgia,48,Texas,305,Lynn County,50,0,50
13,Georgia,48,Texas,309,McLennan County,44,62,-18
13,Georgia,48,Texas,323,Maverick County,33,6,27
13,Georgia,48,Texas,325,Medina County,0,6,-6
13,Georgia,48,Texas,329,Midland County,77,0,77
13,Georgia,48,Texas,331,Milam County,0,3,-3
13,Georgia,48,Texas,339,Montgomery County,198,119,79
13,Georgia,48,Texas,347,Nacogdoches County,6,23,-17
13,Georgia,48,Texas,349,Navarro County,0,15,-15
13,Georgia,48,Texas,351,Newton County,0,1,-1
13,Georgia,48,Texas,353,Nolan County,0,4,-4
13,Georgia,48,Texas,355,Nueces County,119,99,20
13,Georgia,48,Texas,357,Ochiltree County,0,13,-13
13,Georgia,48,Texas,361,Orange County,79,16,63
13,Georgia,48,Texas,363,Palo Pinto County,12,0,12
13,Georgia,48,Texas,365,Panola County,21,0,21
13,Georgia,48,Texas,367,Parker County,137,0,137
13,Georgia,48,Texas,375,Potter County,0,186,-186
13,Georgia,48,Texas,381,Randall County,26,49,-23
13,Georgia,48,Texas,387,Red River County,21,0,21
13,Georgia,48,Texas,397,Rockwall County,45,23,22
13,Georgia,48,Texas,407,San Jacinto County,19,0,19
13,Georgia,48,Texas,409,San Patricio County,58,10,48
13,Georgia,48,Texas,419,Shelby County,0,37,-37
13,Georgia,48,Texas,423,Smith County,69,99,-30
13,Georgia,48,Texas,427,Starr County,17,0,17
13,Georgia,48,Texas,439,Tarrant County,1823,1503,320
13,Georgia,48,Texas,441,Taylor County,13,153,-140
13,Georgia,48,Texas,449,Titus County,0,86,-86
13,Georgia,48,Texas,451,Tom Green County,60,200,-140
13,Georgia,48,Texas,453,Travis County,742,894,-152
13,Georgia,48,Texas,455,Trinity County,11,0,11
13,Georgia,48,Texas,457,Tyler County,0,3,-3
13,Georgia,48,Texas,459,Upshur County,2,10,-8
13,Georgia,48,Texas,463,Uvalde County,4,0,4
13,Georgia,48,Texas,465,Val Verde County,65,66,-1
13,Georgia,48,Texas,469,Victoria County,59,9,50
13,Georgia,48,Texas,471,Walker County,22,161,-139
13,Georgia,48,Texas,473,Waller County,25,38,-13
13,Georgia,48,Texas,477,Washington County,38,0,38
13,Georgia,48,Texas,479,Webb County,7,91,-84
13,Georgia,48,Texas,481,Wharton County,0,14,-14
13,Georgia,48,Texas,483,Wheeler County,0,4,-4
13,Georgia,48,Texas,485,Wichita County,39,366,-327
13,Georgia,48,Texas,487,Wilbarger County,33,0,33
13,Georgia,48,Texas,489,Willacy County,143,24,119
13,Georgia,48,Texas,491,Williamson County,385,271,114
13,Georgia,48,Texas,497,Wise County,27,45,-18
13,Georgia,49,Utah,3,Box Elder County,0,1,-1
13,Georgia,49,Utah,5,Cache County,27,10,17
13,Georgia,49,Utah,7,Carbon County,21,0,21
13,Georgia,49,Utah,11,Davis County,287,47,240
13,Georgia,49,Utah,15,Emery County,0,20,-20
13,Georgia,49,Utah,21,Iron County,46,7,39
13,Georgia,49,Utah,31,Piute County,0,1,-1
13,Georgia,49,Utah,35,Salt Lake County,558,784,-226
13,Georgia,49,Utah,37,San Juan County,5,0,5
13,Georgia,49,Utah,43,Summit County,0,83,-83
13,Georgia,49,Utah,45,Tooele County,0,8,-8
13,Georgia,49,Utah,47,Uintah County,16,0,16
13,Georgia,49,Utah,49,Utah County,328,281,47
13,Georgia,49,Utah,51,Wasatch County,0,289,-289
13,Georgia,49,Utah,53,Washington County,71,111,-40
13,Georgia,49,Utah,55,Wayne County,0,2,-2
13,Georgia,49,Utah,57,Weber County,76,96,-20
13,Georgia,5,Arkansas,3,Ashley County,0,10,-10
13,Georgia,5,Arkansas,5,Baxter County,12,40,-28
13,Georgia,5,Arkansas,7,Benton County,327,183,144
13,Georgia,5,Arkansas,9,Boone County,62,79,-17
13,Georgia,5,Arkansas,19,Clark County,0,5,-5
13,Georgia,5,Arkansas,23,Cleburne County,0,110,-110
13,Georgia,5,Arkansas,27,Columbia County,25,0,25
13,Georgia,5,Arkansas,29,Conway County,0,61,-61
13,Georgia,5,Arkansas,31,Craighead County,174,160,14
13,Georgia,5,Arkansas,35,Crittenden County,126,30,96
13,Georgia,5,Arkansas,43,Drew County,11,0,11
13,Georgia,5,Arkansas,45,Faulkner County,59,141,-82
13,Georgia,5,Arkansas,49,Fulton County,33,15,18
13,Georgia,5,Arkansas,51,Garland County,40,220,-180
13,Georgia,5,Arkansas,53,Grant County,15,0,15
13,Georgia,5,Arkansas,69,Jefferson County,19,17,2
13,Georgia,5,Arkansas,77,Lee County,26,0,26
13,Georgia,5,Arkansas,79,Lincoln County,6,0,6
13,Georgia,5,Arkansas,85,Lonoke County,42,0,42
13,Georgia,5,Arkansas,89,Marion County,0,7,-7
13,Georgia,5,Arkansas,93,Mississippi County,48,239,-191
13,Georgia,5,Arkansas,107,Phillips County,11,0,11
13,Georgia,5,Arkansas,111,Poinsett County,0,4,-4
13,Georgia,5,Arkansas,115,Pope County,94,23,71
13,Georgia,5,Arkansas,119,Pulaski County,549,565,-16
13,Georgia,5,Arkansas,121,Randolph County,0,31,-31
13,Georgia,5,Arkansas,123,St. Francis County,11,0,11
13,Georgia,5,Arkansas,125,Saline County,8,0,8
13,Georgia,5,Arkansas,131,Sebastian County,71,205,-134
13,Georgia,5,Arkansas,137,Stone County,1,0,1
13,Georgia,5,Arkansas,139,Union County,34,0,34
13,Georgia,5,Arkansas,143,Washington County,54,279,-225
13,Georgia,5,Arkansas,145,White County,5,58,-53
13,Georgia,5,Arkansas,149,Yell County,3,0,3
13,Georgia,50,Vermont,1,Addison County,0,38,-38
13,Georgia,50,Vermont,7,Chittenden County,154,69,85
13,Georgia,50,Vermont,11,Franklin County,29,0,29
13,Georgia,50,Vermont,15,Lamoille County,12,6,6
13,Georgia,50,Vermont,17,Orange County,0,11,-11
13,Georgia,50,Vermont,19,Orleans County,10,0,10
13,Georgia,50,Vermont,21,Rutland County,0,3,-3
13,Georgia,50,Vermont,23,Washington County,38,11,27
13,Georgia,50,Vermont,27,Windsor County,23,0,23
13,Georgia,51,Virginia,1,Accomack County,39,319,-280
13,Georgia,51,Virginia,3,Albemarle County,79,176,-97
13,Georgia,51,Virginia,5,Alleghany County,0,22,-22
13,Georgia,51,Virginia,7,Amelia County,38,0,38
13,Georgia,51,Virginia,9,Amherst County,0,15,-15
13,Georgia,51,Virginia,13,Arlington County,160,472,-312
13,Georgia,51,Virginia,15,Augusta County,0,56,-56
13,Georgia,51,Virginia,19,Bedford County,104,0,104
13,Georgia,51,Virginia,23,Botetourt County,261,0,261
13,Georgia,51,Virginia,29,Buckingham County,0,6,-6
13,Georgia,51,Virginia,31,Campbell County,0,71,-71
13,Georgia,51,Virginia,33,Caroline County,115,64,51
13,Georgia,51,Virginia,37,Charlotte County,33,4,29
13,Georgia,51,Virginia,41,Chesterfield County,942,139,803
13,Georgia,51,Virginia,47,Culpeper County,31,21,10
13,Georgia,51,Virginia,49,Cumberland County,0,23,-23
13,Georgia,51,Virginia,51,Dickenson County,81,0,81
13,Georgia,51,Virginia,53,Dinwiddie County,168,20,148
13,Georgia,51,Virginia,57,Essex County,0,8,-8
13,Georgia,51,Virginia,59,Fairfax County,1420,1437,-17
13,Georgia,51,Virginia,61,Fauquier County,13,0,13
13,Georgia,51,Virginia,65,Fluvanna County,0,25,-25
13,Georgia,51,Virginia,67,Franklin County,48,55,-7
13,Georgia,51,Virginia,69,Frederick County,141,31,110
13,Georgia,51,Virginia,79,Greene County,19,8,11
13,Georgia,51,Virginia,83,Halifax County,25,0,25
13,Georgia,51,Virginia,85,Hanover County,126,102,24
13,Georgia,51,Virginia,87,Henrico County,307,119,188
13,Georgia,51,Virginia,93,Isle of Wight County,28,0,28
13,Georgia,51,Virginia,95,James City County,27,77,-50
13,Georgia,51,Virginia,99,King George County,17,0,17
13,Georgia,51,Virginia,105,Lee County,7,15,-8
13,Georgia,51,Virginia,107,Loudoun County,436,321,115
13,Georgia,51,Virginia,111,Lunenburg County,9,0,9
13,Georgia,51,Virginia,119,Middlesex County,0,19,-19
13,Georgia,51,Virginia,121,Montgomery County,59,193,-134
13,Georgia,51,Virginia,125,Nelson County,0,22,-22
13,Georgia,51,Virginia,133,Northumberland County,9,0,9
13,Georgia,51,Virginia,141,Patrick County,0,55,-55
13,Georgia,51,Virginia,145,Powhatan County,9,0,9
13,Georgia,51,Virginia,147,Prince Edward County,0,41,-41
13,Georgia,51,Virginia,149,Prince George County,152,285,-133
13,Georgia,51,Virginia,153,Prince William County,645,342,303
13,Georgia,51,Virginia,155,Pulaski County,4,18,-14
13,Georgia,51,Virginia,159,Richmond County,0,41,-41
13,Georgia,51,Virginia,161,Roanoke County,290,11,279
13,Georgia,51,Virginia,163,Rockbridge County,53,0,53
13,Georgia,51,Virginia,165,Rockingham County,15,15,0
13,Georgia,51,Virginia,167,Russell County,13,12,1
13,Georgia,51,Virginia,171,Shenandoah County,0,39,-39
13,Georgia,51,Virginia,173,Smyth County,0,37,-37
13,Georgia,51,Virginia,175,Southampton County,7,10,-3
13,Georgia,51,Virginia,177,Spotsylvania County,20,93,-73
13,Georgia,51,Virginia,179,Stafford County,232,212,20
13,Georgia,51,Virginia,183,Sussex County,0,41,-41
13,Georgia,51,Virginia,185,Tazewell County,13,0,13
13,Georgia,51,Virginia,187,Warren County,0,28,-28
13,Georgia,51,Virginia,191,Washington County,37,50,-13
13,Georgia,51,Virginia,195,Wise County,0,5,-5
13,Georgia,51,Virginia,197,Wythe County,47,0,47
13,Georgia,51,Virginia,199,York County,55,72,-17
13,Georgia,51,Virginia,510,Alexandria city,350,354,-4
13,Georgia,51,Virginia,530,Buena Vista city,0,25,-25
13,Georgia,51,Virginia,540,Charlottesville city,230,73,157
13,Georgia,51,Virginia,550,Chesapeake city,510,362,148
13,Georgia,51,Virginia,570,Colonial Heights city,0,13,-13
13,Georgia,51,Virginia,590,Danville city,8,0,8
13,Georgia,51,Virginia,600,Fairfax city,48,18,30
13,Georgia,51,Virginia,630,Fredericksburg city,0,14,-14
13,Georgia,51,Virginia,650,Hampton city,148,408,-260
13,Georgia,51,Virginia,660,Harrisonburg city,0,32,-32
13,Georgia,51,Virginia,678,Lexington city,32,30,2
13,Georgia,51,Virginia,680,Lynchburg city,332,100,232
13,Georgia,51,Virginia,683,Manassas city,0,32,-32
13,Georgia,51,Virginia,685,Manassas Park city,102,0,102
13,Georgia,51,Virginia,690,Martinsville city,0,24,-24
13,Georgia,51,Virginia,700,Newport News city,571,510,61
13,Georgia,51,Virginia,710,Norfolk city,381,492,-111
13,Georgia,51,Virginia,730,Petersburg city,55,7,48
13,Georgia,51,Virginia,740,Portsmouth city,318,113,205
13,Georgia,51,Virginia,750,Radford city,1,7,-6
13,Georgia,51,Virginia,760,Richmond city,256,231,25
13,Georgia,51,Virginia,770,Roanoke city,74,151,-77
13,Georgia,51,Virginia,775,Salem city,37,23,14
13,Georgia,51,Virginia,790,Staunton city,8,4,4
13,Georgia,51,Virginia,800,Suffolk city,218,119,99
13,Georgia,51,Virginia,810,Virginia Beach city,1241,705,536
13,Georgia,51,Virginia,820,Waynesboro city,0,21,-21
13,Georgia,51,Virginia,830,Williamsburg city,53,63,-10
13,Georgia,51,Virginia,840,Winchester city,70,31,39
13,Georgia,53,Washington,1,Adams County,8,13,-5
13,Georgia,53,Washington,5,Benton County,53,53,0
13,Georgia,53,Washington,7,Chelan County,14,0,14
13,Georgia,53,Washington,9,Clallam County,62,15,47
13,Georgia,53,Washington,11,Clark County,47,245,-198
13,Georgia,53,Washington,15,Cowlitz County,9,29,-20
13,Georgia,53,Washington,19,Ferry County,9,0,9
13,Georgia,53,Washington,21,Franklin County,46,0,46
13,Georgia,53,Washington,25,Grant County,2,14,-12
13,Georgia,53,Washington,27,Grays Harbor County,0,41,-41
13,Georgia,53,Washington,29,Island County,6,14,-8
13,Georgia,53,Washington,31,Jefferson County,0,1,-1
13,Georgia,53,Washington,33,King County,858,1718,-860
13,Georgia,53,Washington,35,Kitsap County,145,299,-154
13,Georgia,53,Washington,37,Kittitas County,10,35,-25
13,Georgia,53,Washington,41,Lewis County,48,17,31
13,Georgia,53,Washington,45,Mason County,12,0,12
13,Georgia,53,Washington,53,Pierce County,1049,1370,-321
13,Georgia,53,Washington,55,San Juan County,0,4,-4
13,Georgia,53,Washington,57,Skagit County,53,17,36
13,Georgia,53,Washington,59,Skamania County,17,0,17
13,Georgia,53,Washington,61,Snohomish County,130,495,-365
13,Georgia,53,Washington,63,Spokane County,71,98,-27
13,Georgia,53,Washington,67,Thurston County,186,516,-330
13,Georgia,53,Washington,71,Walla Walla County,6,0,6
13,Georgia,53,Washington,73,Whatcom County,29,27,2
13,Georgia,53,Washington,75,Whitman County,19,0,19
13,Georgia,53,Washington,77,Yakima County,21,48,-27
13,Georgia,54,West Virginia,3,Berkeley County,98,183,-85
13,Georgia,54,West Virginia,9,Brooke County,9,0,9
13,Georgia,54,West Virginia,11,Cabell County,53,86,-33
13,Georgia,54,West Virginia,17,Doddridge County,0,12,-12
13,Georgia,54,West Virginia,19,Fayette County,0,25,-25
13,Georgia,54,West Virginia,23,Grant County,1,0,1
13,Georgia,54,West Virginia,25,Greenbrier County,23,0,23
13,Georgia,54,West Virginia,27,Hampshire County,10,0,10
13,Georgia,54,West Virginia,33,Harrison County,20,1,19
13,Georgia,54,West Virginia,35,Jackson County,11,0,11
13,Georgia,54,West Virginia,37,Jefferson County,12,83,-71
13,Georgia,54,West Virginia,39,Kanawha County,66,79,-13
13,Georgia,54,West Virginia,41,Lewis County,0,3,-3
13,Georgia,54,West Virginia,45,Logan County,25,8,17
13,Georgia,54,West Virginia,47,McDowell County,55,26,29
13,Georgia,54,West Virginia,49,Marion County,0,60,-60
13,Georgia,54,West Virginia,51,Marshall County,4,3,1
13,Georgia,54,West Virginia,55,Mercer County,0,88,-88
13,Georgia,54,West Virginia,59,Mingo County,8,0,8
13,Georgia,54,West Virginia,61,Monongalia County,142,38,104
13,Georgia,54,West Virginia,63,Monroe County,0,25,-25
13,Georgia,54,West Virginia,65,Morgan County,30,29,1
13,Georgia,54,West Virginia,69,Ohio County,0,15,-15
13,Georgia,54,West Virginia,71,Pendleton County,12,0,12
13,Georgia,54,West Virginia,79,Putnam County,18,0,18
13,Georgia,54,West Virginia,81,Raleigh County,19,49,-30
13,Georgia,54,West Virginia,87,Roane County,11,0,11
13,Georgia,54,West Virginia,89,Summers County,0,3,-3
13,Georgia,54,West Virginia,95,Tyler County,0,35,-35
13,Georgia,54,West Virginia,97,Upshur County,61,3,58
13,Georgia,54,West Virginia,99,Wayne County,24,63,-39
13,Georgia,54,West Virginia,105,Wirt County,43,0,43
13,Georgia,54,West Virginia,107,Wood County,89,4,85
13,Georgia,55,Wisconsin,3,Ashland County,0,12,-12
13,Georgia,55,Wisconsin,9,Brown County,135,121,14
13,Georgia,55,Wisconsin,21,Columbia County,16,0,16
13,Georgia,55,Wisconsin,25,Dane County,192,209,-17
13,Georgia,55,Wisconsin,29,Door County,0,5,-5
13,Georgia,55,Wisconsin,31,Douglas County,16,0,16
13,Georgia,55,Wisconsin,33,Dunn County,47,0,47
13,Georgia,55,Wisconsin,35,Eau Claire County,41,19,22
13,Georgia,55,Wisconsin,39,Fond du Lac County,28,15,13
13,Georgia,55,Wisconsin,45,Green County,0,11,-11
13,Georgia,55,Wisconsin,49,Iowa County,15,0,15
13,Georgia,55,Wisconsin,55,Jefferson County,16,77,-61
13,Georgia,55,Wisconsin,57,Juneau County,0,8,-8
13,Georgia,55,Wisconsin,59,Kenosha County,62,36,26
13,Georgia,55,Wisconsin,63,La Crosse County,7,27,-20
13,Georgia,55,Wisconsin,69,Lincoln County,0,17,-17
13,Georgia,55,Wisconsin,71,Manitowoc County,0,15,-15
13,Georgia,55,Wisconsin,73,Marathon County,0,50,-50
13,Georgia,55,Wisconsin,75,Marinette County,13,0,13
13,Georgia,55,Wisconsin,79,Milwaukee County,1021,340,681
13,Georgia,55,Wisconsin,81,Monroe County,53,60,-7
13,Georgia,55,Wisconsin,83,Oconto County,0,2,-2
13,Georgia,55,Wisconsin,85,Oneida County,0,9,-9
13,Georgia,55,Wisconsin,87,Outagamie County,147,91,56
13,Georgia,55,Wisconsin,89,Ozaukee County,25,0,25
13,Georgia,55,Wisconsin,95,Polk County,0,8,-8
13,Georgia,55,Wisconsin,97,Portage County,16,0,16
13,Georgia,55,Wisconsin,99,Price County,0,2,-2
13,Georgia,55,Wisconsin,101,Racine County,123,58,65
13,Georgia,55,Wisconsin,103,Richland County,30,0,30
13,Georgia,55,Wisconsin,105,Rock County,86,80,6
13,Georgia,55,Wisconsin,109,St. Croix County,215,6,209
13,Georgia,55,Wisconsin,111,Sauk County,13,0,13
13,Georgia,55,Wisconsin,113,Sawyer County,23,11,12
13,Georgia,55,Wisconsin,117,Sheboygan County,0,7,-7
13,Georgia,55,Wisconsin,123,Vernon County,0,53,-53
13,Georgia,55,Wisconsin,125,Vilas County,2,3,-1
13,Georgia,55,Wisconsin,127,Walworth County,96,6,90
13,Georgia,55,Wisconsin,129,Washburn County,0,3,-3
13,Georgia,55,Wisconsin,131,Washington County,13,8,5
13,Georgia,55,Wisconsin,133,Waukesha County,371,100,271
13,Georgia,55,Wisconsin,135,Waupaca County,0,8,-8
13,Georgia,55,Wisconsin,137,Waushara County,0,18,-18
13,Georgia,55,Wisconsin,139,Winnebago County,184,20,164
13,Georgia,55,Wisconsin,141,Wood County,0,9,-9
13,Georgia,56,Wyoming,1,Albany County,17,0,17
13,Georgia,56,Wyoming,5,Campbell County,11,0,11
13,Georgia,56,Wyoming,7,Carbon County,4,0,4
13,Georgia,56,Wyoming,13,Fremont County,0,10,-10
13,Georgia,56,Wyoming,15,Goshen County,0,2,-2
13,Georgia,56,Wyoming,19,Johnson County,0,36,-36
13,Georgia,56,Wyoming,21,Laramie County,248,4,244
13,Georgia,56,Wyoming,25,Natrona County,19,46,-27
13,Georgia,56,Wyoming,29,Park County,0,24,-24
13,Georgia,56,Wyoming,33,Sheridan County,133,5,128
13,Georgia,56,Wyoming,37,Sweetwater County,0,101,-101
13,Georgia,56,Wyoming,39,Teton County,10,3,7
13,Georgia,56,Wyoming,41,Uinta County,6,0,6
13,Georgia,56,Wyoming,43,Washakie County,0,1,-1
13,Georgia,6,California,1,Alameda County,427,690,-263
13,Georgia,6,California,7,Butte County,50,53,-3
13,Georgia,6,California,9,Calaveras County,38,0,38
13,Georgia,6,California,13,Contra Costa County,280,490,-210
13,Georgia,6,California,17,El Dorado County,14,97,-83
13,Georgia,6,California,19,Fresno County,312,132,180
13,Georgia,6,California,23,Humboldt County,61,12,49
13,Georgia,6,California,25,Imperial County,11,48,-37
13,Georgia,6,California,29,Kern County,125,146,-21
13,Georgia,6,California,31,Kings County,12,14,-2
13,Georgia,6,California,35,Lassen County,40,0,40
13,Georgia,6,California,37,Los Angeles County,3451,2594,857
13,Georgia,6,California,39,Madera County,75,15,60
13,Georgia,6,California,41,Marin County,108,11,97
13,Georgia,6,California,45,Mendocino County,0,7,-7
13,Georgia,6,California,47,Merced County,51,32,19
13,Georgia,6,California,49,Modoc County,2,0,2
13,Georgia,6,California,51,Mono County,61,3,58
13,Georgia,6,California,53,Monterey County,514,519,-5
13,Georgia,6,California,55,Napa County,74,22,52
13,Georgia,6,California,57,Nevada County,16,0,16
13,Georgia,6,California,59,Orange County,845,528,317
13,Georgia,6,California,61,Placer County,136,97,39
13,Georgia,6,California,65,Riverside County,1538,605,933
13,Georgia,6,California,67,Sacramento County,259,592,-333
13,Georgia,6,California,71,San Bernardino County,1294,934,360
13,Georgia,6,California,73,San Diego County,2386,1230,1156
13,Georgia,6,California,75,San Francisco County,282,255,27
13,Georgia,6,California,77,San Joaquin County,82,14,68
13,Georgia,6,California,79,San Luis Obispo County,62,0,62
13,Georgia,6,California,81,San Mateo County,210,218,-8
13,Georgia,6,California,83,Santa Barbara County,29,73,-44
13,Georgia,6,California,85,Santa Clara County,468,832,-364
13,Georgia,6,California,87,Santa Cruz County,13,27,-14
13,Georgia,6,California,89,Shasta County,75,24,51
13,Georgia,6,California,93,Siskiyou County,0,7,-7
13,Georgia,6,California,95,Solano County,301,97,204
13,Georgia,6,California,97,Sonoma County,46,86,-40
13,Georgia,6,California,99,Stanislaus County,41,26,15
13,Georgia,6,California,101,Sutter County,24,0,24
13,Georgia,6,California,103,Tehama County,58,0,58
13,Georgia,6,California,107,Tulare County,304,39,265
13,Georgia,6,California,111,Ventura County,151,276,-125
13,Georgia,6,California,113,Yolo County,224,34,190
13,Georgia,6,California,115,Yuba County,47,119,-72
13,Georgia,72,Puerto Rico,3,Aguada Municipio,14,0,14
13,Georgia,72,Puerto Rico,5,Aguadilla Municipio,25,27,-2
13,Georgia,72,Puerto Rico,13,Arecibo Municipio,54,0,54
13,Georgia,72,Puerto Rico,21,Bayamón Municipio,113,113,0
13,Georgia,72,Puerto Rico,23,Cabo Rojo Municipio,35,0,35
13,Georgia,72,Puerto Rico,25,Caguas Municipio,185,72,113
13,Georgia,72,Puerto Rico,31,Carolina Municipio,109,0,109
13,Georgia,72,Puerto Rico,33,Cataño Municipio,26,0,26
13,Georgia,72,Puerto Rico,35,Cayey Municipio,131,0,131
13,Georgia,72,Puerto Rico,39,Ciales Municipio,24,0,24
13,Georgia,72,Puerto Rico,41,Cidra Municipio,26,0,26
13,Georgia,72,Puerto Rico,47,Corozal Municipio,82,0,82
13,Georgia,72,Puerto Rico,51,Dorado Municipio,37,0,37
13,Georgia,72,Puerto Rico,57,Guayama Municipio,10,8,2
13,Georgia,72,Puerto Rico,59,Guayanilla Municipio,0,7,-7
13,Georgia,72,Puerto Rico,61,Guaynabo Municipio,138,0,138
13,Georgia,72,Puerto Rico,63,Gurabo Municipio,24,0,24
13,Georgia,72,Puerto Rico,71,Isabela Municipio,8,0,8
13,Georgia,72,Puerto Rico,75,Juana Díaz Municipio,12,22,-10
13,Georgia,72,Puerto Rico,77,Juncos Municipio,33,0,33
13,Georgia,72,Puerto Rico,79,Lajas Municipio,3,0,3
13,Georgia,72,Puerto Rico,85,Las Piedras Municipio,79,0,79
13,Georgia,72,Puerto Rico,91,Manatí Municipio,9,0,9
13,Georgia,72,Puerto Rico,97,Mayagüez Municipio,0,3,-3
13,Georgia,72,Puerto Rico,101,Morovis Municipio,149,0,149
13,Georgia,72,Puerto Rico,103,Naguabo Municipio,80,0,80
13,Georgia,72,Puerto Rico,105,Naranjito Municipio,26,0,26
13,Georgia,72,Puerto Rico,111,Peñuelas Municipio,8,0,8
13,Georgia,72,Puerto Rico,113,Ponce Municipio,95,0,95
13,Georgia,72,Puerto Rico,119,Río Grande Municipio,51,58,-7
13,Georgia,72,Puerto Rico,121,Sabana Grande Municipio,45,0,45
13,Georgia,72,Puerto Rico,123,Salinas Municipio,395,0,395
13,Georgia,72,Puerto Rico,127,San Juan Municipio,534,0,534
13,Georgia,72,Puerto Rico,129,San Lorenzo Municipio,8,0,8
13,Georgia,72,Puerto Rico,133,Santa Isabel Municipio,18,0,18
13,Georgia,72,Puerto Rico,135,Toa Alta Municipio,0,3,-3
13,Georgia,72,Puerto Rico,141,Utuado Municipio,15,0,15
13,Georgia,72,Puerto Rico,145,Vega Baja Municipio,28,0,28
13,Georgia,72,Puerto Rico,149,Villalba Municipio,53,0,53
13,Georgia,72,Puerto Rico,151,Yabucoa Municipio,7,0,7
13,Georgia,72,Puerto Rico,153,Yauco Municipio,0,29,-29
13,Georgia,8,Colorado,1,Adams County,272,182,90
13,Georgia,8,Colorado,3,Alamosa County,0,9,-9
13,Georgia,8,Colorado,5,Arapahoe County,447,430,17
13,Georgia,8,Colorado,7,Archuleta County,0,54,-54
13,Georgia,8,Colorado,13,Boulder County,113,331,-218
13,Georgia,8,Colorado,14,Broomfield County,26,49,-23
13,Georgia,8,Colorado,19,Clear Creek County,4,15,-11
13,Georgia,8,Colorado,25,Crowley County,0,5,-5
13,Georgia,8,Colorado,31,Denver County,676,642,34
13,Georgia,8,Colorado,35,Douglas County,296,300,-4
13,Georgia,8,Colorado,37,Eagle County,113,8,105
13,Georgia,8,Colorado,39,Elbert County,36,0,36
13,Georgia,8,Colorado,41,El Paso County,1582,2654,-1072
13,Georgia,8,Colorado,43,Fremont County,75,0,75
13,Georgia,8,Colorado,45,Garfield County,83,0,83
13,Georgia,8,Colorado,51,Gunnison County,29,21,8
13,Georgia,8,Colorado,59,Jefferson County,109,210,-101
13,Georgia,8,Colorado,67,La Plata County,105,95,10
13,Georgia,8,Colorado,69,Larimer County,104,188,-84
13,Georgia,8,Colorado,77,Mesa County,81,2,79
13,Georgia,8,Colorado,89,Otero County,0,11,-11
13,Georgia,8,Colorado,93,Park County,4,29,-25
13,Georgia,8,Colorado,97,Pitkin County,22,0,22
13,Georgia,8,Colorado,101,Pueblo County,73,76,-3
13,Georgia,8,Colorado,107,Routt County,42,168,-126
13,Georgia,8,Colorado,113,San Miguel County,10,0,10
13,Georgia,8,Colorado,117,Summit County,0,34,-34
13,Georgia,8,Colorado,119,Teller County,0,57,-57
13,Georgia,8,Colorado,123,Weld County,89,186,-97
13,Georgia,9,Connecticut,1,Fairfield County,644,388,256
13,Georgia,9,Connecticut,3,Hartford County,1668,398,1270
13,Georgia,9,Connecticut,5,Litchfield County,110,36,74
13,Georgia,9,Connecticut,7,Middlesex County,0,17,-17
13,Georgia,9,Connecticut,9,New Haven County,554,369,185
13,Georgia,9,Connecticut,11,New London County,165,272,-107
13,Georgia,9,Connecticut,13,Tolland County,383,50,333
13,Georgia,9,Connecticut,15,Windham County,79,15,64
13,Georgia,AFR,Africa,,-,5726,0,0
13,Georgia,ASI,Asia,,-,25483,0,0
13,Georgia,CAM,Central America,,-,6407,0,0
13,Georgia,CAR,Caribbean,,-,2491,0,0
13,Georgia,EUR,Europe,,-,7932,0,0
13,Georgia,ISL,U.S. Island Areas,,-,742,0,0
13,Georgia,NAM,Northern America,,-,1222,0,0
13,Georgia,OCE,Oceania and At Sea,,-,758,0,0
13,Georgia,SAM,South America,,-,3974,0,0
15,Hawaii,1,Alabama,1,Autauga County,0,29,-29
15,Hawaii,1,Alabama,3,Baldwin County,20,47,-27
15,Hawaii,1,Alabama,15,Calhoun County,35,19,16
15,Hawaii,1,Alabama,29,Cleburne County,0,16,-16
15,Hawaii,1,Alabama,31,Coffee County,105,2,103
15,Hawaii,1,Alabama,43,Cullman County,5,0,5
15,Hawaii,1,Alabama,45,Dale County,87,180,-93
15,Hawaii,1,Alabama,47,Dallas County,7,0,7
15,Hawaii,1,Alabama,53,Escambia County,21,0,21
15,Hawaii,1,Alabama,69,Houston County,47,14,33
15,Hawaii,1,Alabama,73,Jefferson County,16,23,-7
15,Hawaii,1,Alabama,75,Lamar County,0,5,-5
15,Hawaii,1,Alabama,81,Lee County,0,28,-28
15,Hawaii,1,Alabama,83,Limestone County,29,0,29
15,Hawaii,1,Alabama,89,Madison County,0,64,-64
15,Hawaii,1,Alabama,95,Marshall County,0,95,-95
15,Hawaii,1,Alabama,97,Mobile County,53,9,44
15,Hawaii,1,Alabama,101,Montgomery County,6,0,6
15,Hawaii,1,Alabama,103,Morgan County,11,98,-87
15,Hawaii,1,Alabama,113,Russell County,47,277,-230
15,Hawaii,1,Alabama,117,Shelby County,0,7,-7
15,Hawaii,1,Alabama,125,Tuscaloosa County,75,7,68
15,Hawaii,10,Delaware,1,Kent County,0,47,-47
15,Hawaii,10,Delaware,3,New Castle County,28,0,28
15,Hawaii,11,District of Columbia,1,District of Columbia,404,155,249
15,Hawaii,12,Florida,1,Alachua County,19,51,-32
15,Hawaii,12,Florida,3,Baker County,2,0,2
15,Hawaii,12,Florida,9,Brevard County,191,22,169
15,Hawaii,12,Florida,11,Broward County,16,49,-33
15,Hawaii,12,Florida,19,Clay County,93,54,39
15,Hawaii,12,Florida,21,Collier County,59,30,29
15,Hawaii,12,Florida,31,Duval County,423,132,291
15,Hawaii,12,Florida,33,Escambia County,117,197,-80
15,Hawaii,12,Florida,35,Flagler County,22,0,22
15,Hawaii,12,Florida,39,Gadsden County,0,4,-4
15,Hawaii,12,Florida,55,Highlands County,0,20,-20
15,Hawaii,12,Florida,57,Hillsborough County,156,149,7
15,Hawaii,12,Florida,61,Indian River County,0,33,-33
15,Hawaii,12,Florida,63,Jackson County,4,0,4
15,Hawaii,12,Florida,69,Lake County,0,19,-19
15,Hawaii,12,Florida,71,Lee County,56,0,56
15,Hawaii,12,Florida,73,Leon County,26,84,-58
15,Hawaii,12,Florida,81,Manatee County,51,33,18
15,Hawaii,12,Florida,83,Marion County,71,0,71
15,Hawaii,12,Florida,85,Martin County,4,0,4
15,Hawaii,12,Florida,86,Miami-Dade County,125,47,78
15,Hawaii,12,Florida,87,Monroe County,0,31,-31
15,Hawaii,12,Florida,89,Nassau County,0,5,-5
15,Hawaii,12,Florida,91,Okaloosa County,148,27,121
15,Hawaii,12,Florida,95,Orange County,346,267,79
15,Hawaii,12,Florida,97,Osceola County,69,15,54
15,Hawaii,12,Florida,99,Palm Beach County,112,26,86
15,Hawaii,12,Florida,101,Pasco County,25,37,-12
15,Hawaii,12,Florida,103,Pinellas County,73,13,60
15,Hawaii,12,Florida,105,Polk County,12,38,-26
15,Hawaii,12,Florida,107,Putnam County,7,0,7
15,Hawaii,12,Florida,109,St. Johns County,0,133,-133
15,Hawaii,12,Florida,111,St. Lucie County,0,8,-8
15,Hawaii,12,Florida,113,Santa Rosa County,48,10,38
15,Hawaii,12,Florida,115,Sarasota County,10,52,-42
15,Hawaii,12,Florida,117,Seminole County,27,50,-23
15,Hawaii,12,Florida,127,Volusia County,21,60,-39
15,Hawaii,12,Florida,131,Walton County,7,0,7
15,Hawaii,13,Georgia,9,Baldwin County,0,7,-7
15,Hawaii,13,Georgia,15,Bartow County,4,0,4
15,Hawaii,13,Georgia,25,Brantley County,17,0,17
15,Hawaii,13,Georgia,29,Bryan County,0,59,-59
15,Hawaii,13,Georgia,31,Bulloch County,0,24,-24
15,Hawaii,13,Georgia,39,Camden County,37,98,-61
15,Hawaii,13,Georgia,45,Carroll County,4,0,4
15,Hawaii,13,Georgia,51,Chatham County,89,24,65
15,Hawaii,13,Georgia,53,Chattahoochee County,72,55,17
15,Hawaii,13,Georgia,57,Cherokee County,17,0,17
15,Hawaii,13,Georgia,59,Clarke County,0,16,-16
15,Hawaii,13,Georgia,67,Cobb County,27,40,-13
15,Hawaii,13,Georgia,71,Colquitt County,23,0,23
15,Hawaii,13,Georgia,73,Columbia County,90,0,90
15,Hawaii,13,Georgia,77,Coweta County,4,29,-25
15,Hawaii,13,Georgia,89,DeKalb County,0,51,-51
15,Hawaii,13,Georgia,97,Douglas County,0,41,-41
15,Hawaii,13,Georgia,111,Fannin County,30,0,30
15,Hawaii,13,Georgia,113,Fayette County,182,0,182
15,Hawaii,13,Georgia,117,Forsyth County,30,0,30
15,Hawaii,13,Georgia,121,Fulton County,61,196,-135
15,Hawaii,13,Georgia,135,Gwinnett County,19,26,-7
15,Hawaii,13,Georgia,139,Hall County,14,0,14
15,Hawaii,13,Georgia,151,Henry County,0,52,-52
15,Hawaii,13,Georgia,153,Houston County,41,0,41
15,Hawaii,13,Georgia,155,Irwin County,4,0,4
15,Hawaii,13,Georgia,159,Jasper County,0,5,-5
15,Hawaii,13,Georgia,163,Jefferson County,6,0,6
15,Hawaii,13,Georgia,179,Liberty County,220,42,178
15,Hawaii,13,Georgia,183,Long County,0,24,-24
15,Hawaii,13,Georgia,185,Lowndes County,32,105,-73
15,Hawaii,13,Georgia,187,Lumpkin County,4,0,4
15,Hawaii,13,Georgia,191,McIntosh County,2,0,2
15,Hawaii,13,Georgia,215,Muscogee County,661,312,349
15,Hawaii,13,Georgia,245,Richmond County,237,106,131
15,Hawaii,13,Georgia,259,Stewart County,0,5,-5
15,Hawaii,13,Georgia,283,Treutlen County,19,0,19
15,Hawaii,13,Georgia,313,Whitfield County,30,0,30
15,Hawaii,13,Georgia,319,Wilkinson County,14,0,14
15,Hawaii,15,Hawaii,1,Hawaii County,2565,1753,812
15,Hawaii,15,Hawaii,3,Honolulu County,3498,3231,267
15,Hawaii,15,Hawaii,5,Kalawao County,0,6,-6
15,Hawaii,15,Hawaii,7,Kauai County,637,937,-300
15,Hawaii,15,Hawaii,9,Maui County,1248,2021,-773
15,Hawaii,16,Idaho,1,Ada County,214,267,-53
15,Hawaii,16,Idaho,3,Adams County,0,11,-11
15,Hawaii,16,Idaho,5,Bannock County,78,4,74
15,Hawaii,16,Idaho,9,Benewah County,0,4,-4
15,Hawaii,16,Idaho,17,Bonner County,0,183,-183
15,Hawaii,16,Idaho,19,Bonneville County,0,7,-7
15,Hawaii,16,Idaho,27,Canyon County,44,52,-8
15,Hawaii,16,Idaho,35,Clearwater County,0,2,-2
15,Hawaii,16,Idaho,39,Elmore County,12,28,-16
15,Hawaii,16,Idaho,41,Franklin County,0,6,-6
15,Hawaii,16,Idaho,45,Gem County,0,27,-27
15,Hawaii,16,Idaho,53,Jerome County,0,2,-2
15,Hawaii,16,Idaho,55,Kootenai County,40,1,39
15,Hawaii,16,Idaho,57,Latah County,10,0,10
15,Hawaii,16,Idaho,59,Lemhi County,24,0,24
15,Hawaii,16,Idaho,65,Madison County,3,0,3
15,Hawaii,16,Idaho,77,Power County,0,70,-70
15,Hawaii,16,Idaho,79,Shoshone County,15,0,15
15,Hawaii,17,Illinois,19,Champaign County,217,22,195
15,Hawaii,17,Illinois,31,Cook County,476,473,3
15,Hawaii,17,Illinois,37,DeKalb County,21,0,21
15,Hawaii,17,Illinois,39,De Witt County,14,0,14
15,Hawaii,17,Illinois,43,DuPage County,51,22,29
15,Hawaii,17,Illinois,51,Fayette County,29,23,6
15,Hawaii,17,Illinois,73,Henry County,20,0,20
15,Hawaii,17,Illinois,77,Jackson County,10,0,10
15,Hawaii,17,Illinois,81,Jefferson County,0,4,-4
15,Hawaii,17,Illinois,89,Kane County,17,0,17
15,Hawaii,17,Illinois,91,Kankakee County,8,0,8
15,Hawaii,17,Illinois,95,Knox County,0,8,-8
15,Hawaii,17,Illinois,97,Lake County,230,471,-241
15,Hawaii,17,Illinois,109,McDonough County,17,0,17
15,Hawaii,17,Illinois,111,McHenry County,0,11,-11
15,Hawaii,17,Illinois,113,McLean County,0,5,-5
15,Hawaii,17,Illinois,117,Macoupin County,0,14,-14
15,Hawaii,17,Illinois,119,Madison County,66,14,52
15,Hawaii,17,Illinois,131,Mercer County,18,0,18
15,Hawaii,17,Illinois,137,Morgan County,25,0,25
15,Hawaii,17,Illinois,143,Peoria County,21,0,21
15,Hawaii,17,Illinois,147,Piatt County,6,0,6
15,Hawaii,17,Illinois,157,Randolph County,8,0,8
15,Hawaii,17,Illinois,163,St. Clair County,75,28,47
15,Hawaii,17,Illinois,167,Sangamon County,25,0,25
15,Hawaii,17,Illinois,177,Stephenson County,0,4,-4
15,Hawaii,17,Illinois,179,Tazewell County,18,0,18
15,Hawaii,17,Illinois,187,Warren County,0,4,-4
15,Hawaii,17,Illinois,197,Will County,104,0,104
15,Hawaii,17,Illinois,201,Winnebago County,0,49,-49
15,Hawaii,17,Illinois,203,Woodford County,0,4,-4
15,Hawaii,18,Indiana,3,Allen County,0,61,-61
15,Hawaii,18,Indiana,7,Benton County,0,8,-8
15,Hawaii,18,Indiana,11,Boone County,0,17,-17
15,Hawaii,18,Indiana,13,Brown County,0,12,-12
15,Hawaii,18,Indiana,19,Clark County,6,0,6
15,Hawaii,18,Indiana,35,Delaware County,0,11,-11
15,Hawaii,18,Indiana,37,Dubois County,8,0,8
15,Hawaii,18,Indiana,43,Floyd County,6,0,6
15,Hawaii,18,Indiana,45,Fountain County,0,2,-2
15,Hawaii,18,Indiana,51,Gibson County,2,0,2
15,Hawaii,18,Indiana,53,Grant County,0,5,-5
15,Hawaii,18,Indiana,57,Hamilton County,41,316,-275
15,Hawaii,18,Indiana,59,Hancock County,11,0,11
15,Hawaii,18,Indiana,63,Hendricks County,45,0,45
15,Hawaii,18,Indiana,67,Howard County,0,9,-9
15,Hawaii,18,Indiana,79,Jennings County,39,0,39
15,Hawaii,18,Indiana,81,Johnson County,0,65,-65
15,Hawaii,18,Indiana,83,Knox County,32,0,32
15,Hawaii,18,Indiana,85,Kosciusko County,133,0,133
15,Hawaii,18,Indiana,89,Lake County,9,0,9
15,Hawaii,18,Indiana,93,Lawrence County,8,0,8
15,Hawaii,18,Indiana,97,Marion County,101,55,46
15,Hawaii,18,Indiana,101,Martin County,0,25,-25
15,Hawaii,18,Indiana,105,Monroe County,25,17,8
15,Hawaii,18,Indiana,109,Morgan County,0,68,-68
15,Hawaii,18,Indiana,135,Randolph County,0,11,-11
15,Hawaii,18,Indiana,141,St. Joseph County,0,13,-13
15,Hawaii,18,Indiana,145,Shelby County,71,0,71
15,Hawaii,18,Indiana,157,Tippecanoe County,101,71,30
15,Hawaii,18,Indiana,167,Vigo County,15,32,-17
15,Hawaii,18,Indiana,173,Warrick County,17,0,17
15,Hawaii,19,Iowa,13,Black Hawk County,17,0,17
15,Hawaii,19,Iowa,21,Buena Vista County,0,9,-9
15,Hawaii,19,Iowa,29,Cass County,150,0,150
15,Hawaii,19,Iowa,45,Clinton County,0,39,-39
15,Hawaii,19,Iowa,57,Des Moines County,0,13,-13
15,Hawaii,19,Iowa,65,Fayette County,34,0,34
15,Hawaii,19,Iowa,79,Hamilton County,20,0,20
15,Hawaii,19,Iowa,99,Jasper County,0,27,-27
15,Hawaii,19,Iowa,113,Linn County,7,23,-16
15,Hawaii,19,Iowa,137,Montgomery County,0,8,-8
15,Hawaii,19,Iowa,153,Polk County,83,17,66
15,Hawaii,19,Iowa,163,Scott County,53,16,37
15,Hawaii,19,Iowa,167,Sioux County,0,11,-11
15,Hawaii,19,Iowa,181,Warren County,25,20,5
15,Hawaii,19,Iowa,187,Webster County,17,0,17
15,Hawaii,19,Iowa,191,Winneshiek County,29,0,29
15,Hawaii,19,Iowa,193,Woodbury County,14,0,14
15,Hawaii,19,Iowa,197,Wright County,0,6,-6
15,Hawaii,2,Alaska,13,Aleutians East Borough,0,7,-7
15,Hawaii,2,Alaska,16,Aleutians West Census Area,0,12,-12
15,Hawaii,2,Alaska,20,Anchorage Municipality,239,183,56
15,Hawaii,2,Alaska,60,Bristol Bay Borough,0,2,-2
15,Hawaii,2,Alaska,68,Denali Borough,3,0,3
15,Hawaii,2,Alaska,90,Fairbanks North Star Borough,219,54,165
15,Hawaii,2,Alaska,110,Juneau City and Borough,6,16,-10
15,Hawaii,2,Alaska,122,Kenai Peninsula Borough,24,11,13
15,Hawaii,2,Alaska,130,Ketchikan Gateway Borough,0,45,-45
15,Hawaii,2,Alaska,150,Kodiak Island Borough,78,0,78
15,Hawaii,2,Alaska,170,Matanuska-Susitna Borough,107,61,46
15,Hawaii,2,Alaska,180,Nome Census Area,48,13,35
15,Hawaii,2,Alaska,185,North Slope Borough,0,62,-62
15,Hawaii,2,Alaska,188,Northwest Arctic Borough,0,3,-3
15,Hawaii,2,Alaska,195,Petersburg Borough,0,1,-1
15,Hawaii,2,Alaska,220,Sitka City and Borough,0,5,-5
15,Hawaii,2,Alaska,261,Valdez-Cordova Census Area,0,95,-95
15,Hawaii,2,Alaska,275,Wrangell City and Borough,0,1,-1
15,Hawaii,20,Kansas,11,Bourbon County,3,0,3
15,Hawaii,20,Kansas,21,Cherokee County,0,26,-26
15,Hawaii,20,Kansas,45,Douglas County,48,25,23
15,Hawaii,20,Kansas,61,Geary County,42,41,1
15,Hawaii,20,Kansas,69,Gray County,0,2,-2
15,Hawaii,20,Kansas,91,Johnson County,14,131,-117
15,Hawaii,20,Kansas,103,Leavenworth County,180,68,112
15,Hawaii,20,Kansas,129,Morton County,0,8,-8
15,Hawaii,20,Kansas,131,Nemaha County,10,0,10
15,Hawaii,20,Kansas,141,Osborne County,0,4,-4
15,Hawaii,20,Kansas,153,Rawlins County,0,5,-5
15,Hawaii,20,Kansas,155,Reno County,0,14,-14
15,Hawaii,20,Kansas,161,Riley County,111,17,94
15,Hawaii,20,Kansas,173,Sedgwick County,3,10,-7
15,Hawaii,20,Kansas,177,Shawnee County,7,64,-57
15,Hawaii,20,Kansas,191,Sumner County,0,25,-25
15,Hawaii,20,Kansas,209,Wyandotte County,40,0,40
15,Hawaii,21,Kentucky,9,Barren County,10,0,10
15,Hawaii,21,Kentucky,19,Boyd County,0,14,-14
15,Hawaii,21,Kentucky,37,Campbell County,0,12,-12
15,Hawaii,21,Kentucky,47,Christian County,0,80,-80
15,Hawaii,21,Kentucky,65,Estill County,0,4,-4
15,Hawaii,21,Kentucky,67,Fayette County,0,63,-63
15,Hawaii,21,Kentucky,73,Franklin County,30,0,30
15,Hawaii,21,Kentucky,93,Hardin County,134,73,61
15,Hawaii,21,Kentucky,111,Jefferson County,68,23,45
15,Hawaii,21,Kentucky,117,Kenton County,10,58,-48
15,Hawaii,21,Kentucky,119,Knott County,10,0,10
15,Hawaii,21,Kentucky,145,McCracken County,2,0,2
15,Hawaii,21,Kentucky,151,Madison County,5,22,-17
15,Hawaii,21,Kentucky,211,Shelby County,0,77,-77
15,Hawaii,21,Kentucky,217,Taylor County,0,22,-22
15,Hawaii,21,Kentucky,237,Wolfe County,0,19,-19
15,Hawaii,22,Louisiana,11,Beauregard Parish,11,1,10
15,Hawaii,22,Louisiana,15,Bossier Parish,0,56,-56
15,Hawaii,22,Louisiana,17,Caddo Parish,0,9,-9
15,Hawaii,22,Louisiana,19,Calcasieu Parish,12,37,-25
15,Hawaii,22,Louisiana,33,East Baton Rouge Parish,144,0,144
15,Hawaii,22,Louisiana,51,Jefferson Parish,6,85,-79
15,Hawaii,22,Louisiana,63,Livingston Parish,0,75,-75
15,Hawaii,22,Louisiana,71,Orleans Parish,97,52,45
15,Hawaii,22,Louisiana,75,Plaquemines Parish,9,0,9
15,Hawaii,22,Louisiana,79,Rapides Parish,0,43,-43
15,Hawaii,22,Louisiana,93,St. James Parish,0,11,-11
15,Hawaii,22,Louisiana,97,St. Landry Parish,0,3,-3
15,Hawaii,22,Louisiana,109,Terrebonne Parish,0,1,-1
15,Hawaii,22,Louisiana,115,Vernon Parish,257,235,22
15,Hawaii,22,Louisiana,117,Washington Parish,0,39,-39
15,Hawaii,23,Maine,1,Androscoggin County,0,44,-44
15,Hawaii,23,Maine,5,Cumberland County,79,4,75
15,Hawaii,23,Maine,7,Franklin County,46,16,30
15,Hawaii,23,Maine,13,Knox County,0,22,-22
15,Hawaii,23,Maine,23,Sagadahoc County,142,0,142
15,Hawaii,23,Maine,31,York County,80,140,-60
15,Hawaii,24,Maryland,3,Anne Arundel County,133,615,-482
15,Hawaii,24,Maryland,5,Baltimore County,85,5,80
15,Hawaii,24,Maryland,9,Calvert County,44,53,-9
15,Hawaii,24,Maryland,15,Cecil County,2,0,2
15,Hawaii,24,Maryland,17,Charles County,1,109,-108
15,Hawaii,24,Maryland,21,Frederick County,190,50,140
15,Hawaii,24,Maryland,25,Harford County,0,120,-120
15,Hawaii,24,Maryland,27,Howard County,98,250,-152
15,Hawaii,24,Maryland,31,Montgomery County,164,237,-73
15,Hawaii,24,Maryland,33,Prince George's County,104,106,-2
15,Hawaii,24,Maryland,35,Queen Anne's County,18,0,18
15,Hawaii,24,Maryland,37,St. Mary's County,11,240,-229
15,Hawaii,24,Maryland,39,Somerset County,0,48,-48
15,Hawaii,24,Maryland,43,Washington County,0,57,-57
15,Hawaii,24,Maryland,510,Baltimore city,2,17,-15
15,Hawaii,25,Massachusetts,1,Barnstable County,0,20,-20
15,Hawaii,25,Massachusetts,3,Berkshire County,0,6,-6
15,Hawaii,25,Massachusetts,5,Bristol County,13,51,-38
15,Hawaii,25,Massachusetts,7,Dukes County,78,0,78
15,Hawaii,25,Massachusetts,9,Essex County,10,14,-4
15,Hawaii,25,Massachusetts,13,Hampden County,53,11,42
15,Hawaii,25,Massachusetts,17,Middlesex County,51,97,-46
15,Hawaii,25,Massachusetts,21,Norfolk County,38,144,-106
15,Hawaii,25,Massachusetts,23,Plymouth County,59,0,59
15,Hawaii,25,Massachusetts,25,Suffolk County,86,151,-65
15,Hawaii,25,Massachusetts,27,Worcester County,76,0,76
15,Hawaii,26,Michigan,1,Alcona County,4,0,4
15,Hawaii,26,Michigan,9,Antrim County,6,0,6
15,Hawaii,26,Michigan,19,Benzie County,0,12,-12
15,Hawaii,26,Michigan,21,Berrien County,25,6,19
15,Hawaii,26,Michigan,25,Calhoun County,0,4,-4
15,Hawaii,26,Michigan,29,Charlevoix County,3,0,3
15,Hawaii,26,Michigan,33,Chippewa County,28,0,28
15,Hawaii,26,Michigan,41,Delta County,21,0,21
15,Hawaii,26,Michigan,45,Eaton County,6,0,6
15,Hawaii,26,Michigan,49,Genesee County,3,39,-36
15,Hawaii,26,Michigan,55,Grand Traverse County,19,0,19
15,Hawaii,26,Michigan,61,Houghton County,0,29,-29
15,Hawaii,26,Michigan,67,Ionia County,6,0,6
15,Hawaii,26,Michigan,73,Isabella County,0,18,-18
15,Hawaii,26,Michigan,77,Kalamazoo County,0,64,-64
15,Hawaii,26,Michigan,81,Kent County,86,26,60
15,Hawaii,26,Michigan,85,Lake County,8,0,8
15,Hawaii,26,Michigan,87,Lapeer County,8,0,8
15,Hawaii,26,Michigan,91,Lenawee County,13,18,-5
15,Hawaii,26,Michigan,93,Livingston County,0,16,-16
15,Hawaii,26,Michigan,99,Macomb County,70,19,51
15,Hawaii,26,Michigan,101,Manistee County,0,6,-6
15,Hawaii,26,Michigan,103,Marquette County,0,24,-24
15,Hawaii,26,Michigan,105,Mason County,11,0,11
15,Hawaii,26,Michigan,111,Midland County,17,17,0
15,Hawaii,26,Michigan,121,Muskegon County,0,12,-12
15,Hawaii,26,Michigan,125,Oakland County,12,19,-7
15,Hawaii,26,Michigan,137,Otsego County,0,6,-6
15,Hawaii,26,Michigan,139,Ottawa County,15,0,15
15,Hawaii,26,Michigan,145,Saginaw County,3,33,-30
15,Hawaii,26,Michigan,147,St. Clair County,0,38,-38
15,Hawaii,26,Michigan,149,St. Joseph County,13,10,3
15,Hawaii,26,Michigan,155,Shiawassee County,6,0,6
15,Hawaii,26,Michigan,157,Tuscola County,14,0,14
15,Hawaii,26,Michigan,161,Washtenaw County,0,108,-108
15,Hawaii,26,Michigan,163,Wayne County,106,8,98
15,Hawaii,26,Michigan,165,Wexford County,0,10,-10
15,Hawaii,27,Minnesota,3,Anoka County,57,0,57
15,Hawaii,27,Minnesota,7,Beltrami County,33,0,33
15,Hawaii,27,Minnesota,9,Benton County,0,160,-160
15,Hawaii,27,Minnesota,27,Clay County,0,2,-2
15,Hawaii,27,Minnesota,35,Crow Wing County,0,15,-15
15,Hawaii,27,Minnesota,37,Dakota County,18,11,7
15,Hawaii,27,Minnesota,45,Fillmore County,0,5,-5
15,Hawaii,27,Minnesota,51,Grant County,0,2,-2
15,Hawaii,27,Minnesota,53,Hennepin County,93,86,7
15,Hawaii,27,Minnesota,59,Isanti County,0,41,-41
15,Hawaii,27,Minnesota,63,Jackson County,0,2,-2
15,Hawaii,27,Minnesota,73,Lac qui Parle County,0,1,-1
15,Hawaii,27,Minnesota,79,Le Sueur County,28,0,28
15,Hawaii,27,Minnesota,99,Mower County,0,3,-3
15,Hawaii,27,Minnesota,109,Olmsted County,23,0,23
15,Hawaii,27,Minnesota,111,Otter Tail County,0,32,-32
15,Hawaii,27,Minnesota,115,Pine County,0,36,-36
15,Hawaii,27,Minnesota,123,Ramsey County,77,4,73
15,Hawaii,27,Minnesota,131,Rice County,0,4,-4
15,Hawaii,27,Minnesota,145,Stearns County,0,15,-15
15,Hawaii,27,Minnesota,147,Steele County,0,3,-3
15,Hawaii,27,Minnesota,159,Wadena County,31,0,31
15,Hawaii,27,Minnesota,163,Washington County,49,24,25
15,Hawaii,27,Minnesota,171,Wright County,0,3,-3
15,Hawaii,28,Mississippi,11,Bolivar County,0,9,-9
15,Hawaii,28,Mississippi,29,Copiah County,8,0,8
15,Hawaii,28,Mississippi,33,DeSoto County,0,10,-10
15,Hawaii,28,Mississippi,35,Forrest County,0,8,-8
15,Hawaii,28,Mississippi,45,Hancock County,10,0,10
15,Hawaii,28,Mississippi,47,Harrison County,59,73,-14
15,Hawaii,28,Mississippi,49,Hinds County,81,68,13
15,Hawaii,28,Mississippi,59,Jackson County,6,63,-57
15,Hawaii,28,Mississippi,71,Lafayette County,0,12,-12
15,Hawaii,28,Mississippi,75,Lauderdale County,3,25,-22
15,Hawaii,28,Mississippi,109,Pearl River County,0,16,-16
15,Hawaii,28,Mississippi,121,Rankin County,0,66,-66
15,Hawaii,28,Mississippi,149,Warren County,0,5,-5
15,Hawaii,29,Missouri,21,Buchanan County,0,4,-4
15,Hawaii,29,Missouri,23,Butler County,19,17,2
15,Hawaii,29,Missouri,25,Caldwell County,0,9,-9
15,Hawaii,29,Missouri,27,Callaway County,12,0,12
15,Hawaii,29,Missouri,37,Cass County,0,28,-28
15,Hawaii,29,Missouri,43,Christian County,28,0,28
15,Hawaii,29,Missouri,47,Clay County,49,30,19
15,Hawaii,29,Missouri,77,Greene County,0,26,-26
15,Hawaii,29,Missouri,93,Iron County,0,43,-43
15,Hawaii,29,Missouri,95,Jackson County,30,53,-23
15,Hawaii,29,Missouri,99,Jefferson County,1,0,1
15,Hawaii,29,Missouri,105,Laclede County,18,13,5
15,Hawaii,29,Missouri,139,Montgomery County,0,16,-16
15,Hawaii,29,Missouri,145,Newton County,0,69,-69
15,Hawaii,29,Missouri,147,Nodaway County,51,0,51
15,Hawaii,29,Missouri,159,Pettis County,0,69,-69
15,Hawaii,29,Missouri,165,Platte County,20,68,-48
15,Hawaii,29,Missouri,169,Pulaski County,229,146,83
15,Hawaii,29,Missouri,183,St. Charles County,0,37,-37
15,Hawaii,29,Missouri,189,St. Louis County,111,19,92
15,Hawaii,29,Missouri,209,Stone County,0,21,-21
15,Hawaii,29,Missouri,213,Taney County,0,18,-18
15,Hawaii,29,Missouri,223,Wayne County,8,0,8
15,Hawaii,29,Missouri,225,Webster County,0,37,-37
15,Hawaii,29,Missouri,229,Wright County,3,0,3
15,Hawaii,29,Missouri,510,St. Louis city,62,35,27
15,Hawaii,30,Montana,3,Big Horn County,0,62,-62
15,Hawaii,30,Montana,13,Cascade County,52,22,30
15,Hawaii,30,Montana,29,Flathead County,12,0,12
15,Hawaii,30,Montana,31,Gallatin County,0,20,-20
15,Hawaii,30,Montana,53,Lincoln County,14,0,14
15,Hawaii,30,Montana,63,Missoula County,9,9,0
15,Hawaii,30,Montana,81,Ravalli County,10,0,10
15,Hawaii,30,Montana,111,Yellowstone County,0,10,-10
15,Hawaii,31,Nebraska,37,Colfax County,2,0,2
15,Hawaii,31,Nebraska,53,Dodge County,32,0,32
15,Hawaii,31,Nebraska,55,Douglas County,80,80,0
15,Hawaii,31,Nebraska,109,Lancaster County,35,4,31
15,Hawaii,31,Nebraska,121,Merrick County,4,0,4
15,Hawaii,31,Nebraska,127,Nemaha County,9,1,8
15,Hawaii,31,Nebraska,153,Sarpy County,0,71,-71
15,Hawaii,31,Nebraska,157,Scotts Bluff County,0,5,-5
15,Hawaii,31,Nebraska,173,Thurston County,0,10,-10
15,Hawaii,31,Nebraska,185,York County,0,3,-3
15,Hawaii,32,Nevada,1,Churchill County,31,65,-34
15,Hawaii,32,Nevada,3,Clark County,1179,3870,-2691
15,Hawaii,32,Nevada,7,Elko County,13,6,7
15,Hawaii,32,Nevada,19,Lyon County,6,25,-19
15,Hawaii,32,Nevada,23,Nye County,6,0,6
15,Hawaii,32,Nevada,31,Washoe County,149,382,-233
15,Hawaii,32,Nevada,510,Carson City,10,54,-44
15,Hawaii,33,New Hampshire,9,Grafton County,13,6,7
15,Hawaii,33,New Hampshire,11,Hillsborough County,0,56,-56
15,Hawaii,33,New Hampshire,13,Merrimack County,0,62,-62
15,Hawaii,33,New Hampshire,15,Rockingham County,0,11,-11
15,Hawaii,33,New Hampshire,17,Strafford County,21,0,21
15,Hawaii,34,New Jersey,3,Bergen County,52,9,43
15,Hawaii,34,New Jersey,5,Burlington County,68,91,-23
15,Hawaii,34,New Jersey,7,Camden County,8,0,8
15,Hawaii,34,New Jersey,9,Cape May County,7,15,-8
15,Hawaii,34,New Jersey,11,Cumberland County,0,17,-17
15,Hawaii,34,New Jersey,13,Essex County,9,21,-12
15,Hawaii,34,New Jersey,15,Gloucester County,38,0,38
15,Hawaii,34,New Jersey,17,Hudson County,45,59,-14
15,Hawaii,34,New Jersey,19,Hunterdon County,0,2,-2
15,Hawaii,34,New Jersey,23,Middlesex County,8,36,-28
15,Hawaii,34,New Jersey,25,Monmouth County,16,16,0
15,Hawaii,34,New Jersey,27,Morris County,34,0,34
15,Hawaii,34,New Jersey,29,Ocean County,18,71,-53
15,Hawaii,34,New Jersey,31,Passaic County,26,14,12
15,Hawaii,34,New Jersey,37,Sussex County,6,8,-2
15,Hawaii,35,New Mexico,1,Bernalillo County,294,114,180
15,Hawaii,35,New Mexico,5,Chaves County,0,52,-52
15,Hawaii,35,New Mexico,7,Colfax County,0,1,-1
15,Hawaii,35,New Mexico,9,Curry County,14,0,14
15,Hawaii,35,New Mexico,13,Doña Ana County,47,16,31
15,Hawaii,35,New Mexico,15,Eddy County,14,0,14
15,Hawaii,35,New Mexico,31,McKinley County,0,27,-27
15,Hawaii,35,New Mexico,35,Otero County,13,65,-52
15,Hawaii,35,New Mexico,37,Quay County,0,28,-28
15,Hawaii,35,New Mexico,43,Sandoval County,3,6,-3
15,Hawaii,35,New Mexico,49,Santa Fe County,33,87,-54
15,Hawaii,35,New Mexico,61,Valencia County,0,30,-30
15,Hawaii,36,New York,3,Allegany County,19,0,19
15,Hawaii,36,New York,5,Bronx County,62,5,57
15,Hawaii,36,New York,19,Clinton County,0,63,-63
15,Hawaii,36,New York,27,Dutchess County,0,41,-41
15,Hawaii,36,New York,29,Erie County,14,17,-3
15,Hawaii,36,New York,33,Franklin County,10,0,10
15,Hawaii,36,New York,45,Jefferson County,382,340,42
15,Hawaii,36,New York,47,Kings County,217,70,147
15,Hawaii,36,New York,49,Lewis County,7,0,7
15,Hawaii,36,New York,53,Madison County,50,21,29
15,Hawaii,36,New York,55,Monroe County,7,21,-14
15,Hawaii,36,New York,59,Nassau County,83,25,58
15,Hawaii,36,New York,61,New York County,77,281,-204
15,Hawaii,36,New York,65,Oneida County,102,13,89
15,Hawaii,36,New York,67,Onondaga County,24,75,-51
15,Hawaii,36,New York,69,Ontario County,33,0,33
15,Hawaii,36,New York,71,Orange County,3,18,-15
15,Hawaii,36,New York,75,Oswego County,55,0,55
15,Hawaii,36,New York,81,Queens County,152,29,123
15,Hawaii,36,New York,83,Rensselaer County,5,12,-7
15,Hawaii,36,New York,85,Richmond County,65,51,14
15,Hawaii,36,New York,87,Rockland County,9,9,0
15,Hawaii,36,New York,89,St. Lawrence County,13,0,13
15,Hawaii,36,New York,91,Saratoga County,186,0,186
15,Hawaii,36,New York,93,Schenectady County,73,0,73
15,Hawaii,36,New York,101,Steuben County,0,5,-5
15,Hawaii,36,New York,103,Suffolk County,51,39,12
15,Hawaii,36,New York,105,Sullivan County,0,5,-5
15,Hawaii,36,New York,107,Tioga County,8,0,8
15,Hawaii,36,New York,111,Ulster County,7,0,7
15,Hawaii,36,New York,115,Washington County,0,36,-36
15,Hawaii,36,New York,119,Westchester County,25,57,-32
15,Hawaii,37,North Carolina,13,Beaufort County,0,2,-2
15,Hawaii,37,North Carolina,19,Brunswick County,10,0,10
15,Hawaii,37,North Carolina,21,Buncombe County,7,26,-19
15,Hawaii,37,North Carolina,23,Burke County,0,12,-12
15,Hawaii,37,North Carolina,25,Cabarrus County,0,100,-100
15,Hawaii,37,North Carolina,37,Chatham County,0,76,-76
15,Hawaii,37,North Carolina,45,Cleveland County,8,0,8
15,Hawaii,37,North Carolina,49,Craven County,99,44,55
15,Hawaii,37,North Carolina,51,Cumberland County,787,668,119
15,Hawaii,37,North Carolina,53,Currituck County,45,0,45
15,Hawaii,37,North Carolina,55,Dare County,21,0,21
15,Hawaii,37,North Carolina,63,Durham County,73,44,29
15,Hawaii,37,North Carolina,67,Forsyth County,0,8,-8
15,Hawaii,37,North Carolina,71,Gaston County,5,8,-3
15,Hawaii,37,North Carolina,85,Harnett County,86,142,-56
15,Hawaii,37,North Carolina,87,Haywood County,0,12,-12
15,Hawaii,37,North Carolina,89,Henderson County,1,0,1
15,Hawaii,37,North Carolina,93,Hoke County,12,3,9
15,Hawaii,37,North Carolina,101,Johnston County,17,0,17
15,Hawaii,37,North Carolina,109,Lincoln County,0,64,-64
15,Hawaii,37,North Carolina,119,Mecklenburg County,89,74,15
15,Hawaii,37,North Carolina,125,Moore County,94,17,77
15,Hawaii,37,North Carolina,129,New Hanover County,18,5,13
15,Hawaii,37,North Carolina,133,Onslow County,290,370,-80
15,Hawaii,37,North Carolina,135,Orange County,41,188,-147
15,Hawaii,37,North Carolina,139,Pasquotank County,6,0,6
15,Hawaii,37,North Carolina,143,Perquimans County,3,0,3
15,Hawaii,37,North Carolina,157,Rockingham County,0,10,-10
15,Hawaii,37,North Carolina,159,Rowan County,15,0,15
15,Hawaii,37,North Carolina,183,Wake County,117,87,30
15,Hawaii,37,North Carolina,191,Wayne County,36,0,36
15,Hawaii,37,North Carolina,193,Wilkes County,71,0,71
15,Hawaii,37,North Carolina,199,Yancey County,24,0,24
15,Hawaii,38,North Dakota,3,Barnes County,0,4,-4
15,Hawaii,38,North Dakota,17,Cass County,0,57,-57
15,Hawaii,38,North Dakota,23,Divide County,17,0,17
15,Hawaii,38,North Dakota,35,Grand Forks County,0,17,-17
15,Hawaii,38,North Dakota,71,Ramsey County,0,5,-5
15,Hawaii,38,North Dakota,95,Towner County,0,2,-2
15,Hawaii,38,North Dakota,101,Ward County,0,32,-32
15,Hawaii,39,Ohio,1,Adams County,9,0,9
15,Hawaii,39,Ohio,9,Athens County,0,8,-8
15,Hawaii,39,Ohio,17,Butler County,72,0,72
15,Hawaii,39,Ohio,23,Clark County,12,0,12
15,Hawaii,39,Ohio,27,Clinton County,12,0,12
15,Hawaii,39,Ohio,29,Columbiana County,8,0,8
15,Hawaii,39,Ohio,35,Cuyahoga County,6,69,-63
15,Hawaii,39,Ohio,39,Defiance County,14,0,14
15,Hawaii,39,Ohio,41,Delaware County,19,0,19
15,Hawaii,39,Ohio,43,Erie County,0,93,-93
15,Hawaii,39,Ohio,45,Fairfield County,30,0,30
15,Hawaii,39,Ohio,49,Franklin County,58,11,47
15,Hawaii,39,Ohio,51,Fulton County,10,0,10
15,Hawaii,39,Ohio,57,Greene County,82,6,76
15,Hawaii,39,Ohio,59,Guernsey County,0,9,-9
15,Hawaii,39,Ohio,61,Hamilton County,27,7,20
15,Hawaii,39,Ohio,83,Knox County,0,20,-20
15,Hawaii,39,Ohio,89,Licking County,39,0,39
15,Hawaii,39,Ohio,93,Lorain County,21,0,21
15,Hawaii,39,Ohio,95,Lucas County,16,0,16
15,Hawaii,39,Ohio,99,Mahoning County,42,9,33
15,Hawaii,39,Ohio,103,Medina County,30,0,30
15,Hawaii,39,Ohio,107,Mercer County,19,0,19
15,Hawaii,39,Ohio,113,Montgomery County,70,0,70
15,Hawaii,39,Ohio,129,Pickaway County,18,0,18
15,Hawaii,39,Ohio,133,Portage County,0,35,-35
15,Hawaii,39,Ohio,139,Richland County,18,0,18
15,Hawaii,39,Ohio,141,Ross County,10,26,-16
15,Hawaii,39,Ohio,147,Seneca County,8,0,8
15,Hawaii,39,Ohio,149,Shelby County,2,0,2
15,Hawaii,39,Ohio,153,Summit County,0,11,-11
15,Hawaii,39,Ohio,165,Warren County,22,139,-117
15,Hawaii,39,Ohio,167,Washington County,7,0,7
15,Hawaii,39,Ohio,169,Wayne County,0,4,-4
15,Hawaii,4,Arizona,3,Cochise County,230,26,204
15,Hawaii,4,Arizona,5,Coconino County,32,338,-306
15,Hawaii,4,Arizona,7,Gila County,30,0,30
15,Hawaii,4,Arizona,9,Graham County,0,12,-12
15,Hawaii,4,Arizona,13,Maricopa County,778,1206,-428
15,Hawaii,4,Arizona,15,Mohave County,34,56,-22
15,Hawaii,4,Arizona,17,Navajo County,72,26,46
15,Hawaii,4,Arizona,19,Pima County,310,396,-86
15,Hawaii,4,Arizona,21,Pinal County,261,94,167
15,Hawaii,4,Arizona,25,Yavapai County,244,87,157
15,Hawaii,4,Arizona,27,Yuma County,32,127,-95
15,Hawaii,40,Oklahoma,21,Cherokee County,0,20,-20
15,Hawaii,40,Oklahoma,31,Comanche County,336,154,182
15,Hawaii,40,Oklahoma,37,Creek County,5,0,5
15,Hawaii,40,Oklahoma,47,Garfield County,0,13,-13
15,Hawaii,40,Oklahoma,65,Jackson County,0,35,-35
15,Hawaii,40,Oklahoma,81,Lincoln County,16,0,16
15,Hawaii,40,Oklahoma,83,Logan County,0,17,-17
15,Hawaii,40,Oklahoma,85,Love County,0,6,-6
15,Hawaii,40,Oklahoma,89,McCurtain County,0,2,-2
15,Hawaii,40,Oklahoma,97,Mayes County,8,0,8
15,Hawaii,40,Oklahoma,101,Muskogee County,15,0,15
15,Hawaii,40,Oklahoma,109,Oklahoma County,72,21,51
15,Hawaii,40,Oklahoma,111,Okmulgee County,0,2,-2
15,Hawaii,40,Oklahoma,121,Pittsburg County,0,49,-49
15,Hawaii,40,Oklahoma,125,Pottawatomie County,7,0,7
15,Hawaii,40,Oklahoma,131,Rogers County,0,16,-16
15,Hawaii,40,Oklahoma,133,Seminole County,10,0,10
15,Hawaii,40,Oklahoma,141,Tillman County,0,66,-66
15,Hawaii,40,Oklahoma,143,Tulsa County,33,11,22
15,Hawaii,40,Oklahoma,145,Wagoner County,0,15,-15
15,Hawaii,40,Oklahoma,153,Woodward County,0,28,-28
15,Hawaii,41,Oregon,3,Benton County,13,125,-112
15,Hawaii,41,Oregon,5,Clackamas County,61,251,-190
15,Hawaii,41,Oregon,7,Clatsop County,12,147,-135
15,Hawaii,41,Oregon,9,Columbia County,4,0,4
15,Hawaii,41,Oregon,11,Coos County,14,41,-27
15,Hawaii,41,Oregon,13,Crook County,0,11,-11
15,Hawaii,41,Oregon,17,Deschutes County,191,295,-104
15,Hawaii,41,Oregon,19,Douglas County,8,117,-109
15,Hawaii,41,Oregon,27,Hood River County,0,22,-22
15,Hawaii,41,Oregon,29,Jackson County,106,297,-191
15,Hawaii,41,Oregon,31,Jefferson County,0,11,-11
15,Hawaii,41,Oregon,33,Josephine County,0,29,-29
15,Hawaii,41,Oregon,35,Klamath County,5,6,-1
15,Hawaii,41,Oregon,39,Lane County,88,108,-20
15,Hawaii,41,Oregon,41,Lincoln County,0,86,-86
15,Hawaii,41,Oregon,43,Linn County,45,89,-44
15,Hawaii,41,Oregon,45,Malheur County,28,0,28
15,Hawaii,41,Oregon,47,Marion County,67,93,-26
15,Hawaii,41,Oregon,51,Multnomah County,278,380,-102
15,Hawaii,41,Oregon,53,Polk County,20,225,-205
15,Hawaii,41,Oregon,59,Umatilla County,0,5,-5
15,Hawaii,41,Oregon,61,Union County,39,10,29
15,Hawaii,41,Oregon,63,Wallowa County,0,2,-2
15,Hawaii,41,Oregon,65,Wasco County,0,50,-50
15,Hawaii,41,Oregon,67,Washington County,191,429,-238
15,Hawaii,41,Oregon,71,Yamhill County,64,41,23
15,Hawaii,42,Pennsylvania,3,Allegheny County,119,27,92
15,Hawaii,42,Pennsylvania,7,Beaver County,0,37,-37
15,Hawaii,42,Pennsylvania,11,Berks County,13,21,-8
15,Hawaii,42,Pennsylvania,15,Bradford County,12,0,12
15,Hawaii,42,Pennsylvania,17,Bucks County,137,62,75
15,Hawaii,42,Pennsylvania,19,Butler County,0,60,-60
15,Hawaii,42,Pennsylvania,21,Cambria County,0,5,-5
15,Hawaii,42,Pennsylvania,27,Centre County,11,123,-112
15,Hawaii,42,Pennsylvania,29,Chester County,0,85,-85
15,Hawaii,42,Pennsylvania,39,Crawford County,13,8,5
15,Hawaii,42,Pennsylvania,41,Cumberland County,0,40,-40
15,Hawaii,42,Pennsylvania,43,Dauphin County,13,0,13
15,Hawaii,42,Pennsylvania,45,Delaware County,22,0,22
15,Hawaii,42,Pennsylvania,49,Erie County,8,37,-29
15,Hawaii,42,Pennsylvania,51,Fayette County,14,6,8
15,Hawaii,42,Pennsylvania,65,Jefferson County,0,17,-17
15,Hawaii,42,Pennsylvania,75,Lebanon County,8,0,8
15,Hawaii,42,Pennsylvania,77,Lehigh County,0,59,-59
15,Hawaii,42,Pennsylvania,89,Monroe County,92,33,59
15,Hawaii,42,Pennsylvania,91,Montgomery County,8,18,-10
15,Hawaii,42,Pennsylvania,95,Northampton County,53,21,32
15,Hawaii,42,Pennsylvania,101,Philadelphia County,261,41,220
15,Hawaii,42,Pennsylvania,125,Washington County,53,18,35
15,Hawaii,42,Pennsylvania,129,Westmoreland County,0,7,-7
15,Hawaii,42,Pennsylvania,133,York County,13,0,13
15,Hawaii,44,Rhode Island,3,Kent County,2,0,2
15,Hawaii,44,Rhode Island,5,Newport County,147,59,88
15,Hawaii,44,Rhode Island,7,Providence County,44,10,34
15,Hawaii,44,Rhode Island,9,Washington County,12,0,12
15,Hawaii,45,South Carolina,13,Beaufort County,67,73,-6
15,Hawaii,45,South Carolina,15,Berkeley County,156,55,101
15,Hawaii,45,South Carolina,19,Charleston County,126,307,-181
15,Hawaii,45,South Carolina,35,Dorchester County,73,7,66
15,Hawaii,45,South Carolina,41,Florence County,29,0,29
15,Hawaii,45,South Carolina,45,Greenville County,0,19,-19
15,Hawaii,45,South Carolina,51,Horry County,35,0,35
15,Hawaii,45,South Carolina,53,Jasper County,25,0,25
15,Hawaii,45,South Carolina,63,Lexington County,0,11,-11
15,Hawaii,45,South Carolina,67,Marion County,14,0,14
15,Hawaii,45,South Carolina,73,Oconee County,92,8,84
15,Hawaii,45,South Carolina,75,Orangeburg County,0,32,-32
15,Hawaii,45,South Carolina,79,Richland County,475,179,296
15,Hawaii,45,South Carolina,83,Spartanburg County,97,0,97
15,Hawaii,45,South Carolina,85,Sumter County,48,0,48
15,Hawaii,46,South Dakota,29,Codington County,0,7,-7
15,Hawaii,46,South Dakota,83,Lincoln County,4,12,-8
15,Hawaii,46,South Dakota,93,Meade County,37,0,37
15,Hawaii,46,South Dakota,99,Minnehaha County,11,0,11
15,Hawaii,46,South Dakota,135,Yankton County,0,80,-80
15,Hawaii,47,Tennessee,1,Anderson County,1,27,-26
15,Hawaii,47,Tennessee,9,Blount County,20,0,20
15,Hawaii,47,Tennessee,19,Carter County,3,0,3
15,Hawaii,47,Tennessee,21,Cheatham County,0,19,-19
15,Hawaii,47,Tennessee,37,Davidson County,2,94,-92
15,Hawaii,47,Tennessee,51,Franklin County,0,78,-78
15,Hawaii,47,Tennessee,65,Hamilton County,0,20,-20
15,Hawaii,47,Tennessee,85,Humphreys County,3,0,3
15,Hawaii,47,Tennessee,93,Knox County,0,12,-12
15,Hawaii,47,Tennessee,97,Lauderdale County,20,0,20
15,Hawaii,47,Tennessee,105,Loudon County,7,0,7
15,Hawaii,47,Tennessee,119,Maury County,0,67,-67
15,Hawaii,47,Tennessee,125,Montgomery County,366,156,210
15,Hawaii,47,Tennessee,147,Robertson County,0,24,-24
15,Hawaii,47,Tennessee,149,Rutherford County,17,59,-42
15,Hawaii,47,Tennessee,157,Shelby County,121,103,18
15,Hawaii,47,Tennessee,163,Sullivan County,227,6,221
15,Hawaii,47,Tennessee,165,Sumner County,0,20,-20
15,Hawaii,47,Tennessee,179,Washington County,33,38,-5
15,Hawaii,47,Tennessee,187,Williamson County,0,15,-15
15,Hawaii,48,Texas,1,Anderson County,24,0,24
15,Hawaii,48,Texas,5,Angelina County,22,0,22
15,Hawaii,48,Texas,9,Archer County,0,3,-3
15,Hawaii,48,Texas,15,Austin County,0,69,-69
15,Hawaii,48,Texas,21,Bastrop County,119,0,119
15,Hawaii,48,Texas,27,Bell County,1027,789,238
15,Hawaii,48,Texas,29,Bexar County,698,793,-95
15,Hawaii,48,Texas,35,Bosque County,5,0,5
15,Hawaii,48,Texas,37,Bowie County,32,0,32
15,Hawaii,48,Texas,39,Brazoria County,22,0,22
15,Hawaii,48,Texas,41,Brazos County,11,30,-19
15,Hawaii,48,Texas,61,Cameron County,51,7,44
15,Hawaii,48,Texas,71,Chambers County,0,8,-8
15,Hawaii,48,Texas,73,Cherokee County,21,39,-18
15,Hawaii,48,Texas,85,Collin County,112,61,51
15,Hawaii,48,Texas,91,Comal County,31,0,31
15,Hawaii,48,Texas,97,Cooke County,0,16,-16
15,Hawaii,48,Texas,99,Coryell County,0,139,-139
15,Hawaii,48,Texas,113,Dallas County,69,247,-178
15,Hawaii,48,Texas,121,Denton County,59,110,-51
15,Hawaii,48,Texas,129,Donley County,0,2,-2
15,Hawaii,48,Texas,135,Ector County,0,24,-24
15,Hawaii,48,Texas,139,Ellis County,18,0,18
15,Hawaii,48,Texas,141,El Paso County,578,378,200
15,Hawaii,48,Texas,157,Fort Bend County,46,83,-37
15,Hawaii,48,Texas,167,Galveston County,9,4,5
15,Hawaii,48,Texas,177,Gonzales County,7,1,6
15,Hawaii,48,Texas,181,Grayson County,0,5,-5
15,Hawaii,48,Texas,187,Guadalupe County,15,0,15
15,Hawaii,48,Texas,199,Hardin County,6,0,6
15,Hawaii,48,Texas,201,Harris County,312,159,153
15,Hawaii,48,Texas,213,Henderson County,3,0,3
15,Hawaii,48,Texas,215,Hidalgo County,9,0,9
15,Hawaii,48,Texas,217,Hill County,0,4,-4
15,Hawaii,48,Texas,223,Hopkins County,48,0,48
15,Hawaii,48,Texas,231,Hunt County,51,53,-2
15,Hawaii,48,Texas,237,Jack County,12,0,12
15,Hawaii,48,Texas,265,Kerr County,53,0,53
15,Hawaii,48,Texas,273,Kleberg County,0,100,-100
15,Hawaii,48,Texas,303,Lubbock County,0,246,-246
15,Hawaii,48,Texas,309,McLennan County,55,18,37
15,Hawaii,48,Texas,333,Mills County,0,11,-11
15,Hawaii,48,Texas,337,Montague County,9,6,3
15,Hawaii,48,Texas,339,Montgomery County,28,93,-65
15,Hawaii,48,Texas,347,Nacogdoches County,41,19,22
15,Hawaii,48,Texas,355,Nueces County,186,72,114
15,Hawaii,48,Texas,375,Potter County,0,15,-15
15,Hawaii,48,Texas,397,Rockwall County,36,0,36
15,Hawaii,48,Texas,409,San Patricio County,0,29,-29
15,Hawaii,48,Texas,423,Smith County,18,13,5
15,Hawaii,48,Texas,437,Swisher County,0,10,-10
15,Hawaii,48,Texas,439,Tarrant County,288,118,170
15,Hawaii,48,Texas,441,Taylor County,14,0,14
15,Hawaii,48,Texas,451,Tom Green County,25,66,-41
15,Hawaii,48,Texas,453,Travis County,63,586,-523
15,Hawaii,48,Texas,457,Tyler County,0,14,-14
15,Hawaii,48,Texas,459,Upshur County,63,102,-39
15,Hawaii,48,Texas,463,Uvalde County,0,2,-2
15,Hawaii,48,Texas,471,Walker County,15,0,15
15,Hawaii,48,Texas,485,Wichita County,37,193,-156
15,Hawaii,48,Texas,491,Williamson County,39,70,-31
15,Hawaii,49,Utah,3,Box Elder County,0,8,-8
15,Hawaii,49,Utah,5,Cache County,0,13,-13
15,Hawaii,49,Utah,11,Davis County,223,86,137
15,Hawaii,49,Utah,15,Emery County,9,0,9
15,Hawaii,49,Utah,19,Grand County,6,0,6
15,Hawaii,49,Utah,23,Juab County,7,0,7
15,Hawaii,49,Utah,35,Salt Lake County,181,846,-665
15,Hawaii,49,Utah,39,Sanpete County,0,7,-7
15,Hawaii,49,Utah,43,Summit County,11,0,11
15,Hawaii,49,Utah,49,Utah County,350,411,-61
15,Hawaii,49,Utah,53,Washington County,46,115,-69
15,Hawaii,49,Utah,57,Weber County,9,11,-2
15,Hawaii,5,Arkansas,7,Benton County,0,9,-9
15,Hawaii,5,Arkansas,45,Faulkner County,24,61,-37
15,Hawaii,5,Arkansas,119,Pulaski County,39,16,23
15,Hawaii,5,Arkansas,125,Saline County,9,0,9
15,Hawaii,5,Arkansas,143,Washington County,0,42,-42
15,Hawaii,50,Vermont,7,Chittenden County,0,12,-12
15,Hawaii,50,Vermont,15,Lamoille County,0,13,-13
15,Hawaii,50,Vermont,23,Washington County,23,0,23
15,Hawaii,50,Vermont,25,Windham County,0,17,-17
15,Hawaii,51,Virginia,3,Albemarle County,29,74,-45
15,Hawaii,51,Virginia,9,Amherst County,0,25,-25
15,Hawaii,51,Virginia,13,Arlington County,71,84,-13
15,Hawaii,51,Virginia,27,Buchanan County,19,0,19
15,Hawaii,51,Virginia,33,Caroline County,171,0,171
15,Hawaii,51,Virginia,41,Chesterfield County,14,219,-205
15,Hawaii,51,Virginia,59,Fairfax County,281,664,-383
15,Hawaii,51,Virginia,61,Fauquier County,24,0,24
15,Hawaii,51,Virginia,73,Gloucester County,106,13,93
15,Hawaii,51,Virginia,87,Henrico County,34,0,34
15,Hawaii,51,Virginia,89,Henry County,11,0,11
15,Hawaii,51,Virginia,95,James City County,0,134,-134
15,Hawaii,51,Virginia,99,King George County,31,2,29
15,Hawaii,51,Virginia,107,Loudoun County,5,47,-42
15,Hawaii,51,Virginia,121,Montgomery County,0,41,-41
15,Hawaii,51,Virginia,131,Northampton County,3,0,3
15,Hawaii,51,Virginia,149,Prince George County,62,228,-166
15,Hawaii,51,Virginia,153,Prince William County,76,237,-161
15,Hawaii,51,Virginia,161,Roanoke County,5,0,5
15,Hawaii,51,Virginia,163,Rockbridge County,0,25,-25
15,Hawaii,51,Virginia,177,Spotsylvania County,0,23,-23
15,Hawaii,51,Virginia,179,Stafford County,107,246,-139
15,Hawaii,51,Virginia,199,York County,119,59,60
15,Hawaii,51,Virginia,510,Alexandria city,201,89,112
15,Hawaii,51,Virginia,540,Charlottesville city,12,0,12
15,Hawaii,51,Virginia,550,Chesapeake city,51,183,-132
15,Hawaii,51,Virginia,610,Falls Church city,0,51,-51
15,Hawaii,51,Virginia,650,Hampton city,156,11,145
15,Hawaii,51,Virginia,660,Harrisonburg city,0,21,-21
15,Hawaii,51,Virginia,680,Lynchburg city,0,12,-12
15,Hawaii,51,Virginia,683,Manassas city,0,14,-14
15,Hawaii,51,Virginia,700,Newport News city,134,225,-91
15,Hawaii,51,Virginia,710,Norfolk city,207,72,135
15,Hawaii,51,Virginia,730,Petersburg city,47,0,47
15,Hawaii,51,Virginia,740,Portsmouth city,78,7,71
15,Hawaii,51,Virginia,760,Richmond city,0,10,-10
15,Hawaii,51,Virginia,770,Roanoke city,9,0,9
15,Hawaii,51,Virginia,775,Salem city,0,22,-22
15,Hawaii,51,Virginia,800,Suffolk city,18,92,-74
15,Hawaii,51,Virginia,810,Virginia Beach city,310,394,-84
15,Hawaii,51,Virginia,830,Williamsburg city,51,9,42
15,Hawaii,53,Washington,3,Asotin County,5,0,5
15,Hawaii,53,Washington,5,Benton County,21,4,17
15,Hawaii,53,Washington,9,Clallam County,7,81,-74
15,Hawaii,53,Washington,11,Clark County,133,12,121
15,Hawaii,53,Washington,15,Cowlitz County,81,23,58
15,Hawaii,53,Washington,21,Franklin County,78,0,78
15,Hawaii,53,Washington,27,Grays Harbor County,45,0,45
15,Hawaii,53,Washington,29,Island County,78,126,-48
15,Hawaii,53,Washington,31,Jefferson County,8,88,-80
15,Hawaii,53,Washington,33,King County,1349,1284,65
15,Hawaii,53,Washington,35,Kitsap County,156,290,-134
15,Hawaii,53,Washington,37,Kittitas County,335,4,331
15,Hawaii,53,Washington,39,Klickitat County,0,17,-17
15,Hawaii,53,Washington,47,Okanogan County,17,7,10
15,Hawaii,53,Washington,49,Pacific County,0,5,-5
15,Hawaii,53,Washington,53,Pierce County,702,815,-113
15,Hawaii,53,Washington,55,San Juan County,26,56,-30
15,Hawaii,53,Washington,57,Skagit County,19,92,-73
15,Hawaii,53,Washington,61,Snohomish County,170,383,-213
15,Hawaii,53,Washington,63,Spokane County,84,167,-83
15,Hawaii,53,Washington,65,Stevens County,0,53,-53
15,Hawaii,53,Washington,67,Thurston County,200,854,-654
15,Hawaii,53,Washington,71,Walla Walla County,21,28,-7
15,Hawaii,53,Washington,73,Whatcom County,36,110,-74
15,Hawaii,53,Washington,75,Whitman County,23,79,-56
15,Hawaii,53,Washington,77,Yakima County,21,48,-27
15,Hawaii,54,West Virginia,39,Kanawha County,20,0,20
15,Hawaii,54,West Virginia,55,Mercer County,7,0,7
15,Hawaii,55,Wisconsin,9,Brown County,17,32,-15
15,Hawaii,55,Wisconsin,11,Buffalo County,0,1,-1
15,Hawaii,55,Wisconsin,25,Dane County,84,92,-8
15,Hawaii,55,Wisconsin,27,Dodge County,3,0,3
15,Hawaii,55,Wisconsin,33,Dunn County,25,0,25
15,Hawaii,55,Wisconsin,35,Eau Claire County,0,15,-15
15,Hawaii,55,Wisconsin,55,Jefferson County,0,14,-14
15,Hawaii,55,Wisconsin,57,Juneau County,0,4,-4
15,Hawaii,55,Wisconsin,59,Kenosha County,0,10,-10
15,Hawaii,55,Wisconsin,63,La Crosse County,0,69,-69
15,Hawaii,55,Wisconsin,71,Manitowoc County,6,86,-80
15,Hawaii,55,Wisconsin,79,Milwaukee County,0,25,-25
15,Hawaii,55,Wisconsin,81,Monroe County,0,2,-2
15,Hawaii,55,Wisconsin,87,Outagamie County,16,68,-52
15,Hawaii,55,Wisconsin,109,St. Croix County,0,50,-50
15,Hawaii,55,Wisconsin,115,Shawano County,1,0,1
15,Hawaii,55,Wisconsin,117,Sheboygan County,16,0,16
15,Hawaii,55,Wisconsin,121,Trempealeau County,0,10,-10
15,Hawaii,55,Wisconsin,133,Waukesha County,71,16,55
15,Hawaii,55,Wisconsin,141,Wood County,0,2,-2
15,Hawaii,56,Wyoming,1,Albany County,0,78,-78
15,Hawaii,56,Wyoming,13,Fremont County,22,22,0
15,Hawaii,56,Wyoming,21,Laramie County,0,17,-17
15,Hawaii,56,Wyoming,39,Teton County,0,8,-8
15,Hawaii,6,California,1,Alameda County,411,590,-179
15,Hawaii,6,California,5,Amador County,8,0,8
15,Hawaii,6,California,7,Butte County,56,78,-22
15,Hawaii,6,California,9,Calaveras County,0,28,-28
15,Hawaii,6,California,11,Colusa County,0,12,-12
15,Hawaii,6,California,13,Contra Costa County,191,386,-195
15,Hawaii,6,California,17,El Dorado County,127,82,45
15,Hawaii,6,California,19,Fresno County,237,99,138
15,Hawaii,6,California,23,Humboldt County,34,56,-22
15,Hawaii,6,California,25,Imperial County,36,29,7
15,Hawaii,6,California,27,Inyo County,11,34,-23
15,Hawaii,6,California,29,Kern County,60,133,-73
15,Hawaii,6,California,31,Kings County,47,21,26
15,Hawaii,6,California,33,Lake County,13,0,13
15,Hawaii,6,California,37,Los Angeles County,1639,2091,-452
15,Hawaii,6,California,39,Madera County,0,15,-15
15,Hawaii,6,California,41,Marin County,102,82,20
15,Hawaii,6,California,43,Mariposa County,2,0,2
15,Hawaii,6,California,45,Mendocino County,0,22,-22
15,Hawaii,6,California,47,Merced County,0,30,-30
15,Hawaii,6,California,51,Mono County,0,5,-5
15,Hawaii,6,California,53,Monterey County,453,197,256
15,Hawaii,6,California,55,Napa County,29,62,-33
15,Hawaii,6,California,57,Nevada County,11,67,-56
15,Hawaii,6,California,59,Orange County,1533,682,851
15,Hawaii,6,California,61,Placer County,58,253,-195
15,Hawaii,6,California,65,Riverside County,528,627,-99
15,Hawaii,6,California,67,Sacramento County,206,449,-243
15,Hawaii,6,California,71,San Bernardino County,653,674,-21
15,Hawaii,6,California,73,San Diego County,2191,3288,-1097
15,Hawaii,6,California,75,San Francisco County,276,381,-105
15,Hawaii,6,California,77,San Joaquin County,97,82,15
15,Hawaii,6,California,79,San Luis Obispo County,3,154,-151
15,Hawaii,6,California,81,San Mateo County,295,283,12
15,Hawaii,6,California,83,Santa Barbara County,232,147,85
15,Hawaii,6,California,85,Santa Clara County,457,364,93
15,Hawaii,6,California,87,Santa Cruz County,305,121,184
15,Hawaii,6,California,89,Shasta County,77,52,25
15,Hawaii,6,California,93,Siskiyou County,16,0,16
15,Hawaii,6,California,95,Solano County,190,194,-4
15,Hawaii,6,California,97,Sonoma County,270,176,94
15,Hawaii,6,California,99,Stanislaus County,7,0,7
15,Hawaii,6,California,101,Sutter County,1,0,1
15,Hawaii,6,California,107,Tulare County,10,158,-148
15,Hawaii,6,California,109,Tuolumne County,0,32,-32
15,Hawaii,6,California,111,Ventura County,202,585,-383
15,Hawaii,6,California,113,Yolo County,38,59,-21
15,Hawaii,6,California,115,Yuba County,106,23,83
15,Hawaii,72,Puerto Rico,5,Aguadilla Municipio,37,0,37
15,Hawaii,72,Puerto Rico,21,Bayamón Municipio,12,0,12
15,Hawaii,72,Puerto Rico,25,Caguas Municipio,2,0,2
15,Hawaii,72,Puerto Rico,29,Canóvanas Municipio,0,17,-17
15,Hawaii,72,Puerto Rico,69,Humacao Municipio,1,0,1
15,Hawaii,72,Puerto Rico,89,Luquillo Municipio,0,23,-23
15,Hawaii,72,Puerto Rico,97,Mayagüez Municipio,0,18,-18
15,Hawaii,72,Puerto Rico,125,San Germán Municipio,10,0,10
15,Hawaii,72,Puerto Rico,127,San Juan Municipio,56,5,51
15,Hawaii,8,Colorado,1,Adams County,41,34,7
15,Hawaii,8,Colorado,5,Arapahoe County,81,320,-239
15,Hawaii,8,Colorado,7,Archuleta County,0,10,-10
15,Hawaii,8,Colorado,9,Baca County,0,3,-3
15,Hawaii,8,Colorado,13,Boulder County,125,287,-162
15,Hawaii,8,Colorado,14,Broomfield County,0,57,-57
15,Hawaii,8,Colorado,19,Clear Creek County,15,0,15
15,Hawaii,8,Colorado,31,Denver County,139,316,-177
15,Hawaii,8,Colorado,35,Douglas County,123,122,1
15,Hawaii,8,Colorado,37,Eagle County,54,0,54
15,Hawaii,8,Colorado,39,Elbert County,23,0,23
15,Hawaii,8,Colorado,41,El Paso County,951,1031,-80
15,Hawaii,8,Colorado,43,Fremont County,2,0,2
15,Hawaii,8,Colorado,45,Garfield County,0,161,-161
15,Hawaii,8,Colorado,49,Grand County,0,65,-65
15,Hawaii,8,Colorado,51,Gunnison County,0,14,-14
15,Hawaii,8,Colorado,59,Jefferson County,233,144,89
15,Hawaii,8,Colorado,67,La Plata County,0,44,-44
15,Hawaii,8,Colorado,69,Larimer County,47,189,-142
15,Hawaii,8,Colorado,71,Las Animas County,0,4,-4
15,Hawaii,8,Colorado,77,Mesa County,29,76,-47
15,Hawaii,8,Colorado,83,Montezuma County,0,53,-53
15,Hawaii,8,Colorado,85,Montrose County,87,0,87
15,Hawaii,8,Colorado,91,Ouray County,0,4,-4
15,Hawaii,8,Colorado,97,Pitkin County,16,0,16
15,Hawaii,8,Colorado,101,Pueblo County,24,5,19
15,Hawaii,8,Colorado,105,Rio Grande County,0,43,-43
15,Hawaii,8,Colorado,107,Routt County,17,0,17
15,Hawaii,8,Colorado,119,Teller County,13,0,13
15,Hawaii,8,Colorado,123,Weld County,0,16,-16
15,Hawaii,9,Connecticut,1,Fairfield County,58,107,-49
15,Hawaii,9,Connecticut,3,Hartford County,36,27,9
15,Hawaii,9,Connecticut,5,Litchfield County,0,9,-9
15,Hawaii,9,Connecticut,9,New Haven County,58,28,30
15,Hawaii,9,Connecticut,11,New London County,267,278,-11
15,Hawaii,9,Connecticut,15,Windham County,15,0,15
15,Hawaii,AFR,Africa,,-,105,0,0
15,Hawaii,ASI,Asia,,-,9978,0,0
15,Hawaii,CAM,Central America,,-,384,0,0
15,Hawaii,CAR,Caribbean,,-,65,0,0
15,Hawaii,EUR,Europe,,-,2136,0,0
15,Hawaii,ISL,U.S. Island Areas,,-,1220,0,0
15,Hawaii,NAM,Northern America,,-,485,0,0
15,Hawaii,OCE,Oceania and At Sea,,-,1078,0,0
15,Hawaii,SAM,South America,,-,156,0,0
16,Idaho,1,Alabama,1,Autauga County,0,11,-11
16,Idaho,1,Alabama,3,Baldwin County,14,0,14
16,Idaho,1,Alabama,5,Barbour County,0,5,-5
16,Idaho,1,Alabama,15,Calhoun County,0,21,-21
16,Idaho,1,Alabama,19,Cherokee County,0,10,-10
16,Idaho,1,Alabama,25,Clarke County,0,7,-7
16,Idaho,1,Alabama,45,Dale County,52,0,52
16,Idaho,1,Alabama,69,Houston County,32,32,0
16,Idaho,1,Alabama,73,Jefferson County,21,12,9
16,Idaho,1,Alabama,77,Lauderdale County,3,0,3
16,Idaho,1,Alabama,83,Limestone County,0,40,-40
16,Idaho,1,Alabama,95,Marshall County,4,32,-28
16,Idaho,1,Alabama,101,Montgomery County,10,0,10
16,Idaho,1,Alabama,103,Morgan County,0,1,-1
16,Idaho,1,Alabama,113,Russell County,0,20,-20
16,Idaho,1,Alabama,115,St. Clair County,5,0,5
16,Idaho,1,Alabama,123,Tallapoosa County,0,26,-26
16,Idaho,10,Delaware,1,Kent County,0,6,-6
16,Idaho,10,Delaware,3,New Castle County,27,0,27
16,Idaho,11,District of Columbia,1,District of Columbia,18,144,-126
16,Idaho,12,Florida,1,Alachua County,92,0,92
16,Idaho,12,Florida,5,Bay County,8,42,-34
16,Idaho,12,Florida,9,Brevard County,69,7,62
16,Idaho,12,Florida,11,Broward County,8,60,-52
16,Idaho,12,Florida,17,Citrus County,0,9,-9
16,Idaho,12,Florida,19,Clay County,27,15,12
16,Idaho,12,Florida,21,Collier County,27,25,2
16,Idaho,12,Florida,31,Duval County,10,39,-29
16,Idaho,12,Florida,33,Escambia County,67,187,-120
16,Idaho,12,Florida,35,Flagler County,9,15,-6
16,Idaho,12,Florida,57,Hillsborough County,54,83,-29
16,Idaho,12,Florida,61,Indian River County,0,17,-17
16,Idaho,12,Florida,71,Lee County,68,50,18
16,Idaho,12,Florida,73,Leon County,25,0,25
16,Idaho,12,Florida,81,Manatee County,0,172,-172
16,Idaho,12,Florida,83,Marion County,0,37,-37
16,Idaho,12,Florida,85,Martin County,0,69,-69
16,Idaho,12,Florida,86,Miami-Dade County,62,0,62
16,Idaho,12,Florida,87,Monroe County,12,0,12
16,Idaho,12,Florida,91,Okaloosa County,41,26,15
16,Idaho,12,Florida,95,Orange County,30,18,12
16,Idaho,12,Florida,97,Osceola County,73,79,-6
16,Idaho,12,Florida,99,Palm Beach County,59,50,9
16,Idaho,12,Florida,101,Pasco County,28,32,-4
16,Idaho,12,Florida,105,Polk County,137,0,137
16,Idaho,12,Florida,109,St. Johns County,0,7,-7
16,Idaho,12,Florida,115,Sarasota County,0,115,-115
16,Idaho,12,Florida,133,Washington County,0,10,-10
16,Idaho,13,Georgia,13,Barrow County,0,13,-13
16,Idaho,13,Georgia,21,Bibb County,0,56,-56
16,Idaho,13,Georgia,29,Bryan County,34,0,34
16,Idaho,13,Georgia,51,Chatham County,4,84,-80
16,Idaho,13,Georgia,53,Chattahoochee County,0,37,-37
16,Idaho,13,Georgia,57,Cherokee County,0,14,-14
16,Idaho,13,Georgia,59,Clarke County,6,32,-26
16,Idaho,13,Georgia,63,Clayton County,0,30,-30
16,Idaho,13,Georgia,67,Cobb County,25,98,-73
16,Idaho,13,Georgia,73,Columbia County,21,0,21
16,Idaho,13,Georgia,89,DeKalb County,0,20,-20
16,Idaho,13,Georgia,111,Fannin County,38,0,38
16,Idaho,13,Georgia,113,Fayette County,27,0,27
16,Idaho,13,Georgia,115,Floyd County,0,75,-75
16,Idaho,13,Georgia,117,Forsyth County,0,6,-6
16,Idaho,13,Georgia,121,Fulton County,104,21,83
16,Idaho,13,Georgia,135,Gwinnett County,22,53,-31
16,Idaho,13,Georgia,151,Henry County,0,131,-131
16,Idaho,13,Georgia,153,Houston County,16,0,16
16,Idaho,13,Georgia,185,Lowndes County,0,9,-9
16,Idaho,13,Georgia,201,Miller County,6,7,-1
16,Idaho,13,Georgia,211,Morgan County,5,0,5
16,Idaho,13,Georgia,215,Muscogee County,0,31,-31
16,Idaho,13,Georgia,219,Oconee County,103,0,103
16,Idaho,13,Georgia,223,Paulding County,17,0,17
16,Idaho,13,Georgia,245,Richmond County,0,29,-29
16,Idaho,13,Georgia,247,Rockdale County,35,0,35
16,Idaho,13,Georgia,297,Walton County,25,0,25
16,Idaho,13,Georgia,321,Worth County,0,6,-6
16,Idaho,15,Hawaii,1,Hawaii County,143,87,56
16,Idaho,15,Hawaii,3,Honolulu County,369,267,102
16,Idaho,15,Hawaii,7,Kauai County,36,8,28
16,Idaho,15,Hawaii,9,Maui County,116,78,38
16,Idaho,16,Idaho,1,Ada County,11707,9260,2447
16,Idaho,16,Idaho,3,Adams County,397,223,174
16,Idaho,16,Idaho,5,Bannock County,2954,3092,-138
16,Idaho,16,Idaho,7,Bear Lake County,297,156,141
16,Idaho,16,Idaho,9,Benewah County,382,206,176
16,Idaho,16,Idaho,11,Bingham County,2414,1563,851
16,Idaho,16,Idaho,13,Blaine County,826,462,364
16,Idaho,16,Idaho,15,Boise County,100,480,-380
16,Idaho,16,Idaho,17,Bonner County,1073,1213,-140
16,Idaho,16,Idaho,19,Bonneville County,2622,3402,-780
16,Idaho,16,Idaho,21,Boundary County,429,506,-77
16,Idaho,16,Idaho,23,Butte County,222,66,156
16,Idaho,16,Idaho,25,Camas County,180,0,180
16,Idaho,16,Idaho,27,Canyon County,6355,9378,-3023
16,Idaho,16,Idaho,29,Caribou County,80,117,-37
16,Idaho,16,Idaho,31,Cassia County,1485,1336,149
16,Idaho,16,Idaho,33,Clark County,4,47,-43
16,Idaho,16,Idaho,35,Clearwater County,377,591,-214
16,Idaho,16,Idaho,37,Custer County,212,153,59
16,Idaho,16,Idaho,39,Elmore County,1004,712,292
16,Idaho,16,Idaho,41,Franklin County,268,274,-6
16,Idaho,16,Idaho,43,Fremont County,636,603,33
16,Idaho,16,Idaho,45,Gem County,717,644,73
16,Idaho,16,Idaho,47,Gooding County,422,719,-297
16,Idaho,16,Idaho,49,Idaho County,662,1212,-550
16,Idaho,16,Idaho,51,Jefferson County,1512,1302,210
16,Idaho,16,Idaho,53,Jerome County,1014,1008,6
16,Idaho,16,Idaho,55,Kootenai County,2839,2324,515
16,Idaho,16,Idaho,57,Latah County,1672,2890,-1218
16,Idaho,16,Idaho,59,Lemhi County,294,199,95
16,Idaho,16,Idaho,61,Lewis County,420,216,204
16,Idaho,16,Idaho,63,Lincoln County,682,262,420
16,Idaho,16,Idaho,65,Madison County,1520,1667,-147
16,Idaho,16,Idaho,67,Minidoka County,1182,1065,117
16,Idaho,16,Idaho,69,Nez Perce County,1201,1079,122
16,Idaho,16,Idaho,71,Oneida County,29,17,12
16,Idaho,16,Idaho,73,Owyhee County,905,763,142
16,Idaho,16,Idaho,75,Payette County,808,655,153
16,Idaho,16,Idaho,77,Power County,483,423,60
16,Idaho,16,Idaho,79,Shoshone County,406,440,-34
16,Idaho,16,Idaho,81,Teton County,180,135,45
16,Idaho,16,Idaho,83,Twin Falls County,3290,3190,100
16,Idaho,16,Idaho,85,Valley County,418,764,-346
16,Idaho,16,Idaho,87,Washington County,433,299,134
16,Idaho,17,Illinois,19,Champaign County,43,39,4
16,Idaho,17,Illinois,27,Clinton County,81,0,81
16,Idaho,17,Illinois,31,Cook County,230,225,5
16,Idaho,17,Illinois,37,DeKalb County,19,0,19
16,Idaho,17,Illinois,43,DuPage County,158,10,148
16,Idaho,17,Illinois,67,Hancock County,38,10,28
16,Idaho,17,Illinois,77,Jackson County,3,0,3
16,Idaho,17,Illinois,81,Jefferson County,12,0,12
16,Idaho,17,Illinois,89,Kane County,37,0,37
16,Idaho,17,Illinois,91,Kankakee County,5,0,5
16,Idaho,17,Illinois,97,Lake County,8,123,-115
16,Idaho,17,Illinois,99,LaSalle County,12,0,12
16,Idaho,17,Illinois,109,McDonough County,0,3,-3
16,Idaho,17,Illinois,111,McHenry County,26,0,26
16,Idaho,17,Illinois,113,McLean County,37,20,17
16,Idaho,17,Illinois,115,Macon County,1,0,1
16,Idaho,17,Illinois,129,Menard County,0,1,-1
16,Idaho,17,Illinois,133,Monroe County,25,20,5
16,Idaho,17,Illinois,143,Peoria County,1,14,-13
16,Idaho,17,Illinois,161,Rock Island County,0,26,-26
16,Idaho,17,Illinois,163,St. Clair County,0,12,-12
16,Idaho,17,Illinois,179,Tazewell County,24,0,24
16,Idaho,17,Illinois,183,Vermilion County,0,20,-20
16,Idaho,17,Illinois,187,Warren County,30,0,30
16,Idaho,17,Illinois,197,Will County,31,61,-30
16,Idaho,17,Illinois,201,Winnebago County,131,0,131
16,Idaho,17,Illinois,203,Woodford County,0,6,-6
16,Idaho,18,Indiana,3,Allen County,11,77,-66
16,Idaho,18,Indiana,5,Bartholomew County,0,8,-8
16,Idaho,18,Indiana,23,Clinton County,0,10,-10
16,Idaho,18,Indiana,33,DeKalb County,0,9,-9
16,Idaho,18,Indiana,35,Delaware County,0,7,-7
16,Idaho,18,Indiana,45,Fountain County,0,33,-33
16,Idaho,18,Indiana,53,Grant County,7,0,7
16,Idaho,18,Indiana,57,Hamilton County,0,124,-124
16,Idaho,18,Indiana,67,Howard County,0,6,-6
16,Idaho,18,Indiana,81,Johnson County,0,9,-9
16,Idaho,18,Indiana,89,Lake County,50,13,37
16,Idaho,18,Indiana,91,LaPorte County,0,5,-5
16,Idaho,18,Indiana,97,Marion County,30,31,-1
16,Idaho,18,Indiana,107,Montgomery County,0,7,-7
16,Idaho,18,Indiana,127,Porter County,17,5,12
16,Idaho,18,Indiana,153,Sullivan County,0,9,-9
16,Idaho,18,Indiana,157,Tippecanoe County,0,18,-18
16,Idaho,18,Indiana,167,Vigo County,11,0,11
16,Idaho,18,Indiana,177,Wayne County,0,4,-4
16,Idaho,19,Iowa,13,Black Hawk County,0,16,-16
16,Idaho,19,Iowa,17,Bremer County,0,18,-18
16,Idaho,19,Iowa,19,Buchanan County,17,0,17
16,Idaho,19,Iowa,35,Cherokee County,0,24,-24
16,Idaho,19,Iowa,49,Dallas County,0,35,-35
16,Idaho,19,Iowa,61,Dubuque County,0,4,-4
16,Idaho,19,Iowa,63,Emmet County,22,0,22
16,Idaho,19,Iowa,77,Guthrie County,0,9,-9
16,Idaho,19,Iowa,99,Jasper County,0,13,-13
16,Idaho,19,Iowa,103,Johnson County,0,62,-62
16,Idaho,19,Iowa,107,Keokuk County,0,2,-2
16,Idaho,19,Iowa,109,Kossuth County,0,79,-79
16,Idaho,19,Iowa,113,Linn County,0,62,-62
16,Idaho,19,Iowa,115,Louisa County,0,6,-6
16,Idaho,19,Iowa,119,Lyon County,0,3,-3
16,Idaho,19,Iowa,125,Marion County,0,27,-27
16,Idaho,19,Iowa,127,Marshall County,0,11,-11
16,Idaho,19,Iowa,129,Mills County,23,0,23
16,Idaho,19,Iowa,139,Muscatine County,0,24,-24
16,Idaho,19,Iowa,155,Pottawattamie County,16,19,-3
16,Idaho,19,Iowa,163,Scott County,0,13,-13
16,Idaho,19,Iowa,167,Sioux County,0,20,-20
16,Idaho,19,Iowa,181,Warren County,5,33,-28
16,Idaho,19,Iowa,189,Winnebago County,98,0,98
16,Idaho,19,Iowa,193,Woodbury County,72,25,47
16,Idaho,2,Alaska,13,Aleutians East Borough,0,3,-3
16,Idaho,2,Alaska,20,Anchorage Municipality,678,176,502
16,Idaho,2,Alaska,68,Denali Borough,7,0,7
16,Idaho,2,Alaska,70,Dillingham Census Area,0,4,-4
16,Idaho,2,Alaska,90,Fairbanks North Star Borough,140,77,63
16,Idaho,2,Alaska,100,Haines Borough,18,0,18
16,Idaho,2,Alaska,110,Juneau City and Borough,85,38,47
16,Idaho,2,Alaska,122,Kenai Peninsula Borough,173,40,133
16,Idaho,2,Alaska,130,Ketchikan Gateway Borough,0,14,-14
16,Idaho,2,Alaska,150,Kodiak Island Borough,35,0,35
16,Idaho,2,Alaska,170,Matanuska-Susitna Borough,209,73,136
16,Idaho,2,Alaska,180,Nome Census Area,293,1,292
16,Idaho,2,Alaska,185,North Slope Borough,3,0,3
16,Idaho,2,Alaska,188,Northwest Arctic Borough,0,6,-6
16,Idaho,2,Alaska,195,Petersburg Borough,0,4,-4
16,Idaho,2,Alaska,198,Prince of Wales-Hyder Census Area,0,17,-17
16,Idaho,2,Alaska,220,Sitka City and Borough,43,15,28
16,Idaho,2,Alaska,230,Skagway Municipality,0,6,-6
16,Idaho,2,Alaska,261,Valdez-Cordova Census Area,113,0,113
16,Idaho,2,Alaska,275,Wrangell City and Borough,0,5,-5
16,Idaho,2,Alaska,282,Yakutat City and Borough,0,9,-9
16,Idaho,20,Kansas,29,Cloud County,0,12,-12
16,Idaho,20,Kansas,31,Coffey County,0,16,-16
16,Idaho,20,Kansas,41,Dickinson County,0,2,-2
16,Idaho,20,Kansas,43,Doniphan County,0,3,-3
16,Idaho,20,Kansas,45,Douglas County,23,0,23
16,Idaho,20,Kansas,75,Hamilton County,0,4,-4
16,Idaho,20,Kansas,79,Harvey County,14,0,14
16,Idaho,20,Kansas,91,Johnson County,48,0,48
16,Idaho,20,Kansas,93,Kearny County,0,3,-3
16,Idaho,20,Kansas,95,Kingman County,0,1,-1
16,Idaho,20,Kansas,97,Kiowa County,61,0,61
16,Idaho,20,Kansas,111,Lyon County,2,0,2
16,Idaho,20,Kansas,113,McPherson County,0,10,-10
16,Idaho,20,Kansas,121,Miami County,40,0,40
16,Idaho,20,Kansas,133,Neosho County,0,19,-19
16,Idaho,20,Kansas,137,Norton County,0,8,-8
16,Idaho,20,Kansas,145,Pawnee County,151,0,151
16,Idaho,20,Kansas,149,Pottawatomie County,0,4,-4
16,Idaho,20,Kansas,155,Reno County,96,0,96
16,Idaho,20,Kansas,157,Republic County,0,4,-4
16,Idaho,20,Kansas,161,Riley County,7,0,7
16,Idaho,20,Kansas,169,Saline County,0,3,-3
16,Idaho,20,Kansas,173,Sedgwick County,66,12,54
16,Idaho,20,Kansas,177,Shawnee County,57,0,57
16,Idaho,21,Kentucky,35,Calloway County,9,0,9
16,Idaho,21,Kentucky,47,Christian County,126,34,92
16,Idaho,21,Kentucky,67,Fayette County,0,2,-2
16,Idaho,21,Kentucky,93,Hardin County,153,0,153
16,Idaho,21,Kentucky,103,Henry County,0,41,-41
16,Idaho,21,Kentucky,111,Jefferson County,45,62,-17
16,Idaho,21,Kentucky,151,Madison County,8,0,8
16,Idaho,21,Kentucky,195,Pike County,0,41,-41
16,Idaho,22,Louisiana,33,East Baton Rouge Parish,72,0,72
16,Idaho,22,Louisiana,55,Lafayette Parish,18,0,18
16,Idaho,22,Louisiana,69,Natchitoches Parish,10,0,10
16,Idaho,22,Louisiana,71,Orleans Parish,15,14,1
16,Idaho,22,Louisiana,79,Rapides Parish,5,39,-34
16,Idaho,22,Louisiana,85,Sabine Parish,48,0,48
16,Idaho,22,Louisiana,93,St. James Parish,4,0,4
16,Idaho,22,Louisiana,103,St. Tammany Parish,35,0,35
16,Idaho,22,Louisiana,105,Tangipahoa Parish,0,60,-60
16,Idaho,22,Louisiana,115,Vernon Parish,23,0,23
16,Idaho,23,Maine,1,Androscoggin County,0,4,-4
16,Idaho,23,Maine,3,Aroostook County,0,28,-28
16,Idaho,23,Maine,5,Cumberland County,34,31,3
16,Idaho,23,Maine,9,Hancock County,30,0,30
16,Idaho,23,Maine,11,Kennebec County,0,14,-14
16,Idaho,23,Maine,13,Knox County,0,3,-3
16,Idaho,23,Maine,17,Oxford County,80,0,80
16,Idaho,23,Maine,31,York County,16,13,3
16,Idaho,24,Maryland,3,Anne Arundel County,37,24,13
16,Idaho,24,Maryland,5,Baltimore County,0,13,-13
16,Idaho,24,Maryland,15,Cecil County,12,0,12
16,Idaho,24,Maryland,17,Charles County,14,0,14
16,Idaho,24,Maryland,21,Frederick County,11,0,11
16,Idaho,24,Maryland,27,Howard County,26,65,-39
16,Idaho,24,Maryland,31,Montgomery County,49,11,38
16,Idaho,24,Maryland,33,Prince George's County,16,16,0
16,Idaho,24,Maryland,43,Washington County,0,44,-44
16,Idaho,24,Maryland,45,Wicomico County,22,0,22
16,Idaho,24,Maryland,47,Worcester County,17,0,17
16,Idaho,25,Massachusetts,1,Barnstable County,81,9,72
16,Idaho,25,Massachusetts,3,Berkshire County,0,10,-10
16,Idaho,25,Massachusetts,9,Essex County,0,98,-98
16,Idaho,25,Massachusetts,15,Hampshire County,0,14,-14
16,Idaho,25,Massachusetts,17,Middlesex County,93,54,39
16,Idaho,25,Massachusetts,21,Norfolk County,0,8,-8
16,Idaho,25,Massachusetts,23,Plymouth County,0,67,-67
16,Idaho,25,Massachusetts,25,Suffolk County,37,170,-133
16,Idaho,25,Massachusetts,27,Worcester County,9,0,9
16,Idaho,26,Michigan,7,Alpena County,0,8,-8
16,Idaho,26,Michigan,17,Bay County,4,0,4
16,Idaho,26,Michigan,33,Chippewa County,0,6,-6
16,Idaho,26,Michigan,39,Crawford County,0,48,-48
16,Idaho,26,Michigan,43,Dickinson County,0,19,-19
16,Idaho,26,Michigan,59,Hillsdale County,142,4,138
16,Idaho,26,Michigan,65,Ingham County,2,63,-61
16,Idaho,26,Michigan,73,Isabella County,0,17,-17
16,Idaho,26,Michigan,77,Kalamazoo County,68,0,68
16,Idaho,26,Michigan,81,Kent County,0,226,-226
16,Idaho,26,Michigan,85,Lake County,0,7,-7
16,Idaho,26,Michigan,93,Livingston County,18,12,6
16,Idaho,26,Michigan,103,Marquette County,0,33,-33
16,Idaho,26,Michigan,105,Mason County,7,0,7
16,Idaho,26,Michigan,109,Menominee County,13,0,13
16,Idaho,26,Michigan,111,Midland County,4,0,4
16,Idaho,26,Michigan,119,Montmorency County,0,7,-7
16,Idaho,26,Michigan,121,Muskegon County,73,0,73
16,Idaho,26,Michigan,123,Newaygo County,0,11,-11
16,Idaho,26,Michigan,125,Oakland County,60,0,60
16,Idaho,26,Michigan,127,Oceana County,0,26,-26
16,Idaho,26,Michigan,139,Ottawa County,21,0,21
16,Idaho,26,Michigan,143,Roscommon County,0,17,-17
16,Idaho,26,Michigan,151,Sanilac County,0,9,-9
16,Idaho,26,Michigan,161,Washtenaw County,0,120,-120
16,Idaho,26,Michigan,163,Wayne County,20,91,-71
16,Idaho,27,Minnesota,1,Aitkin County,0,6,-6
16,Idaho,27,Minnesota,3,Anoka County,0,6,-6
16,Idaho,27,Minnesota,7,Beltrami County,0,2,-2
16,Idaho,27,Minnesota,35,Crow Wing County,28,37,-9
16,Idaho,27,Minnesota,37,Dakota County,37,2,35
16,Idaho,27,Minnesota,39,Dodge County,3,0,3
16,Idaho,27,Minnesota,47,Freeborn County,59,3,56
16,Idaho,27,Minnesota,49,Goodhue County,0,3,-3
16,Idaho,27,Minnesota,53,Hennepin County,65,134,-69
16,Idaho,27,Minnesota,55,Houston County,17,0,17
16,Idaho,27,Minnesota,59,Isanti County,0,7,-7
16,Idaho,27,Minnesota,73,Lac qui Parle County,3,0,3
16,Idaho,27,Minnesota,83,Lyon County,34,0,34
16,Idaho,27,Minnesota,91,Martin County,0,2,-2
16,Idaho,27,Minnesota,93,Meeker County,0,16,-16
16,Idaho,27,Minnesota,103,Nicollet County,28,0,28
16,Idaho,27,Minnesota,109,Olmsted County,34,47,-13
16,Idaho,27,Minnesota,111,Otter Tail County,33,6,27
16,Idaho,27,Minnesota,115,Pine County,0,3,-3
16,Idaho,27,Minnesota,123,Ramsey County,35,16,19
16,Idaho,27,Minnesota,131,Rice County,5,0,5
16,Idaho,27,Minnesota,137,St. Louis County,45,18,27
16,Idaho,27,Minnesota,139,Scott County,6,0,6
16,Idaho,27,Minnesota,141,Sherburne County,44,0,44
16,Idaho,27,Minnesota,151,Swift County,4,0,4
16,Idaho,27,Minnesota,153,Todd County,0,2,-2
16,Idaho,27,Minnesota,157,Wabasha County,6,0,6
16,Idaho,27,Minnesota,163,Washington County,0,29,-29
16,Idaho,27,Minnesota,169,Winona County,39,0,39
16,Idaho,27,Minnesota,171,Wright County,0,48,-48
16,Idaho,28,Mississippi,3,Alcorn County,0,10,-10
16,Idaho,28,Mississippi,7,Attala County,0,6,-6
16,Idaho,28,Mississippi,11,Bolivar County,0,4,-4
16,Idaho,28,Mississippi,13,Calhoun County,0,1,-1
16,Idaho,28,Mississippi,33,DeSoto County,33,0,33
16,Idaho,28,Mississippi,47,Harrison County,4,203,-199
16,Idaho,28,Mississippi,49,Hinds County,5,0,5
16,Idaho,28,Mississippi,59,Jackson County,4,26,-22
16,Idaho,28,Mississippi,65,Jefferson Davis County,0,1,-1
16,Idaho,28,Mississippi,75,Lauderdale County,0,27,-27
16,Idaho,28,Mississippi,87,Lowndes County,0,11,-11
16,Idaho,28,Mississippi,89,Madison County,0,13,-13
16,Idaho,28,Mississippi,93,Marshall County,0,11,-11
16,Idaho,28,Mississippi,101,Newton County,0,2,-2
16,Idaho,28,Mississippi,113,Pike County,4,0,4
16,Idaho,28,Mississippi,117,Prentiss County,0,11,-11
16,Idaho,28,Mississippi,121,Rankin County,45,18,27
16,Idaho,28,Mississippi,139,Tippah County,0,4,-4
16,Idaho,28,Mississippi,145,Union County,0,29,-29
16,Idaho,28,Mississippi,149,Warren County,0,1,-1
16,Idaho,28,Mississippi,151,Washington County,0,1,-1
16,Idaho,29,Missouri,13,Bates County,0,10,-10
16,Idaho,29,Missouri,19,Boone County,146,30,116
16,Idaho,29,Missouri,33,Carroll County,0,143,-143
16,Idaho,29,Missouri,47,Clay County,54,8,46
16,Idaho,29,Missouri,49,Clinton County,6,0,6
16,Idaho,29,Missouri,59,Dallas County,0,105,-105
16,Idaho,29,Missouri,61,Daviess County,3,0,3
16,Idaho,29,Missouri,63,DeKalb County,0,1,-1
16,Idaho,29,Missouri,75,Gentry County,0,6,-6
16,Idaho,29,Missouri,77,Greene County,52,0,52
16,Idaho,29,Missouri,83,Henry County,55,0,55
16,Idaho,29,Missouri,95,Jackson County,62,16,46
16,Idaho,29,Missouri,97,Jasper County,57,8,49
16,Idaho,29,Missouri,101,Johnson County,0,9,-9
16,Idaho,29,Missouri,105,Laclede County,51,0,51
16,Idaho,29,Missouri,109,Lawrence County,5,0,5
16,Idaho,29,Missouri,113,Lincoln County,58,0,58
16,Idaho,29,Missouri,147,Nodaway County,6,4,2
16,Idaho,29,Missouri,167,Polk County,0,139,-139
16,Idaho,29,Missouri,169,Pulaski County,214,60,154
16,Idaho,29,Missouri,173,Ralls County,0,12,-12
16,Idaho,29,Missouri,175,Randolph County,0,13,-13
16,Idaho,29,Missouri,183,St. Charles County,60,83,-23
16,Idaho,29,Missouri,189,St. Louis County,83,7,76
16,Idaho,29,Missouri,213,Taney County,0,14,-14
16,Idaho,29,Missouri,217,Vernon County,0,3,-3
16,Idaho,29,Missouri,219,Warren County,0,21,-21
16,Idaho,29,Missouri,225,Webster County,0,28,-28
16,Idaho,29,Missouri,229,Wright County,0,123,-123
16,Idaho,29,Missouri,510,St. Louis city,0,13,-13
16,Idaho,30,Montana,1,Beaverhead County,64,71,-7
16,Idaho,30,Montana,3,Big Horn County,16,0,16
16,Idaho,30,Montana,5,Blaine County,0,9,-9
16,Idaho,30,Montana,9,Carbon County,3,1,2
16,Idaho,30,Montana,13,Cascade County,156,60,96
16,Idaho,30,Montana,15,Chouteau County,49,3,46
16,Idaho,30,Montana,17,Custer County,1,24,-23
16,Idaho,30,Montana,21,Dawson County,0,21,-21
16,Idaho,30,Montana,23,Deer Lodge County,0,39,-39
16,Idaho,30,Montana,27,Fergus County,54,5,49
16,Idaho,30,Montana,29,Flathead County,40,605,-565
16,Idaho,30,Montana,31,Gallatin County,147,433,-286
16,Idaho,30,Montana,35,Glacier County,7,0,7
16,Idaho,30,Montana,39,Granite County,20,24,-4
16,Idaho,30,Montana,41,Hill County,0,8,-8
16,Idaho,30,Montana,43,Jefferson County,39,1,38
16,Idaho,30,Montana,47,Lake County,75,4,71
16,Idaho,30,Montana,49,Lewis and Clark County,134,80,54
16,Idaho,30,Montana,51,Liberty County,0,20,-20
16,Idaho,30,Montana,53,Lincoln County,92,122,-30
16,Idaho,30,Montana,61,Mineral County,7,21,-14
16,Idaho,30,Montana,63,Missoula County,577,289,288
16,Idaho,30,Montana,67,Park County,0,7,-7
16,Idaho,30,Montana,71,Phillips County,7,0,7
16,Idaho,30,Montana,73,Pondera County,29,8,21
16,Idaho,30,Montana,77,Powell County,0,11,-11
16,Idaho,30,Montana,81,Ravalli County,63,158,-95
16,Idaho,30,Montana,83,Richland County,58,78,-20
16,Idaho,30,Montana,85,Roosevelt County,13,0,13
16,Idaho,30,Montana,89,Sanders County,77,51,26
16,Idaho,30,Montana,91,Sheridan County,0,8,-8
16,Idaho,30,Montana,93,Silver Bow County,131,6,125
16,Idaho,30,Montana,99,Teton County,0,16,-16
16,Idaho,30,Montana,101,Toole County,0,1,-1
16,Idaho,30,Montana,105,Valley County,3,0,3
16,Idaho,30,Montana,111,Yellowstone County,65,114,-49
16,Idaho,31,Nebraska,19,Buffalo County,0,135,-135
16,Idaho,31,Nebraska,21,Burt County,0,2,-2
16,Idaho,31,Nebraska,31,Cherry County,0,10,-10
16,Idaho,31,Nebraska,33,Cheyenne County,0,4,-4
16,Idaho,31,Nebraska,39,Cuming County,0,8,-8
16,Idaho,31,Nebraska,43,Dakota County,0,1,-1
16,Idaho,31,Nebraska,45,Dawes County,0,4,-4
16,Idaho,31,Nebraska,49,Deuel County,0,9,-9
16,Idaho,31,Nebraska,55,Douglas County,46,52,-6
16,Idaho,31,Nebraska,79,Hall County,54,0,54
16,Idaho,31,Nebraska,93,Howard County,0,7,-7
16,Idaho,31,Nebraska,109,Lancaster County,40,87,-47
16,Idaho,31,Nebraska,119,Madison County,0,7,-7
16,Idaho,31,Nebraska,131,Otoe County,12,0,12
16,Idaho,31,Nebraska,141,Platte County,6,0,6
16,Idaho,31,Nebraska,147,Richardson County,0,21,-21
16,Idaho,31,Nebraska,153,Sarpy County,57,20,37
16,Idaho,31,Nebraska,157,Scotts Bluff County,8,30,-22
16,Idaho,31,Nebraska,161,Sheridan County,0,9,-9
16,Idaho,32,Nevada,1,Churchill County,71,22,49
16,Idaho,32,Nevada,3,Clark County,997,1388,-391
16,Idaho,32,Nevada,5,Douglas County,65,13,52
16,Idaho,32,Nevada,7,Elko County,500,717,-217
16,Idaho,32,Nevada,9,Esmeralda County,0,29,-29
16,Idaho,32,Nevada,11,Eureka County,8,0,8
16,Idaho,32,Nevada,13,Humboldt County,50,25,25
16,Idaho,32,Nevada,15,Lander County,0,87,-87
16,Idaho,32,Nevada,17,Lincoln County,59,0,59
16,Idaho,32,Nevada,19,Lyon County,70,51,19
16,Idaho,32,Nevada,21,Mineral County,0,1,-1
16,Idaho,32,Nevada,23,Nye County,13,77,-64
16,Idaho,32,Nevada,27,Pershing County,60,0,60
16,Idaho,32,Nevada,31,Washoe County,314,274,40
16,Idaho,32,Nevada,33,White Pine County,20,18,2
16,Idaho,32,Nevada,510,Carson City,149,0,149
16,Idaho,33,New Hampshire,11,Hillsborough County,0,28,-28
16,Idaho,33,New Hampshire,15,Rockingham County,10,0,10
16,Idaho,33,New Hampshire,17,Strafford County,35,0,35
16,Idaho,34,New Jersey,1,Atlantic County,2,0,2
16,Idaho,34,New Jersey,3,Bergen County,8,0,8
16,Idaho,34,New Jersey,5,Burlington County,12,0,12
16,Idaho,34,New Jersey,17,Hudson County,18,5,13
16,Idaho,34,New Jersey,27,Morris County,8,39,-31
16,Idaho,34,New Jersey,35,Somerset County,11,0,11
16,Idaho,34,New Jersey,39,Union County,14,10,4
16,Idaho,35,New Mexico,1,Bernalillo County,136,54,82
16,Idaho,35,New Mexico,5,Chaves County,55,36,19
16,Idaho,35,New Mexico,9,Curry County,61,0,61
16,Idaho,35,New Mexico,13,Doña Ana County,15,0,15
16,Idaho,35,New Mexico,15,Eddy County,3,123,-120
16,Idaho,35,New Mexico,17,Grant County,17,0,17
16,Idaho,35,New Mexico,25,Lea County,27,36,-9
16,Idaho,35,New Mexico,27,Lincoln County,7,2,5
16,Idaho,35,New Mexico,28,Los Alamos County,0,40,-40
16,Idaho,35,New Mexico,29,Luna County,0,7,-7
16,Idaho,35,New Mexico,31,McKinley County,3,0,3
16,Idaho,35,New Mexico,35,Otero County,26,22,4
16,Idaho,35,New Mexico,43,Sandoval County,135,11,124
16,Idaho,35,New Mexico,45,San Juan County,39,9,30
16,Idaho,35,New Mexico,49,Santa Fe County,1,10,-9
16,Idaho,35,New Mexico,53,Socorro County,2,14,-12
16,Idaho,35,New Mexico,61,Valencia County,144,0,144
16,Idaho,36,New York,5,Bronx County,46,0,46
16,Idaho,36,New York,9,Cattaraugus County,10,27,-17
16,Idaho,36,New York,13,Chautauqua County,8,0,8
16,Idaho,36,New York,23,Cortland County,9,5,4
16,Idaho,36,New York,29,Erie County,0,43,-43
16,Idaho,36,New York,45,Jefferson County,19,54,-35
16,Idaho,36,New York,47,Kings County,21,13,8
16,Idaho,36,New York,55,Monroe County,13,0,13
16,Idaho,36,New York,59,Nassau County,17,0,17
16,Idaho,36,New York,61,New York County,47,11,36
16,Idaho,36,New York,63,Niagara County,6,34,-28
16,Idaho,36,New York,65,Oneida County,23,0,23
16,Idaho,36,New York,67,Onondaga County,13,73,-60
16,Idaho,36,New York,71,Orange County,56,0,56
16,Idaho,36,New York,77,Otsego County,0,12,-12
16,Idaho,36,New York,81,Queens County,92,7,85
16,Idaho,36,New York,87,Rockland County,5,0,5
16,Idaho,36,New York,91,Saratoga County,0,101,-101
16,Idaho,36,New York,101,Steuben County,22,0,22
16,Idaho,36,New York,103,Suffolk County,79,0,79
16,Idaho,36,New York,109,Tompkins County,58,0,58
16,Idaho,36,New York,113,Warren County,0,22,-22
16,Idaho,36,New York,115,Washington County,38,0,38
16,Idaho,36,New York,117,Wayne County,0,46,-46
16,Idaho,36,New York,119,Westchester County,7,0,7
16,Idaho,37,North Carolina,21,Buncombe County,0,15,-15
16,Idaho,37,North Carolina,49,Craven County,34,7,27
16,Idaho,37,North Carolina,51,Cumberland County,193,50,143
16,Idaho,37,North Carolina,57,Davidson County,0,14,-14
16,Idaho,37,North Carolina,63,Durham County,36,8,28
16,Idaho,37,North Carolina,67,Forsyth County,36,51,-15
16,Idaho,37,North Carolina,71,Gaston County,28,48,-20
16,Idaho,37,North Carolina,81,Guilford County,23,65,-42
16,Idaho,37,North Carolina,83,Halifax County,0,20,-20
16,Idaho,37,North Carolina,85,Harnett County,6,0,6
16,Idaho,37,North Carolina,87,Haywood County,18,0,18
16,Idaho,37,North Carolina,89,Henderson County,0,7,-7
16,Idaho,37,North Carolina,93,Hoke County,38,0,38
16,Idaho,37,North Carolina,97,Iredell County,3,0,3
16,Idaho,37,North Carolina,119,Mecklenburg County,71,63,8
16,Idaho,37,North Carolina,125,Moore County,16,10,6
16,Idaho,37,North Carolina,129,New Hanover County,13,19,-6
16,Idaho,37,North Carolina,133,Onslow County,22,128,-106
16,Idaho,37,North Carolina,135,Orange County,31,0,31
16,Idaho,37,North Carolina,155,Robeson County,19,0,19
16,Idaho,37,North Carolina,171,Surry County,0,3,-3
16,Idaho,37,North Carolina,173,Swain County,135,0,135
16,Idaho,37,North Carolina,181,Vance County,0,1,-1
16,Idaho,37,North Carolina,183,Wake County,43,95,-52
16,Idaho,37,North Carolina,191,Wayne County,134,11,123
16,Idaho,37,North Carolina,193,Wilkes County,0,28,-28
16,Idaho,38,North Dakota,11,Bowman County,2,0,2
16,Idaho,38,North Dakota,15,Burleigh County,193,5,188
16,Idaho,38,North Dakota,17,Cass County,67,13,54
16,Idaho,38,North Dakota,23,Divide County,66,0,66
16,Idaho,38,North Dakota,25,Dunn County,0,13,-13
16,Idaho,38,North Dakota,31,Foster County,0,15,-15
16,Idaho,38,North Dakota,33,Golden Valley County,15,0,15
16,Idaho,38,North Dakota,35,Grand Forks County,14,12,2
16,Idaho,38,North Dakota,45,LaMoure County,0,5,-5
16,Idaho,38,North Dakota,47,Logan County,0,24,-24
16,Idaho,38,North Dakota,53,McKenzie County,81,10,71
16,Idaho,38,North Dakota,57,Mercer County,0,3,-3
16,Idaho,38,North Dakota,59,Morton County,89,11,78
16,Idaho,38,North Dakota,61,Mountrail County,6,0,6
16,Idaho,38,North Dakota,63,Nelson County,0,1,-1
16,Idaho,38,North Dakota,67,Pembina County,0,6,-6
16,Idaho,38,North Dakota,89,Stark County,26,66,-40
16,Idaho,38,North Dakota,91,Steele County,0,14,-14
16,Idaho,38,North Dakota,93,Stutsman County,0,4,-4
16,Idaho,38,North Dakota,97,Traill County,0,1,-1
16,Idaho,38,North Dakota,101,Ward County,71,14,57
16,Idaho,38,North Dakota,105,Williams County,87,272,-185
16,Idaho,39,Ohio,7,Ashtabula County,35,49,-14
16,Idaho,39,Ohio,9,Athens County,28,0,28
16,Idaho,39,Ohio,15,Brown County,18,0,18
16,Idaho,39,Ohio,17,Butler County,13,0,13
16,Idaho,39,Ohio,25,Clermont County,0,50,-50
16,Idaho,39,Ohio,35,Cuyahoga County,25,11,14
16,Idaho,39,Ohio,41,Delaware County,10,0,10
16,Idaho,39,Ohio,49,Franklin County,6,44,-38
16,Idaho,39,Ohio,51,Fulton County,79,0,79
16,Idaho,39,Ohio,57,Greene County,0,128,-128
16,Idaho,39,Ohio,61,Hamilton County,0,23,-23
16,Idaho,39,Ohio,63,Hancock County,0,37,-37
16,Idaho,39,Ohio,89,Licking County,32,15,17
16,Idaho,39,Ohio,91,Logan County,0,7,-7
16,Idaho,39,Ohio,93,Lorain County,0,15,-15
16,Idaho,39,Ohio,99,Mahoning County,35,0,35
16,Idaho,39,Ohio,101,Marion County,0,23,-23
16,Idaho,39,Ohio,103,Medina County,0,31,-31
16,Idaho,39,Ohio,113,Montgomery County,36,0,36
16,Idaho,39,Ohio,131,Pike County,0,8,-8
16,Idaho,39,Ohio,133,Portage County,9,0,9
16,Idaho,39,Ohio,141,Ross County,0,8,-8
16,Idaho,39,Ohio,147,Seneca County,10,0,10
16,Idaho,39,Ohio,151,Stark County,0,14,-14
16,Idaho,39,Ohio,153,Summit County,13,0,13
16,Idaho,39,Ohio,165,Warren County,11,7,4
16,Idaho,39,Ohio,169,Wayne County,7,0,7
16,Idaho,4,Arizona,1,Apache County,25,0,25
16,Idaho,4,Arizona,3,Cochise County,142,81,61
16,Idaho,4,Arizona,5,Coconino County,148,71,77
16,Idaho,4,Arizona,9,Graham County,61,51,10
16,Idaho,4,Arizona,12,La Paz County,0,4,-4
16,Idaho,4,Arizona,13,Maricopa County,1697,1454,243
16,Idaho,4,Arizona,15,Mohave County,44,328,-284
16,Idaho,4,Arizona,17,Navajo County,9,41,-32
16,Idaho,4,Arizona,19,Pima County,398,285,113
16,Idaho,4,Arizona,21,Pinal County,224,805,-581
16,Idaho,4,Arizona,25,Yavapai County,132,136,-4
16,Idaho,4,Arizona,27,Yuma County,63,100,-37
16,Idaho,40,Oklahoma,13,Bryan County,0,3,-3
16,Idaho,40,Oklahoma,17,Canadian County,125,0,125
16,Idaho,40,Oklahoma,27,Cleveland County,0,35,-35
16,Idaho,40,Oklahoma,31,Comanche County,16,97,-81
16,Idaho,40,Oklahoma,51,Grady County,0,8,-8
16,Idaho,40,Oklahoma,61,Haskell County,0,9,-9
16,Idaho,40,Oklahoma,81,Lincoln County,0,7,-7
16,Idaho,40,Oklahoma,91,McIntosh County,0,9,-9
16,Idaho,40,Oklahoma,97,Mayes County,11,0,11
16,Idaho,40,Oklahoma,99,Murray County,0,16,-16
16,Idaho,40,Oklahoma,101,Muskogee County,0,12,-12
16,Idaho,40,Oklahoma,109,Oklahoma County,4,40,-36
16,Idaho,40,Oklahoma,115,Ottawa County,0,3,-3
16,Idaho,40,Oklahoma,123,Pontotoc County,0,7,-7
16,Idaho,40,Oklahoma,127,Pushmataha County,7,0,7
16,Idaho,40,Oklahoma,131,Rogers County,0,2,-2
16,Idaho,40,Oklahoma,135,Sequoyah County,37,0,37
16,Idaho,40,Oklahoma,141,Tillman County,0,8,-8
16,Idaho,40,Oklahoma,143,Tulsa County,181,207,-26
16,Idaho,40,Oklahoma,145,Wagoner County,8,6,2
16,Idaho,41,Oregon,1,Baker County,287,143,144
16,Idaho,41,Oregon,3,Benton County,127,137,-10
16,Idaho,41,Oregon,5,Clackamas County,178,572,-394
16,Idaho,41,Oregon,7,Clatsop County,22,110,-88
16,Idaho,41,Oregon,9,Columbia County,10,0,10
16,Idaho,41,Oregon,11,Coos County,17,115,-98
16,Idaho,41,Oregon,13,Crook County,31,74,-43
16,Idaho,41,Oregon,15,Curry County,0,65,-65
16,Idaho,41,Oregon,17,Deschutes County,390,137,253
16,Idaho,41,Oregon,19,Douglas County,37,154,-117
16,Idaho,41,Oregon,23,Grant County,8,99,-91
16,Idaho,41,Oregon,25,Harney County,0,51,-51
16,Idaho,41,Oregon,29,Jackson County,91,96,-5
16,Idaho,41,Oregon,31,Jefferson County,7,33,-26
16,Idaho,41,Oregon,33,Josephine County,88,34,54
16,Idaho,41,Oregon,35,Klamath County,12,96,-84
16,Idaho,41,Oregon,37,Lake County,0,3,-3
16,Idaho,41,Oregon,39,Lane County,316,341,-25
16,Idaho,41,Oregon,41,Lincoln County,7,80,-73
16,Idaho,41,Oregon,43,Linn County,74,302,-228
16,Idaho,41,Oregon,45,Malheur County,752,1006,-254
16,Idaho,41,Oregon,47,Marion County,181,274,-93
16,Idaho,41,Oregon,49,Morrow County,25,22,3
16,Idaho,41,Oregon,51,Multnomah County,590,561,29
16,Idaho,41,Oregon,53,Polk County,37,33,4
16,Idaho,41,Oregon,55,Sherman County,0,5,-5
16,Idaho,41,Oregon,59,Umatilla County,273,261,12
16,Idaho,41,Oregon,61,Union County,319,113,206
16,Idaho,41,Oregon,63,Wallowa County,94,54,40
16,Idaho,41,Oregon,65,Wasco County,101,16,85
16,Idaho,41,Oregon,67,Washington County,397,591,-194
16,Idaho,41,Oregon,69,Wheeler County,24,0,24
16,Idaho,41,Oregon,71,Yamhill County,122,261,-139
16,Idaho,42,Pennsylvania,1,Adams County,0,4,-4
16,Idaho,42,Pennsylvania,3,Allegheny County,74,43,31
16,Idaho,42,Pennsylvania,11,Berks County,35,0,35
16,Idaho,42,Pennsylvania,17,Bucks County,0,119,-119
16,Idaho,42,Pennsylvania,19,Butler County,53,0,53
16,Idaho,42,Pennsylvania,21,Cambria County,0,39,-39
16,Idaho,42,Pennsylvania,27,Centre County,24,0,24
16,Idaho,42,Pennsylvania,41,Cumberland County,5,0,5
16,Idaho,42,Pennsylvania,43,Dauphin County,12,12,0
16,Idaho,42,Pennsylvania,49,Erie County,0,86,-86
16,Idaho,42,Pennsylvania,55,Franklin County,12,6,6
16,Idaho,42,Pennsylvania,61,Huntingdon County,26,0,26
16,Idaho,42,Pennsylvania,63,Indiana County,8,0,8
16,Idaho,42,Pennsylvania,69,Lackawanna County,0,6,-6
16,Idaho,42,Pennsylvania,71,Lancaster County,54,0,54
16,Idaho,42,Pennsylvania,75,Lebanon County,63,0,63
16,Idaho,42,Pennsylvania,77,Lehigh County,47,0,47
16,Idaho,42,Pennsylvania,91,Montgomery County,22,143,-121
16,Idaho,42,Pennsylvania,95,Northampton County,10,12,-2
16,Idaho,42,Pennsylvania,101,Philadelphia County,39,0,39
16,Idaho,42,Pennsylvania,107,Schuylkill County,0,17,-17
16,Idaho,42,Pennsylvania,119,Union County,0,7,-7
16,Idaho,42,Pennsylvania,129,Westmoreland County,7,0,7
16,Idaho,42,Pennsylvania,131,Wyoming County,0,3,-3
16,Idaho,44,Rhode Island,5,Newport County,0,9,-9
16,Idaho,44,Rhode Island,7,Providence County,0,67,-67
16,Idaho,45,South Carolina,3,Aiken County,20,81,-61
16,Idaho,45,South Carolina,13,Beaufort County,7,10,-3
16,Idaho,45,South Carolina,15,Berkeley County,4,240,-236
16,Idaho,45,South Carolina,19,Charleston County,0,8,-8
16,Idaho,45,South Carolina,45,Greenville County,30,8,22
16,Idaho,45,South Carolina,63,Lexington County,22,30,-8
16,Idaho,45,South Carolina,73,Oconee County,111,0,111
16,Idaho,45,South Carolina,79,Richland County,17,64,-47
16,Idaho,45,South Carolina,81,Saluda County,0,16,-16
16,Idaho,45,South Carolina,83,Spartanburg County,2,143,-141
16,Idaho,45,South Carolina,89,Williamsburg County,14,0,14
16,Idaho,46,South Dakota,5,Beadle County,443,0,443
16,Idaho,46,South Dakota,7,Bennett County,0,1,-1
16,Idaho,46,South Dakota,11,Brookings County,11,0,11
16,Idaho,46,South Dakota,27,Clay County,0,13,-13
16,Idaho,46,South Dakota,41,Dewey County,0,3,-3
16,Idaho,46,South Dakota,47,Fall River County,0,15,-15
16,Idaho,46,South Dakota,59,Hand County,0,8,-8
16,Idaho,46,South Dakota,79,Lake County,0,8,-8
16,Idaho,46,South Dakota,93,Meade County,59,0,59
16,Idaho,46,South Dakota,99,Minnehaha County,33,33,0
16,Idaho,46,South Dakota,103,Pennington County,37,0,37
16,Idaho,46,South Dakota,105,Perkins County,28,0,28
16,Idaho,46,South Dakota,109,Roberts County,15,0,15
16,Idaho,46,South Dakota,115,Spink County,0,5,-5
16,Idaho,47,Tennessee,1,Anderson County,73,0,73
16,Idaho,47,Tennessee,9,Blount County,18,32,-14
16,Idaho,47,Tennessee,31,Coffee County,11,25,-14
16,Idaho,47,Tennessee,37,Davidson County,20,465,-445
16,Idaho,47,Tennessee,49,Fentress County,0,20,-20
16,Idaho,47,Tennessee,59,Greene County,4,0,4
16,Idaho,47,Tennessee,65,Hamilton County,17,1,16
16,Idaho,47,Tennessee,93,Knox County,165,0,165
16,Idaho,47,Tennessee,95,Lake County,19,0,19
16,Idaho,47,Tennessee,103,Lincoln County,3,0,3
16,Idaho,47,Tennessee,107,McMinn County,0,36,-36
16,Idaho,47,Tennessee,113,Madison County,10,0,10
16,Idaho,47,Tennessee,119,Maury County,13,0,13
16,Idaho,47,Tennessee,125,Montgomery County,0,26,-26
16,Idaho,47,Tennessee,135,Perry County,39,0,39
16,Idaho,47,Tennessee,143,Rhea County,0,40,-40
16,Idaho,47,Tennessee,145,Roane County,95,62,33
16,Idaho,47,Tennessee,147,Robertson County,0,12,-12
16,Idaho,47,Tennessee,149,Rutherford County,26,56,-30
16,Idaho,47,Tennessee,157,Shelby County,149,129,20
16,Idaho,47,Tennessee,167,Tipton County,0,16,-16
16,Idaho,47,Tennessee,179,Washington County,2,11,-9
16,Idaho,47,Tennessee,187,Williamson County,24,0,24
16,Idaho,48,Texas,7,Aransas County,9,0,9
16,Idaho,48,Texas,19,Bandera County,11,0,11
16,Idaho,48,Texas,21,Bastrop County,19,0,19
16,Idaho,48,Texas,27,Bell County,19,54,-35
16,Idaho,48,Texas,29,Bexar County,401,130,271
16,Idaho,48,Texas,39,Brazoria County,10,9,1
16,Idaho,48,Texas,41,Brazos County,19,24,-5
16,Idaho,48,Texas,53,Burnet County,9,0,9
16,Idaho,48,Texas,61,Cameron County,0,18,-18
16,Idaho,48,Texas,85,Collin County,49,53,-4
16,Idaho,48,Texas,91,Comal County,0,34,-34
16,Idaho,48,Texas,99,Coryell County,4,33,-29
16,Idaho,48,Texas,111,Dallam County,0,26,-26
16,Idaho,48,Texas,113,Dallas County,112,137,-25
16,Idaho,48,Texas,119,Delta County,10,0,10
16,Idaho,48,Texas,121,Denton County,52,21,31
16,Idaho,48,Texas,127,Dimmit County,85,0,85
16,Idaho,48,Texas,135,Ector County,0,37,-37
16,Idaho,48,Texas,141,El Paso County,0,12,-12
16,Idaho,48,Texas,143,Erath County,0,6,-6
16,Idaho,48,Texas,157,Fort Bend County,71,48,23
16,Idaho,48,Texas,167,Galveston County,46,30,16
16,Idaho,48,Texas,183,Gregg County,8,0,8
16,Idaho,48,Texas,201,Harris County,474,138,336
16,Idaho,48,Texas,209,Hays County,12,105,-93
16,Idaho,48,Texas,215,Hidalgo County,5,145,-140
16,Idaho,48,Texas,229,Hudspeth County,2,0,2
16,Idaho,48,Texas,231,Hunt County,7,27,-20
16,Idaho,48,Texas,239,Jackson County,50,0,50
16,Idaho,48,Texas,241,Jasper County,0,22,-22
16,Idaho,48,Texas,243,Jeff Davis County,0,4,-4
16,Idaho,48,Texas,245,Jefferson County,4,5,-1
16,Idaho,48,Texas,251,Johnson County,0,19,-19
16,Idaho,48,Texas,257,Kaufman County,0,4,-4
16,Idaho,48,Texas,267,Kimble County,0,4,-4
16,Idaho,48,Texas,279,Lamb County,0,17,-17
16,Idaho,48,Texas,281,Lampasas County,3,0,3
16,Idaho,48,Texas,289,Leon County,0,4,-4
16,Idaho,48,Texas,291,Liberty County,14,8,6
16,Idaho,48,Texas,299,Llano County,75,0,75
16,Idaho,48,Texas,303,Lubbock County,0,113,-113
16,Idaho,48,Texas,309,McLennan County,0,69,-69
16,Idaho,48,Texas,329,Midland County,133,0,133
16,Idaho,48,Texas,339,Montgomery County,294,62,232
16,Idaho,48,Texas,347,Nacogdoches County,0,15,-15
16,Idaho,48,Texas,349,Navarro County,28,0,28
16,Idaho,48,Texas,423,Smith County,27,19,8
16,Idaho,48,Texas,439,Tarrant County,246,259,-13
16,Idaho,48,Texas,441,Taylor County,0,38,-38
16,Idaho,48,Texas,451,Tom Green County,0,135,-135
16,Idaho,48,Texas,453,Travis County,185,45,140
16,Idaho,48,Texas,459,Upshur County,17,0,17
16,Idaho,48,Texas,469,Victoria County,82,0,82
16,Idaho,48,Texas,475,Ward County,0,22,-22
16,Idaho,48,Texas,479,Webb County,36,0,36
16,Idaho,48,Texas,485,Wichita County,56,0,56
16,Idaho,48,Texas,491,Williamson County,16,180,-164
16,Idaho,48,Texas,493,Wilson County,54,24,30
16,Idaho,48,Texas,497,Wise County,58,0,58
16,Idaho,48,Texas,507,Zavala County,42,0,42
16,Idaho,49,Utah,1,Beaver County,67,0,67
16,Idaho,49,Utah,3,Box Elder County,147,137,10
16,Idaho,49,Utah,5,Cache County,948,748,200
16,Idaho,49,Utah,7,Carbon County,0,33,-33
16,Idaho,49,Utah,9,Daggett County,0,3,-3
16,Idaho,49,Utah,11,Davis County,476,753,-277
16,Idaho,49,Utah,13,Duchesne County,53,0,53
16,Idaho,49,Utah,15,Emery County,7,0,7
16,Idaho,49,Utah,17,Garfield County,2,0,2
16,Idaho,49,Utah,21,Iron County,11,169,-158
16,Idaho,49,Utah,25,Kane County,0,14,-14
16,Idaho,49,Utah,29,Morgan County,20,0,20
16,Idaho,49,Utah,33,Rich County,98,0,98
16,Idaho,49,Utah,35,Salt Lake County,1591,1454,137
16,Idaho,49,Utah,37,San Juan County,0,6,-6
16,Idaho,49,Utah,39,Sanpete County,66,1,65
16,Idaho,49,Utah,41,Sevier County,0,20,-20
16,Idaho,49,Utah,43,Summit County,28,33,-5
16,Idaho,49,Utah,45,Tooele County,145,112,33
16,Idaho,49,Utah,47,Uintah County,148,34,114
16,Idaho,49,Utah,49,Utah County,2171,2366,-195
16,Idaho,49,Utah,51,Wasatch County,1,180,-179
16,Idaho,49,Utah,53,Washington County,191,434,-243
16,Idaho,49,Utah,57,Weber County,712,607,105
16,Idaho,5,Arkansas,3,Ashley County,11,0,11
16,Idaho,5,Arkansas,7,Benton County,71,36,35
16,Idaho,5,Arkansas,9,Boone County,303,0,303
16,Idaho,5,Arkansas,33,Crawford County,71,0,71
16,Idaho,5,Arkansas,45,Faulkner County,22,28,-6
16,Idaho,5,Arkansas,51,Garland County,4,0,4
16,Idaho,5,Arkansas,59,Hot Spring County,19,0,19
16,Idaho,5,Arkansas,69,Jefferson County,27,0,27
16,Idaho,5,Arkansas,85,Lonoke County,21,0,21
16,Idaho,5,Arkansas,89,Marion County,0,11,-11
16,Idaho,5,Arkansas,105,Perry County,0,16,-16
16,Idaho,5,Arkansas,119,Pulaski County,56,0,56
16,Idaho,5,Arkansas,123,St. Francis County,5,0,5
16,Idaho,5,Arkansas,139,Union County,9,0,9
16,Idaho,5,Arkansas,141,Van Buren County,18,12,6
16,Idaho,5,Arkansas,143,Washington County,17,40,-23
16,Idaho,5,Arkansas,145,White County,39,14,25
16,Idaho,50,Vermont,1,Addison County,0,2,-2
16,Idaho,50,Vermont,3,Bennington County,0,35,-35
16,Idaho,50,Vermont,7,Chittenden County,213,3,210
16,Idaho,50,Vermont,21,Rutland County,14,14,0
16,Idaho,50,Vermont,23,Washington County,0,3,-3
16,Idaho,51,Virginia,3,Albemarle County,15,7,8
16,Idaho,51,Virginia,13,Arlington County,45,0,45
16,Idaho,51,Virginia,31,Campbell County,0,30,-30
16,Idaho,51,Virginia,41,Chesterfield County,89,0,89
16,Idaho,51,Virginia,59,Fairfax County,147,27,120
16,Idaho,51,Virginia,79,Greene County,71,0,71
16,Idaho,51,Virginia,107,Loudoun County,156,23,133
16,Idaho,51,Virginia,137,Orange County,0,74,-74
16,Idaho,51,Virginia,153,Prince William County,83,8,75
16,Idaho,51,Virginia,161,Roanoke County,0,21,-21
16,Idaho,51,Virginia,177,Spotsylvania County,67,0,67
16,Idaho,51,Virginia,179,Stafford County,54,41,13
16,Idaho,51,Virginia,185,Tazewell County,0,4,-4
16,Idaho,51,Virginia,540,Charlottesville city,19,0,19
16,Idaho,51,Virginia,680,Lynchburg city,0,15,-15
16,Idaho,51,Virginia,683,Manassas city,0,35,-35
16,Idaho,51,Virginia,700,Newport News city,0,6,-6
16,Idaho,51,Virginia,710,Norfolk city,0,46,-46
16,Idaho,51,Virginia,760,Richmond city,0,14,-14
16,Idaho,51,Virginia,770,Roanoke city,6,0,6
16,Idaho,51,Virginia,810,Virginia Beach city,4,16,-12
16,Idaho,53,Washington,1,Adams County,6,6,0
16,Idaho,53,Washington,3,Asotin County,745,1232,-487
16,Idaho,53,Washington,5,Benton County,225,264,-39
16,Idaho,53,Washington,7,Chelan County,201,56,145
16,Idaho,53,Washington,9,Clallam County,55,89,-34
16,Idaho,53,Washington,11,Clark County,670,601,69
16,Idaho,53,Washington,13,Columbia County,97,5,92
16,Idaho,53,Washington,15,Cowlitz County,103,101,2
16,Idaho,53,Washington,17,Douglas County,35,5,30
16,Idaho,53,Washington,19,Ferry County,9,21,-12
16,Idaho,53,Washington,21,Franklin County,150,126,24
16,Idaho,53,Washington,23,Garfield County,23,47,-24
16,Idaho,53,Washington,25,Grant County,336,246,90
16,Idaho,53,Washington,27,Grays Harbor County,87,27,60
16,Idaho,53,Washington,29,Island County,105,19,86
16,Idaho,53,Washington,31,Jefferson County,10,39,-29
16,Idaho,53,Washington,33,King County,869,1491,-622
16,Idaho,53,Washington,35,Kitsap County,330,161,169
16,Idaho,53,Washington,37,Kittitas County,15,17,-2
16,Idaho,53,Washington,39,Klickitat County,30,20,10
16,Idaho,53,Washington,41,Lewis County,112,34,78
16,Idaho,53,Washington,43,Lincoln County,29,29,0
16,Idaho,53,Washington,45,Mason County,124,0,124
16,Idaho,53,Washington,47,Okanogan County,52,50,2
16,Idaho,53,Washington,49,Pacific County,4,23,-19
16,Idaho,53,Washington,51,Pend Oreille County,321,205,116
16,Idaho,53,Washington,53,Pierce County,587,713,-126
16,Idaho,53,Washington,55,San Juan County,6,14,-8
16,Idaho,53,Washington,57,Skagit County,30,70,-40
16,Idaho,53,Washington,59,Skamania County,87,0,87
16,Idaho,53,Washington,61,Snohomish County,596,634,-38
16,Idaho,53,Washington,63,Spokane County,1716,2608,-892
16,Idaho,53,Washington,65,Stevens County,188,203,-15
16,Idaho,53,Washington,67,Thurston County,164,180,-16
16,Idaho,53,Washington,69,Wahkiakum County,8,0,8
16,Idaho,53,Washington,71,Walla Walla County,79,234,-155
16,Idaho,53,Washington,73,Whatcom County,281,123,158
16,Idaho,53,Washington,75,Whitman County,568,629,-61
16,Idaho,53,Washington,77,Yakima County,119,191,-72
16,Idaho,54,West Virginia,3,Berkeley County,70,0,70
16,Idaho,54,West Virginia,25,Greenbrier County,0,5,-5
16,Idaho,54,West Virginia,37,Jefferson County,0,21,-21
16,Idaho,54,West Virginia,49,Marion County,0,36,-36
16,Idaho,54,West Virginia,61,Monongalia County,47,22,25
16,Idaho,54,West Virginia,75,Pocahontas County,20,0,20
16,Idaho,54,West Virginia,85,Ritchie County,0,5,-5
16,Idaho,54,West Virginia,107,Wood County,0,5,-5
16,Idaho,55,Wisconsin,1,Adams County,0,4,-4
16,Idaho,55,Wisconsin,3,Ashland County,24,0,24
16,Idaho,55,Wisconsin,9,Brown County,0,139,-139
16,Idaho,55,Wisconsin,21,Columbia County,22,0,22
16,Idaho,55,Wisconsin,25,Dane County,2,61,-59
16,Idaho,55,Wisconsin,27,Dodge County,0,6,-6
16,Idaho,55,Wisconsin,29,Door County,0,5,-5
16,Idaho,55,Wisconsin,67,Langlade County,0,2,-2
16,Idaho,55,Wisconsin,73,Marathon County,0,119,-119
16,Idaho,55,Wisconsin,79,Milwaukee County,79,9,70
16,Idaho,55,Wisconsin,81,Monroe County,12,0,12
16,Idaho,55,Wisconsin,87,Outagamie County,20,3,17
16,Idaho,55,Wisconsin,89,Ozaukee County,6,0,6
16,Idaho,55,Wisconsin,93,Pierce County,0,7,-7
16,Idaho,55,Wisconsin,97,Portage County,10,0,10
16,Idaho,55,Wisconsin,105,Rock County,22,0,22
16,Idaho,55,Wisconsin,117,Sheboygan County,0,4,-4
16,Idaho,55,Wisconsin,121,Trempealeau County,9,0,9
16,Idaho,55,Wisconsin,125,Vilas County,63,0,63
16,Idaho,55,Wisconsin,129,Washburn County,0,4,-4
16,Idaho,55,Wisconsin,133,Waukesha County,0,17,-17
16,Idaho,55,Wisconsin,139,Winnebago County,8,3,5
16,Idaho,56,Wyoming,1,Albany County,0,45,-45
16,Idaho,56,Wyoming,5,Campbell County,105,69,36
16,Idaho,56,Wyoming,7,Carbon County,16,11,5
16,Idaho,56,Wyoming,9,Converse County,0,17,-17
16,Idaho,56,Wyoming,13,Fremont County,99,28,71
16,Idaho,56,Wyoming,19,Johnson County,163,0,163
16,Idaho,56,Wyoming,21,Laramie County,198,32,166
16,Idaho,56,Wyoming,23,Lincoln County,243,118,125
16,Idaho,56,Wyoming,25,Natrona County,276,307,-31
16,Idaho,56,Wyoming,27,Niobrara County,0,6,-6
16,Idaho,56,Wyoming,29,Park County,180,56,124
16,Idaho,56,Wyoming,33,Sheridan County,16,0,16
16,Idaho,56,Wyoming,35,Sublette County,132,13,119
16,Idaho,56,Wyoming,37,Sweetwater County,108,99,9
16,Idaho,56,Wyoming,39,Teton County,412,294,118
16,Idaho,56,Wyoming,41,Uinta County,29,57,-28
16,Idaho,56,Wyoming,43,Washakie County,20,59,-39
16,Idaho,6,California,1,Alameda County,290,278,12
16,Idaho,6,California,7,Butte County,143,150,-7
16,Idaho,6,California,9,Calaveras County,93,37,56
16,Idaho,6,California,11,Colusa County,7,0,7
16,Idaho,6,California,13,Contra Costa County,353,75,278
16,Idaho,6,California,15,Del Norte County,17,0,17
16,Idaho,6,California,17,El Dorado County,52,94,-42
16,Idaho,6,California,19,Fresno County,392,14,378
16,Idaho,6,California,21,Glenn County,149,0,149
16,Idaho,6,California,23,Humboldt County,83,132,-49
16,Idaho,6,California,25,Imperial County,28,32,-4
16,Idaho,6,California,27,Inyo County,48,0,48
16,Idaho,6,California,29,Kern County,540,157,383
16,Idaho,6,California,31,Kings County,0,4,-4
16,Idaho,6,California,33,Lake County,21,85,-64
16,Idaho,6,California,35,Lassen County,12,51,-39
16,Idaho,6,California,37,Los Angeles County,1879,473,1406
16,Idaho,6,California,39,Madera County,30,0,30
16,Idaho,6,California,41,Marin County,76,0,76
16,Idaho,6,California,43,Mariposa County,0,58,-58
16,Idaho,6,California,45,Mendocino County,82,18,64
16,Idaho,6,California,47,Merced County,26,6,20
16,Idaho,6,California,49,Modoc County,21,0,21
16,Idaho,6,California,53,Monterey County,39,36,3
16,Idaho,6,California,55,Napa County,82,7,75
16,Idaho,6,California,57,Nevada County,11,0,11
16,Idaho,6,California,59,Orange County,1584,226,1358
16,Idaho,6,California,61,Placer County,487,151,336
16,Idaho,6,California,63,Plumas County,16,0,16
16,Idaho,6,California,65,Riverside County,1024,458,566
16,Idaho,6,California,67,Sacramento County,815,202,613
16,Idaho,6,California,71,San Bernardino County,1178,162,1016
16,Idaho,6,California,73,San Diego County,1570,435,1135
16,Idaho,6,California,75,San Francisco County,52,231,-179
16,Idaho,6,California,77,San Joaquin County,122,420,-298
16,Idaho,6,California,79,San Luis Obispo County,120,57,63
16,Idaho,6,California,81,San Mateo County,224,14,210
16,Idaho,6,California,83,Santa Barbara County,422,171,251
16,Idaho,6,California,85,Santa Clara County,596,223,373
16,Idaho,6,California,87,Santa Cruz County,66,65,1
16,Idaho,6,California,89,Shasta County,120,30,90
16,Idaho,6,California,93,Siskiyou County,56,39,17
16,Idaho,6,California,95,Solano County,25,7,18
16,Idaho,6,California,97,Sonoma County,299,58,241
16,Idaho,6,California,99,Stanislaus County,448,334,114
16,Idaho,6,California,101,Sutter County,70,46,24
16,Idaho,6,California,103,Tehama County,57,125,-68
16,Idaho,6,California,105,Trinity County,6,0,6
16,Idaho,6,California,107,Tulare County,247,131,116
16,Idaho,6,California,109,Tuolumne County,63,0,63
16,Idaho,6,California,111,Ventura County,393,68,325
16,Idaho,6,California,113,Yolo County,59,216,-157
16,Idaho,6,California,115,Yuba County,185,55,130
16,Idaho,72,Puerto Rico,3,Aguada Municipio,2,0,2
16,Idaho,72,Puerto Rico,23,Cabo Rojo Municipio,5,0,5
16,Idaho,72,Puerto Rico,25,Caguas Municipio,23,0,23
16,Idaho,72,Puerto Rico,129,San Lorenzo Municipio,1,0,1
16,Idaho,72,Puerto Rico,137,Toa Baja Municipio,18,0,18
16,Idaho,72,Puerto Rico,149,Villalba Municipio,3,0,3
16,Idaho,8,Colorado,1,Adams County,90,10,80
16,Idaho,8,Colorado,5,Arapahoe County,321,202,119
16,Idaho,8,Colorado,13,Boulder County,185,426,-241
16,Idaho,8,Colorado,14,Broomfield County,29,40,-11
16,Idaho,8,Colorado,21,Conejos County,33,0,33
16,Idaho,8,Colorado,31,Denver County,367,97,270
16,Idaho,8,Colorado,35,Douglas County,330,92,238
16,Idaho,8,Colorado,37,Eagle County,82,3,79
16,Idaho,8,Colorado,39,Elbert County,0,3,-3
16,Idaho,8,Colorado,41,El Paso County,106,91,15
16,Idaho,8,Colorado,43,Fremont County,18,54,-36
16,Idaho,8,Colorado,45,Garfield County,2,131,-129
16,Idaho,8,Colorado,49,Grand County,0,49,-49
16,Idaho,8,Colorado,51,Gunnison County,0,20,-20
16,Idaho,8,Colorado,59,Jefferson County,171,86,85
16,Idaho,8,Colorado,63,Kit Carson County,36,0,36
16,Idaho,8,Colorado,67,La Plata County,8,66,-58
16,Idaho,8,Colorado,69,Larimer County,170,150,20
16,Idaho,8,Colorado,77,Mesa County,80,108,-28
16,Idaho,8,Colorado,83,Montezuma County,16,75,-59
16,Idaho,8,Colorado,85,Montrose County,8,0,8
16,Idaho,8,Colorado,87,Morgan County,32,10,22
16,Idaho,8,Colorado,89,Otero County,0,5,-5
16,Idaho,8,Colorado,93,Park County,13,0,13
16,Idaho,8,Colorado,97,Pitkin County,14,0,14
16,Idaho,8,Colorado,99,Prowers County,0,3,-3
16,Idaho,8,Colorado,101,Pueblo County,100,35,65
16,Idaho,8,Colorado,103,Rio Blanco County,0,9,-9
16,Idaho,8,Colorado,105,Rio Grande County,0,12,-12
16,Idaho,8,Colorado,107,Routt County,24,0,24
16,Idaho,8,Colorado,109,Saguache County,0,14,-14
16,Idaho,8,Colorado,111,San Juan County,18,0,18
16,Idaho,8,Colorado,113,San Miguel County,0,17,-17
16,Idaho,8,Colorado,117,Summit County,0,16,-16
16,Idaho,8,Colorado,119,Teller County,187,0,187
16,Idaho,8,Colorado,123,Weld County,55,162,-107
16,Idaho,8,Colorado,125,Yuma County,48,0,48
16,Idaho,9,Connecticut,1,Fairfield County,0,11,-11
16,Idaho,9,Connecticut,3,Hartford County,6,0,6
16,Idaho,9,Connecticut,5,Litchfield County,10,0,10
16,Idaho,9,Connecticut,9,New Haven County,9,0,9
16,Idaho,9,Connecticut,13,Tolland County,24,0,24
16,Idaho,9,Connecticut,15,Windham County,10,0,10
16,Idaho,AFR,Africa,,-,108,0,0
16,Idaho,ASI,Asia,,-,2517,0,0
16,Idaho,CAM,Central America,,-,1675,0,0
16,Idaho,CAR,Caribbean,,-,172,0,0
16,Idaho,EUR,Europe,,-,2063,0,0
16,Idaho,ISL,U.S. Island Areas,,-,64,0,0
16,Idaho,NAM,Northern America,,-,494,0,0
16,Idaho,OCE,Oceania and At Sea,,-,297,0,0
16,Idaho,SAM,South America,,-,690,0,0
17,Illinois,1,Alabama,1,Autauga County,68,8,60
17,Illinois,1,Alabama,3,Baldwin County,87,8,79
17,Illinois,1,Alabama,7,Bibb County,6,0,6
17,Illinois,1,Alabama,13,Butler County,17,9,8
17,Illinois,1,Alabama,15,Calhoun County,20,6,14
17,Illinois,1,Alabama,17,Chambers County,0,9,-9
17,Illinois,1,Alabama,21,Chilton County,0,67,-67
17,Illinois,1,Alabama,23,Choctaw County,0,6,-6
17,Illinois,1,Alabama,25,Clarke County,0,8,-8
17,Illinois,1,Alabama,31,Coffee County,13,86,-73
17,Illinois,1,Alabama,33,Colbert County,10,17,-7
17,Illinois,1,Alabama,39,Covington County,0,10,-10
17,Illinois,1,Alabama,45,Dale County,0,53,-53
17,Illinois,1,Alabama,47,Dallas County,0,10,-10
17,Illinois,1,Alabama,49,DeKalb County,22,0,22
17,Illinois,1,Alabama,51,Elmore County,0,20,-20
17,Illinois,1,Alabama,55,Etowah County,11,29,-18
17,Illinois,1,Alabama,65,Hale County,0,1,-1
17,Illinois,1,Alabama,69,Houston County,60,6,54
17,Illinois,1,Alabama,73,Jefferson County,234,349,-115
17,Illinois,1,Alabama,75,Lamar County,0,8,-8
17,Illinois,1,Alabama,77,Lauderdale County,0,120,-120
17,Illinois,1,Alabama,81,Lee County,118,112,6
17,Illinois,1,Alabama,83,Limestone County,44,191,-147
17,Illinois,1,Alabama,87,Macon County,0,62,-62
17,Illinois,1,Alabama,89,Madison County,139,185,-46
17,Illinois,1,Alabama,95,Marshall County,16,192,-176
17,Illinois,1,Alabama,97,Mobile County,58,298,-240
17,Illinois,1,Alabama,101,Montgomery County,489,216,273
17,Illinois,1,Alabama,103,Morgan County,0,6,-6
17,Illinois,1,Alabama,105,Perry County,0,10,-10
17,Illinois,1,Alabama,107,Pickens County,16,7,9
17,Illinois,1,Alabama,113,Russell County,86,0,86
17,Illinois,1,Alabama,115,St. Clair County,107,0,107
17,Illinois,1,Alabama,117,Shelby County,88,204,-116
17,Illinois,1,Alabama,125,Tuscaloosa County,180,278,-98
17,Illinois,1,Alabama,127,Walker County,0,44,-44
17,Illinois,10,Delaware,1,Kent County,0,244,-244
17,Illinois,10,Delaware,3,New Castle County,169,207,-38
17,Illinois,10,Delaware,5,Sussex County,0,41,-41
17,Illinois,11,District of Columbia,1,District of Columbia,1089,1700,-611
17,Illinois,12,Florida,1,Alachua County,415,223,192
17,Illinois,12,Florida,5,Bay County,114,264,-150
17,Illinois,12,Florida,9,Brevard County,242,1017,-775
17,Illinois,12,Florida,11,Broward County,1472,1445,27
17,Illinois,12,Florida,15,Charlotte County,46,730,-684
17,Illinois,12,Florida,17,Citrus County,133,127,6
17,Illinois,12,Florida,19,Clay County,97,158,-61
17,Illinois,12,Florida,21,Collier County,439,915,-476
17,Illinois,12,Florida,27,DeSoto County,12,8,4
17,Illinois,12,Florida,31,Duval County,639,781,-142
17,Illinois,12,Florida,33,Escambia County,256,387,-131
17,Illinois,12,Florida,35,Flagler County,0,62,-62
17,Illinois,12,Florida,39,Gadsden County,14,12,2
17,Illinois,12,Florida,41,Gilchrist County,0,4,-4
17,Illinois,12,Florida,43,Glades County,10,6,4
17,Illinois,12,Florida,45,Gulf County,28,0,28
17,Illinois,12,Florida,47,Hamilton County,0,49,-49
17,Illinois,12,Florida,51,Hendry County,0,44,-44
17,Illinois,12,Florida,53,Hernando County,17,146,-129
17,Illinois,12,Florida,55,Highlands County,57,344,-287
17,Illinois,12,Florida,57,Hillsborough County,906,2162,-1256
17,Illinois,12,Florida,59,Holmes County,9,0,9
17,Illinois,12,Florida,61,Indian River County,28,99,-71
17,Illinois,12,Florida,63,Jackson County,0,28,-28
17,Illinois,12,Florida,69,Lake County,240,568,-328
17,Illinois,12,Florida,71,Lee County,778,2025,-1247
17,Illinois,12,Florida,73,Leon County,250,492,-242
17,Illinois,12,Florida,75,Levy County,22,83,-61
17,Illinois,12,Florida,77,Liberty County,0,6,-6
17,Illinois,12,Florida,81,Manatee County,495,674,-179
17,Illinois,12,Florida,83,Marion County,77,654,-577
17,Illinois,12,Florida,85,Martin County,65,98,-33
17,Illinois,12,Florida,86,Miami-Dade County,695,892,-197
17,Illinois,12,Florida,87,Monroe County,139,238,-99
17,Illinois,12,Florida,89,Nassau County,0,57,-57
17,Illinois,12,Florida,91,Okaloosa County,178,470,-292
17,Illinois,12,Florida,93,Okeechobee County,16,49,-33
17,Illinois,12,Florida,95,Orange County,1282,1774,-492
17,Illinois,12,Florida,97,Osceola County,215,93,122
17,Illinois,12,Florida,99,Palm Beach County,838,1645,-807
17,Illinois,12,Florida,101,Pasco County,331,848,-517
17,Illinois,12,Florida,103,Pinellas County,377,1303,-926
17,Illinois,12,Florida,105,Polk County,430,687,-257
17,Illinois,12,Florida,107,Putnam County,23,3,20
17,Illinois,12,Florida,109,St. Johns County,128,274,-146
17,Illinois,12,Florida,111,St. Lucie County,210,278,-68
17,Illinois,12,Florida,113,Santa Rosa County,76,196,-120
17,Illinois,12,Florida,115,Sarasota County,342,577,-235
17,Illinois,12,Florida,117,Seminole County,296,264,32
17,Illinois,12,Florida,119,Sumter County,47,282,-235
17,Illinois,12,Florida,127,Volusia County,253,478,-225
17,Illinois,12,Florida,131,Walton County,30,80,-50
17,Illinois,12,Florida,133,Washington County,0,14,-14
17,Illinois,13,Georgia,1,Appling County,0,21,-21
17,Illinois,13,Georgia,9,Baldwin County,26,21,5
17,Illinois,13,Georgia,13,Barrow County,0,11,-11
17,Illinois,13,Georgia,15,Bartow County,4,0,4
17,Illinois,13,Georgia,19,Berrien County,0,24,-24
17,Illinois,13,Georgia,21,Bibb County,107,50,57
17,Illinois,13,Georgia,27,Brooks County,0,8,-8
17,Illinois,13,Georgia,29,Bryan County,33,0,33
17,Illinois,13,Georgia,31,Bulloch County,0,29,-29
17,Illinois,13,Georgia,33,Burke County,0,3,-3
17,Illinois,13,Georgia,35,Butts County,0,6,-6
17,Illinois,13,Georgia,39,Camden County,40,19,21
17,Illinois,13,Georgia,45,Carroll County,0,202,-202
17,Illinois,13,Georgia,47,Catoosa County,49,85,-36
17,Illinois,13,Georgia,51,Chatham County,280,185,95
17,Illinois,13,Georgia,53,Chattahoochee County,5,39,-34
17,Illinois,13,Georgia,57,Cherokee County,28,311,-283
17,Illinois,13,Georgia,59,Clarke County,10,102,-92
17,Illinois,13,Georgia,63,Clayton County,58,398,-340
17,Illinois,13,Georgia,67,Cobb County,501,1135,-634
17,Illinois,13,Georgia,69,Coffee County,150,23,127
17,Illinois,13,Georgia,71,Colquitt County,0,178,-178
17,Illinois,13,Georgia,73,Columbia County,36,68,-32
17,Illinois,13,Georgia,77,Coweta County,45,71,-26
17,Illinois,13,Georgia,83,Dade County,0,48,-48
17,Illinois,13,Georgia,85,Dawson County,21,0,21
17,Illinois,13,Georgia,89,DeKalb County,496,819,-323
17,Illinois,13,Georgia,95,Dougherty County,0,3,-3
17,Illinois,13,Georgia,97,Douglas County,11,293,-282
17,Illinois,13,Georgia,103,Effingham County,0,86,-86
17,Illinois,13,Georgia,107,Emanuel County,0,8,-8
17,Illinois,13,Georgia,113,Fayette County,56,40,16
17,Illinois,13,Georgia,115,Floyd County,26,0,26
17,Illinois,13,Georgia,117,Forsyth County,47,452,-405
17,Illinois,13,Georgia,119,Franklin County,0,10,-10
17,Illinois,13,Georgia,121,Fulton County,1296,1309,-13
17,Illinois,13,Georgia,127,Glynn County,0,21,-21
17,Illinois,13,Georgia,129,Gordon County,35,27,8
17,Illinois,13,Georgia,133,Greene County,19,0,19
17,Illinois,13,Georgia,135,Gwinnett County,917,807,110
17,Illinois,13,Georgia,139,Hall County,4,162,-158
17,Illinois,13,Georgia,145,Harris County,26,5,21
17,Illinois,13,Georgia,151,Henry County,157,204,-47
17,Illinois,13,Georgia,153,Houston County,73,65,8
17,Illinois,13,Georgia,157,Jackson County,52,0,52
17,Illinois,13,Georgia,165,Jenkins County,30,0,30
17,Illinois,13,Georgia,167,Johnson County,0,7,-7
17,Illinois,13,Georgia,169,Jones County,47,0,47
17,Illinois,13,Georgia,175,Laurens County,0,15,-15
17,Illinois,13,Georgia,179,Liberty County,91,55,36
17,Illinois,13,Georgia,181,Lincoln County,0,4,-4
17,Illinois,13,Georgia,183,Long County,0,25,-25
17,Illinois,13,Georgia,185,Lowndes County,0,84,-84
17,Illinois,13,Georgia,189,McDuffie County,3,0,3
17,Illinois,13,Georgia,215,Muscogee County,198,283,-85
17,Illinois,13,Georgia,217,Newton County,5,131,-126
17,Illinois,13,Georgia,223,Paulding County,4,136,-132
17,Illinois,13,Georgia,225,Peach County,0,9,-9
17,Illinois,13,Georgia,233,Polk County,0,39,-39
17,Illinois,13,Georgia,245,Richmond County,50,79,-29
17,Illinois,13,Georgia,247,Rockdale County,32,23,9
17,Illinois,13,Georgia,251,Screven County,0,18,-18
17,Illinois,13,Georgia,255,Spalding County,9,18,-9
17,Illinois,13,Georgia,257,Stephens County,0,7,-7
17,Illinois,13,Georgia,267,Tattnall County,0,102,-102
17,Illinois,13,Georgia,275,Thomas County,0,5,-5
17,Illinois,13,Georgia,279,Toombs County,30,9,21
17,Illinois,13,Georgia,285,Troup County,6,38,-32
17,Illinois,13,Georgia,293,Upson County,14,0,14
17,Illinois,13,Georgia,295,Walker County,7,0,7
17,Illinois,13,Georgia,297,Walton County,35,0,35
17,Illinois,13,Georgia,305,Wayne County,0,42,-42
17,Illinois,13,Georgia,313,Whitfield County,115,209,-94
17,Illinois,15,Hawaii,1,Hawaii County,123,160,-37
17,Illinois,15,Hawaii,3,Honolulu County,885,1182,-297
17,Illinois,15,Hawaii,7,Kauai County,32,21,11
17,Illinois,15,Hawaii,9,Maui County,116,113,3
17,Illinois,16,Idaho,1,Ada County,171,259,-88
17,Illinois,16,Idaho,3,Adams County,0,24,-24
17,Illinois,16,Idaho,5,Bannock County,70,119,-49
17,Illinois,16,Idaho,9,Benewah County,1,0,1
17,Illinois,16,Idaho,11,Bingham County,20,0,20
17,Illinois,16,Idaho,13,Blaine County,0,12,-12
17,Illinois,16,Idaho,17,Bonner County,0,1,-1
17,Illinois,16,Idaho,19,Bonneville County,27,108,-81
17,Illinois,16,Idaho,21,Boundary County,0,4,-4
17,Illinois,16,Idaho,27,Canyon County,176,39,137
17,Illinois,16,Idaho,33,Clark County,0,12,-12
17,Illinois,16,Idaho,39,Elmore County,0,20,-20
17,Illinois,16,Idaho,45,Gem County,14,0,14
17,Illinois,16,Idaho,53,Jerome County,0,18,-18
17,Illinois,16,Idaho,55,Kootenai County,19,12,7
17,Illinois,16,Idaho,57,Latah County,73,0,73
17,Illinois,16,Idaho,59,Lemhi County,0,12,-12
17,Illinois,16,Idaho,65,Madison County,4,241,-237
17,Illinois,16,Idaho,69,Nez Perce County,0,25,-25
17,Illinois,16,Idaho,73,Owyhee County,0,19,-19
17,Illinois,16,Idaho,81,Teton County,0,15,-15
17,Illinois,16,Idaho,83,Twin Falls County,15,12,3
17,Illinois,17,Illinois,1,Adams County,1567,832,735
17,Illinois,17,Illinois,3,Alexander County,193,149,44
17,Illinois,17,Illinois,5,Bond County,776,958,-182
17,Illinois,17,Illinois,7,Boone County,2562,2596,-34
17,Illinois,17,Illinois,9,Brown County,540,1027,-487
17,Illinois,17,Illinois,11,Bureau County,1383,892,491
17,Illinois,17,Illinois,13,Calhoun County,188,84,104
17,Illinois,17,Illinois,15,Carroll County,476,300,176
17,Illinois,17,Illinois,17,Cass County,751,343,408
17,Illinois,17,Illinois,19,Champaign County,7523,15456,-7933
17,Illinois,17,Illinois,21,Christian County,1552,1477,75
17,Illinois,17,Illinois,23,Clark County,566,368,198
17,Illinois,17,Illinois,25,Clay County,610,333,277
17,Illinois,17,Illinois,27,Clinton County,1547,1680,-133
17,Illinois,17,Illinois,29,Coles County,1859,4196,-2337
17,Illinois,17,Illinois,31,Cook County,81478,51004,30474
17,Illinois,17,Illinois,33,Crawford County,562,1039,-477
17,Illinois,17,Illinois,35,Cumberland County,632,628,4
17,Illinois,17,Illinois,37,DeKalb County,4658,7885,-3227
17,Illinois,17,Illinois,39,De Witt County,825,622,203
17,Illinois,17,Illinois,41,Douglas County,1127,405,722
17,Illinois,17,Illinois,43,DuPage County,34495,34828,-333
17,Illinois,17,Illinois,45,Edgar County,304,647,-343
17,Illinois,17,Illinois,47,Edwards County,255,305,-50
17,Illinois,17,Illinois,49,Effingham County,1032,1172,-140
17,Illinois,17,Illinois,51,Fayette County,1061,1550,-489
17,Illinois,17,Illinois,53,Ford County,551,730,-179
17,Illinois,17,Illinois,55,Franklin County,1166,1228,-62
17,Illinois,17,Illinois,57,Fulton County,1448,1758,-310
17,Illinois,17,Illinois,59,Gallatin County,237,79,158
17,Illinois,17,Illinois,61,Greene County,528,539,-11
17,Illinois,17,Illinois,63,Grundy County,2762,1866,896
17,Illinois,17,Illinois,65,Hamilton County,331,132,199
17,Illinois,17,Illinois,67,Hancock County,269,171,98
17,Illinois,17,Illinois,69,Hardin County,123,103,20
17,Illinois,17,Illinois,71,Henderson County,281,217,64
17,Illinois,17,Illinois,73,Henry County,1255,1140,115
17,Illinois,17,Illinois,75,Iroquois County,1057,972,85
17,Illinois,17,Illinois,77,Jackson County,3032,5555,-2523
17,Illinois,17,Illinois,79,Jasper County,106,235,-129
17,Illinois,17,Illinois,81,Jefferson County,1301,1567,-266
17,Illinois,17,Illinois,83,Jersey County,546,754,-208
17,Illinois,17,Illinois,85,Jo Daviess County,289,504,-215
17,Illinois,17,Illinois,87,Johnson County,680,1426,-746
17,Illinois,17,Illinois,89,Kane County,19396,18600,796
17,Illinois,17,Illinois,91,Kankakee County,2750,3125,-375
17,Illinois,17,Illinois,93,Kendall County,6075,6193,-118
17,Illinois,17,Illinois,95,Knox County,1506,1744,-238
17,Illinois,17,Illinois,97,Lake County,17049,16537,512
17,Illinois,17,Illinois,99,LaSalle County,4460,4000,460
17,Illinois,17,Illinois,101,Lawrence County,817,1069,-252
17,Illinois,17,Illinois,103,Lee County,1653,2424,-771
17,Illinois,17,Illinois,105,Livingston County,1949,1824,125
17,Illinois,17,Illinois,107,Logan County,1526,2627,-1101
17,Illinois,17,Illinois,109,McDonough County,1235,2556,-1321
17,Illinois,17,Illinois,111,McHenry County,8967,9230,-263
17,Illinois,17,Illinois,113,McLean County,6041,9703,-3662
17,Illinois,17,Illinois,115,Macon County,2917,3050,-133
17,Illinois,17,Illinois,117,Macoupin County,1824,1618,206
17,Illinois,17,Illinois,119,Madison County,5977,8911,-2934
17,Illinois,17,Illinois,121,Marion County,1546,1017,529
17,Illinois,17,Illinois,123,Marshall County,349,414,-65
17,Illinois,17,Illinois,125,Mason County,719,627,92
17,Illinois,17,Illinois,127,Massac County,111,233,-122
17,Illinois,17,Illinois,129,Menard County,581,463,118
17,Illinois,17,Illinois,131,Mercer County,446,530,-84
17,Illinois,17,Illinois,133,Monroe County,607,735,-128
17,Illinois,17,Illinois,135,Montgomery County,1725,2735,-1010
17,Illinois,17,Illinois,137,Morgan County,1554,2115,-561
17,Illinois,17,Illinois,139,Moultrie County,704,715,-11
17,Illinois,17,Illinois,141,Ogle County,1979,1850,129
17,Illinois,17,Illinois,143,Peoria County,6679,5826,853
17,Illinois,17,Illinois,145,Perry County,1290,1496,-206
17,Illinois,17,Illinois,147,Piatt County,847,1121,-274
17,Illinois,17,Illinois,149,Pike County,545,527,18
17,Illinois,17,Illinois,151,Pope County,68,134,-66
17,Illinois,17,Illinois,153,Pulaski County,134,115,19
17,Illinois,17,Illinois,155,Putnam County,244,191,53
17,Illinois,17,Illinois,157,Randolph County,1423,1724,-301
17,Illinois,17,Illinois,159,Richland County,858,628,230
17,Illinois,17,Illinois,161,Rock Island County,2213,3247,-1034
17,Illinois,17,Illinois,163,St. Clair County,6476,5147,1329
17,Illinois,17,Illinois,165,Saline County,638,635,3
17,Illinois,17,Illinois,167,Sangamon County,5149,5621,-472
17,Illinois,17,Illinois,169,Schuyler County,168,370,-202
17,Illinois,17,Illinois,171,Scott County,328,254,74
17,Illinois,17,Illinois,173,Shelby County,1051,758,293
17,Illinois,17,Illinois,175,Stark County,186,120,66
17,Illinois,17,Illinois,177,Stephenson County,1314,1310,4
17,Illinois,17,Illinois,179,Tazewell County,4435,4939,-504
17,Illinois,17,Illinois,181,Union County,395,365,30
17,Illinois,17,Illinois,183,Vermilion County,1869,1661,208
17,Illinois,17,Illinois,185,Wabash County,317,180,137
17,Illinois,17,Illinois,187,Warren County,683,681,2
17,Illinois,17,Illinois,189,Washington County,391,398,-7
17,Illinois,17,Illinois,191,Wayne County,721,569,152
17,Illinois,17,Illinois,193,White County,614,409,205
17,Illinois,17,Illinois,195,Whiteside County,1373,1368,5
17,Illinois,17,Illinois,197,Will County,21447,24191,-2744
17,Illinois,17,Illinois,199,Williamson County,2126,1970,156
17,Illinois,17,Illinois,201,Winnebago County,5302,7529,-2227
17,Illinois,17,Illinois,203,Woodford County,1287,1637,-350
17,Illinois,18,Indiana,1,Adams County,8,280,-272
17,Illinois,18,Indiana,3,Allen County,417,1032,-615
17,Illinois,18,Indiana,5,Bartholomew County,33,184,-151
17,Illinois,18,Indiana,7,Benton County,5,100,-95
17,Illinois,18,Indiana,9,Blackford County,34,0,34
17,Illinois,18,Indiana,11,Boone County,91,281,-190
17,Illinois,18,Indiana,13,Brown County,28,30,-2
17,Illinois,18,Indiana,15,Carroll County,0,35,-35
17,Illinois,18,Indiana,17,Cass County,61,19,42
17,Illinois,18,Indiana,19,Clark County,28,48,-20
17,Illinois,18,Indiana,21,Clay County,175,2,173
17,Illinois,18,Indiana,27,Daviess County,42,28,14
17,Illinois,18,Indiana,29,Dearborn County,40,0,40
17,Illinois,18,Indiana,31,Decatur County,2,49,-47
17,Illinois,18,Indiana,33,DeKalb County,0,73,-73
17,Illinois,18,Indiana,35,Delaware County,105,411,-306
17,Illinois,18,Indiana,37,Dubois County,53,0,53
17,Illinois,18,Indiana,39,Elkhart County,190,55,135
17,Illinois,18,Indiana,41,Fayette County,1,0,1
17,Illinois,18,Indiana,43,Floyd County,112,95,17
17,Illinois,18,Indiana,45,Fountain County,26,54,-28
17,Illinois,18,Indiana,49,Fulton County,12,0,12
17,Illinois,18,Indiana,51,Gibson County,125,104,21
17,Illinois,18,Indiana,53,Grant County,165,244,-79
17,Illinois,18,Indiana,55,Greene County,48,8,40
17,Illinois,18,Indiana,57,Hamilton County,497,1627,-1130
17,Illinois,18,Indiana,59,Hancock County,5,120,-115
17,Illinois,18,Indiana,61,Harrison County,64,23,41
17,Illinois,18,Indiana,63,Hendricks County,329,128,201
17,Illinois,18,Indiana,65,Henry County,0,11,-11
17,Illinois,18,Indiana,67,Howard County,145,215,-70
17,Illinois,18,Indiana,69,Huntington County,76,44,32
17,Illinois,18,Indiana,71,Jackson County,0,27,-27
17,Illinois,18,Indiana,73,Jasper County,62,340,-278
17,Illinois,18,Indiana,75,Jay County,3,21,-18
17,Illinois,18,Indiana,77,Jefferson County,0,55,-55
17,Illinois,18,Indiana,79,Jennings County,0,42,-42
17,Illinois,18,Indiana,81,Johnson County,190,198,-8
17,Illinois,18,Indiana,83,Knox County,226,275,-49
17,Illinois,18,Indiana,85,Kosciusko County,18,226,-208
17,Illinois,18,Indiana,87,LaGrange County,29,61,-32
17,Illinois,18,Indiana,89,Lake County,4679,11820,-7141
17,Illinois,18,Indiana,91,LaPorte County,113,629,-516
17,Illinois,18,Indiana,93,Lawrence County,24,36,-12
17,Illinois,18,Indiana,95,Madison County,76,143,-67
17,Illinois,18,Indiana,97,Marion County,1735,3047,-1312
17,Illinois,18,Indiana,99,Marshall County,55,94,-39
17,Illinois,18,Indiana,101,Martin County,9,27,-18
17,Illinois,18,Indiana,103,Miami County,13,53,-40
17,Illinois,18,Indiana,105,Monroe County,694,2032,-1338
17,Illinois,18,Indiana,107,Montgomery County,55,199,-144
17,Illinois,18,Indiana,109,Morgan County,51,36,15
17,Illinois,18,Indiana,111,Newton County,24,89,-65
17,Illinois,18,Indiana,113,Noble County,32,36,-4
17,Illinois,18,Indiana,115,Ohio County,0,5,-5
17,Illinois,18,Indiana,117,Orange County,0,8,-8
17,Illinois,18,Indiana,119,Owen County,0,15,-15
17,Illinois,18,Indiana,121,Parke County,24,65,-41
17,Illinois,18,Indiana,123,Perry County,3,28,-25
17,Illinois,18,Indiana,125,Pike County,27,9,18
17,Illinois,18,Indiana,127,Porter County,582,1623,-1041
17,Illinois,18,Indiana,129,Posey County,46,57,-11
17,Illinois,18,Indiana,131,Pulaski County,14,5,9
17,Illinois,18,Indiana,133,Putnam County,159,247,-88
17,Illinois,18,Indiana,135,Randolph County,0,28,-28
17,Illinois,18,Indiana,137,Ripley County,1,40,-39
17,Illinois,18,Indiana,139,Rush County,0,4,-4
17,Illinois,18,Indiana,141,St. Joseph County,1695,1308,387
17,Illinois,18,Indiana,143,Scott County,27,0,27
17,Illinois,18,Indiana,145,Shelby County,22,23,-1
17,Illinois,18,Indiana,147,Spencer County,18,8,10
17,Illinois,18,Indiana,149,Starke County,33,46,-13
17,Illinois,18,Indiana,151,Steuben County,22,42,-20
17,Illinois,18,Indiana,153,Sullivan County,52,29,23
17,Illinois,18,Indiana,157,Tippecanoe County,946,1581,-635
17,Illinois,18,Indiana,159,Tipton County,0,1,-1
17,Illinois,18,Indiana,163,Vanderburgh County,557,927,-370
17,Illinois,18,Indiana,165,Vermillion County,112,75,37
17,Illinois,18,Indiana,167,Vigo County,363,928,-565
17,Illinois,18,Indiana,169,Wabash County,4,52,-48
17,Illinois,18,Indiana,171,Warren County,62,31,31
17,Illinois,18,Indiana,173,Warrick County,102,0,102
17,Illinois,18,Indiana,177,Wayne County,0,101,-101
17,Illinois,18,Indiana,179,Wells County,102,12,90
17,Illinois,18,Indiana,181,White County,82,26,56
17,Illinois,18,Indiana,183,Whitley County,44,7,37
17,Illinois,19,Iowa,3,Adams County,0,1,-1
17,Illinois,19,Iowa,5,Allamakee County,23,19,4
17,Illinois,19,Iowa,7,Appanoose County,0,2,-2
17,Illinois,19,Iowa,11,Benton County,0,5,-5
17,Illinois,19,Iowa,13,Black Hawk County,157,437,-280
17,Illinois,19,Iowa,15,Boone County,63,0,63
17,Illinois,19,Iowa,17,Bremer County,25,101,-76
17,Illinois,19,Iowa,19,Buchanan County,21,65,-44
17,Illinois,19,Iowa,21,Buena Vista County,13,42,-29
17,Illinois,19,Iowa,23,Butler County,55,14,41
17,Illinois,19,Iowa,27,Carroll County,55,49,6
17,Illinois,19,Iowa,31,Cedar County,0,40,-40
17,Illinois,19,Iowa,33,Cerro Gordo County,0,56,-56
17,Illinois,19,Iowa,37,Chickasaw County,10,0,10
17,Illinois,19,Iowa,39,Clarke County,0,4,-4
17,Illinois,19,Iowa,41,Clay County,7,11,-4
17,Illinois,19,Iowa,43,Clayton County,0,16,-16
17,Illinois,19,Iowa,45,Clinton County,347,392,-45
17,Illinois,19,Iowa,47,Crawford County,0,16,-16
17,Illinois,19,Iowa,49,Dallas County,269,121,148
17,Illinois,19,Iowa,51,Davis County,0,63,-63
17,Illinois,19,Iowa,53,Decatur County,0,5,-5
17,Illinois,19,Iowa,55,Delaware County,16,62,-46
17,Illinois,19,Iowa,57,Des Moines County,297,608,-311
17,Illinois,19,Iowa,59,Dickinson County,0,4,-4
17,Illinois,19,Iowa,61,Dubuque County,679,1561,-882
17,Illinois,19,Iowa,63,Emmet County,0,10,-10
17,Illinois,19,Iowa,65,Fayette County,0,45,-45
17,Illinois,19,Iowa,67,Floyd County,16,8,8
17,Illinois,19,Iowa,71,Fremont County,0,5,-5
17,Illinois,19,Iowa,73,Greene County,4,2,2
17,Illinois,19,Iowa,75,Grundy County,10,0,10
17,Illinois,19,Iowa,77,Guthrie County,0,43,-43
17,Illinois,19,Iowa,79,Hamilton County,16,11,5
17,Illinois,19,Iowa,81,Hancock County,4,1,3
17,Illinois,19,Iowa,83,Hardin County,8,15,-7
17,Illinois,19,Iowa,85,Harrison County,0,7,-7
17,Illinois,19,Iowa,87,Henry County,39,81,-42
17,Illinois,19,Iowa,89,Howard County,3,0,3
17,Illinois,19,Iowa,95,Iowa County,26,7,19
17,Illinois,19,Iowa,97,Jackson County,11,69,-58
17,Illinois,19,Iowa,99,Jasper County,0,5,-5
17,Illinois,19,Iowa,101,Jefferson County,0,28,-28
17,Illinois,19,Iowa,103,Johnson County,1121,2277,-1156
17,Illinois,19,Iowa,105,Jones County,6,47,-41
17,Illinois,19,Iowa,107,Keokuk County,77,38,39
17,Illinois,19,Iowa,109,Kossuth County,0,33,-33
17,Illinois,19,Iowa,111,Lee County,206,470,-264
17,Illinois,19,Iowa,113,Linn County,505,660,-155
17,Illinois,19,Iowa,115,Louisa County,109,28,81
17,Illinois,19,Iowa,121,Madison County,0,3,-3
17,Illinois,19,Iowa,123,Mahaska County,4,11,-7
17,Illinois,19,Iowa,125,Marion County,0,90,-90
17,Illinois,19,Iowa,127,Marshall County,0,74,-74
17,Illinois,19,Iowa,129,Mills County,35,4,31
17,Illinois,19,Iowa,131,Mitchell County,0,3,-3
17,Illinois,19,Iowa,133,Monona County,0,34,-34
17,Illinois,19,Iowa,135,Monroe County,1,25,-24
17,Illinois,19,Iowa,137,Montgomery County,5,0,5
17,Illinois,19,Iowa,139,Muscatine County,363,52,311
17,Illinois,19,Iowa,141,O'Brien County,0,4,-4
17,Illinois,19,Iowa,143,Osceola County,0,1,-1
17,Illinois,19,Iowa,145,Page County,33,0,33
17,Illinois,19,Iowa,149,Plymouth County,0,4,-4
17,Illinois,19,Iowa,151,Pocahontas County,0,20,-20
17,Illinois,19,Iowa,153,Polk County,606,1368,-762
17,Illinois,19,Iowa,155,Pottawattamie County,0,176,-176
17,Illinois,19,Iowa,157,Poweshiek County,122,71,51
17,Illinois,19,Iowa,159,Ringgold County,0,1,-1
17,Illinois,19,Iowa,161,Sac County,0,14,-14
17,Illinois,19,Iowa,163,Scott County,2411,2329,82
17,Illinois,19,Iowa,165,Shelby County,2,77,-75
17,Illinois,19,Iowa,167,Sioux County,0,45,-45
17,Illinois,19,Iowa,169,Story County,402,1218,-816
17,Illinois,19,Iowa,171,Tama County,67,3,64
17,Illinois,19,Iowa,173,Taylor County,0,4,-4
17,Illinois,19,Iowa,175,Union County,0,39,-39
17,Illinois,19,Iowa,177,Van Buren County,60,5,55
17,Illinois,19,Iowa,179,Wapello County,122,97,25
17,Illinois,19,Iowa,181,Warren County,39,39,0
17,Illinois,19,Iowa,183,Washington County,12,132,-120
17,Illinois,19,Iowa,185,Wayne County,0,2,-2
17,Illinois,19,Iowa,187,Webster County,160,211,-51
17,Illinois,19,Iowa,189,Winnebago County,0,3,-3
17,Illinois,19,Iowa,191,Winneshiek County,27,14,13
17,Illinois,19,Iowa,193,Woodbury County,22,178,-156
17,Illinois,19,Iowa,195,Worth County,0,37,-37
17,Illinois,19,Iowa,197,Wright County,0,25,-25
17,Illinois,2,Alaska,13,Aleutians East Borough,0,21,-21
17,Illinois,2,Alaska,16,Aleutians West Census Area,0,27,-27
17,Illinois,2,Alaska,20,Anchorage Municipality,1159,598,561
17,Illinois,2,Alaska,50,Bethel Census Area,0,13,-13
17,Illinois,2,Alaska,68,Denali Borough,0,11,-11
17,Illinois,2,Alaska,70,Dillingham Census Area,0,2,-2
17,Illinois,2,Alaska,90,Fairbanks North Star Borough,211,53,158
17,Illinois,2,Alaska,122,Kenai Peninsula Borough,45,6,39
17,Illinois,2,Alaska,130,Ketchikan Gateway Borough,0,32,-32
17,Illinois,2,Alaska,150,Kodiak Island Borough,14,0,14
17,Illinois,2,Alaska,164,Lake and Peninsula Borough,0,4,-4
17,Illinois,2,Alaska,170,Matanuska-Susitna Borough,0,65,-65
17,Illinois,2,Alaska,185,North Slope Borough,0,4,-4
17,Illinois,2,Alaska,195,Petersburg Borough,0,1,-1
17,Illinois,20,Kansas,5,Atchison County,14,5,9
17,Illinois,20,Kansas,7,Barber County,0,6,-6
17,Illinois,20,Kansas,9,Barton County,0,30,-30
17,Illinois,20,Kansas,11,Bourbon County,0,15,-15
17,Illinois,20,Kansas,15,Butler County,84,0,84
17,Illinois,20,Kansas,37,Crawford County,11,8,3
17,Illinois,20,Kansas,41,Dickinson County,36,0,36
17,Illinois,20,Kansas,45,Douglas County,103,455,-352
17,Illinois,20,Kansas,51,Ellis County,0,9,-9
17,Illinois,20,Kansas,55,Finney County,10,0,10
17,Illinois,20,Kansas,57,Ford County,0,3,-3
17,Illinois,20,Kansas,59,Franklin County,0,18,-18
17,Illinois,20,Kansas,61,Geary County,19,59,-40
17,Illinois,20,Kansas,63,Gove County,0,8,-8
17,Illinois,20,Kansas,69,Gray County,14,0,14
17,Illinois,20,Kansas,71,Greeley County,0,10,-10
17,Illinois,20,Kansas,79,Harvey County,6,0,6
17,Illinois,20,Kansas,81,Haskell County,14,0,14
17,Illinois,20,Kansas,83,Hodgeman County,0,3,-3
17,Illinois,20,Kansas,91,Johnson County,477,452,25
17,Illinois,20,Kansas,99,Labette County,24,0,24
17,Illinois,20,Kansas,103,Leavenworth County,118,74,44
17,Illinois,20,Kansas,105,Lincoln County,0,7,-7
17,Illinois,20,Kansas,111,Lyon County,10,42,-32
17,Illinois,20,Kansas,113,McPherson County,15,27,-12
17,Illinois,20,Kansas,121,Miami County,0,51,-51
17,Illinois,20,Kansas,125,Montgomery County,0,13,-13
17,Illinois,20,Kansas,137,Norton County,0,10,-10
17,Illinois,20,Kansas,139,Osage County,8,11,-3
17,Illinois,20,Kansas,141,Osborne County,0,12,-12
17,Illinois,20,Kansas,151,Pratt County,0,2,-2
17,Illinois,20,Kansas,155,Reno County,34,19,15
17,Illinois,20,Kansas,161,Riley County,144,158,-14
17,Illinois,20,Kansas,165,Rush County,0,6,-6
17,Illinois,20,Kansas,167,Russell County,0,2,-2
17,Illinois,20,Kansas,171,Scott County,5,0,5
17,Illinois,20,Kansas,173,Sedgwick County,413,431,-18
17,Illinois,20,Kansas,175,Seward County,0,8,-8
17,Illinois,20,Kansas,177,Shawnee County,105,232,-127
17,Illinois,20,Kansas,183,Smith County,0,1,-1
17,Illinois,20,Kansas,189,Stevens County,0,3,-3
17,Illinois,20,Kansas,191,Sumner County,5,0,5
17,Illinois,20,Kansas,209,Wyandotte County,150,168,-18
17,Illinois,21,Kentucky,1,Adair County,0,11,-11
17,Illinois,21,Kentucky,7,Ballard County,34,91,-57
17,Illinois,21,Kentucky,9,Barren County,0,32,-32
17,Illinois,21,Kentucky,11,Bath County,0,3,-3
17,Illinois,21,Kentucky,15,Boone County,23,78,-55
17,Illinois,21,Kentucky,17,Bourbon County,0,36,-36
17,Illinois,21,Kentucky,19,Boyd County,0,3,-3
17,Illinois,21,Kentucky,21,Boyle County,9,15,-6
17,Illinois,21,Kentucky,25,Breathitt County,0,14,-14
17,Illinois,21,Kentucky,27,Breckinridge County,0,4,-4
17,Illinois,21,Kentucky,33,Caldwell County,21,31,-10
17,Illinois,21,Kentucky,35,Calloway County,43,401,-358
17,Illinois,21,Kentucky,37,Campbell County,15,10,5
17,Illinois,21,Kentucky,39,Carlisle County,111,2,109
17,Illinois,21,Kentucky,41,Carroll County,0,150,-150
17,Illinois,21,Kentucky,47,Christian County,41,148,-107
17,Illinois,21,Kentucky,49,Clark County,0,34,-34
17,Illinois,21,Kentucky,51,Clay County,7,0,7
17,Illinois,21,Kentucky,55,Crittenden County,0,4,-4
17,Illinois,21,Kentucky,57,Cumberland County,0,5,-5
17,Illinois,21,Kentucky,59,Daviess County,51,72,-21
17,Illinois,21,Kentucky,61,Edmonson County,0,13,-13
17,Illinois,21,Kentucky,65,Estill County,0,3,-3
17,Illinois,21,Kentucky,67,Fayette County,329,849,-520
17,Illinois,21,Kentucky,69,Fleming County,0,8,-8
17,Illinois,21,Kentucky,71,Floyd County,0,7,-7
17,Illinois,21,Kentucky,73,Franklin County,24,48,-24
17,Illinois,21,Kentucky,75,Fulton County,4,0,4
17,Illinois,21,Kentucky,79,Garrard County,0,5,-5
17,Illinois,21,Kentucky,83,Graves County,7,21,-14
17,Illinois,21,Kentucky,85,Grayson County,9,0,9
17,Illinois,21,Kentucky,93,Hardin County,163,99,64
17,Illinois,21,Kentucky,95,Harlan County,13,2,11
17,Illinois,21,Kentucky,101,Henderson County,37,38,-1
17,Illinois,21,Kentucky,105,Hickman County,0,34,-34
17,Illinois,21,Kentucky,107,Hopkins County,94,2,92
17,Illinois,21,Kentucky,111,Jefferson County,1132,812,320
17,Illinois,21,Kentucky,113,Jessamine County,51,99,-48
17,Illinois,21,Kentucky,117,Kenton County,76,90,-14
17,Illinois,21,Kentucky,123,Larue County,0,43,-43
17,Illinois,21,Kentucky,125,Laurel County,0,89,-89
17,Illinois,21,Kentucky,131,Leslie County,4,0,4
17,Illinois,21,Kentucky,139,Livingston County,0,21,-21
17,Illinois,21,Kentucky,141,Logan County,25,0,25
17,Illinois,21,Kentucky,143,Lyon County,0,49,-49
17,Illinois,21,Kentucky,145,McCracken County,350,647,-297
17,Illinois,21,Kentucky,151,Madison County,74,118,-44
17,Illinois,21,Kentucky,155,Marion County,10,1,9
17,Illinois,21,Kentucky,157,Marshall County,51,50,1
17,Illinois,21,Kentucky,159,Martin County,11,17,-6
17,Illinois,21,Kentucky,163,Meade County,32,13,19
17,Illinois,21,Kentucky,165,Menifee County,0,2,-2
17,Illinois,21,Kentucky,173,Montgomery County,0,3,-3
17,Illinois,21,Kentucky,175,Morgan County,0,9,-9
17,Illinois,21,Kentucky,177,Muhlenberg County,0,43,-43
17,Illinois,21,Kentucky,179,Nelson County,23,10,13
17,Illinois,21,Kentucky,183,Ohio County,39,95,-56
17,Illinois,21,Kentucky,185,Oldham County,0,97,-97
17,Illinois,21,Kentucky,195,Pike County,0,21,-21
17,Illinois,21,Kentucky,197,Powell County,0,2,-2
17,Illinois,21,Kentucky,199,Pulaski County,41,26,15
17,Illinois,21,Kentucky,203,Rockcastle County,22,0,22
17,Illinois,21,Kentucky,209,Scott County,19,89,-70
17,Illinois,21,Kentucky,211,Shelby County,0,29,-29
17,Illinois,21,Kentucky,213,Simpson County,1,23,-22
17,Illinois,21,Kentucky,217,Taylor County,29,35,-6
17,Illinois,21,Kentucky,221,Trigg County,13,88,-75
17,Illinois,21,Kentucky,223,Trimble County,5,0,5
17,Illinois,21,Kentucky,225,Union County,28,123,-95
17,Illinois,21,Kentucky,227,Warren County,191,306,-115
17,Illinois,21,Kentucky,229,Washington County,0,11,-11
17,Illinois,21,Kentucky,231,Wayne County,14,0,14
17,Illinois,21,Kentucky,233,Webster County,0,3,-3
17,Illinois,21,Kentucky,235,Whitley County,0,11,-11
17,Illinois,21,Kentucky,237,Wolfe County,0,65,-65
17,Illinois,21,Kentucky,239,Woodford County,0,4,-4
17,Illinois,22,Louisiana,1,Acadia Parish,0,39,-39
17,Illinois,22,Louisiana,3,Allen Parish,49,74,-25
17,Illinois,22,Louisiana,5,Ascension Parish,43,29,14
17,Illinois,22,Louisiana,9,Avoyelles Parish,0,20,-20
17,Illinois,22,Louisiana,11,Beauregard Parish,2,62,-60
17,Illinois,22,Louisiana,15,Bossier Parish,54,218,-164
17,Illinois,22,Louisiana,17,Caddo Parish,81,51,30
17,Illinois,22,Louisiana,19,Calcasieu Parish,89,102,-13
17,Illinois,22,Louisiana,33,East Baton Rouge Parish,244,437,-193
17,Illinois,22,Louisiana,39,Evangeline Parish,0,11,-11
17,Illinois,22,Louisiana,41,Franklin Parish,0,49,-49
17,Illinois,22,Louisiana,43,Grant Parish,26,18,8
17,Illinois,22,Louisiana,49,Jackson Parish,0,40,-40
17,Illinois,22,Louisiana,51,Jefferson Parish,98,196,-98
17,Illinois,22,Louisiana,55,Lafayette Parish,170,5,165
17,Illinois,22,Louisiana,57,Lafourche Parish,8,28,-20
17,Illinois,22,Louisiana,59,LaSalle Parish,0,16,-16
17,Illinois,22,Louisiana,61,Lincoln Parish,0,10,-10
17,Illinois,22,Louisiana,63,Livingston Parish,31,94,-63
17,Illinois,22,Louisiana,69,Natchitoches Parish,0,98,-98
17,Illinois,22,Louisiana,71,Orleans Parish,303,452,-149
17,Illinois,22,Louisiana,73,Ouachita Parish,31,17,14
17,Illinois,22,Louisiana,75,Plaquemines Parish,0,119,-119
17,Illinois,22,Louisiana,79,Rapides Parish,36,103,-67
17,Illinois,22,Louisiana,89,St. Charles Parish,52,0,52
17,Illinois,22,Louisiana,97,St. Landry Parish,25,0,25
17,Illinois,22,Louisiana,101,St. Mary Parish,55,0,55
17,Illinois,22,Louisiana,103,St. Tammany Parish,68,27,41
17,Illinois,22,Louisiana,105,Tangipahoa Parish,41,0,41
17,Illinois,22,Louisiana,107,Tensas Parish,0,8,-8
17,Illinois,22,Louisiana,109,Terrebonne Parish,1,37,-36
17,Illinois,22,Louisiana,113,Vermilion Parish,7,0,7
17,Illinois,22,Louisiana,115,Vernon Parish,67,155,-88
17,Illinois,22,Louisiana,117,Washington Parish,0,35,-35
17,Illinois,22,Louisiana,121,West Baton Rouge Parish,33,13,20
17,Illinois,22,Louisiana,123,West Carroll Parish,0,8,-8
17,Illinois,23,Maine,1,Androscoggin County,0,4,-4
17,Illinois,23,Maine,3,Aroostook County,0,35,-35
17,Illinois,23,Maine,5,Cumberland County,194,125,69
17,Illinois,23,Maine,9,Hancock County,7,7,0
17,Illinois,23,Maine,11,Kennebec County,0,15,-15
17,Illinois,23,Maine,13,Knox County,4,0,4
17,Illinois,23,Maine,15,Lincoln County,0,17,-17
17,Illinois,23,Maine,17,Oxford County,93,5,88
17,Illinois,23,Maine,19,Penobscot County,3,37,-34
17,Illinois,23,Maine,23,Sagadahoc County,9,44,-35
17,Illinois,23,Maine,27,Waldo County,6,0,6
17,Illinois,23,Maine,29,Washington County,0,6,-6
17,Illinois,23,Maine,31,York County,201,46,155
17,Illinois,24,Maryland,1,Allegany County,0,43,-43
17,Illinois,24,Maryland,3,Anne Arundel County,232,128,104
17,Illinois,24,Maryland,5,Baltimore County,248,175,73
17,Illinois,24,Maryland,9,Calvert County,60,10,50
17,Illinois,24,Maryland,13,Carroll County,18,26,-8
17,Illinois,24,Maryland,15,Cecil County,2,34,-32
17,Illinois,24,Maryland,17,Charles County,52,48,4
17,Illinois,24,Maryland,19,Dorchester County,21,0,21
17,Illinois,24,Maryland,21,Frederick County,51,85,-34
17,Illinois,24,Maryland,25,Harford County,44,80,-36
17,Illinois,24,Maryland,27,Howard County,106,142,-36
17,Illinois,24,Maryland,31,Montgomery County,763,712,51
17,Illinois,24,Maryland,33,Prince George's County,331,336,-5
17,Illinois,24,Maryland,37,St. Mary's County,46,0,46
17,Illinois,24,Maryland,41,Talbot County,0,38,-38
17,Illinois,24,Maryland,43,Washington County,1,79,-78
17,Illinois,24,Maryland,45,Wicomico County,0,2,-2
17,Illinois,24,Maryland,47,Worcester County,6,0,6
17,Illinois,24,Maryland,510,Baltimore city,627,223,404
17,Illinois,25,Massachusetts,1,Barnstable County,72,175,-103
17,Illinois,25,Massachusetts,3,Berkshire County,26,45,-19
17,Illinois,25,Massachusetts,5,Bristol County,138,6,132
17,Illinois,25,Massachusetts,9,Essex County,261,184,77
17,Illinois,25,Massachusetts,11,Franklin County,111,0,111
17,Illinois,25,Massachusetts,13,Hampden County,47,64,-17
17,Illinois,25,Massachusetts,15,Hampshire County,68,156,-88
17,Illinois,25,Massachusetts,17,Middlesex County,1312,1659,-347
17,Illinois,25,Massachusetts,19,Nantucket County,7,0,7
17,Illinois,25,Massachusetts,21,Norfolk County,511,257,254
17,Illinois,25,Massachusetts,23,Plymouth County,58,57,1
17,Illinois,25,Massachusetts,25,Suffolk County,818,891,-73
17,Illinois,25,Massachusetts,27,Worcester County,206,118,88
17,Illinois,26,Michigan,1,Alcona County,0,3,-3
17,Illinois,26,Michigan,3,Alger County,4,0,4
17,Illinois,26,Michigan,5,Allegan County,174,164,10
17,Illinois,26,Michigan,7,Alpena County,17,18,-1
17,Illinois,26,Michigan,9,Antrim County,0,9,-9
17,Illinois,26,Michigan,11,Arenac County,34,5,29
17,Illinois,26,Michigan,13,Baraga County,0,5,-5
17,Illinois,26,Michigan,15,Barry County,78,30,48
17,Illinois,26,Michigan,17,Bay County,28,7,21
17,Illinois,26,Michigan,19,Benzie County,24,60,-36
17,Illinois,26,Michigan,21,Berrien County,496,728,-232
17,Illinois,26,Michigan,23,Branch County,49,21,28
17,Illinois,26,Michigan,25,Calhoun County,175,101,74
17,Illinois,26,Michigan,27,Cass County,62,121,-59
17,Illinois,26,Michigan,29,Charlevoix County,19,5,14
17,Illinois,26,Michigan,31,Cheboygan County,0,24,-24
17,Illinois,26,Michigan,33,Chippewa County,0,198,-198
17,Illinois,26,Michigan,35,Clare County,0,21,-21
17,Illinois,26,Michigan,37,Clinton County,44,14,30
17,Illinois,26,Michigan,41,Delta County,16,29,-13
17,Illinois,26,Michigan,43,Dickinson County,27,51,-24
17,Illinois,26,Michigan,45,Eaton County,112,110,2
17,Illinois,26,Michigan,47,Emmet County,43,46,-3
17,Illinois,26,Michigan,49,Genesee County,426,239,187
17,Illinois,26,Michigan,53,Gogebic County,0,20,-20
17,Illinois,26,Michigan,55,Grand Traverse County,26,118,-92
17,Illinois,26,Michigan,57,Gratiot County,0,15,-15
17,Illinois,26,Michigan,59,Hillsdale County,65,25,40
17,Illinois,26,Michigan,61,Houghton County,71,93,-22
17,Illinois,26,Michigan,65,Ingham County,704,1041,-337
17,Illinois,26,Michigan,67,Ionia County,30,2,28
17,Illinois,26,Michigan,69,Iosco County,0,40,-40
17,Illinois,26,Michigan,71,Iron County,0,26,-26
17,Illinois,26,Michigan,73,Isabella County,67,197,-130
17,Illinois,26,Michigan,75,Jackson County,178,90,88
17,Illinois,26,Michigan,77,Kalamazoo County,626,884,-258
17,Illinois,26,Michigan,79,Kalkaska County,0,13,-13
17,Illinois,26,Michigan,81,Kent County,1257,1528,-271
17,Illinois,26,Michigan,83,Keweenaw County,0,5,-5
17,Illinois,26,Michigan,85,Lake County,0,5,-5
17,Illinois,26,Michigan,87,Lapeer County,4,8,-4
17,Illinois,26,Michigan,89,Leelanau County,42,71,-29
17,Illinois,26,Michigan,91,Lenawee County,24,20,4
17,Illinois,26,Michigan,93,Livingston County,102,76,26
17,Illinois,26,Michigan,99,Macomb County,443,328,115
17,Illinois,26,Michigan,101,Manistee County,0,35,-35
17,Illinois,26,Michigan,103,Marquette County,160,274,-114
17,Illinois,26,Michigan,105,Mason County,6,46,-40
17,Illinois,26,Michigan,107,Mecosta County,6,21,-15
17,Illinois,26,Michigan,109,Menominee County,0,5,-5
17,Illinois,26,Michigan,111,Midland County,83,132,-49
17,Illinois,26,Michigan,113,Missaukee County,0,13,-13
17,Illinois,26,Michigan,115,Monroe County,93,42,51
17,Illinois,26,Michigan,117,Montcalm County,5,1,4
17,Illinois,26,Michigan,121,Muskegon County,161,123,38
17,Illinois,26,Michigan,123,Newaygo County,54,19,35
17,Illinois,26,Michigan,125,Oakland County,1381,1817,-436
17,Illinois,26,Michigan,127,Oceana County,8,28,-20
17,Illinois,26,Michigan,129,Ogemaw County,0,5,-5
17,Illinois,26,Michigan,131,Ontonagon County,0,26,-26
17,Illinois,26,Michigan,133,Osceola County,113,19,94
17,Illinois,26,Michigan,135,Oscoda County,86,0,86
17,Illinois,26,Michigan,137,Otsego County,86,0,86
17,Illinois,26,Michigan,139,Ottawa County,245,712,-467
17,Illinois,26,Michigan,143,Roscommon County,9,7,2
17,Illinois,26,Michigan,145,Saginaw County,244,176,68
17,Illinois,26,Michigan,147,St. Clair County,131,19,112
17,Illinois,26,Michigan,149,St. Joseph County,53,190,-137
17,Illinois,26,Michigan,151,Sanilac County,7,19,-12
17,Illinois,26,Michigan,153,Schoolcraft County,92,8,84
17,Illinois,26,Michigan,155,Shiawassee County,43,23,20
17,Illinois,26,Michigan,157,Tuscola County,0,3,-3
17,Illinois,26,Michigan,159,Van Buren County,118,335,-217
17,Illinois,26,Michigan,161,Washtenaw County,1231,1758,-527
17,Illinois,26,Michigan,163,Wayne County,1448,1710,-262
17,Illinois,26,Michigan,165,Wexford County,0,6,-6
17,Illinois,27,Minnesota,3,Anoka County,145,305,-160
17,Illinois,27,Minnesota,5,Becker County,0,20,-20
17,Illinois,27,Minnesota,7,Beltrami County,90,34,56
17,Illinois,27,Minnesota,9,Benton County,0,13,-13
17,Illinois,27,Minnesota,13,Blue Earth County,14,65,-51
17,Illinois,27,Minnesota,15,Brown County,12,27,-15
17,Illinois,27,Minnesota,17,Carlton County,0,6,-6
17,Illinois,27,Minnesota,19,Carver County,17,114,-97
17,Illinois,27,Minnesota,21,Cass County,0,14,-14
17,Illinois,27,Minnesota,25,Chisago County,0,15,-15
17,Illinois,27,Minnesota,27,Clay County,9,36,-27
17,Illinois,27,Minnesota,29,Clearwater County,0,19,-19
17,Illinois,27,Minnesota,31,Cook County,0,1,-1
17,Illinois,27,Minnesota,33,Cottonwood County,13,2,11
17,Illinois,27,Minnesota,35,Crow Wing County,0,115,-115
17,Illinois,27,Minnesota,37,Dakota County,481,688,-207
17,Illinois,27,Minnesota,41,Douglas County,0,25,-25
17,Illinois,27,Minnesota,43,Faribault County,0,2,-2
17,Illinois,27,Minnesota,45,Fillmore County,0,36,-36
17,Illinois,27,Minnesota,47,Freeborn County,13,30,-17
17,Illinois,27,Minnesota,49,Goodhue County,15,11,4
17,Illinois,27,Minnesota,53,Hennepin County,2037,3283,-1246
17,Illinois,27,Minnesota,55,Houston County,48,21,27
17,Illinois,27,Minnesota,57,Hubbard County,0,14,-14
17,Illinois,27,Minnesota,59,Isanti County,0,1,-1
17,Illinois,27,Minnesota,61,Itasca County,13,24,-11
17,Illinois,27,Minnesota,63,Jackson County,19,0,19
17,Illinois,27,Minnesota,65,Kanabec County,0,2,-2
17,Illinois,27,Minnesota,79,Le Sueur County,77,5,72
17,Illinois,27,Minnesota,81,Lincoln County,0,5,-5
17,Illinois,27,Minnesota,83,Lyon County,7,5,2
17,Illinois,27,Minnesota,85,McLeod County,15,0,15
17,Illinois,27,Minnesota,89,Marshall County,0,4,-4
17,Illinois,27,Minnesota,95,Mille Lacs County,0,1,-1
17,Illinois,27,Minnesota,97,Morrison County,0,5,-5
17,Illinois,27,Minnesota,99,Mower County,0,86,-86
17,Illinois,27,Minnesota,101,Murray County,16,24,-8
17,Illinois,27,Minnesota,103,Nicollet County,24,0,24
17,Illinois,27,Minnesota,105,Nobles County,0,12,-12
17,Illinois,27,Minnesota,109,Olmsted County,64,173,-109
17,Illinois,27,Minnesota,111,Otter Tail County,67,85,-18
17,Illinois,27,Minnesota,113,Pennington County,0,16,-16
17,Illinois,27,Minnesota,115,Pine County,12,64,-52
17,Illinois,27,Minnesota,117,Pipestone County,8,13,-5
17,Illinois,27,Minnesota,119,Polk County,0,2,-2
17,Illinois,27,Minnesota,121,Pope County,11,13,-2
17,Illinois,27,Minnesota,123,Ramsey County,628,1429,-801
17,Illinois,27,Minnesota,129,Renville County,0,7,-7
17,Illinois,27,Minnesota,131,Rice County,40,196,-156
17,Illinois,27,Minnesota,133,Rock County,0,2,-2
17,Illinois,27,Minnesota,135,Roseau County,0,10,-10
17,Illinois,27,Minnesota,137,St. Louis County,272,265,7
17,Illinois,27,Minnesota,139,Scott County,63,58,5
17,Illinois,27,Minnesota,141,Sherburne County,29,16,13
17,Illinois,27,Minnesota,143,Sibley County,8,0,8
17,Illinois,27,Minnesota,145,Stearns County,29,139,-110
17,Illinois,27,Minnesota,147,Steele County,0,10,-10
17,Illinois,27,Minnesota,149,Stevens County,0,14,-14
17,Illinois,27,Minnesota,153,Todd County,0,7,-7
17,Illinois,27,Minnesota,155,Traverse County,0,3,-3
17,Illinois,27,Minnesota,157,Wabasha County,0,8,-8
17,Illinois,27,Minnesota,159,Wadena County,0,34,-34
17,Illinois,27,Minnesota,161,Waseca County,25,42,-17
17,Illinois,27,Minnesota,163,Washington County,197,187,10
17,Illinois,27,Minnesota,169,Winona County,41,153,-112
17,Illinois,27,Minnesota,171,Wright County,28,40,-12
17,Illinois,28,Mississippi,1,Adams County,0,51,-51
17,Illinois,28,Mississippi,3,Alcorn County,11,0,11
17,Illinois,28,Mississippi,11,Bolivar County,18,41,-23
17,Illinois,28,Mississippi,15,Carroll County,0,63,-63
17,Illinois,28,Mississippi,21,Claiborne County,0,6,-6
17,Illinois,28,Mississippi,25,Clay County,0,2,-2
17,Illinois,28,Mississippi,27,Coahoma County,43,194,-151
17,Illinois,28,Mississippi,29,Copiah County,0,21,-21
17,Illinois,28,Mississippi,33,DeSoto County,64,93,-29
17,Illinois,28,Mississippi,35,Forrest County,82,37,45
17,Illinois,28,Mississippi,37,Franklin County,0,4,-4
17,Illinois,28,Mississippi,41,Greene County,0,11,-11
17,Illinois,28,Mississippi,43,Grenada County,13,0,13
17,Illinois,28,Mississippi,45,Hancock County,0,112,-112
17,Illinois,28,Mississippi,47,Harrison County,32,188,-156
17,Illinois,28,Mississippi,49,Hinds County,387,303,84
17,Illinois,28,Mississippi,51,Holmes County,128,0,128
17,Illinois,28,Mississippi,53,Humphreys County,68,0,68
17,Illinois,28,Mississippi,57,Itawamba County,0,72,-72
17,Illinois,28,Mississippi,59,Jackson County,61,0,61
17,Illinois,28,Mississippi,67,Jones County,0,7,-7
17,Illinois,28,Mississippi,71,Lafayette County,154,131,23
17,Illinois,28,Mississippi,75,Lauderdale County,0,112,-112
17,Illinois,28,Mississippi,77,Lawrence County,0,45,-45
17,Illinois,28,Mississippi,79,Leake County,0,15,-15
17,Illinois,28,Mississippi,81,Lee County,74,36,38
17,Illinois,28,Mississippi,83,Leflore County,80,72,8
17,Illinois,28,Mississippi,85,Lincoln County,3,0,3
17,Illinois,28,Mississippi,87,Lowndes County,10,147,-137
17,Illinois,28,Mississippi,89,Madison County,70,319,-249
17,Illinois,28,Mississippi,91,Marion County,0,11,-11
17,Illinois,28,Mississippi,93,Marshall County,0,6,-6
17,Illinois,28,Mississippi,95,Monroe County,44,0,44
17,Illinois,28,Mississippi,99,Neshoba County,0,73,-73
17,Illinois,28,Mississippi,101,Newton County,0,8,-8
17,Illinois,28,Mississippi,103,Noxubee County,0,20,-20
17,Illinois,28,Mississippi,105,Oktibbeha County,54,56,-2
17,Illinois,28,Mississippi,109,Pearl River County,7,0,7
17,Illinois,28,Mississippi,111,Perry County,17,7,10
17,Illinois,28,Mississippi,113,Pike County,0,10,-10
17,Illinois,28,Mississippi,115,Pontotoc County,15,0,15
17,Illinois,28,Mississippi,117,Prentiss County,10,5,5
17,Illinois,28,Mississippi,119,Quitman County,0,125,-125
17,Illinois,28,Mississippi,121,Rankin County,246,46,200
17,Illinois,28,Mississippi,131,Stone County,24,0,24
17,Illinois,28,Mississippi,133,Sunflower County,0,9,-9
17,Illinois,28,Mississippi,135,Tallahatchie County,0,15,-15
17,Illinois,28,Mississippi,139,Tippah County,60,35,25
17,Illinois,28,Mississippi,141,Tishomingo County,36,0,36
17,Illinois,28,Mississippi,145,Union County,0,56,-56
17,Illinois,28,Mississippi,147,Walthall County,0,32,-32
17,Illinois,28,Mississippi,149,Warren County,18,37,-19
17,Illinois,28,Mississippi,151,Washington County,67,85,-18
17,Illinois,28,Mississippi,153,Wayne County,9,0,9
17,Illinois,28,Mississippi,155,Webster County,0,1,-1
17,Illinois,28,Mississippi,161,Yalobusha County,0,7,-7
17,Illinois,28,Mississippi,163,Yazoo County,23,101,-78
17,Illinois,29,Missouri,1,Adair County,71,338,-267
17,Illinois,29,Missouri,5,Atchison County,0,3,-3
17,Illinois,29,Missouri,7,Audrain County,22,93,-71
17,Illinois,29,Missouri,9,Barry County,21,91,-70
17,Illinois,29,Missouri,13,Bates County,0,19,-19
17,Illinois,29,Missouri,15,Benton County,0,128,-128
17,Illinois,29,Missouri,17,Bollinger County,5,23,-18
17,Illinois,29,Missouri,19,Boone County,740,1715,-975
17,Illinois,29,Missouri,21,Buchanan County,73,30,43
17,Illinois,29,Missouri,23,Butler County,28,145,-117
17,Illinois,29,Missouri,25,Caldwell County,22,4,18
17,Illinois,29,Missouri,27,Callaway County,31,63,-32
17,Illinois,29,Missouri,29,Camden County,44,194,-150
17,Illinois,29,Missouri,31,Cape Girardeau County,371,684,-313
17,Illinois,29,Missouri,35,Carter County,0,9,-9
17,Illinois,29,Missouri,37,Cass County,0,73,-73
17,Illinois,29,Missouri,39,Cedar County,12,3,9
17,Illinois,29,Missouri,43,Christian County,0,195,-195
17,Illinois,29,Missouri,45,Clark County,0,65,-65
17,Illinois,29,Missouri,47,Clay County,92,328,-236
17,Illinois,29,Missouri,49,Clinton County,7,31,-24
17,Illinois,29,Missouri,51,Cole County,213,258,-45
17,Illinois,29,Missouri,53,Cooper County,47,104,-57
17,Illinois,29,Missouri,55,Crawford County,4,321,-317
17,Illinois,29,Missouri,63,DeKalb County,118,5,113
17,Illinois,29,Missouri,65,Dent County,0,8,-8
17,Illinois,29,Missouri,67,Douglas County,19,5,14
17,Illinois,29,Missouri,69,Dunklin County,0,19,-19
17,Illinois,29,Missouri,71,Franklin County,168,161,7
17,Illinois,29,Missouri,73,Gasconade County,27,0,27
17,Illinois,29,Missouri,77,Greene County,626,1012,-386
17,Illinois,29,Missouri,79,Grundy County,4,7,-3
17,Illinois,29,Missouri,81,Harrison County,0,12,-12
17,Illinois,29,Missouri,83,Henry County,0,3,-3
17,Illinois,29,Missouri,87,Holt County,0,5,-5
17,Illinois,29,Missouri,89,Howard County,18,13,5
17,Illinois,29,Missouri,91,Howell County,48,3,45
17,Illinois,29,Missouri,93,Iron County,60,21,39
17,Illinois,29,Missouri,95,Jackson County,407,534,-127
17,Illinois,29,Missouri,97,Jasper County,149,126,23
17,Illinois,29,Missouri,99,Jefferson County,606,425,181
17,Illinois,29,Missouri,101,Johnson County,125,125,0
17,Illinois,29,Missouri,103,Knox County,128,28,100
17,Illinois,29,Missouri,105,Laclede County,0,52,-52
17,Illinois,29,Missouri,107,Lafayette County,0,21,-21
17,Illinois,29,Missouri,109,Lawrence County,14,36,-22
17,Illinois,29,Missouri,111,Lewis County,85,243,-158
17,Illinois,29,Missouri,113,Lincoln County,143,90,53
17,Illinois,29,Missouri,115,Linn County,56,0,56
17,Illinois,29,Missouri,117,Livingston County,0,47,-47
17,Illinois,29,Missouri,119,McDonald County,0,5,-5
17,Illinois,29,Missouri,121,Macon County,0,7,-7
17,Illinois,29,Missouri,123,Madison County,18,3,15
17,Illinois,29,Missouri,125,Maries County,0,7,-7
17,Illinois,29,Missouri,127,Marion County,345,320,25
17,Illinois,29,Missouri,129,Mercer County,0,3,-3
17,Illinois,29,Missouri,131,Miller County,34,66,-32
17,Illinois,29,Missouri,133,Mississippi County,0,12,-12
17,Illinois,29,Missouri,135,Moniteau County,0,39,-39
17,Illinois,29,Missouri,137,Monroe County,0,37,-37
17,Illinois,29,Missouri,141,Morgan County,0,84,-84
17,Illinois,29,Missouri,143,New Madrid County,33,5,28
17,Illinois,29,Missouri,145,Newton County,12,23,-11
17,Illinois,29,Missouri,147,Nodaway County,10,56,-46
17,Illinois,29,Missouri,149,Oregon County,0,8,-8
17,Illinois,29,Missouri,151,Osage County,5,15,-10
17,Illinois,29,Missouri,153,Ozark County,20,39,-19
17,Illinois,29,Missouri,155,Pemiscot County,23,10,13
17,Illinois,29,Missouri,157,Perry County,68,325,-257
17,Illinois,29,Missouri,159,Pettis County,20,66,-46
17,Illinois,29,Missouri,161,Phelps County,83,182,-99
17,Illinois,29,Missouri,163,Pike County,64,136,-72
17,Illinois,29,Missouri,165,Platte County,28,267,-239
17,Illinois,29,Missouri,167,Polk County,19,82,-63
17,Illinois,29,Missouri,169,Pulaski County,47,844,-797
17,Illinois,29,Missouri,173,Ralls County,73,19,54
17,Illinois,29,Missouri,175,Randolph County,79,185,-106
17,Illinois,29,Missouri,177,Ray County,0,9,-9
17,Illinois,29,Missouri,179,Reynolds County,28,9,19
17,Illinois,29,Missouri,183,St. Charles County,822,1146,-324
17,Illinois,29,Missouri,185,St. Clair County,0,17,-17
17,Illinois,29,Missouri,186,Ste. Genevieve County,31,154,-123
17,Illinois,29,Missouri,187,St. Francois County,352,530,-178
17,Illinois,29,Missouri,189,St. Louis County,4565,6086,-1521
17,Illinois,29,Missouri,195,Saline County,7,34,-27
17,Illinois,29,Missouri,197,Schuyler County,0,47,-47
17,Illinois,29,Missouri,199,Scotland County,2,0,2
17,Illinois,29,Missouri,201,Scott County,25,315,-290
17,Illinois,29,Missouri,205,Shelby County,38,43,-5
17,Illinois,29,Missouri,207,Stoddard County,0,3,-3
17,Illinois,29,Missouri,209,Stone County,23,117,-94
17,Illinois,29,Missouri,211,Sullivan County,0,8,-8
17,Illinois,29,Missouri,213,Taney County,259,92,167
17,Illinois,29,Missouri,215,Texas County,16,29,-13
17,Illinois,29,Missouri,217,Vernon County,9,4,5
17,Illinois,29,Missouri,219,Warren County,2,39,-37
17,Illinois,29,Missouri,221,Washington County,136,1,135
17,Illinois,29,Missouri,223,Wayne County,35,26,9
17,Illinois,29,Missouri,225,Webster County,28,38,-10
17,Illinois,29,Missouri,227,Worth County,0,6,-6
17,Illinois,29,Missouri,229,Wright County,36,60,-24
17,Illinois,29,Missouri,510,St. Louis city,2760,4461,-1701
17,Illinois,30,Montana,1,Beaverhead County,0,12,-12
17,Illinois,30,Montana,13,Cascade County,106,59,47
17,Illinois,30,Montana,17,Custer County,21,0,21
17,Illinois,30,Montana,25,Fallon County,0,4,-4
17,Illinois,30,Montana,27,Fergus County,0,1,-1
17,Illinois,30,Montana,29,Flathead County,14,168,-154
17,Illinois,30,Montana,31,Gallatin County,109,125,-16
17,Illinois,30,Montana,43,Jefferson County,0,20,-20
17,Illinois,30,Montana,45,Judith Basin County,0,16,-16
17,Illinois,30,Montana,49,Lewis and Clark County,0,97,-97
17,Illinois,30,Montana,53,Lincoln County,0,19,-19
17,Illinois,30,Montana,57,Madison County,0,22,-22
17,Illinois,30,Montana,63,Missoula County,123,81,42
17,Illinois,30,Montana,65,Musselshell County,25,0,25
17,Illinois,30,Montana,73,Pondera County,9,0,9
17,Illinois,30,Montana,81,Ravalli County,102,0,102
17,Illinois,30,Montana,85,Roosevelt County,0,4,-4
17,Illinois,30,Montana,91,Sheridan County,0,37,-37
17,Illinois,30,Montana,93,Silver Bow County,3,69,-66
17,Illinois,30,Montana,95,Stillwater County,0,6,-6
17,Illinois,30,Montana,99,Teton County,0,1,-1
17,Illinois,30,Montana,111,Yellowstone County,33,127,-94
17,Illinois,31,Nebraska,1,Adams County,0,12,-12
17,Illinois,31,Nebraska,19,Buffalo County,0,227,-227
17,Illinois,31,Nebraska,25,Cass County,30,17,13
17,Illinois,31,Nebraska,33,Cheyenne County,0,3,-3
17,Illinois,31,Nebraska,39,Cuming County,0,2,-2
17,Illinois,31,Nebraska,45,Dawes County,9,0,9
17,Illinois,31,Nebraska,47,Dawson County,0,45,-45
17,Illinois,31,Nebraska,51,Dixon County,16,0,16
17,Illinois,31,Nebraska,55,Douglas County,527,918,-391
17,Illinois,31,Nebraska,59,Fillmore County,0,3,-3
17,Illinois,31,Nebraska,63,Frontier County,0,2,-2
17,Illinois,31,Nebraska,67,Gage County,0,8,-8
17,Illinois,31,Nebraska,79,Hall County,0,9,-9
17,Illinois,31,Nebraska,85,Hayes County,16,0,16
17,Illinois,31,Nebraska,87,Hitchcock County,0,2,-2
17,Illinois,31,Nebraska,97,Johnson County,0,1,-1
17,Illinois,31,Nebraska,101,Keith County,0,1,-1
17,Illinois,31,Nebraska,109,Lancaster County,255,623,-368
17,Illinois,31,Nebraska,111,Lincoln County,47,0,47
17,Illinois,31,Nebraska,119,Madison County,38,15,23
17,Illinois,31,Nebraska,121,Merrick County,0,16,-16
17,Illinois,31,Nebraska,127,Nemaha County,4,0,4
17,Illinois,31,Nebraska,129,Nuckolls County,119,0,119
17,Illinois,31,Nebraska,139,Pierce County,0,8,-8
17,Illinois,31,Nebraska,141,Platte County,39,0,39
17,Illinois,31,Nebraska,145,Red Willow County,58,11,47
17,Illinois,31,Nebraska,151,Saline County,0,10,-10
17,Illinois,31,Nebraska,153,Sarpy County,215,308,-93
17,Illinois,31,Nebraska,157,Scotts Bluff County,14,0,14
17,Illinois,31,Nebraska,159,Seward County,5,0,5
17,Illinois,31,Nebraska,169,Thayer County,0,1,-1
17,Illinois,31,Nebraska,177,Washington County,26,12,14
17,Illinois,31,Nebraska,181,Webster County,0,11,-11
17,Illinois,31,Nebraska,185,York County,26,11,15
17,Illinois,32,Nevada,1,Churchill County,0,27,-27
17,Illinois,32,Nevada,3,Clark County,1970,2969,-999
17,Illinois,32,Nevada,5,Douglas County,46,0,46
17,Illinois,32,Nevada,7,Elko County,12,0,12
17,Illinois,32,Nevada,17,Lincoln County,0,61,-61
17,Illinois,32,Nevada,23,Nye County,5,363,-358
17,Illinois,32,Nevada,27,Pershing County,35,0,35
17,Illinois,32,Nevada,31,Washoe County,235,121,114
17,Illinois,32,Nevada,510,Carson City,5,0,5
17,Illinois,33,New Hampshire,3,Carroll County,0,22,-22
17,Illinois,33,New Hampshire,5,Cheshire County,37,0,37
17,Illinois,33,New Hampshire,7,Coos County,0,4,-4
17,Illinois,33,New Hampshire,9,Grafton County,19,131,-112
17,Illinois,33,New Hampshire,11,Hillsborough County,139,304,-165
17,Illinois,33,New Hampshire,13,Merrimack County,55,36,19
17,Illinois,33,New Hampshire,15,Rockingham County,6,68,-62
17,Illinois,33,New Hampshire,17,Strafford County,56,11,45
17,Illinois,33,New Hampshire,19,Sullivan County,10,32,-22
17,Illinois,34,New Jersey,1,Atlantic County,37,62,-25
17,Illinois,34,New Jersey,3,Bergen County,198,318,-120
17,Illinois,34,New Jersey,5,Burlington County,238,86,152
17,Illinois,34,New Jersey,7,Camden County,212,251,-39
17,Illinois,34,New Jersey,13,Essex County,150,176,-26
17,Illinois,34,New Jersey,15,Gloucester County,16,38,-22
17,Illinois,34,New Jersey,17,Hudson County,528,107,421
17,Illinois,34,New Jersey,19,Hunterdon County,48,6,42
17,Illinois,34,New Jersey,21,Mercer County,98,207,-109
17,Illinois,34,New Jersey,23,Middlesex County,194,313,-119
17,Illinois,34,New Jersey,25,Monmouth County,98,45,53
17,Illinois,34,New Jersey,27,Morris County,597,226,371
17,Illinois,34,New Jersey,29,Ocean County,145,19,126
17,Illinois,34,New Jersey,31,Passaic County,74,124,-50
17,Illinois,34,New Jersey,33,Salem County,19,0,19
17,Illinois,34,New Jersey,35,Somerset County,87,36,51
17,Illinois,34,New Jersey,37,Sussex County,15,8,7
17,Illinois,34,New Jersey,39,Union County,361,178,183
17,Illinois,34,New Jersey,41,Warren County,16,15,1
17,Illinois,35,New Mexico,1,Bernalillo County,297,291,6
17,Illinois,35,New Mexico,5,Chaves County,2,63,-61
17,Illinois,35,New Mexico,7,Colfax County,26,23,3
17,Illinois,35,New Mexico,9,Curry County,145,238,-93
17,Illinois,35,New Mexico,13,Doña Ana County,111,192,-81
17,Illinois,35,New Mexico,17,Grant County,15,0,15
17,Illinois,35,New Mexico,25,Lea County,0,23,-23
17,Illinois,35,New Mexico,27,Lincoln County,100,0,100
17,Illinois,35,New Mexico,28,Los Alamos County,46,0,46
17,Illinois,35,New Mexico,29,Luna County,0,73,-73
17,Illinois,35,New Mexico,31,McKinley County,0,9,-9
17,Illinois,35,New Mexico,35,Otero County,0,58,-58
17,Illinois,35,New Mexico,37,Quay County,0,2,-2
17,Illinois,35,New Mexico,39,Rio Arriba County,6,0,6
17,Illinois,35,New Mexico,43,Sandoval County,17,45,-28
17,Illinois,35,New Mexico,45,San Juan County,20,33,-13
17,Illinois,35,New Mexico,47,San Miguel County,0,8,-8
17,Illinois,35,New Mexico,49,Santa Fe County,25,134,-109
17,Illinois,35,New Mexico,51,Sierra County,0,10,-10
17,Illinois,35,New Mexico,55,Taos County,0,16,-16
17,Illinois,35,New Mexico,61,Valencia County,38,14,24
17,Illinois,36,New York,1,Albany County,114,116,-2
17,Illinois,36,New York,3,Allegany County,49,15,34
17,Illinois,36,New York,5,Bronx County,220,103,117
17,Illinois,36,New York,7,Broome County,31,131,-100
17,Illinois,36,New York,9,Cattaraugus County,0,22,-22
17,Illinois,36,New York,11,Cayuga County,0,7,-7
17,Illinois,36,New York,13,Chautauqua County,58,4,54
17,Illinois,36,New York,15,Chemung County,21,0,21
17,Illinois,36,New York,19,Clinton County,11,0,11
17,Illinois,36,New York,23,Cortland County,0,1,-1
17,Illinois,36,New York,27,Dutchess County,134,126,8
17,Illinois,36,New York,29,Erie County,372,230,142
17,Illinois,36,New York,33,Franklin County,0,64,-64
17,Illinois,36,New York,37,Genesee County,10,9,1
17,Illinois,36,New York,39,Greene County,9,40,-31
17,Illinois,36,New York,43,Herkimer County,8,3,5
17,Illinois,36,New York,45,Jefferson County,18,228,-210
17,Illinois,36,New York,47,Kings County,1415,1178,237
17,Illinois,36,New York,51,Livingston County,19,23,-4
17,Illinois,36,New York,53,Madison County,20,0,20
17,Illinois,36,New York,55,Monroe County,307,518,-211
17,Illinois,36,New York,59,Nassau County,301,375,-74
17,Illinois,36,New York,61,New York County,1873,2182,-309
17,Illinois,36,New York,63,Niagara County,10,37,-27
17,Illinois,36,New York,65,Oneida County,28,32,-4
17,Illinois,36,New York,67,Onondaga County,274,260,14
17,Illinois,36,New York,69,Ontario County,24,17,7
17,Illinois,36,New York,71,Orange County,91,25,66
17,Illinois,36,New York,73,Orleans County,21,0,21
17,Illinois,36,New York,75,Oswego County,0,15,-15
17,Illinois,36,New York,77,Otsego County,31,8,23
17,Illinois,36,New York,81,Queens County,828,530,298
17,Illinois,36,New York,83,Rensselaer County,28,46,-18
17,Illinois,36,New York,85,Richmond County,153,21,132
17,Illinois,36,New York,87,Rockland County,51,18,33
17,Illinois,36,New York,89,St. Lawrence County,18,13,5
17,Illinois,36,New York,91,Saratoga County,33,98,-65
17,Illinois,36,New York,93,Schenectady County,29,0,29
17,Illinois,36,New York,95,Schoharie County,22,0,22
17,Illinois,36,New York,99,Seneca County,62,13,49
17,Illinois,36,New York,101,Steuben County,0,13,-13
17,Illinois,36,New York,103,Suffolk County,374,94,280
17,Illinois,36,New York,105,Sullivan County,0,6,-6
17,Illinois,36,New York,107,Tioga County,5,0,5
17,Illinois,36,New York,109,Tompkins County,83,269,-186
17,Illinois,36,New York,111,Ulster County,21,16,5
17,Illinois,36,New York,113,Warren County,23,30,-7
17,Illinois,36,New York,115,Washington County,0,26,-26
17,Illinois,36,New York,119,Westchester County,444,326,118
17,Illinois,36,New York,121,Wyoming County,0,43,-43
17,Illinois,37,North Carolina,1,Alamance County,59,115,-56
17,Illinois,37,North Carolina,11,Avery County,0,4,-4
17,Illinois,37,North Carolina,13,Beaufort County,8,0,8
17,Illinois,37,North Carolina,15,Bertie County,16,0,16
17,Illinois,37,North Carolina,17,Bladen County,12,0,12
17,Illinois,37,North Carolina,19,Brunswick County,54,187,-133
17,Illinois,37,North Carolina,21,Buncombe County,187,98,89
17,Illinois,37,North Carolina,25,Cabarrus County,0,12,-12
17,Illinois,37,North Carolina,27,Caldwell County,0,13,-13
17,Illinois,37,North Carolina,29,Camden County,0,42,-42
17,Illinois,37,North Carolina,31,Carteret County,0,20,-20
17,Illinois,37,North Carolina,33,Caswell County,0,7,-7
17,Illinois,37,North Carolina,35,Catawba County,0,120,-120
17,Illinois,37,North Carolina,37,Chatham County,40,104,-64
17,Illinois,37,North Carolina,39,Cherokee County,27,13,14
17,Illinois,37,North Carolina,45,Cleveland County,1,69,-68
17,Illinois,37,North Carolina,47,Columbus County,0,9,-9
17,Illinois,37,North Carolina,49,Craven County,92,133,-41
17,Illinois,37,North Carolina,51,Cumberland County,359,431,-72
17,Illinois,37,North Carolina,53,Currituck County,9,0,9
17,Illinois,37,North Carolina,57,Davidson County,52,25,27
17,Illinois,37,North Carolina,59,Davie County,34,0,34
17,Illinois,37,North Carolina,63,Durham County,197,259,-62
17,Illinois,37,North Carolina,67,Forsyth County,366,214,152
17,Illinois,37,North Carolina,69,Franklin County,11,11,0
17,Illinois,37,North Carolina,71,Gaston County,115,93,22
17,Illinois,37,North Carolina,81,Guilford County,228,396,-168
17,Illinois,37,North Carolina,83,Halifax County,41,0,41
17,Illinois,37,North Carolina,85,Harnett County,38,13,25
17,Illinois,37,North Carolina,87,Haywood County,0,12,-12
17,Illinois,37,North Carolina,89,Henderson County,8,245,-237
17,Illinois,37,North Carolina,91,Hertford County,0,1,-1
17,Illinois,37,North Carolina,93,Hoke County,0,22,-22
17,Illinois,37,North Carolina,95,Hyde County,10,0,10
17,Illinois,37,North Carolina,97,Iredell County,32,190,-158
17,Illinois,37,North Carolina,101,Johnston County,0,129,-129
17,Illinois,37,North Carolina,103,Jones County,0,19,-19
17,Illinois,37,North Carolina,105,Lee County,16,12,4
17,Illinois,37,North Carolina,109,Lincoln County,13,9,4
17,Illinois,37,North Carolina,111,McDowell County,43,0,43
17,Illinois,37,North Carolina,113,Macon County,19,15,4
17,Illinois,37,North Carolina,115,Madison County,0,4,-4
17,Illinois,37,North Carolina,119,Mecklenburg County,1022,1644,-622
17,Illinois,37,North Carolina,125,Moore County,72,56,16
17,Illinois,37,North Carolina,127,Nash County,37,0,37
17,Illinois,37,North Carolina,129,New Hanover County,115,241,-126
17,Illinois,37,North Carolina,133,Onslow County,316,497,-181
17,Illinois,37,North Carolina,135,Orange County,116,342,-226
17,Illinois,37,North Carolina,139,Pasquotank County,0,62,-62
17,Illinois,37,North Carolina,141,Pender County,13,37,-24
17,Illinois,37,North Carolina,145,Person County,0,13,-13
17,Illinois,37,North Carolina,147,Pitt County,0,58,-58
17,Illinois,37,North Carolina,153,Richmond County,0,8,-8
17,Illinois,37,North Carolina,155,Robeson County,0,8,-8
17,Illinois,37,North Carolina,159,Rowan County,126,14,112
17,Illinois,37,North Carolina,163,Sampson County,0,6,-6
17,Illinois,37,North Carolina,165,Scotland County,0,8,-8
17,Illinois,37,North Carolina,167,Stanly County,11,26,-15
17,Illinois,37,North Carolina,171,Surry County,3,0,3
17,Illinois,37,North Carolina,173,Swain County,32,0,32
17,Illinois,37,North Carolina,175,Transylvania County,4,3,1
17,Illinois,37,North Carolina,179,Union County,13,94,-81
17,Illinois,37,North Carolina,183,Wake County,872,1017,-145
17,Illinois,37,North Carolina,189,Watauga County,42,25,17
17,Illinois,37,North Carolina,191,Wayne County,6,35,-29
17,Illinois,37,North Carolina,195,Wilson County,43,15,28
17,Illinois,37,North Carolina,199,Yancey County,0,19,-19
17,Illinois,38,North Dakota,3,Barnes County,0,7,-7
17,Illinois,38,North Dakota,9,Bottineau County,5,0,5
17,Illinois,38,North Dakota,15,Burleigh County,53,62,-9
17,Illinois,38,North Dakota,17,Cass County,173,146,27
17,Illinois,38,North Dakota,35,Grand Forks County,52,70,-18
17,Illinois,38,North Dakota,43,Kidder County,0,7,-7
17,Illinois,38,North Dakota,45,LaMoure County,0,5,-5
17,Illinois,38,North Dakota,49,McHenry County,0,2,-2
17,Illinois,38,North Dakota,53,McKenzie County,0,3,-3
17,Illinois,38,North Dakota,55,McLean County,9,27,-18
17,Illinois,38,North Dakota,59,Morton County,21,0,21
17,Illinois,38,North Dakota,61,Mountrail County,0,3,-3
17,Illinois,38,North Dakota,63,Nelson County,0,5,-5
17,Illinois,38,North Dakota,67,Pembina County,0,1,-1
17,Illinois,38,North Dakota,71,Ramsey County,2,0,2
17,Illinois,38,North Dakota,73,Ransom County,0,46,-46
17,Illinois,38,North Dakota,77,Richland County,23,4,19
17,Illinois,38,North Dakota,79,Rolette County,6,0,6
17,Illinois,38,North Dakota,81,Sargent County,0,4,-4
17,Illinois,38,North Dakota,89,Stark County,27,14,13
17,Illinois,38,North Dakota,101,Ward County,12,14,-2
17,Illinois,38,North Dakota,105,Williams County,0,8,-8
17,Illinois,39,Ohio,3,Allen County,26,43,-17
17,Illinois,39,Ohio,7,Ashtabula County,24,0,24
17,Illinois,39,Ohio,9,Athens County,162,97,65
17,Illinois,39,Ohio,11,Auglaize County,22,35,-13
17,Illinois,39,Ohio,13,Belmont County,2,40,-38
17,Illinois,39,Ohio,15,Brown County,12,17,-5
17,Illinois,39,Ohio,17,Butler County,411,530,-119
17,Illinois,39,Ohio,21,Champaign County,36,11,25
17,Illinois,39,Ohio,23,Clark County,140,98,42
17,Illinois,39,Ohio,25,Clermont County,59,191,-132
17,Illinois,39,Ohio,27,Clinton County,67,0,67
17,Illinois,39,Ohio,29,Columbiana County,19,83,-64
17,Illinois,39,Ohio,35,Cuyahoga County,1043,1079,-36
17,Illinois,39,Ohio,41,Delaware County,103,252,-149
17,Illinois,39,Ohio,43,Erie County,68,62,6
17,Illinois,39,Ohio,45,Fairfield County,14,20,-6
17,Illinois,39,Ohio,47,Fayette County,57,0,57
17,Illinois,39,Ohio,49,Franklin County,1583,1672,-89
17,Illinois,39,Ohio,53,Gallia County,0,10,-10
17,Illinois,39,Ohio,55,Geauga County,129,6,123
17,Illinois,39,Ohio,57,Greene County,226,417,-191
17,Illinois,39,Ohio,61,Hamilton County,1337,1304,33
17,Illinois,39,Ohio,63,Hancock County,64,107,-43
17,Illinois,39,Ohio,65,Hardin County,0,15,-15
17,Illinois,39,Ohio,69,Henry County,7,8,-1
17,Illinois,39,Ohio,81,Jefferson County,36,71,-35
17,Illinois,39,Ohio,83,Knox County,66,38,28
17,Illinois,39,Ohio,85,Lake County,48,137,-89
17,Illinois,39,Ohio,89,Licking County,65,158,-93
17,Illinois,39,Ohio,91,Logan County,0,35,-35
17,Illinois,39,Ohio,93,Lorain County,130,234,-104
17,Illinois,39,Ohio,95,Lucas County,268,365,-97
17,Illinois,39,Ohio,97,Madison County,1,7,-6
17,Illinois,39,Ohio,99,Mahoning County,92,111,-19
17,Illinois,39,Ohio,101,Marion County,20,3,17
17,Illinois,39,Ohio,103,Medina County,90,29,61
17,Illinois,39,Ohio,107,Mercer County,0,1,-1
17,Illinois,39,Ohio,109,Miami County,120,0,120
17,Illinois,39,Ohio,113,Montgomery County,568,1061,-493
17,Illinois,39,Ohio,117,Morrow County,111,0,111
17,Illinois,39,Ohio,123,Ottawa County,0,7,-7
17,Illinois,39,Ohio,125,Paulding County,5,0,5
17,Illinois,39,Ohio,133,Portage County,78,194,-116
17,Illinois,39,Ohio,137,Putnam County,61,0,61
17,Illinois,39,Ohio,141,Ross County,25,11,14
17,Illinois,39,Ohio,143,Sandusky County,96,66,30
17,Illinois,39,Ohio,147,Seneca County,0,43,-43
17,Illinois,39,Ohio,149,Shelby County,26,0,26
17,Illinois,39,Ohio,151,Stark County,108,256,-148
17,Illinois,39,Ohio,153,Summit County,197,318,-121
17,Illinois,39,Ohio,155,Trumbull County,12,74,-62
17,Illinois,39,Ohio,157,Tuscarawas County,3,29,-26
17,Illinois,39,Ohio,159,Union County,54,81,-27
17,Illinois,39,Ohio,161,Van Wert County,0,20,-20
17,Illinois,39,Ohio,163,Vinton County,71,0,71
17,Illinois,39,Ohio,165,Warren County,216,285,-69
17,Illinois,39,Ohio,167,Washington County,43,38,5
17,Illinois,39,Ohio,169,Wayne County,24,119,-95
17,Illinois,39,Ohio,171,Williams County,0,44,-44
17,Illinois,39,Ohio,173,Wood County,96,131,-35
17,Illinois,4,Arizona,1,Apache County,30,7,23
17,Illinois,4,Arizona,3,Cochise County,38,190,-152
17,Illinois,4,Arizona,5,Coconino County,167,178,-11
17,Illinois,4,Arizona,9,Graham County,19,37,-18
17,Illinois,4,Arizona,12,La Paz County,0,10,-10
17,Illinois,4,Arizona,13,Maricopa County,3280,7817,-4537
17,Illinois,4,Arizona,15,Mohave County,37,633,-596
17,Illinois,4,Arizona,17,Navajo County,33,0,33
17,Illinois,4,Arizona,19,Pima County,678,1000,-322
17,Illinois,4,Arizona,21,Pinal County,204,602,-398
17,Illinois,4,Arizona,25,Yavapai County,187,281,-94
17,Illinois,4,Arizona,27,Yuma County,52,82,-30
17,Illinois,40,Oklahoma,9,Beckham County,12,0,12
17,Illinois,40,Oklahoma,13,Bryan County,10,0,10
17,Illinois,40,Oklahoma,17,Canadian County,4,109,-105
17,Illinois,40,Oklahoma,19,Carter County,0,21,-21
17,Illinois,40,Oklahoma,27,Cleveland County,195,264,-69
17,Illinois,40,Oklahoma,29,Coal County,34,0,34
17,Illinois,40,Oklahoma,31,Comanche County,42,267,-225
17,Illinois,40,Oklahoma,37,Creek County,0,25,-25
17,Illinois,40,Oklahoma,41,Delaware County,179,22,157
17,Illinois,40,Oklahoma,47,Garfield County,11,126,-115
17,Illinois,40,Oklahoma,49,Garvin County,0,39,-39
17,Illinois,40,Oklahoma,51,Grady County,27,0,27
17,Illinois,40,Oklahoma,65,Jackson County,2,2,0
17,Illinois,40,Oklahoma,77,Latimer County,0,13,-13
17,Illinois,40,Oklahoma,79,Le Flore County,0,38,-38
17,Illinois,40,Oklahoma,81,Lincoln County,13,0,13
17,Illinois,40,Oklahoma,83,Logan County,0,40,-40
17,Illinois,40,Oklahoma,85,Love County,16,0,16
17,Illinois,40,Oklahoma,87,McClain County,16,0,16
17,Illinois,40,Oklahoma,89,McCurtain County,85,0,85
17,Illinois,40,Oklahoma,97,Mayes County,23,3,20
17,Illinois,40,Oklahoma,101,Muskogee County,0,4,-4
17,Illinois,40,Oklahoma,107,Okfuskee County,20,6,14
17,Illinois,40,Oklahoma,109,Oklahoma County,318,413,-95
17,Illinois,40,Oklahoma,111,Okmulgee County,0,3,-3
17,Illinois,40,Oklahoma,113,Osage County,0,23,-23
17,Illinois,40,Oklahoma,115,Ottawa County,0,23,-23
17,Illinois,40,Oklahoma,117,Pawnee County,11,9,2
17,Illinois,40,Oklahoma,119,Payne County,108,116,-8
17,Illinois,40,Oklahoma,121,Pittsburg County,15,14,1
17,Illinois,40,Oklahoma,123,Pontotoc County,14,0,14
17,Illinois,40,Oklahoma,125,Pottawatomie County,19,25,-6
17,Illinois,40,Oklahoma,127,Pushmataha County,0,11,-11
17,Illinois,40,Oklahoma,131,Rogers County,33,22,11
17,Illinois,40,Oklahoma,133,Seminole County,0,3,-3
17,Illinois,40,Oklahoma,143,Tulsa County,362,496,-134
17,Illinois,40,Oklahoma,145,Wagoner County,0,30,-30
17,Illinois,40,Oklahoma,147,Washington County,16,67,-51
17,Illinois,40,Oklahoma,149,Washita County,0,4,-4
17,Illinois,40,Oklahoma,151,Woods County,0,4,-4
17,Illinois,41,Oregon,1,Baker County,15,0,15
17,Illinois,41,Oregon,3,Benton County,52,57,-5
17,Illinois,41,Oregon,5,Clackamas County,123,209,-86
17,Illinois,41,Oregon,9,Columbia County,0,18,-18
17,Illinois,41,Oregon,15,Curry County,23,30,-7
17,Illinois,41,Oregon,17,Deschutes County,40,66,-26
17,Illinois,41,Oregon,19,Douglas County,16,15,1
17,Illinois,41,Oregon,29,Jackson County,141,80,61
17,Illinois,41,Oregon,31,Jefferson County,0,99,-99
17,Illinois,41,Oregon,33,Josephine County,0,90,-90
17,Illinois,41,Oregon,35,Klamath County,0,32,-32
17,Illinois,41,Oregon,39,Lane County,164,211,-47
17,Illinois,41,Oregon,41,Lincoln County,0,9,-9
17,Illinois,41,Oregon,43,Linn County,43,57,-14
17,Illinois,41,Oregon,47,Marion County,13,33,-20
17,Illinois,41,Oregon,51,Multnomah County,435,812,-377
17,Illinois,41,Oregon,53,Polk County,0,3,-3
17,Illinois,41,Oregon,57,Tillamook County,0,1,-1
17,Illinois,41,Oregon,59,Umatilla County,15,0,15
17,Illinois,41,Oregon,61,Union County,37,11,26
17,Illinois,41,Oregon,63,Wallowa County,29,0,29
17,Illinois,41,Oregon,65,Wasco County,0,3,-3
17,Illinois,41,Oregon,67,Washington County,260,325,-65
17,Illinois,41,Oregon,71,Yamhill County,0,40,-40
17,Illinois,42,Pennsylvania,1,Adams County,17,0,17
17,Illinois,42,Pennsylvania,3,Allegheny County,996,823,173
17,Illinois,42,Pennsylvania,5,Armstrong County,69,5,64
17,Illinois,42,Pennsylvania,7,Beaver County,4,43,-39
17,Illinois,42,Pennsylvania,11,Berks County,110,37,73
17,Illinois,42,Pennsylvania,13,Blair County,34,48,-14
17,Illinois,42,Pennsylvania,15,Bradford County,0,15,-15
17,Illinois,42,Pennsylvania,17,Bucks County,74,82,-8
17,Illinois,42,Pennsylvania,19,Butler County,17,37,-20
17,Illinois,42,Pennsylvania,21,Cambria County,93,26,67
17,Illinois,42,Pennsylvania,25,Carbon County,0,30,-30
17,Illinois,42,Pennsylvania,27,Centre County,227,31,196
17,Illinois,42,Pennsylvania,29,Chester County,234,329,-95
17,Illinois,42,Pennsylvania,33,Clearfield County,0,13,-13
17,Illinois,42,Pennsylvania,37,Columbia County,89,7,82
17,Illinois,42,Pennsylvania,39,Crawford County,15,143,-128
17,Illinois,42,Pennsylvania,41,Cumberland County,67,124,-57
17,Illinois,42,Pennsylvania,43,Dauphin County,109,93,16
17,Illinois,42,Pennsylvania,45,Delaware County,71,239,-168
17,Illinois,42,Pennsylvania,49,Erie County,249,102,147
17,Illinois,42,Pennsylvania,51,Fayette County,14,8,6
17,Illinois,42,Pennsylvania,55,Franklin County,12,84,-72
17,Illinois,42,Pennsylvania,61,Huntingdon County,0,4,-4
17,Illinois,42,Pennsylvania,63,Indiana County,67,17,50
17,Illinois,42,Pennsylvania,65,Jefferson County,7,61,-54
17,Illinois,42,Pennsylvania,69,Lackawanna County,11,47,-36
17,Illinois,42,Pennsylvania,71,Lancaster County,79,134,-55
17,Illinois,42,Pennsylvania,73,Lawrence County,0,2,-2
17,Illinois,42,Pennsylvania,75,Lebanon County,41,0,41
17,Illinois,42,Pennsylvania,77,Lehigh County,40,130,-90
17,Illinois,42,Pennsylvania,79,Luzerne County,118,14,104
17,Illinois,42,Pennsylvania,81,Lycoming County,50,16,34
17,Illinois,42,Pennsylvania,85,Mercer County,0,15,-15
17,Illinois,42,Pennsylvania,87,Mifflin County,9,22,-13
17,Illinois,42,Pennsylvania,89,Monroe County,10,2,8
17,Illinois,42,Pennsylvania,91,Montgomery County,597,358,239
17,Illinois,42,Pennsylvania,93,Montour County,12,12,0
17,Illinois,42,Pennsylvania,95,Northampton County,92,61,31
17,Illinois,42,Pennsylvania,97,Northumberland County,0,2,-2
17,Illinois,42,Pennsylvania,101,Philadelphia County,581,500,81
17,Illinois,42,Pennsylvania,103,Pike County,39,46,-7
17,Illinois,42,Pennsylvania,107,Schuylkill County,316,6,310
17,Illinois,42,Pennsylvania,111,Somerset County,0,4,-4
17,Illinois,42,Pennsylvania,117,Tioga County,34,0,34
17,Illinois,42,Pennsylvania,119,Union County,4,56,-52
17,Illinois,42,Pennsylvania,121,Venango County,28,0,28
17,Illinois,42,Pennsylvania,123,Warren County,0,3,-3
17,Illinois,42,Pennsylvania,125,Washington County,45,34,11
17,Illinois,42,Pennsylvania,127,Wayne County,0,26,-26
17,Illinois,42,Pennsylvania,129,Westmoreland County,175,102,73
17,Illinois,42,Pennsylvania,133,York County,107,28,79
17,Illinois,44,Rhode Island,3,Kent County,62,16,46
17,Illinois,44,Rhode Island,5,Newport County,64,119,-55
17,Illinois,44,Rhode Island,7,Providence County,205,161,44
17,Illinois,44,Rhode Island,9,Washington County,26,59,-33
17,Illinois,45,South Carolina,3,Aiken County,88,102,-14
17,Illinois,45,South Carolina,7,Anderson County,12,149,-137
17,Illinois,45,South Carolina,13,Beaufort County,215,304,-89
17,Illinois,45,South Carolina,15,Berkeley County,171,148,23
17,Illinois,45,South Carolina,19,Charleston County,285,545,-260
17,Illinois,45,South Carolina,21,Cherokee County,13,0,13
17,Illinois,45,South Carolina,23,Chester County,7,0,7
17,Illinois,45,South Carolina,35,Dorchester County,18,21,-3
17,Illinois,45,South Carolina,37,Edgefield County,0,32,-32
17,Illinois,45,South Carolina,41,Florence County,8,83,-75
17,Illinois,45,South Carolina,43,Georgetown County,0,66,-66
17,Illinois,45,South Carolina,45,Greenville County,166,532,-366
17,Illinois,45,South Carolina,47,Greenwood County,11,0,11
17,Illinois,45,South Carolina,51,Horry County,47,217,-170
17,Illinois,45,South Carolina,53,Jasper County,0,38,-38
17,Illinois,45,South Carolina,55,Kershaw County,7,35,-28
17,Illinois,45,South Carolina,57,Lancaster County,80,0,80
17,Illinois,45,South Carolina,63,Lexington County,27,76,-49
17,Illinois,45,South Carolina,71,Newberry County,11,0,11
17,Illinois,45,South Carolina,73,Oconee County,0,60,-60
17,Illinois,45,South Carolina,75,Orangeburg County,14,9,5
17,Illinois,45,South Carolina,77,Pickens County,17,79,-62
17,Illinois,45,South Carolina,79,Richland County,238,591,-353
17,Illinois,45,South Carolina,83,Spartanburg County,33,20,13
17,Illinois,45,South Carolina,85,Sumter County,3,77,-74
17,Illinois,45,South Carolina,91,York County,59,158,-99
17,Illinois,46,South Dakota,11,Brookings County,11,44,-33
17,Illinois,46,South Dakota,13,Brown County,11,14,-3
17,Illinois,46,South Dakota,15,Brule County,0,9,-9
17,Illinois,46,South Dakota,23,Charles Mix County,6,0,6
17,Illinois,46,South Dakota,27,Clay County,9,12,-3
17,Illinois,46,South Dakota,29,Codington County,46,0,46
17,Illinois,46,South Dakota,33,Custer County,0,8,-8
17,Illinois,46,South Dakota,35,Davison County,28,24,4
17,Illinois,46,South Dakota,39,Deuel County,0,2,-2
17,Illinois,46,South Dakota,55,Haakon County,38,0,38
17,Illinois,46,South Dakota,67,Hutchinson County,0,10,-10
17,Illinois,46,South Dakota,71,Jackson County,14,0,14
17,Illinois,46,South Dakota,79,Lake County,0,2,-2
17,Illinois,46,South Dakota,83,Lincoln County,35,25,10
17,Illinois,46,South Dakota,93,Meade County,0,49,-49
17,Illinois,46,South Dakota,99,Minnehaha County,51,94,-43
17,Illinois,46,South Dakota,101,Moody County,0,1,-1
17,Illinois,46,South Dakota,103,Pennington County,46,108,-62
17,Illinois,46,South Dakota,109,Roberts County,7,0,7
17,Illinois,46,South Dakota,121,Todd County,0,36,-36
17,Illinois,46,South Dakota,123,Tripp County,0,3,-3
17,Illinois,46,South Dakota,135,Yankton County,1,11,-10
17,Illinois,47,Tennessee,1,Anderson County,0,15,-15
17,Illinois,47,Tennessee,3,Bedford County,39,86,-47
17,Illinois,47,Tennessee,5,Benton County,6,23,-17
17,Illinois,47,Tennessee,9,Blount County,7,14,-7
17,Illinois,47,Tennessee,11,Bradley County,136,211,-75
17,Illinois,47,Tennessee,13,Campbell County,0,75,-75
17,Illinois,47,Tennessee,17,Carroll County,0,65,-65
17,Illinois,47,Tennessee,19,Carter County,0,11,-11
17,Illinois,47,Tennessee,21,Cheatham County,55,123,-68
17,Illinois,47,Tennessee,23,Chester County,0,2,-2
17,Illinois,47,Tennessee,27,Clay County,97,25,72
17,Illinois,47,Tennessee,29,Cocke County,0,64,-64
17,Illinois,47,Tennessee,31,Coffee County,0,14,-14
17,Illinois,47,Tennessee,33,Crockett County,4,0,4
17,Illinois,47,Tennessee,35,Cumberland County,21,97,-76
17,Illinois,47,Tennessee,37,Davidson County,889,1721,-832
17,Illinois,47,Tennessee,39,Decatur County,0,14,-14
17,Illinois,47,Tennessee,41,DeKalb County,0,1,-1
17,Illinois,47,Tennessee,43,Dickson County,61,0,61
17,Illinois,47,Tennessee,45,Dyer County,138,0,138
17,Illinois,47,Tennessee,47,Fayette County,0,20,-20
17,Illinois,47,Tennessee,49,Fentress County,0,78,-78
17,Illinois,47,Tennessee,51,Franklin County,0,46,-46
17,Illinois,47,Tennessee,53,Gibson County,126,5,121
17,Illinois,47,Tennessee,57,Grainger County,0,83,-83
17,Illinois,47,Tennessee,59,Greene County,0,206,-206
17,Illinois,47,Tennessee,63,Hamblen County,0,16,-16
17,Illinois,47,Tennessee,65,Hamilton County,230,100,130
17,Illinois,47,Tennessee,67,Hancock County,0,10,-10
17,Illinois,47,Tennessee,69,Hardeman County,42,1,41
17,Illinois,47,Tennessee,71,Hardin County,8,0,8
17,Illinois,47,Tennessee,73,Hawkins County,82,31,51
17,Illinois,47,Tennessee,79,Henry County,23,89,-66
17,Illinois,47,Tennessee,81,Hickman County,7,0,7
17,Illinois,47,Tennessee,85,Humphreys County,0,15,-15
17,Illinois,47,Tennessee,87,Jackson County,34,0,34
17,Illinois,47,Tennessee,89,Jefferson County,0,131,-131
17,Illinois,47,Tennessee,91,Johnson County,0,36,-36
17,Illinois,47,Tennessee,93,Knox County,633,414,219
17,Illinois,47,Tennessee,95,Lake County,0,25,-25
17,Illinois,47,Tennessee,97,Lauderdale County,10,41,-31
17,Illinois,47,Tennessee,99,Lawrence County,22,7,15
17,Illinois,47,Tennessee,103,Lincoln County,0,30,-30
17,Illinois,47,Tennessee,105,Loudon County,4,38,-34
17,Illinois,47,Tennessee,107,McMinn County,0,45,-45
17,Illinois,47,Tennessee,109,McNairy County,0,58,-58
17,Illinois,47,Tennessee,111,Macon County,0,55,-55
17,Illinois,47,Tennessee,113,Madison County,117,124,-7
17,Illinois,47,Tennessee,115,Marion County,9,0,9
17,Illinois,47,Tennessee,117,Marshall County,0,58,-58
17,Illinois,47,Tennessee,119,Maury County,53,67,-14
17,Illinois,47,Tennessee,121,Meigs County,0,22,-22
17,Illinois,47,Tennessee,123,Monroe County,0,21,-21
17,Illinois,47,Tennessee,125,Montgomery County,286,509,-223
17,Illinois,47,Tennessee,127,Moore County,6,0,6
17,Illinois,47,Tennessee,133,Overton County,0,34,-34
17,Illinois,47,Tennessee,139,Polk County,0,40,-40
17,Illinois,47,Tennessee,141,Putnam County,10,108,-98
17,Illinois,47,Tennessee,143,Rhea County,41,75,-34
17,Illinois,47,Tennessee,145,Roane County,74,0,74
17,Illinois,47,Tennessee,147,Robertson County,148,32,116
17,Illinois,47,Tennessee,149,Rutherford County,282,844,-562
17,Illinois,47,Tennessee,153,Sequatchie County,10,0,10
17,Illinois,47,Tennessee,155,Sevier County,54,125,-71
17,Illinois,47,Tennessee,157,Shelby County,1004,1741,-737
17,Illinois,47,Tennessee,161,Stewart County,0,19,-19
17,Illinois,47,Tennessee,163,Sullivan County,117,51,66
17,Illinois,47,Tennessee,165,Sumner County,105,518,-413
17,Illinois,47,Tennessee,167,Tipton County,0,145,-145
17,Illinois,47,Tennessee,173,Union County,0,4,-4
17,Illinois,47,Tennessee,177,Warren County,0,14,-14
17,Illinois,47,Tennessee,179,Washington County,0,67,-67
17,Illinois,47,Tennessee,183,Weakley County,18,88,-70
17,Illinois,47,Tennessee,185,White County,0,52,-52
17,Illinois,47,Tennessee,187,Williamson County,300,606,-306
17,Illinois,47,Tennessee,189,Wilson County,12,74,-62
17,Illinois,48,Texas,1,Anderson County,30,0,30
17,Illinois,48,Texas,5,Angelina County,189,0,189
17,Illinois,48,Texas,7,Aransas County,3,0,3
17,Illinois,48,Texas,13,Atascosa County,0,5,-5
17,Illinois,48,Texas,15,Austin County,12,0,12
17,Illinois,48,Texas,19,Bandera County,70,0,70
17,Illinois,48,Texas,21,Bastrop County,0,165,-165
17,Illinois,48,Texas,27,Bell County,291,594,-303
17,Illinois,48,Texas,29,Bexar County,1069,1410,-341
17,Illinois,48,Texas,35,Bosque County,0,14,-14
17,Illinois,48,Texas,37,Bowie County,0,12,-12
17,Illinois,48,Texas,39,Brazoria County,180,121,59
17,Illinois,48,Texas,41,Brazos County,152,144,8
17,Illinois,48,Texas,47,Brooks County,0,5,-5
17,Illinois,48,Texas,49,Brown County,108,0,108
17,Illinois,48,Texas,55,Caldwell County,31,70,-39
17,Illinois,48,Texas,61,Cameron County,193,60,133
17,Illinois,48,Texas,71,Chambers County,0,329,-329
17,Illinois,48,Texas,79,Cochran County,0,12,-12
17,Illinois,48,Texas,85,Collin County,555,1053,-498
17,Illinois,48,Texas,91,Comal County,0,174,-174
17,Illinois,48,Texas,95,Concho County,0,22,-22
17,Illinois,48,Texas,99,Coryell County,228,210,18
17,Illinois,48,Texas,111,Dallam County,0,13,-13
17,Illinois,48,Texas,113,Dallas County,954,2511,-1557
17,Illinois,48,Texas,121,Denton County,740,1161,-421
17,Illinois,48,Texas,123,DeWitt County,6,0,6
17,Illinois,48,Texas,133,Eastland County,3,11,-8
17,Illinois,48,Texas,135,Ector County,8,21,-13
17,Illinois,48,Texas,139,Ellis County,0,52,-52
17,Illinois,48,Texas,141,El Paso County,459,847,-388
17,Illinois,48,Texas,143,Erath County,0,3,-3
17,Illinois,48,Texas,147,Fannin County,0,44,-44
17,Illinois,48,Texas,149,Fayette County,0,166,-166
17,Illinois,48,Texas,157,Fort Bend County,327,1256,-929
17,Illinois,48,Texas,161,Freestone County,0,68,-68
17,Illinois,48,Texas,167,Galveston County,174,385,-211
17,Illinois,48,Texas,171,Gillespie County,10,46,-36
17,Illinois,48,Texas,181,Grayson County,0,120,-120
17,Illinois,48,Texas,183,Gregg County,84,154,-70
17,Illinois,48,Texas,187,Guadalupe County,0,118,-118
17,Illinois,48,Texas,201,Harris County,2022,4187,-2165
17,Illinois,48,Texas,203,Harrison County,0,37,-37
17,Illinois,48,Texas,209,Hays County,84,161,-77
17,Illinois,48,Texas,213,Henderson County,31,4,27
17,Illinois,48,Texas,215,Hidalgo County,107,624,-517
17,Illinois,48,Texas,217,Hill County,0,13,-13
17,Illinois,48,Texas,221,Hood County,5,120,-115
17,Illinois,48,Texas,223,Hopkins County,22,0,22
17,Illinois,48,Texas,231,Hunt County,14,23,-9
17,Illinois,48,Texas,237,Jack County,0,9,-9
17,Illinois,48,Texas,243,Jeff Davis County,0,4,-4
17,Illinois,48,Texas,245,Jefferson County,73,188,-115
17,Illinois,48,Texas,251,Johnson County,154,0,154
17,Illinois,48,Texas,257,Kaufman County,0,94,-94
17,Illinois,48,Texas,259,Kendall County,4,0,4
17,Illinois,48,Texas,261,Kenedy County,0,1,-1
17,Illinois,48,Texas,265,Kerr County,25,51,-26
17,Illinois,48,Texas,273,Kleberg County,43,0,43
17,Illinois,48,Texas,277,Lamar County,0,3,-3
17,Illinois,48,Texas,281,Lampasas County,4,0,4
17,Illinois,48,Texas,291,Liberty County,0,6,-6
17,Illinois,48,Texas,297,Live Oak County,21,0,21
17,Illinois,48,Texas,301,Loving County,0,3,-3
17,Illinois,48,Texas,303,Lubbock County,38,138,-100
17,Illinois,48,Texas,309,McLennan County,65,269,-204
17,Illinois,48,Texas,315,Marion County,0,23,-23
17,Illinois,48,Texas,323,Maverick County,0,40,-40
17,Illinois,48,Texas,325,Medina County,20,51,-31
17,Illinois,48,Texas,329,Midland County,27,182,-155
17,Illinois,48,Texas,331,Milam County,5,0,5
17,Illinois,48,Texas,337,Montague County,0,1,-1
17,Illinois,48,Texas,339,Montgomery County,78,815,-737
17,Illinois,48,Texas,349,Navarro County,0,43,-43
17,Illinois,48,Texas,353,Nolan County,0,137,-137
17,Illinois,48,Texas,355,Nueces County,186,212,-26
17,Illinois,48,Texas,361,Orange County,35,48,-13
17,Illinois,48,Texas,363,Palo Pinto County,10,0,10
17,Illinois,48,Texas,367,Parker County,36,23,13
17,Illinois,48,Texas,369,Parmer County,70,0,70
17,Illinois,48,Texas,375,Potter County,150,27,123
17,Illinois,48,Texas,381,Randall County,16,9,7
17,Illinois,48,Texas,387,Red River County,3,0,3
17,Illinois,48,Texas,395,Robertson County,17,0,17
17,Illinois,48,Texas,397,Rockwall County,0,71,-71
17,Illinois,48,Texas,409,San Patricio County,0,44,-44
17,Illinois,48,Texas,419,Shelby County,0,2,-2
17,Illinois,48,Texas,421,Sherman County,0,4,-4
17,Illinois,48,Texas,423,Smith County,53,127,-74
17,Illinois,48,Texas,427,Starr County,14,0,14
17,Illinois,48,Texas,439,Tarrant County,788,2052,-1264
17,Illinois,48,Texas,441,Taylor County,192,41,151
17,Illinois,48,Texas,451,Tom Green County,36,9,27
17,Illinois,48,Texas,453,Travis County,1279,1411,-132
17,Illinois,48,Texas,459,Upshur County,0,29,-29
17,Illinois,48,Texas,465,Val Verde County,6,23,-17
17,Illinois,48,Texas,467,Van Zandt County,54,0,54
17,Illinois,48,Texas,469,Victoria County,8,0,8
17,Illinois,48,Texas,471,Walker County,33,7,26
17,Illinois,48,Texas,473,Waller County,0,30,-30
17,Illinois,48,Texas,479,Webb County,11,61,-50
17,Illinois,48,Texas,481,Wharton County,16,0,16
17,Illinois,48,Texas,485,Wichita County,57,369,-312
17,Illinois,48,Texas,489,Willacy County,55,0,55
17,Illinois,48,Texas,491,Williamson County,193,971,-778
17,Illinois,48,Texas,499,Wood County,0,220,-220
17,Illinois,49,Utah,1,Beaver County,0,2,-2
17,Illinois,49,Utah,5,Cache County,7,66,-59
17,Illinois,49,Utah,7,Carbon County,0,7,-7
17,Illinois,49,Utah,11,Davis County,42,113,-71
17,Illinois,49,Utah,13,Duchesne County,0,6,-6
17,Illinois,49,Utah,21,Iron County,47,8,39
17,Illinois,49,Utah,25,Kane County,32,0,32
17,Illinois,49,Utah,31,Piute County,5,1,4
17,Illinois,49,Utah,35,Salt Lake County,598,692,-94
17,Illinois,49,Utah,39,Sanpete County,0,11,-11
17,Illinois,49,Utah,43,Summit County,0,33,-33
17,Illinois,49,Utah,45,Tooele County,0,30,-30
17,Illinois,49,Utah,49,Utah County,193,345,-152
17,Illinois,49,Utah,51,Wasatch County,0,23,-23
17,Illinois,49,Utah,53,Washington County,57,40,17
17,Illinois,49,Utah,55,Wayne County,0,1,-1
17,Illinois,49,Utah,57,Weber County,0,15,-15
17,Illinois,5,Arkansas,1,Arkansas County,34,0,34
17,Illinois,5,Arkansas,5,Baxter County,46,119,-73
17,Illinois,5,Arkansas,7,Benton County,118,300,-182
17,Illinois,5,Arkansas,9,Boone County,0,8,-8
17,Illinois,5,Arkansas,15,Carroll County,0,8,-8
17,Illinois,5,Arkansas,17,Chicot County,11,19,-8
17,Illinois,5,Arkansas,19,Clark County,0,6,-6
17,Illinois,5,Arkansas,21,Clay County,0,40,-40
17,Illinois,5,Arkansas,23,Cleburne County,52,8,44
17,Illinois,5,Arkansas,31,Craighead County,32,144,-112
17,Illinois,5,Arkansas,33,Crawford County,22,80,-58
17,Illinois,5,Arkansas,35,Crittenden County,15,29,-14
17,Illinois,5,Arkansas,39,Dallas County,0,35,-35
17,Illinois,5,Arkansas,43,Drew County,12,6,6
17,Illinois,5,Arkansas,45,Faulkner County,54,7,47
17,Illinois,5,Arkansas,49,Fulton County,18,0,18
17,Illinois,5,Arkansas,51,Garland County,337,117,220
17,Illinois,5,Arkansas,53,Grant County,0,93,-93
17,Illinois,5,Arkansas,55,Greene County,0,97,-97
17,Illinois,5,Arkansas,57,Hempstead County,0,26,-26
17,Illinois,5,Arkansas,59,Hot Spring County,0,66,-66
17,Illinois,5,Arkansas,61,Howard County,12,0,12
17,Illinois,5,Arkansas,63,Independence County,19,20,-1
17,Illinois,5,Arkansas,65,Izard County,25,45,-20
17,Illinois,5,Arkansas,67,Jackson County,0,12,-12
17,Illinois,5,Arkansas,69,Jefferson County,25,26,-1
17,Illinois,5,Arkansas,71,Johnson County,0,7,-7
17,Illinois,5,Arkansas,73,Lafayette County,0,26,-26
17,Illinois,5,Arkansas,77,Lee County,21,12,9
17,Illinois,5,Arkansas,81,Little River County,0,9,-9
17,Illinois,5,Arkansas,83,Logan County,57,0,57
17,Illinois,5,Arkansas,85,Lonoke County,45,36,9
17,Illinois,5,Arkansas,89,Marion County,35,74,-39
17,Illinois,5,Arkansas,91,Miller County,53,0,53
17,Illinois,5,Arkansas,93,Mississippi County,15,0,15
17,Illinois,5,Arkansas,99,Nevada County,0,73,-73
17,Illinois,5,Arkansas,103,Ouachita County,29,0,29
17,Illinois,5,Arkansas,107,Phillips County,0,58,-58
17,Illinois,5,Arkansas,111,Poinsett County,37,5,32
17,Illinois,5,Arkansas,113,Polk County,0,8,-8
17,Illinois,5,Arkansas,115,Pope County,13,18,-5
17,Illinois,5,Arkansas,117,Prairie County,0,32,-32
17,Illinois,5,Arkansas,119,Pulaski County,295,572,-277
17,Illinois,5,Arkansas,121,Randolph County,0,1,-1
17,Illinois,5,Arkansas,123,St. Francis County,0,95,-95
17,Illinois,5,Arkansas,125,Saline County,90,81,9
17,Illinois,5,Arkansas,131,Sebastian County,43,14,29
17,Illinois,5,Arkansas,133,Sevier County,0,3,-3
17,Illinois,5,Arkansas,135,Sharp County,29,42,-13
17,Illinois,5,Arkansas,137,Stone County,2,13,-11
17,Illinois,5,Arkansas,139,Union County,0,2,-2
17,Illinois,5,Arkansas,141,Van Buren County,2,11,-9
17,Illinois,5,Arkansas,143,Washington County,170,208,-38
17,Illinois,5,Arkansas,145,White County,6,131,-125
17,Illinois,5,Arkansas,149,Yell County,15,4,11
17,Illinois,50,Vermont,1,Addison County,0,49,-49
17,Illinois,50,Vermont,3,Bennington County,0,22,-22
17,Illinois,50,Vermont,5,Caledonia County,7,6,1
17,Illinois,50,Vermont,7,Chittenden County,381,223,158
17,Illinois,50,Vermont,11,Franklin County,62,0,62
17,Illinois,50,Vermont,15,Lamoille County,0,24,-24
17,Illinois,50,Vermont,17,Orange County,0,21,-21
17,Illinois,50,Vermont,21,Rutland County,0,2,-2
17,Illinois,50,Vermont,23,Washington County,0,10,-10
17,Illinois,50,Vermont,25,Windham County,22,48,-26
17,Illinois,50,Vermont,27,Windsor County,3,0,3
17,Illinois,51,Virginia,3,Albemarle County,89,71,18
17,Illinois,51,Virginia,13,Arlington County,209,271,-62
17,Illinois,51,Virginia,15,Augusta County,35,0,35
17,Illinois,51,Virginia,19,Bedford County,9,28,-19
17,Illinois,51,Virginia,23,Botetourt County,47,0,47
17,Illinois,51,Virginia,25,Brunswick County,0,83,-83
17,Illinois,51,Virginia,31,Campbell County,37,0,37
17,Illinois,51,Virginia,33,Caroline County,22,0,22
17,Illinois,51,Virginia,41,Chesterfield County,172,114,58
17,Illinois,51,Virginia,47,Culpeper County,62,0,62
17,Illinois,51,Virginia,49,Cumberland County,38,0,38
17,Illinois,51,Virginia,59,Fairfax County,687,1191,-504
17,Illinois,51,Virginia,61,Fauquier County,154,27,127
17,Illinois,51,Virginia,69,Frederick County,17,0,17
17,Illinois,51,Virginia,85,Hanover County,0,8,-8
17,Illinois,51,Virginia,87,Henrico County,172,117,55
17,Illinois,51,Virginia,89,Henry County,0,75,-75
17,Illinois,51,Virginia,93,Isle of Wight County,8,24,-16
17,Illinois,51,Virginia,95,James City County,0,30,-30
17,Illinois,51,Virginia,99,King George County,0,94,-94
17,Illinois,51,Virginia,105,Lee County,6,0,6
17,Illinois,51,Virginia,107,Loudoun County,228,286,-58
17,Illinois,51,Virginia,113,Madison County,10,0,10
17,Illinois,51,Virginia,121,Montgomery County,248,66,182
17,Illinois,51,Virginia,145,Powhatan County,9,45,-36
17,Illinois,51,Virginia,147,Prince Edward County,11,0,11
17,Illinois,51,Virginia,149,Prince George County,0,80,-80
17,Illinois,51,Virginia,153,Prince William County,230,106,124
17,Illinois,51,Virginia,155,Pulaski County,14,0,14
17,Illinois,51,Virginia,157,Rappahannock County,15,0,15
17,Illinois,51,Virginia,161,Roanoke County,27,54,-27
17,Illinois,51,Virginia,169,Scott County,24,0,24
17,Illinois,51,Virginia,175,Southampton County,59,0,59
17,Illinois,51,Virginia,177,Spotsylvania County,13,33,-20
17,Illinois,51,Virginia,179,Stafford County,51,43,8
17,Illinois,51,Virginia,191,Washington County,14,0,14
17,Illinois,51,Virginia,199,York County,54,83,-29
17,Illinois,51,Virginia,510,Alexandria city,245,310,-65
17,Illinois,51,Virginia,520,Bristol city,19,0,19
17,Illinois,51,Virginia,540,Charlottesville city,51,22,29
17,Illinois,51,Virginia,550,Chesapeake city,75,169,-94
17,Illinois,51,Virginia,600,Fairfax city,13,9,4
17,Illinois,51,Virginia,610,Falls Church city,31,0,31
17,Illinois,51,Virginia,620,Franklin city,2,0,2
17,Illinois,51,Virginia,630,Fredericksburg city,31,11,20
17,Illinois,51,Virginia,650,Hampton city,210,122,88
17,Illinois,51,Virginia,660,Harrisonburg city,24,22,2
17,Illinois,51,Virginia,670,Hopewell city,0,215,-215
17,Illinois,51,Virginia,678,Lexington city,0,12,-12
17,Illinois,51,Virginia,680,Lynchburg city,23,88,-65
17,Illinois,51,Virginia,683,Manassas city,22,0,22
17,Illinois,51,Virginia,685,Manassas Park city,0,21,-21
17,Illinois,51,Virginia,700,Newport News city,152,223,-71
17,Illinois,51,Virginia,710,Norfolk city,326,1102,-776
17,Illinois,51,Virginia,730,Petersburg city,0,22,-22
17,Illinois,51,Virginia,735,Poquoson city,0,24,-24
17,Illinois,51,Virginia,740,Portsmouth city,0,199,-199
17,Illinois,51,Virginia,760,Richmond city,133,104,29
17,Illinois,51,Virginia,770,Roanoke city,27,5,22
17,Illinois,51,Virginia,790,Staunton city,76,0,76
17,Illinois,51,Virginia,800,Suffolk city,155,5,150
17,Illinois,51,Virginia,810,Virginia Beach city,899,1070,-171
17,Illinois,51,Virginia,830,Williamsburg city,75,94,-19
17,Illinois,53,Washington,5,Benton County,99,10,89
17,Illinois,53,Washington,7,Chelan County,0,60,-60
17,Illinois,53,Washington,9,Clallam County,37,13,24
17,Illinois,53,Washington,11,Clark County,246,68,178
17,Illinois,53,Washington,15,Cowlitz County,20,0,20
17,Illinois,53,Washington,21,Franklin County,0,23,-23
17,Illinois,53,Washington,27,Grays Harbor County,0,29,-29
17,Illinois,53,Washington,29,Island County,156,84,72
17,Illinois,53,Washington,31,Jefferson County,0,1,-1
17,Illinois,53,Washington,33,King County,1431,3863,-2432
17,Illinois,53,Washington,35,Kitsap County,61,386,-325
17,Illinois,53,Washington,39,Klickitat County,4,0,4
17,Illinois,53,Washington,41,Lewis County,0,50,-50
17,Illinois,53,Washington,43,Lincoln County,0,9,-9
17,Illinois,53,Washington,45,Mason County,0,28,-28
17,Illinois,53,Washington,49,Pacific County,0,10,-10
17,Illinois,53,Washington,51,Pend Oreille County,0,7,-7
17,Illinois,53,Washington,53,Pierce County,514,786,-272
17,Illinois,53,Washington,57,Skagit County,24,37,-13
17,Illinois,53,Washington,61,Snohomish County,256,546,-290
17,Illinois,53,Washington,63,Spokane County,316,432,-116
17,Illinois,53,Washington,65,Stevens County,10,0,10
17,Illinois,53,Washington,67,Thurston County,531,138,393
17,Illinois,53,Washington,71,Walla Walla County,0,6,-6
17,Illinois,53,Washington,73,Whatcom County,50,63,-13
17,Illinois,53,Washington,75,Whitman County,37,91,-54
17,Illinois,53,Washington,77,Yakima County,29,95,-66
17,Illinois,54,West Virginia,1,Barbour County,0,58,-58
17,Illinois,54,West Virginia,3,Berkeley County,3,11,-8
17,Illinois,54,West Virginia,9,Brooke County,0,18,-18
17,Illinois,54,West Virginia,11,Cabell County,142,6,136
17,Illinois,54,West Virginia,21,Gilmer County,20,10,10
17,Illinois,54,West Virginia,25,Greenbrier County,10,0,10
17,Illinois,54,West Virginia,29,Hancock County,37,0,37
17,Illinois,54,West Virginia,37,Jefferson County,0,5,-5
17,Illinois,54,West Virginia,39,Kanawha County,45,14,31
17,Illinois,54,West Virginia,47,McDowell County,0,12,-12
17,Illinois,54,West Virginia,55,Mercer County,14,0,14
17,Illinois,54,West Virginia,57,Mineral County,43,0,43
17,Illinois,54,West Virginia,61,Monongalia County,14,47,-33
17,Illinois,54,West Virginia,69,Ohio County,0,31,-31
17,Illinois,54,West Virginia,75,Pocahontas County,17,0,17
17,Illinois,54,West Virginia,77,Preston County,0,9,-9
17,Illinois,54,West Virginia,79,Putnam County,48,0,48
17,Illinois,54,West Virginia,81,Raleigh County,10,31,-21
17,Illinois,54,West Virginia,83,Randolph County,65,0,65
17,Illinois,54,West Virginia,89,Summers County,0,25,-25
17,Illinois,54,West Virginia,99,Wayne County,16,31,-15
17,Illinois,54,West Virginia,107,Wood County,158,0,158
17,Illinois,55,Wisconsin,1,Adams County,43,129,-86
17,Illinois,55,Wisconsin,3,Ashland County,8,25,-17
17,Illinois,55,Wisconsin,5,Barron County,0,55,-55
17,Illinois,55,Wisconsin,7,Bayfield County,0,9,-9
17,Illinois,55,Wisconsin,9,Brown County,513,1194,-681
17,Illinois,55,Wisconsin,11,Buffalo County,0,2,-2
17,Illinois,55,Wisconsin,13,Burnett County,0,3,-3
17,Illinois,55,Wisconsin,15,Calumet County,120,50,70
17,Illinois,55,Wisconsin,17,Chippewa County,20,88,-68
17,Illinois,55,Wisconsin,19,Clark County,0,20,-20
17,Illinois,55,Wisconsin,21,Columbia County,98,245,-147
17,Illinois,55,Wisconsin,23,Crawford County,6,46,-40
17,Illinois,55,Wisconsin,25,Dane County,1976,3797,-1821
17,Illinois,55,Wisconsin,27,Dodge County,71,133,-62
17,Illinois,55,Wisconsin,29,Door County,59,255,-196
17,Illinois,55,Wisconsin,31,Douglas County,11,93,-82
17,Illinois,55,Wisconsin,33,Dunn County,29,109,-80
17,Illinois,55,Wisconsin,35,Eau Claire County,67,71,-4
17,Illinois,55,Wisconsin,39,Fond du Lac County,127,188,-61
17,Illinois,55,Wisconsin,41,Forest County,0,42,-42
17,Illinois,55,Wisconsin,43,Grant County,151,497,-346
17,Illinois,55,Wisconsin,45,Green County,74,460,-386
17,Illinois,55,Wisconsin,47,Green Lake County,8,27,-19
17,Illinois,55,Wisconsin,49,Iowa County,62,78,-16
17,Illinois,55,Wisconsin,51,Iron County,7,9,-2
17,Illinois,55,Wisconsin,53,Jackson County,61,18,43
17,Illinois,55,Wisconsin,55,Jefferson County,118,386,-268
17,Illinois,55,Wisconsin,57,Juneau County,1,77,-76
17,Illinois,55,Wisconsin,59,Kenosha County,1970,3970,-2000
17,Illinois,55,Wisconsin,61,Kewaunee County,15,69,-54
17,Illinois,55,Wisconsin,63,La Crosse County,15,208,-193
17,Illinois,55,Wisconsin,65,Lafayette County,23,119,-96
17,Illinois,55,Wisconsin,67,Langlade County,21,39,-18
17,Illinois,55,Wisconsin,69,Lincoln County,29,203,-174
17,Illinois,55,Wisconsin,71,Manitowoc County,96,139,-43
17,Illinois,55,Wisconsin,73,Marathon County,99,238,-139
17,Illinois,55,Wisconsin,75,Marinette County,32,120,-88
17,Illinois,55,Wisconsin,77,Marquette County,83,54,29
17,Illinois,55,Wisconsin,78,Menominee County,0,4,-4
17,Illinois,55,Wisconsin,79,Milwaukee County,2993,5396,-2403
17,Illinois,55,Wisconsin,81,Monroe County,24,127,-103
17,Illinois,55,Wisconsin,83,Oconto County,12,58,-46
17,Illinois,55,Wisconsin,85,Oneida County,60,156,-96
17,Illinois,55,Wisconsin,87,Outagamie County,293,271,22
17,Illinois,55,Wisconsin,89,Ozaukee County,461,330,131
17,Illinois,55,Wisconsin,91,Pepin County,13,1,12
17,Illinois,55,Wisconsin,93,Pierce County,41,46,-5
17,Illinois,55,Wisconsin,95,Polk County,139,23,116
17,Illinois,55,Wisconsin,97,Portage County,52,100,-48
17,Illinois,55,Wisconsin,99,Price County,4,29,-25
17,Illinois,55,Wisconsin,101,Racine County,526,996,-470
17,Illinois,55,Wisconsin,103,Richland County,0,68,-68
17,Illinois,55,Wisconsin,105,Rock County,1217,1495,-278
17,Illinois,55,Wisconsin,107,Rusk County,0,21,-21
17,Illinois,55,Wisconsin,109,St. Croix County,33,19,14
17,Illinois,55,Wisconsin,111,Sauk County,12,225,-213
17,Illinois,55,Wisconsin,113,Sawyer County,35,26,9
17,Illinois,55,Wisconsin,115,Shawano County,13,12,1
17,Illinois,55,Wisconsin,117,Sheboygan County,64,284,-220
17,Illinois,55,Wisconsin,119,Taylor County,0,10,-10
17,Illinois,55,Wisconsin,121,Trempealeau County,16,11,5
17,Illinois,55,Wisconsin,123,Vernon County,35,27,8
17,Illinois,55,Wisconsin,125,Vilas County,20,147,-127
17,Illinois,55,Wisconsin,127,Walworth County,909,2065,-1156
17,Illinois,55,Wisconsin,129,Washburn County,0,46,-46
17,Illinois,55,Wisconsin,131,Washington County,80,206,-126
17,Illinois,55,Wisconsin,133,Waukesha County,937,1143,-206
17,Illinois,55,Wisconsin,135,Waupaca County,30,90,-60
17,Illinois,55,Wisconsin,137,Waushara County,7,46,-39
17,Illinois,55,Wisconsin,139,Winnebago County,272,341,-69
17,Illinois,55,Wisconsin,141,Wood County,16,64,-48
17,Illinois,56,Wyoming,1,Albany County,23,71,-48
17,Illinois,56,Wyoming,3,Big Horn County,0,50,-50
17,Illinois,56,Wyoming,5,Campbell County,9,81,-72
17,Illinois,56,Wyoming,9,Converse County,16,0,16
17,Illinois,56,Wyoming,13,Fremont County,11,31,-20
17,Illinois,56,Wyoming,15,Goshen County,4,1,3
17,Illinois,56,Wyoming,21,Laramie County,46,49,-3
17,Illinois,56,Wyoming,23,Lincoln County,0,40,-40
17,Illinois,56,Wyoming,25,Natrona County,18,0,18
17,Illinois,56,Wyoming,29,Park County,0,26,-26
17,Illinois,56,Wyoming,33,Sheridan County,0,1,-1
17,Illinois,56,Wyoming,37,Sweetwater County,110,0,110
17,Illinois,56,Wyoming,39,Teton County,48,41,7
17,Illinois,56,Wyoming,45,Weston County,3,0,3
17,Illinois,6,California,1,Alameda County,1205,1352,-147
17,Illinois,6,California,7,Butte County,53,34,19
17,Illinois,6,California,13,Contra Costa County,513,480,33
17,Illinois,6,California,15,Del Norte County,19,0,19
17,Illinois,6,California,17,El Dorado County,38,122,-84
17,Illinois,6,California,19,Fresno County,249,90,159
17,Illinois,6,California,21,Glenn County,92,0,92
17,Illinois,6,California,23,Humboldt County,56,68,-12
17,Illinois,6,California,25,Imperial County,34,14,20
17,Illinois,6,California,29,Kern County,208,143,65
17,Illinois,6,California,31,Kings County,7,138,-131
17,Illinois,6,California,35,Lassen County,0,49,-49
17,Illinois,6,California,37,Los Angeles County,4259,5243,-984
17,Illinois,6,California,41,Marin County,73,76,-3
17,Illinois,6,California,43,Mariposa County,0,11,-11
17,Illinois,6,California,45,Mendocino County,26,24,2
17,Illinois,6,California,47,Merced County,81,0,81
17,Illinois,6,California,53,Monterey County,142,355,-213
17,Illinois,6,California,55,Napa County,108,10,98
17,Illinois,6,California,57,Nevada County,29,0,29
17,Illinois,6,California,59,Orange County,1283,2043,-760
17,Illinois,6,California,61,Placer County,51,27,24
17,Illinois,6,California,63,Plumas County,0,10,-10
17,Illinois,6,California,65,Riverside County,1003,650,353
17,Illinois,6,California,67,Sacramento County,423,475,-52
17,Illinois,6,California,69,San Benito County,0,11,-11
17,Illinois,6,California,71,San Bernardino County,687,620,67
17,Illinois,6,California,73,San Diego County,2549,3674,-1125
17,Illinois,6,California,75,San Francisco County,872,1817,-945
17,Illinois,6,California,77,San Joaquin County,104,115,-11
17,Illinois,6,California,79,San Luis Obispo County,69,113,-44
17,Illinois,6,California,81,San Mateo County,387,553,-166
17,Illinois,6,California,83,Santa Barbara County,183,341,-158
17,Illinois,6,California,85,Santa Clara County,838,2669,-1831
17,Illinois,6,California,87,Santa Cruz County,119,51,68
17,Illinois,6,California,89,Shasta County,24,52,-28
17,Illinois,6,California,93,Siskiyou County,0,4,-4
17,Illinois,6,California,95,Solano County,144,541,-397
17,Illinois,6,California,97,Sonoma County,137,330,-193
17,Illinois,6,California,99,Stanislaus County,210,66,144
17,Illinois,6,California,103,Tehama County,55,0,55
17,Illinois,6,California,107,Tulare County,54,168,-114
17,Illinois,6,California,111,Ventura County,247,498,-251
17,Illinois,6,California,113,Yolo County,130,142,-12
17,Illinois,6,California,115,Yuba County,0,19,-19
17,Illinois,72,Puerto Rico,3,Aguada Municipio,0,22,-22
17,Illinois,72,Puerto Rico,11,Añasco Municipio,23,0,23
17,Illinois,72,Puerto Rico,13,Arecibo Municipio,17,0,17
17,Illinois,72,Puerto Rico,15,Arroyo Municipio,45,0,45
17,Illinois,72,Puerto Rico,21,Bayamón Municipio,78,7,71
17,Illinois,72,Puerto Rico,23,Cabo Rojo Municipio,10,0,10
17,Illinois,72,Puerto Rico,25,Caguas Municipio,184,47,137
17,Illinois,72,Puerto Rico,27,Camuy Municipio,46,0,46
17,Illinois,72,Puerto Rico,31,Carolina Municipio,0,19,-19
17,Illinois,72,Puerto Rico,33,Cataño Municipio,4,0,4
17,Illinois,72,Puerto Rico,41,Cidra Municipio,58,0,58
17,Illinois,72,Puerto Rico,43,Coamo Municipio,13,0,13
17,Illinois,72,Puerto Rico,47,Corozal Municipio,17,0,17
17,Illinois,72,Puerto Rico,54,Florida Municipio,39,0,39
17,Illinois,72,Puerto Rico,55,Guánica Municipio,19,0,19
17,Illinois,72,Puerto Rico,57,Guayama Municipio,59,0,59
17,Illinois,72,Puerto Rico,61,Guaynabo Municipio,12,0,12
17,Illinois,72,Puerto Rico,75,Juana Díaz Municipio,0,5,-5
17,Illinois,72,Puerto Rico,81,Lares Municipio,81,0,81
17,Illinois,72,Puerto Rico,85,Las Piedras Municipio,8,0,8
17,Illinois,72,Puerto Rico,89,Luquillo Municipio,13,0,13
17,Illinois,72,Puerto Rico,95,Maunabo Municipio,45,0,45
17,Illinois,72,Puerto Rico,97,Mayagüez Municipio,41,0,41
17,Illinois,72,Puerto Rico,99,Moca Municipio,30,0,30
17,Illinois,72,Puerto Rico,109,Patillas Municipio,0,124,-124
17,Illinois,72,Puerto Rico,113,Ponce Municipio,16,0,16
17,Illinois,72,Puerto Rico,127,San Juan Municipio,356,4,352
17,Illinois,72,Puerto Rico,129,San Lorenzo Municipio,19,16,3
17,Illinois,72,Puerto Rico,137,Toa Baja Municipio,19,0,19
17,Illinois,72,Puerto Rico,139,Trujillo Alto Municipio,0,59,-59
17,Illinois,72,Puerto Rico,145,Vega Baja Municipio,128,0,128
17,Illinois,72,Puerto Rico,149,Villalba Municipio,29,0,29
17,Illinois,72,Puerto Rico,153,Yauco Municipio,37,0,37
17,Illinois,8,Colorado,1,Adams County,139,247,-108
17,Illinois,8,Colorado,3,Alamosa County,15,0,15
17,Illinois,8,Colorado,5,Arapahoe County,501,1089,-588
17,Illinois,8,Colorado,7,Archuleta County,11,0,11
17,Illinois,8,Colorado,13,Boulder County,195,770,-575
17,Illinois,8,Colorado,14,Broomfield County,11,128,-117
17,Illinois,8,Colorado,15,Chaffee County,3,35,-32
17,Illinois,8,Colorado,19,Clear Creek County,0,61,-61
17,Illinois,8,Colorado,31,Denver County,914,1536,-622
17,Illinois,8,Colorado,35,Douglas County,113,589,-476
17,Illinois,8,Colorado,37,Eagle County,145,76,69
17,Illinois,8,Colorado,39,Elbert County,4,0,4
17,Illinois,8,Colorado,41,El Paso County,652,1442,-790
17,Illinois,8,Colorado,43,Fremont County,15,11,4
17,Illinois,8,Colorado,45,Garfield County,32,1,31
17,Illinois,8,Colorado,47,Gilpin County,0,85,-85
17,Illinois,8,Colorado,49,Grand County,11,30,-19
17,Illinois,8,Colorado,55,Huerfano County,0,4,-4
17,Illinois,8,Colorado,59,Jefferson County,231,1058,-827
17,Illinois,8,Colorado,63,Kit Carson County,0,17,-17
17,Illinois,8,Colorado,65,Lake County,51,0,51
17,Illinois,8,Colorado,67,La Plata County,0,46,-46
17,Illinois,8,Colorado,69,Larimer County,327,986,-659
17,Illinois,8,Colorado,77,Mesa County,113,196,-83
17,Illinois,8,Colorado,81,Moffat County,28,0,28
17,Illinois,8,Colorado,83,Montezuma County,68,0,68
17,Illinois,8,Colorado,85,Montrose County,0,63,-63
17,Illinois,8,Colorado,87,Morgan County,12,49,-37
17,Illinois,8,Colorado,89,Otero County,0,6,-6
17,Illinois,8,Colorado,93,Park County,0,40,-40
17,Illinois,8,Colorado,97,Pitkin County,0,18,-18
17,Illinois,8,Colorado,101,Pueblo County,39,190,-151
17,Illinois,8,Colorado,103,Rio Blanco County,0,4,-4
17,Illinois,8,Colorado,107,Routt County,7,36,-29
17,Illinois,8,Colorado,109,Saguache County,22,0,22
17,Illinois,8,Colorado,113,San Miguel County,0,78,-78
17,Illinois,8,Colorado,115,Sedgwick County,0,10,-10
17,Illinois,8,Colorado,117,Summit County,0,9,-9
17,Illinois,8,Colorado,119,Teller County,18,280,-262
17,Illinois,8,Colorado,123,Weld County,122,302,-180
17,Illinois,9,Connecticut,1,Fairfield County,784,592,192
17,Illinois,9,Connecticut,3,Hartford County,301,229,72
17,Illinois,9,Connecticut,5,Litchfield County,29,27,2
17,Illinois,9,Connecticut,7,Middlesex County,0,86,-86
17,Illinois,9,Connecticut,9,New Haven County,212,509,-297
17,Illinois,9,Connecticut,11,New London County,179,111,68
17,Illinois,9,Connecticut,13,Tolland County,72,63,9
17,Illinois,9,Connecticut,15,Windham County,6,0,6
17,Illinois,AFR,Africa,,-,6115,0,0
17,Illinois,ASI,Asia,,-,33385,0,0
17,Illinois,CAM,Central America,,-,6716,0,0
17,Illinois,CAR,Caribbean,,-,1026,0,0
17,Illinois,EUR,Europe,,-,13029,0,0
17,Illinois,ISL,U.S. Island Areas,,-,294,0,0
17,Illinois,NAM,Northern America,,-,2095,0,0
17,Illinois,OCE,Oceania and At Sea,,-,481,0,0
17,Illinois,SAM,South America,,-,3684,0,0
18,Indiana,1,Alabama,1,Autauga County,60,8,52
18,Indiana,1,Alabama,3,Baldwin County,106,225,-119
18,Indiana,1,Alabama,7,Bibb County,24,0,24
18,Indiana,1,Alabama,15,Calhoun County,105,22,83
18,Indiana,1,Alabama,17,Chambers County,59,0,59
18,Indiana,1,Alabama,19,Cherokee County,5,3,2
18,Indiana,1,Alabama,21,Chilton County,11,0,11
18,Indiana,1,Alabama,33,Colbert County,6,0,6
18,Indiana,1,Alabama,39,Covington County,0,20,-20
18,Indiana,1,Alabama,41,Crenshaw County,14,0,14
18,Indiana,1,Alabama,43,Cullman County,6,11,-5
18,Indiana,1,Alabama,45,Dale County,0,10,-10
18,Indiana,1,Alabama,49,DeKalb County,51,45,6
18,Indiana,1,Alabama,51,Elmore County,63,28,35
18,Indiana,1,Alabama,53,Escambia County,0,12,-12
18,Indiana,1,Alabama,55,Etowah County,24,24,0
18,Indiana,1,Alabama,57,Fayette County,0,7,-7
18,Indiana,1,Alabama,59,Franklin County,0,40,-40
18,Indiana,1,Alabama,61,Geneva County,28,0,28
18,Indiana,1,Alabama,69,Houston County,13,18,-5
18,Indiana,1,Alabama,71,Jackson County,0,3,-3
18,Indiana,1,Alabama,73,Jefferson County,163,301,-138
18,Indiana,1,Alabama,77,Lauderdale County,2,6,-4
18,Indiana,1,Alabama,79,Lawrence County,0,3,-3
18,Indiana,1,Alabama,81,Lee County,78,84,-6
18,Indiana,1,Alabama,83,Limestone County,0,16,-16
18,Indiana,1,Alabama,89,Madison County,119,176,-57
18,Indiana,1,Alabama,95,Marshall County,56,6,50
18,Indiana,1,Alabama,97,Mobile County,147,67,80
18,Indiana,1,Alabama,101,Montgomery County,100,90,10
18,Indiana,1,Alabama,111,Randolph County,4,0,4
18,Indiana,1,Alabama,113,Russell County,11,0,11
18,Indiana,1,Alabama,115,St. Clair County,14,0,14
18,Indiana,1,Alabama,117,Shelby County,53,240,-187
18,Indiana,1,Alabama,125,Tuscaloosa County,40,86,-46
18,Indiana,1,Alabama,127,Walker County,0,41,-41
18,Indiana,10,Delaware,1,Kent County,53,0,53
18,Indiana,10,Delaware,3,New Castle County,64,47,17
18,Indiana,10,Delaware,5,Sussex County,9,5,4
18,Indiana,11,District of Columbia,1,District of Columbia,403,569,-166
18,Indiana,12,Florida,1,Alachua County,100,34,66
18,Indiana,12,Florida,5,Bay County,277,185,92
18,Indiana,12,Florida,7,Bradford County,4,0,4
18,Indiana,12,Florida,9,Brevard County,314,159,155
18,Indiana,12,Florida,11,Broward County,427,402,25
18,Indiana,12,Florida,15,Charlotte County,202,363,-161
18,Indiana,12,Florida,17,Citrus County,224,298,-74
18,Indiana,12,Florida,19,Clay County,92,7,85
18,Indiana,12,Florida,21,Collier County,169,201,-32
18,Indiana,12,Florida,23,Columbia County,22,19,3
18,Indiana,12,Florida,27,DeSoto County,0,44,-44
18,Indiana,12,Florida,29,Dixie County,25,23,2
18,Indiana,12,Florida,31,Duval County,337,426,-89
18,Indiana,12,Florida,33,Escambia County,102,317,-215
18,Indiana,12,Florida,35,Flagler County,142,0,142
18,Indiana,12,Florida,39,Gadsden County,0,62,-62
18,Indiana,12,Florida,41,Gilchrist County,0,1,-1
18,Indiana,12,Florida,43,Glades County,0,20,-20
18,Indiana,12,Florida,45,Gulf County,0,23,-23
18,Indiana,12,Florida,49,Hardee County,0,28,-28
18,Indiana,12,Florida,51,Hendry County,0,28,-28
18,Indiana,12,Florida,53,Hernando County,144,151,-7
18,Indiana,12,Florida,55,Highlands County,55,274,-219
18,Indiana,12,Florida,57,Hillsborough County,464,779,-315
18,Indiana,12,Florida,59,Holmes County,0,27,-27
18,Indiana,12,Florida,61,Indian River County,0,53,-53
18,Indiana,12,Florida,63,Jackson County,197,5,192
18,Indiana,12,Florida,69,Lake County,181,192,-11
18,Indiana,12,Florida,71,Lee County,317,1201,-884
18,Indiana,12,Florida,73,Leon County,175,124,51
18,Indiana,12,Florida,75,Levy County,0,39,-39
18,Indiana,12,Florida,81,Manatee County,333,371,-38
18,Indiana,12,Florida,83,Marion County,220,192,28
18,Indiana,12,Florida,85,Martin County,45,67,-22
18,Indiana,12,Florida,86,Miami-Dade County,619,183,436
18,Indiana,12,Florida,87,Monroe County,23,9,14
18,Indiana,12,Florida,89,Nassau County,0,156,-156
18,Indiana,12,Florida,91,Okaloosa County,90,109,-19
18,Indiana,12,Florida,93,Okeechobee County,20,0,20
18,Indiana,12,Florida,95,Orange County,603,998,-395
18,Indiana,12,Florida,97,Osceola County,105,168,-63
18,Indiana,12,Florida,99,Palm Beach County,408,518,-110
18,Indiana,12,Florida,101,Pasco County,543,606,-63
18,Indiana,12,Florida,103,Pinellas County,407,1260,-853
18,Indiana,12,Florida,105,Polk County,180,708,-528
18,Indiana,12,Florida,107,Putnam County,0,137,-137
18,Indiana,12,Florida,109,St. Johns County,12,83,-71
18,Indiana,12,Florida,111,St. Lucie County,48,283,-235
18,Indiana,12,Florida,113,Santa Rosa County,55,210,-155
18,Indiana,12,Florida,115,Sarasota County,431,418,13
18,Indiana,12,Florida,117,Seminole County,229,98,131
18,Indiana,12,Florida,119,Sumter County,15,464,-449
18,Indiana,12,Florida,121,Suwannee County,13,0,13
18,Indiana,12,Florida,125,Union County,25,0,25
18,Indiana,12,Florida,127,Volusia County,258,332,-74
18,Indiana,12,Florida,129,Wakulla County,0,17,-17
18,Indiana,13,Georgia,9,Baldwin County,0,6,-6
18,Indiana,13,Georgia,13,Barrow County,113,0,113
18,Indiana,13,Georgia,15,Bartow County,0,17,-17
18,Indiana,13,Georgia,21,Bibb County,9,33,-24
18,Indiana,13,Georgia,31,Bulloch County,0,10,-10
18,Indiana,13,Georgia,33,Burke County,84,0,84
18,Indiana,13,Georgia,37,Calhoun County,22,0,22
18,Indiana,13,Georgia,39,Camden County,0,7,-7
18,Indiana,13,Georgia,45,Carroll County,162,67,95
18,Indiana,13,Georgia,47,Catoosa County,29,0,29
18,Indiana,13,Georgia,49,Charlton County,0,20,-20
18,Indiana,13,Georgia,51,Chatham County,35,181,-146
18,Indiana,13,Georgia,53,Chattahoochee County,0,37,-37
18,Indiana,13,Georgia,55,Chattooga County,39,0,39
18,Indiana,13,Georgia,57,Cherokee County,59,0,59
18,Indiana,13,Georgia,59,Clarke County,20,43,-23
18,Indiana,13,Georgia,63,Clayton County,29,23,6
18,Indiana,13,Georgia,67,Cobb County,155,306,-151
18,Indiana,13,Georgia,69,Coffee County,0,4,-4
18,Indiana,13,Georgia,73,Columbia County,95,75,20
18,Indiana,13,Georgia,77,Coweta County,17,29,-12
18,Indiana,13,Georgia,79,Crawford County,0,26,-26
18,Indiana,13,Georgia,81,Crisp County,48,0,48
18,Indiana,13,Georgia,85,Dawson County,16,0,16
18,Indiana,13,Georgia,89,DeKalb County,251,339,-88
18,Indiana,13,Georgia,95,Dougherty County,79,0,79
18,Indiana,13,Georgia,97,Douglas County,54,9,45
18,Indiana,13,Georgia,105,Elbert County,0,19,-19
18,Indiana,13,Georgia,113,Fayette County,93,38,55
18,Indiana,13,Georgia,115,Floyd County,81,0,81
18,Indiana,13,Georgia,117,Forsyth County,101,86,15
18,Indiana,13,Georgia,121,Fulton County,508,593,-85
18,Indiana,13,Georgia,127,Glynn County,191,39,152
18,Indiana,13,Georgia,135,Gwinnett County,452,388,64
18,Indiana,13,Georgia,137,Habersham County,0,21,-21
18,Indiana,13,Georgia,139,Hall County,89,58,31
18,Indiana,13,Georgia,143,Haralson County,11,0,11
18,Indiana,13,Georgia,145,Harris County,0,17,-17
18,Indiana,13,Georgia,151,Henry County,127,17,110
18,Indiana,13,Georgia,153,Houston County,47,20,27
18,Indiana,13,Georgia,157,Jackson County,52,0,52
18,Indiana,13,Georgia,179,Liberty County,38,70,-32
18,Indiana,13,Georgia,181,Lincoln County,0,8,-8
18,Indiana,13,Georgia,183,Long County,0,99,-99
18,Indiana,13,Georgia,185,Lowndes County,62,22,40
18,Indiana,13,Georgia,191,McIntosh County,34,0,34
18,Indiana,13,Georgia,209,Montgomery County,19,2,17
18,Indiana,13,Georgia,215,Muscogee County,78,161,-83
18,Indiana,13,Georgia,217,Newton County,26,1,25
18,Indiana,13,Georgia,219,Oconee County,0,25,-25
18,Indiana,13,Georgia,223,Paulding County,79,25,54
18,Indiana,13,Georgia,225,Peach County,0,23,-23
18,Indiana,13,Georgia,229,Pierce County,6,0,6
18,Indiana,13,Georgia,239,Quitman County,0,7,-7
18,Indiana,13,Georgia,245,Richmond County,146,97,49
18,Indiana,13,Georgia,247,Rockdale County,71,26,45
18,Indiana,13,Georgia,271,Telfair County,0,1,-1
18,Indiana,13,Georgia,273,Terrell County,6,0,6
18,Indiana,13,Georgia,275,Thomas County,0,18,-18
18,Indiana,13,Georgia,277,Tift County,44,0,44
18,Indiana,13,Georgia,279,Toombs County,0,4,-4
18,Indiana,13,Georgia,281,Towns County,0,4,-4
18,Indiana,13,Georgia,285,Troup County,0,38,-38
18,Indiana,13,Georgia,293,Upson County,10,0,10
18,Indiana,13,Georgia,305,Wayne County,14,0,14
18,Indiana,13,Georgia,313,Whitfield County,1,363,-362
18,Indiana,15,Hawaii,1,Hawaii County,107,65,42
18,Indiana,15,Hawaii,3,Honolulu County,683,441,242
18,Indiana,15,Hawaii,7,Kauai County,0,34,-34
18,Indiana,15,Hawaii,9,Maui County,8,130,-122
18,Indiana,16,Idaho,1,Ada County,55,50,5
18,Indiana,16,Idaho,9,Benewah County,7,0,7
18,Indiana,16,Idaho,15,Boise County,0,11,-11
18,Indiana,16,Idaho,19,Bonneville County,15,17,-2
18,Indiana,16,Idaho,27,Canyon County,21,0,21
18,Indiana,16,Idaho,31,Cassia County,0,12,-12
18,Indiana,16,Idaho,35,Clearwater County,0,2,-2
18,Indiana,16,Idaho,39,Elmore County,7,0,7
18,Indiana,16,Idaho,41,Franklin County,33,0,33
18,Indiana,16,Idaho,51,Jefferson County,10,0,10
18,Indiana,16,Idaho,59,Lemhi County,9,0,9
18,Indiana,16,Idaho,65,Madison County,124,16,108
18,Indiana,16,Idaho,69,Nez Perce County,0,18,-18
18,Indiana,16,Idaho,77,Power County,15,0,15
18,Indiana,16,Idaho,81,Teton County,9,0,9
18,Indiana,16,Idaho,83,Twin Falls County,70,0,70
18,Indiana,17,Illinois,1,Adams County,119,80,39
18,Indiana,17,Illinois,5,Bond County,47,0,47
18,Indiana,17,Illinois,7,Boone County,54,17,37
18,Indiana,17,Illinois,11,Bureau County,17,8,9
18,Indiana,17,Illinois,15,Carroll County,0,4,-4
18,Indiana,17,Illinois,17,Cass County,0,31,-31
18,Indiana,17,Illinois,19,Champaign County,491,346,145
18,Indiana,17,Illinois,21,Christian County,8,132,-124
18,Indiana,17,Illinois,23,Clark County,306,170,136
18,Indiana,17,Illinois,25,Clay County,118,43,75
18,Indiana,17,Illinois,27,Clinton County,57,6,51
18,Indiana,17,Illinois,29,Coles County,124,128,-4
18,Indiana,17,Illinois,31,Cook County,17560,7780,9780
18,Indiana,17,Illinois,33,Crawford County,146,157,-11
18,Indiana,17,Illinois,35,Cumberland County,24,0,24
18,Indiana,17,Illinois,37,DeKalb County,45,189,-144
18,Indiana,17,Illinois,39,De Witt County,101,2,99
18,Indiana,17,Illinois,41,Douglas County,19,58,-39
18,Indiana,17,Illinois,43,DuPage County,2027,818,1209
18,Indiana,17,Illinois,45,Edgar County,264,250,14
18,Indiana,17,Illinois,47,Edwards County,121,16,105
18,Indiana,17,Illinois,49,Effingham County,79,65,14
18,Indiana,17,Illinois,51,Fayette County,5,17,-12
18,Indiana,17,Illinois,53,Ford County,35,0,35
18,Indiana,17,Illinois,55,Franklin County,92,56,36
18,Indiana,17,Illinois,57,Fulton County,0,3,-3
18,Indiana,17,Illinois,59,Gallatin County,0,7,-7
18,Indiana,17,Illinois,63,Grundy County,3,52,-49
18,Indiana,17,Illinois,65,Hamilton County,59,14,45
18,Indiana,17,Illinois,67,Hancock County,13,4,9
18,Indiana,17,Illinois,69,Hardin County,14,0,14
18,Indiana,17,Illinois,73,Henry County,86,32,54
18,Indiana,17,Illinois,75,Iroquois County,158,77,81
18,Indiana,17,Illinois,77,Jackson County,129,218,-89
18,Indiana,17,Illinois,79,Jasper County,44,23,21
18,Indiana,17,Illinois,81,Jefferson County,12,69,-57
18,Indiana,17,Illinois,83,Jersey County,0,34,-34
18,Indiana,17,Illinois,85,Jo Daviess County,49,4,45
18,Indiana,17,Illinois,87,Johnson County,0,16,-16
18,Indiana,17,Illinois,89,Kane County,575,341,234
18,Indiana,17,Illinois,91,Kankakee County,612,361,251
18,Indiana,17,Illinois,93,Kendall County,210,97,113
18,Indiana,17,Illinois,95,Knox County,28,0,28
18,Indiana,17,Illinois,97,Lake County,1265,609,656
18,Indiana,17,Illinois,99,LaSalle County,207,53,154
18,Indiana,17,Illinois,101,Lawrence County,190,171,19
18,Indiana,17,Illinois,103,Lee County,22,20,2
18,Indiana,17,Illinois,105,Livingston County,7,0,7
18,Indiana,17,Illinois,107,Logan County,11,23,-12
18,Indiana,17,Illinois,109,McDonough County,140,23,117
18,Indiana,17,Illinois,111,McHenry County,264,263,1
18,Indiana,17,Illinois,113,McLean County,294,206,88
18,Indiana,17,Illinois,115,Macon County,116,153,-37
18,Indiana,17,Illinois,117,Macoupin County,13,133,-120
18,Indiana,17,Illinois,119,Madison County,149,117,32
18,Indiana,17,Illinois,121,Marion County,205,0,205
18,Indiana,17,Illinois,123,Marshall County,23,19,4
18,Indiana,17,Illinois,133,Monroe County,17,41,-24
18,Indiana,17,Illinois,135,Montgomery County,240,6,234
18,Indiana,17,Illinois,137,Morgan County,142,13,129
18,Indiana,17,Illinois,139,Moultrie County,0,6,-6
18,Indiana,17,Illinois,141,Ogle County,21,36,-15
18,Indiana,17,Illinois,143,Peoria County,703,229,474
18,Indiana,17,Illinois,145,Perry County,17,0,17
18,Indiana,17,Illinois,147,Piatt County,31,33,-2
18,Indiana,17,Illinois,155,Putnam County,6,1,5
18,Indiana,17,Illinois,157,Randolph County,48,0,48
18,Indiana,17,Illinois,159,Richland County,158,46,112
18,Indiana,17,Illinois,161,Rock Island County,78,66,12
18,Indiana,17,Illinois,163,St. Clair County,276,232,44
18,Indiana,17,Illinois,165,Saline County,36,63,-27
18,Indiana,17,Illinois,167,Sangamon County,407,115,292
18,Indiana,17,Illinois,173,Shelby County,6,14,-8
18,Indiana,17,Illinois,175,Stark County,0,5,-5
18,Indiana,17,Illinois,177,Stephenson County,7,0,7
18,Indiana,17,Illinois,179,Tazewell County,114,38,76
18,Indiana,17,Illinois,183,Vermilion County,266,385,-119
18,Indiana,17,Illinois,185,Wabash County,290,217,73
18,Indiana,17,Illinois,189,Washington County,6,22,-16
18,Indiana,17,Illinois,191,Wayne County,53,28,25
18,Indiana,17,Illinois,193,White County,50,47,3
18,Indiana,17,Illinois,195,Whiteside County,44,0,44
18,Indiana,17,Illinois,197,Will County,2123,767,1356
18,Indiana,17,Illinois,199,Williamson County,162,39,123
18,Indiana,17,Illinois,201,Winnebago County,56,135,-79
18,Indiana,17,Illinois,203,Woodford County,3,5,-2
18,Indiana,18,Indiana,1,Adams County,1645,669,976
18,Indiana,18,Indiana,3,Allen County,8982,6907,2075
18,Indiana,18,Indiana,5,Bartholomew County,2906,2530,376
18,Indiana,18,Indiana,7,Benton County,632,730,-98
18,Indiana,18,Indiana,9,Blackford County,425,394,31
18,Indiana,18,Indiana,11,Boone County,2897,3521,-624
18,Indiana,18,Indiana,13,Brown County,764,768,-4
18,Indiana,18,Indiana,15,Carroll County,1318,969,349
18,Indiana,18,Indiana,17,Cass County,1932,1466,466
18,Indiana,18,Indiana,19,Clark County,2894,3429,-535
18,Indiana,18,Indiana,21,Clay County,1149,929,220
18,Indiana,18,Indiana,23,Clinton County,1770,860,910
18,Indiana,18,Indiana,25,Crawford County,245,240,5
18,Indiana,18,Indiana,27,Daviess County,1202,857,345
18,Indiana,18,Indiana,29,Dearborn County,1171,832,339
18,Indiana,18,Indiana,31,Decatur County,982,879,103
18,Indiana,18,Indiana,33,DeKalb County,2063,1370,693
18,Indiana,18,Indiana,35,Delaware County,4904,8456,-3552
18,Indiana,18,Indiana,37,Dubois County,1345,874,471
18,Indiana,18,Indiana,39,Elkhart County,5898,4312,1586
18,Indiana,18,Indiana,41,Fayette County,823,639,184
18,Indiana,18,Indiana,43,Floyd County,3005,2354,651
18,Indiana,18,Indiana,45,Fountain County,968,785,183
18,Indiana,18,Indiana,47,Franklin County,831,689,142
18,Indiana,18,Indiana,49,Fulton County,1357,942,415
18,Indiana,18,Indiana,51,Gibson County,963,935,28
18,Indiana,18,Indiana,53,Grant County,2204,1675,529
18,Indiana,18,Indiana,55,Greene County,1656,1285,371
18,Indiana,18,Indiana,57,Hamilton County,10989,12974,-1985
18,Indiana,18,Indiana,59,Hancock County,3534,3284,250
18,Indiana,18,Indiana,61,Harrison County,883,960,-77
18,Indiana,18,Indiana,63,Hendricks County,8265,9098,-833
18,Indiana,18,Indiana,65,Henry County,1980,2492,-512
18,Indiana,18,Indiana,67,Howard County,3636,3129,507
18,Indiana,18,Indiana,69,Huntington County,1215,1234,-19
18,Indiana,18,Indiana,71,Jackson County,1790,1136,654
18,Indiana,18,Indiana,73,Jasper County,1413,1470,-57
18,Indiana,18,Indiana,75,Jay County,623,521,102
18,Indiana,18,Indiana,77,Jefferson County,1668,1620,48
18,Indiana,18,Indiana,79,Jennings County,1068,1172,-104
18,Indiana,18,Indiana,81,Johnson County,7177,8467,-1290
18,Indiana,18,Indiana,83,Knox County,1501,2414,-913
18,Indiana,18,Indiana,85,Kosciusko County,3387,3596,-209
18,Indiana,18,Indiana,87,LaGrange County,1135,1212,-77
18,Indiana,18,Indiana,89,Lake County,9976,5438,4538
18,Indiana,18,Indiana,91,LaPorte County,3774,5779,-2005
18,Indiana,18,Indiana,93,Lawrence County,1593,1334,259
18,Indiana,18,Indiana,95,Madison County,5279,5297,-18
18,Indiana,18,Indiana,97,Marion County,34521,26028,8493
18,Indiana,18,Indiana,99,Marshall County,1874,1588,286
18,Indiana,18,Indiana,101,Martin County,502,342,160
18,Indiana,18,Indiana,103,Miami County,1823,2695,-872
18,Indiana,18,Indiana,105,Monroe County,5833,12001,-6168
18,Indiana,18,Indiana,107,Montgomery County,1546,1614,-68
18,Indiana,18,Indiana,109,Morgan County,3836,4699,-863
18,Indiana,18,Indiana,111,Newton County,731,752,-21
18,Indiana,18,Indiana,113,Noble County,2429,2328,101
18,Indiana,18,Indiana,115,Ohio County,406,232,174
18,Indiana,18,Indiana,117,Orange County,482,690,-208
18,Indiana,18,Indiana,119,Owen County,1515,1402,113
18,Indiana,18,Indiana,121,Parke County,787,1316,-529
18,Indiana,18,Indiana,123,Perry County,533,812,-279
18,Indiana,18,Indiana,125,Pike County,644,390,254
18,Indiana,18,Indiana,127,Porter County,5801,5435,366
18,Indiana,18,Indiana,129,Posey County,853,740,113
18,Indiana,18,Indiana,131,Pulaski County,815,752,63
18,Indiana,18,Indiana,133,Putnam County,2471,2922,-451
18,Indiana,18,Indiana,135,Randolph County,1330,415,915
18,Indiana,18,Indiana,137,Ripley County,1098,890,208
18,Indiana,18,Indiana,139,Rush County,554,720,-166
18,Indiana,18,Indiana,141,St. Joseph County,5949,5537,412
18,Indiana,18,Indiana,143,Scott County,849,884,-35
18,Indiana,18,Indiana,145,Shelby County,2291,1581,710
18,Indiana,18,Indiana,147,Spencer County,820,479,341
18,Indiana,18,Indiana,149,Starke County,761,820,-59
18,Indiana,18,Indiana,151,Steuben County,1188,1360,-172
18,Indiana,18,Indiana,153,Sullivan County,1049,1189,-140
18,Indiana,18,Indiana,155,Switzerland County,290,410,-120
18,Indiana,18,Indiana,157,Tippecanoe County,5488,11021,-5533
18,Indiana,18,Indiana,159,Tipton County,725,903,-178
18,Indiana,18,Indiana,161,Union County,388,146,242
18,Indiana,18,Indiana,163,Vanderburgh County,5044,5505,-461
18,Indiana,18,Indiana,165,Vermillion County,670,373,297
18,Indiana,18,Indiana,167,Vigo County,3368,5939,-2571
18,Indiana,18,Indiana,169,Wabash County,1689,1338,351
18,Indiana,18,Indiana,171,Warren County,595,328,267
18,Indiana,18,Indiana,173,Warrick County,2534,2606,-72
18,Indiana,18,Indiana,175,Washington County,1022,787,235
18,Indiana,18,Indiana,177,Wayne County,1286,1714,-428
18,Indiana,18,Indiana,179,Wells County,1025,1092,-67
18,Indiana,18,Indiana,181,White County,1725,1162,563
18,Indiana,18,Indiana,183,Whitley County,1510,1607,-97
18,Indiana,19,Iowa,3,Adams County,0,2,-2
18,Indiana,19,Iowa,13,Black Hawk County,160,103,57
18,Indiana,19,Iowa,15,Boone County,7,20,-13
18,Indiana,19,Iowa,17,Bremer County,21,40,-19
18,Indiana,19,Iowa,19,Buchanan County,0,3,-3
18,Indiana,19,Iowa,21,Buena Vista County,0,43,-43
18,Indiana,19,Iowa,29,Cass County,0,27,-27
18,Indiana,19,Iowa,31,Cedar County,0,19,-19
18,Indiana,19,Iowa,33,Cerro Gordo County,21,5,16
18,Indiana,19,Iowa,35,Cherokee County,0,3,-3
18,Indiana,19,Iowa,37,Chickasaw County,12,0,12
18,Indiana,19,Iowa,39,Clarke County,0,1,-1
18,Indiana,19,Iowa,41,Clay County,0,11,-11
18,Indiana,19,Iowa,43,Clayton County,0,1,-1
18,Indiana,19,Iowa,45,Clinton County,82,7,75
18,Indiana,19,Iowa,47,Crawford County,3,0,3
18,Indiana,19,Iowa,49,Dallas County,66,117,-51
18,Indiana,19,Iowa,57,Des Moines County,33,0,33
18,Indiana,19,Iowa,61,Dubuque County,76,43,33
18,Indiana,19,Iowa,63,Emmet County,0,11,-11
18,Indiana,19,Iowa,65,Fayette County,0,9,-9
18,Indiana,19,Iowa,67,Floyd County,0,34,-34
18,Indiana,19,Iowa,69,Franklin County,0,33,-33
18,Indiana,19,Iowa,71,Fremont County,7,2,5
18,Indiana,19,Iowa,73,Greene County,0,5,-5
18,Indiana,19,Iowa,75,Grundy County,0,1,-1
18,Indiana,19,Iowa,77,Guthrie County,89,1,88
18,Indiana,19,Iowa,79,Hamilton County,46,30,16
18,Indiana,19,Iowa,81,Hancock County,0,18,-18
18,Indiana,19,Iowa,83,Hardin County,0,6,-6
18,Indiana,19,Iowa,85,Harrison County,0,2,-2
18,Indiana,19,Iowa,87,Henry County,0,2,-2
18,Indiana,19,Iowa,89,Howard County,0,1,-1
18,Indiana,19,Iowa,91,Humboldt County,0,4,-4
18,Indiana,19,Iowa,95,Iowa County,0,32,-32
18,Indiana,19,Iowa,99,Jasper County,0,6,-6
18,Indiana,19,Iowa,101,Jefferson County,30,7,23
18,Indiana,19,Iowa,103,Johnson County,231,270,-39
18,Indiana,19,Iowa,105,Jones County,0,1,-1
18,Indiana,19,Iowa,111,Lee County,28,0,28
18,Indiana,19,Iowa,113,Linn County,103,254,-151
18,Indiana,19,Iowa,119,Lyon County,0,4,-4
18,Indiana,19,Iowa,121,Madison County,30,0,30
18,Indiana,19,Iowa,123,Mahaska County,6,7,-1
18,Indiana,19,Iowa,125,Marion County,59,1,58
18,Indiana,19,Iowa,127,Marshall County,0,43,-43
18,Indiana,19,Iowa,129,Mills County,0,4,-4
18,Indiana,19,Iowa,135,Monroe County,0,2,-2
18,Indiana,19,Iowa,137,Montgomery County,0,22,-22
18,Indiana,19,Iowa,139,Muscatine County,0,10,-10
18,Indiana,19,Iowa,145,Page County,0,1,-1
18,Indiana,19,Iowa,151,Pocahontas County,0,5,-5
18,Indiana,19,Iowa,153,Polk County,117,348,-231
18,Indiana,19,Iowa,155,Pottawattamie County,0,5,-5
18,Indiana,19,Iowa,161,Sac County,0,10,-10
18,Indiana,19,Iowa,163,Scott County,106,208,-102
18,Indiana,19,Iowa,165,Shelby County,0,1,-1
18,Indiana,19,Iowa,167,Sioux County,0,45,-45
18,Indiana,19,Iowa,169,Story County,91,66,25
18,Indiana,19,Iowa,177,Van Buren County,0,18,-18
18,Indiana,19,Iowa,179,Wapello County,85,1,84
18,Indiana,19,Iowa,181,Warren County,0,3,-3
18,Indiana,19,Iowa,183,Washington County,10,58,-48
18,Indiana,19,Iowa,187,Webster County,0,5,-5
18,Indiana,19,Iowa,191,Winneshiek County,13,3,10
18,Indiana,19,Iowa,193,Woodbury County,39,38,1
18,Indiana,19,Iowa,195,Worth County,0,2,-2
18,Indiana,2,Alaska,16,Aleutians West Census Area,8,1,7
18,Indiana,2,Alaska,20,Anchorage Municipality,137,146,-9
18,Indiana,2,Alaska,50,Bethel Census Area,0,8,-8
18,Indiana,2,Alaska,100,Haines Borough,28,0,28
18,Indiana,2,Alaska,130,Ketchikan Gateway Borough,31,12,19
18,Indiana,2,Alaska,170,Matanuska-Susitna Borough,108,48,60
18,Indiana,2,Alaska,198,Prince of Wales-Hyder Census Area,0,3,-3
18,Indiana,2,Alaska,220,Sitka City and Borough,2,36,-34
18,Indiana,20,Kansas,3,Anderson County,0,3,-3
18,Indiana,20,Kansas,5,Atchison County,0,4,-4
18,Indiana,20,Kansas,13,Brown County,34,0,34
18,Indiana,20,Kansas,15,Butler County,0,2,-2
18,Indiana,20,Kansas,29,Cloud County,0,4,-4
18,Indiana,20,Kansas,31,Coffey County,17,0,17
18,Indiana,20,Kansas,35,Cowley County,0,9,-9
18,Indiana,20,Kansas,37,Crawford County,0,6,-6
18,Indiana,20,Kansas,41,Dickinson County,4,0,4
18,Indiana,20,Kansas,45,Douglas County,107,91,16
18,Indiana,20,Kansas,59,Franklin County,10,0,10
18,Indiana,20,Kansas,61,Geary County,80,23,57
18,Indiana,20,Kansas,65,Graham County,0,4,-4
18,Indiana,20,Kansas,79,Harvey County,35,34,1
18,Indiana,20,Kansas,87,Jefferson County,0,5,-5
18,Indiana,20,Kansas,91,Johnson County,213,221,-8
18,Indiana,20,Kansas,99,Labette County,0,2,-2
18,Indiana,20,Kansas,103,Leavenworth County,87,20,67
18,Indiana,20,Kansas,111,Lyon County,10,0,10
18,Indiana,20,Kansas,113,McPherson County,123,0,123
18,Indiana,20,Kansas,119,Meade County,18,0,18
18,Indiana,20,Kansas,121,Miami County,7,0,7
18,Indiana,20,Kansas,133,Neosho County,14,0,14
18,Indiana,20,Kansas,139,Osage County,10,42,-32
18,Indiana,20,Kansas,141,Osborne County,0,3,-3
18,Indiana,20,Kansas,155,Reno County,7,22,-15
18,Indiana,20,Kansas,159,Rice County,29,0,29
18,Indiana,20,Kansas,161,Riley County,133,54,79
18,Indiana,20,Kansas,173,Sedgwick County,146,120,26
18,Indiana,20,Kansas,177,Shawnee County,73,29,44
18,Indiana,20,Kansas,187,Stanton County,40,0,40
18,Indiana,20,Kansas,191,Sumner County,52,0,52
18,Indiana,20,Kansas,201,Washington County,0,2,-2
18,Indiana,20,Kansas,209,Wyandotte County,47,236,-189
18,Indiana,21,Kentucky,1,Adair County,0,12,-12
18,Indiana,21,Kentucky,3,Allen County,37,16,21
18,Indiana,21,Kentucky,9,Barren County,14,137,-123
18,Indiana,21,Kentucky,11,Bath County,5,0,5
18,Indiana,21,Kentucky,13,Bell County,21,29,-8
18,Indiana,21,Kentucky,15,Boone County,247,394,-147
18,Indiana,21,Kentucky,17,Bourbon County,15,18,-3
18,Indiana,21,Kentucky,19,Boyd County,54,80,-26
18,Indiana,21,Kentucky,21,Boyle County,51,10,41
18,Indiana,21,Kentucky,23,Bracken County,0,42,-42
18,Indiana,21,Kentucky,25,Breathitt County,0,53,-53
18,Indiana,21,Kentucky,27,Breckinridge County,122,104,18
18,Indiana,21,Kentucky,29,Bullitt County,73,51,22
18,Indiana,21,Kentucky,31,Butler County,75,7,68
18,Indiana,21,Kentucky,33,Caldwell County,0,3,-3
18,Indiana,21,Kentucky,35,Calloway County,45,190,-145
18,Indiana,21,Kentucky,37,Campbell County,238,183,55
18,Indiana,21,Kentucky,39,Carlisle County,48,0,48
18,Indiana,21,Kentucky,41,Carroll County,58,87,-29
18,Indiana,21,Kentucky,43,Carter County,35,12,23
18,Indiana,21,Kentucky,45,Casey County,0,36,-36
18,Indiana,21,Kentucky,47,Christian County,46,127,-81
18,Indiana,21,Kentucky,49,Clark County,150,57,93
18,Indiana,21,Kentucky,51,Clay County,0,30,-30
18,Indiana,21,Kentucky,53,Clinton County,16,0,16
18,Indiana,21,Kentucky,55,Crittenden County,0,5,-5
18,Indiana,21,Kentucky,57,Cumberland County,4,10,-6
18,Indiana,21,Kentucky,59,Daviess County,511,485,26
18,Indiana,21,Kentucky,61,Edmonson County,11,82,-71
18,Indiana,21,Kentucky,65,Estill County,9,0,9
18,Indiana,21,Kentucky,67,Fayette County,601,818,-217
18,Indiana,21,Kentucky,69,Fleming County,14,0,14
18,Indiana,21,Kentucky,71,Floyd County,44,6,38
18,Indiana,21,Kentucky,73,Franklin County,86,49,37
18,Indiana,21,Kentucky,77,Gallatin County,114,97,17
18,Indiana,21,Kentucky,79,Garrard County,23,0,23
18,Indiana,21,Kentucky,81,Grant County,0,405,-405
18,Indiana,21,Kentucky,83,Graves County,66,11,55
18,Indiana,21,Kentucky,85,Grayson County,80,13,67
18,Indiana,21,Kentucky,87,Green County,0,5,-5
18,Indiana,21,Kentucky,89,Greenup County,0,20,-20
18,Indiana,21,Kentucky,91,Hancock County,175,105,70
18,Indiana,21,Kentucky,93,Hardin County,302,629,-327
18,Indiana,21,Kentucky,95,Harlan County,0,21,-21
18,Indiana,21,Kentucky,99,Hart County,33,51,-18
18,Indiana,21,Kentucky,101,Henderson County,405,440,-35
18,Indiana,21,Kentucky,103,Henry County,38,17,21
18,Indiana,21,Kentucky,107,Hopkins County,89,67,22
18,Indiana,21,Kentucky,109,Jackson County,0,4,-4
18,Indiana,21,Kentucky,111,Jefferson County,3554,2932,622
18,Indiana,21,Kentucky,113,Jessamine County,52,15,37
18,Indiana,21,Kentucky,115,Johnson County,23,0,23
18,Indiana,21,Kentucky,117,Kenton County,326,394,-68
18,Indiana,21,Kentucky,119,Knott County,0,7,-7
18,Indiana,21,Kentucky,121,Knox County,0,21,-21
18,Indiana,21,Kentucky,123,Larue County,11,73,-62
18,Indiana,21,Kentucky,125,Laurel County,51,7,44
18,Indiana,21,Kentucky,129,Lee County,12,0,12
18,Indiana,21,Kentucky,131,Leslie County,26,0,26
18,Indiana,21,Kentucky,137,Lincoln County,28,24,4
18,Indiana,21,Kentucky,139,Livingston County,0,4,-4
18,Indiana,21,Kentucky,141,Logan County,0,21,-21
18,Indiana,21,Kentucky,143,Lyon County,42,4,38
18,Indiana,21,Kentucky,145,McCracken County,47,15,32
18,Indiana,21,Kentucky,149,McLean County,0,12,-12
18,Indiana,21,Kentucky,151,Madison County,98,59,39
18,Indiana,21,Kentucky,155,Marion County,128,0,128
18,Indiana,21,Kentucky,157,Marshall County,5,67,-62
18,Indiana,21,Kentucky,159,Martin County,0,7,-7
18,Indiana,21,Kentucky,163,Meade County,160,152,8
18,Indiana,21,Kentucky,167,Mercer County,0,20,-20
18,Indiana,21,Kentucky,169,Metcalfe County,76,35,41
18,Indiana,21,Kentucky,175,Morgan County,11,0,11
18,Indiana,21,Kentucky,177,Muhlenberg County,21,7,14
18,Indiana,21,Kentucky,179,Nelson County,16,71,-55
18,Indiana,21,Kentucky,183,Ohio County,15,305,-290
18,Indiana,21,Kentucky,185,Oldham County,106,192,-86
18,Indiana,21,Kentucky,187,Owen County,19,0,19
18,Indiana,21,Kentucky,191,Pendleton County,31,21,10
18,Indiana,21,Kentucky,193,Perry County,52,19,33
18,Indiana,21,Kentucky,195,Pike County,34,23,11
18,Indiana,21,Kentucky,197,Powell County,48,13,35
18,Indiana,21,Kentucky,199,Pulaski County,97,159,-62
18,Indiana,21,Kentucky,203,Rockcastle County,0,9,-9
18,Indiana,21,Kentucky,205,Rowan County,10,54,-44
18,Indiana,21,Kentucky,207,Russell County,50,0,50
18,Indiana,21,Kentucky,209,Scott County,36,25,11
18,Indiana,21,Kentucky,211,Shelby County,84,88,-4
18,Indiana,21,Kentucky,215,Spencer County,3,16,-13
18,Indiana,21,Kentucky,217,Taylor County,56,100,-44
18,Indiana,21,Kentucky,219,Todd County,3,119,-116
18,Indiana,21,Kentucky,221,Trigg County,0,24,-24
18,Indiana,21,Kentucky,223,Trimble County,236,80,156
18,Indiana,21,Kentucky,225,Union County,172,52,120
18,Indiana,21,Kentucky,227,Warren County,179,572,-393
18,Indiana,21,Kentucky,229,Washington County,0,25,-25
18,Indiana,21,Kentucky,231,Wayne County,44,111,-67
18,Indiana,21,Kentucky,233,Webster County,70,16,54
18,Indiana,21,Kentucky,235,Whitley County,21,28,-7
18,Indiana,21,Kentucky,237,Wolfe County,11,0,11
18,Indiana,21,Kentucky,239,Woodford County,13,21,-8
18,Indiana,22,Louisiana,3,Allen Parish,0,37,-37
18,Indiana,22,Louisiana,15,Bossier Parish,58,18,40
18,Indiana,22,Louisiana,17,Caddo Parish,122,14,108
18,Indiana,22,Louisiana,19,Calcasieu Parish,7,0,7
18,Indiana,22,Louisiana,29,Concordia Parish,68,0,68
18,Indiana,22,Louisiana,31,De Soto Parish,29,0,29
18,Indiana,22,Louisiana,33,East Baton Rouge Parish,23,140,-117
18,Indiana,22,Louisiana,39,Evangeline Parish,0,42,-42
18,Indiana,22,Louisiana,43,Grant Parish,35,0,35
18,Indiana,22,Louisiana,45,Iberia Parish,49,0,49
18,Indiana,22,Louisiana,51,Jefferson Parish,67,0,67
18,Indiana,22,Louisiana,55,Lafayette Parish,24,18,6
18,Indiana,22,Louisiana,57,Lafourche Parish,8,0,8
18,Indiana,22,Louisiana,59,LaSalle Parish,0,20,-20
18,Indiana,22,Louisiana,61,Lincoln Parish,0,18,-18
18,Indiana,22,Louisiana,63,Livingston Parish,26,22,4
18,Indiana,22,Louisiana,71,Orleans Parish,182,73,109
18,Indiana,22,Louisiana,73,Ouachita Parish,98,0,98
18,Indiana,22,Louisiana,79,Rapides Parish,0,16,-16
18,Indiana,22,Louisiana,89,St. Charles Parish,0,6,-6
18,Indiana,22,Louisiana,95,St. John the Baptist Parish,16,0,16
18,Indiana,22,Louisiana,103,St. Tammany Parish,19,18,1
18,Indiana,22,Louisiana,115,Vernon Parish,0,13,-13
18,Indiana,22,Louisiana,123,West Carroll Parish,0,5,-5
18,Indiana,23,Maine,1,Androscoggin County,57,29,28
18,Indiana,23,Maine,3,Aroostook County,0,11,-11
18,Indiana,23,Maine,5,Cumberland County,16,19,-3
18,Indiana,23,Maine,7,Franklin County,10,0,10
18,Indiana,23,Maine,9,Hancock County,0,27,-27
18,Indiana,23,Maine,15,Lincoln County,78,0,78
18,Indiana,23,Maine,19,Penobscot County,106,24,82
18,Indiana,23,Maine,29,Washington County,18,0,18
18,Indiana,23,Maine,31,York County,75,0,75
18,Indiana,24,Maryland,1,Allegany County,0,16,-16
18,Indiana,24,Maryland,3,Anne Arundel County,314,295,19
18,Indiana,24,Maryland,5,Baltimore County,188,147,41
18,Indiana,24,Maryland,9,Calvert County,15,0,15
18,Indiana,24,Maryland,13,Carroll County,19,12,7
18,Indiana,24,Maryland,15,Cecil County,36,8,28
18,Indiana,24,Maryland,21,Frederick County,31,28,3
18,Indiana,24,Maryland,23,Garrett County,9,1,8
18,Indiana,24,Maryland,25,Harford County,48,15,33
18,Indiana,24,Maryland,27,Howard County,56,119,-63
18,Indiana,24,Maryland,31,Montgomery County,157,480,-323
18,Indiana,24,Maryland,33,Prince George's County,205,92,113
18,Indiana,24,Maryland,37,St. Mary's County,22,47,-25
18,Indiana,24,Maryland,41,Talbot County,18,0,18
18,Indiana,24,Maryland,43,Washington County,18,0,18
18,Indiana,24,Maryland,45,Wicomico County,0,32,-32
18,Indiana,24,Maryland,47,Worcester County,0,1,-1
18,Indiana,24,Maryland,510,Baltimore city,52,144,-92
18,Indiana,25,Massachusetts,1,Barnstable County,2,0,2
18,Indiana,25,Massachusetts,3,Berkshire County,0,29,-29
18,Indiana,25,Massachusetts,5,Bristol County,19,104,-85
18,Indiana,25,Massachusetts,9,Essex County,56,87,-31
18,Indiana,25,Massachusetts,11,Franklin County,68,0,68
18,Indiana,25,Massachusetts,13,Hampden County,35,27,8
18,Indiana,25,Massachusetts,15,Hampshire County,17,44,-27
18,Indiana,25,Massachusetts,17,Middlesex County,257,281,-24
18,Indiana,25,Massachusetts,21,Norfolk County,245,39,206
18,Indiana,25,Massachusetts,23,Plymouth County,104,15,89
18,Indiana,25,Massachusetts,25,Suffolk County,167,159,8
18,Indiana,25,Massachusetts,27,Worcester County,11,197,-186
18,Indiana,26,Michigan,5,Allegan County,188,55,133
18,Indiana,26,Michigan,7,Alpena County,7,0,7
18,Indiana,26,Michigan,9,Antrim County,18,6,12
18,Indiana,26,Michigan,13,Baraga County,14,0,14
18,Indiana,26,Michigan,15,Barry County,50,29,21
18,Indiana,26,Michigan,17,Bay County,16,76,-60
18,Indiana,26,Michigan,19,Benzie County,0,74,-74
18,Indiana,26,Michigan,21,Berrien County,1255,1694,-439
18,Indiana,26,Michigan,23,Branch County,196,161,35
18,Indiana,26,Michigan,25,Calhoun County,324,289,35
18,Indiana,26,Michigan,27,Cass County,855,1154,-299
18,Indiana,26,Michigan,29,Charlevoix County,13,49,-36
18,Indiana,26,Michigan,31,Cheboygan County,0,19,-19
18,Indiana,26,Michigan,33,Chippewa County,24,16,8
18,Indiana,26,Michigan,37,Clinton County,21,67,-46
18,Indiana,26,Michigan,39,Crawford County,8,0,8
18,Indiana,26,Michigan,41,Delta County,26,6,20
18,Indiana,26,Michigan,43,Dickinson County,16,0,16
18,Indiana,26,Michigan,45,Eaton County,47,95,-48
18,Indiana,26,Michigan,47,Emmet County,0,96,-96
18,Indiana,26,Michigan,49,Genesee County,373,239,134
18,Indiana,26,Michigan,51,Gladwin County,25,4,21
18,Indiana,26,Michigan,53,Gogebic County,0,7,-7
18,Indiana,26,Michigan,55,Grand Traverse County,62,30,32
18,Indiana,26,Michigan,57,Gratiot County,38,13,25
18,Indiana,26,Michigan,59,Hillsdale County,126,212,-86
18,Indiana,26,Michigan,61,Houghton County,79,73,6
18,Indiana,26,Michigan,63,Huron County,12,8,4
18,Indiana,26,Michigan,65,Ingham County,442,209,233
18,Indiana,26,Michigan,67,Ionia County,19,27,-8
18,Indiana,26,Michigan,69,Iosco County,0,26,-26
18,Indiana,26,Michigan,71,Iron County,0,11,-11
18,Indiana,26,Michigan,73,Isabella County,145,128,17
18,Indiana,26,Michigan,75,Jackson County,79,75,4
18,Indiana,26,Michigan,77,Kalamazoo County,427,716,-289
18,Indiana,26,Michigan,79,Kalkaska County,0,9,-9
18,Indiana,26,Michigan,81,Kent County,489,912,-423
18,Indiana,26,Michigan,85,Lake County,0,4,-4
18,Indiana,26,Michigan,87,Lapeer County,0,10,-10
18,Indiana,26,Michigan,89,Leelanau County,0,10,-10
18,Indiana,26,Michigan,91,Lenawee County,31,37,-6
18,Indiana,26,Michigan,93,Livingston County,71,134,-63
18,Indiana,26,Michigan,97,Mackinac County,0,8,-8
18,Indiana,26,Michigan,99,Macomb County,105,71,34
18,Indiana,26,Michigan,101,Manistee County,0,7,-7
18,Indiana,26,Michigan,103,Marquette County,31,148,-117
18,Indiana,26,Michigan,105,Mason County,0,45,-45
18,Indiana,26,Michigan,107,Mecosta County,98,42,56
18,Indiana,26,Michigan,111,Midland County,49,129,-80
18,Indiana,26,Michigan,113,Missaukee County,10,7,3
18,Indiana,26,Michigan,115,Monroe County,78,31,47
18,Indiana,26,Michigan,117,Montcalm County,78,156,-78
18,Indiana,26,Michigan,119,Montmorency County,0,15,-15
18,Indiana,26,Michigan,121,Muskegon County,196,98,98
18,Indiana,26,Michigan,123,Newaygo County,45,79,-34
18,Indiana,26,Michigan,125,Oakland County,742,827,-85
18,Indiana,26,Michigan,127,Oceana County,101,0,101
18,Indiana,26,Michigan,129,Ogemaw County,4,0,4
18,Indiana,26,Michigan,131,Ontonagon County,0,2,-2
18,Indiana,26,Michigan,135,Oscoda County,0,1,-1
18,Indiana,26,Michigan,137,Otsego County,49,36,13
18,Indiana,26,Michigan,139,Ottawa County,223,287,-64
18,Indiana,26,Michigan,143,Roscommon County,0,26,-26
18,Indiana,26,Michigan,145,Saginaw County,170,59,111
18,Indiana,26,Michigan,147,St. Clair County,353,22,331
18,Indiana,26,Michigan,149,St. Joseph County,564,554,10
18,Indiana,26,Michigan,151,Sanilac County,0,21,-21
18,Indiana,26,Michigan,153,Schoolcraft County,0,16,-16
18,Indiana,26,Michigan,155,Shiawassee County,22,93,-71
18,Indiana,26,Michigan,157,Tuscola County,82,8,74
18,Indiana,26,Michigan,159,Van Buren County,134,111,23
18,Indiana,26,Michigan,161,Washtenaw County,531,405,126
18,Indiana,26,Michigan,163,Wayne County,548,579,-31
18,Indiana,26,Michigan,165,Wexford County,0,14,-14
18,Indiana,27,Minnesota,3,Anoka County,52,70,-18
18,Indiana,27,Minnesota,7,Beltrami County,0,12,-12
18,Indiana,27,Minnesota,9,Benton County,104,0,104
18,Indiana,27,Minnesota,13,Blue Earth County,0,225,-225
18,Indiana,27,Minnesota,15,Brown County,47,22,25
18,Indiana,27,Minnesota,17,Carlton County,0,2,-2
18,Indiana,27,Minnesota,19,Carver County,43,56,-13
18,Indiana,27,Minnesota,21,Cass County,0,2,-2
18,Indiana,27,Minnesota,27,Clay County,0,44,-44
18,Indiana,27,Minnesota,29,Clearwater County,0,11,-11
18,Indiana,27,Minnesota,31,Cook County,0,20,-20
18,Indiana,27,Minnesota,35,Crow Wing County,13,47,-34
18,Indiana,27,Minnesota,37,Dakota County,111,85,26
18,Indiana,27,Minnesota,41,Douglas County,3,7,-4
18,Indiana,27,Minnesota,49,Goodhue County,4,18,-14
18,Indiana,27,Minnesota,53,Hennepin County,625,838,-213
18,Indiana,27,Minnesota,57,Hubbard County,0,15,-15
18,Indiana,27,Minnesota,61,Itasca County,0,2,-2
18,Indiana,27,Minnesota,67,Kandiyohi County,0,18,-18
18,Indiana,27,Minnesota,71,Koochiching County,11,0,11
18,Indiana,27,Minnesota,73,Lac qui Parle County,0,3,-3
18,Indiana,27,Minnesota,75,Lake County,76,4,72
18,Indiana,27,Minnesota,83,Lyon County,0,21,-21
18,Indiana,27,Minnesota,85,McLeod County,0,51,-51
18,Indiana,27,Minnesota,89,Marshall County,0,3,-3
18,Indiana,27,Minnesota,97,Morrison County,16,0,16
18,Indiana,27,Minnesota,99,Mower County,9,0,9
18,Indiana,27,Minnesota,103,Nicollet County,7,4,3
18,Indiana,27,Minnesota,105,Nobles County,0,6,-6
18,Indiana,27,Minnesota,109,Olmsted County,0,50,-50
18,Indiana,27,Minnesota,111,Otter Tail County,0,20,-20
18,Indiana,27,Minnesota,119,Polk County,0,15,-15
18,Indiana,27,Minnesota,123,Ramsey County,257,229,28
18,Indiana,27,Minnesota,131,Rice County,37,4,33
18,Indiana,27,Minnesota,137,St. Louis County,11,10,1
18,Indiana,27,Minnesota,145,Stearns County,18,8,10
18,Indiana,27,Minnesota,149,Stevens County,0,7,-7
18,Indiana,27,Minnesota,163,Washington County,42,0,42
18,Indiana,27,Minnesota,165,Watonwan County,0,1,-1
18,Indiana,27,Minnesota,167,Wilkin County,0,8,-8
18,Indiana,27,Minnesota,169,Winona County,0,3,-3
18,Indiana,28,Mississippi,1,Adams County,0,14,-14
18,Indiana,28,Mississippi,3,Alcorn County,0,19,-19
18,Indiana,28,Mississippi,7,Attala County,0,7,-7
18,Indiana,28,Mississippi,9,Benton County,0,91,-91
18,Indiana,28,Mississippi,11,Bolivar County,2,5,-3
18,Indiana,28,Mississippi,25,Clay County,16,0,16
18,Indiana,28,Mississippi,27,Coahoma County,7,0,7
18,Indiana,28,Mississippi,29,Copiah County,16,0,16
18,Indiana,28,Mississippi,33,DeSoto County,35,25,10
18,Indiana,28,Mississippi,35,Forrest County,39,0,39
18,Indiana,28,Mississippi,45,Hancock County,0,18,-18
18,Indiana,28,Mississippi,47,Harrison County,88,62,26
18,Indiana,28,Mississippi,49,Hinds County,81,31,50
18,Indiana,28,Mississippi,51,Holmes County,26,3,23
18,Indiana,28,Mississippi,59,Jackson County,66,35,31
18,Indiana,28,Mississippi,61,Jasper County,21,0,21
18,Indiana,28,Mississippi,71,Lafayette County,70,115,-45
18,Indiana,28,Mississippi,81,Lee County,0,44,-44
18,Indiana,28,Mississippi,87,Lowndes County,17,0,17
18,Indiana,28,Mississippi,89,Madison County,14,0,14
18,Indiana,28,Mississippi,91,Marion County,7,0,7
18,Indiana,28,Mississippi,95,Monroe County,0,22,-22
18,Indiana,28,Mississippi,103,Noxubee County,0,10,-10
18,Indiana,28,Mississippi,105,Oktibbeha County,42,117,-75
18,Indiana,28,Mississippi,109,Pearl River County,0,5,-5
18,Indiana,28,Mississippi,113,Pike County,41,0,41
18,Indiana,28,Mississippi,115,Pontotoc County,148,18,130
18,Indiana,28,Mississippi,121,Rankin County,16,41,-25
18,Indiana,28,Mississippi,123,Scott County,25,55,-30
18,Indiana,28,Mississippi,137,Tate County,20,0,20
18,Indiana,28,Mississippi,141,Tishomingo County,26,0,26
18,Indiana,28,Mississippi,147,Walthall County,0,65,-65
18,Indiana,28,Mississippi,151,Washington County,16,0,16
18,Indiana,28,Mississippi,161,Yalobusha County,0,13,-13
18,Indiana,29,Missouri,1,Adair County,27,22,5
18,Indiana,29,Missouri,3,Andrew County,0,29,-29
18,Indiana,29,Missouri,7,Audrain County,0,9,-9
18,Indiana,29,Missouri,13,Bates County,10,0,10
18,Indiana,29,Missouri,19,Boone County,161,62,99
18,Indiana,29,Missouri,21,Buchanan County,31,0,31
18,Indiana,29,Missouri,27,Callaway County,0,9,-9
18,Indiana,29,Missouri,29,Camden County,24,58,-34
18,Indiana,29,Missouri,31,Cape Girardeau County,103,110,-7
18,Indiana,29,Missouri,35,Carter County,0,26,-26
18,Indiana,29,Missouri,37,Cass County,16,23,-7
18,Indiana,29,Missouri,41,Chariton County,28,0,28
18,Indiana,29,Missouri,43,Christian County,0,107,-107
18,Indiana,29,Missouri,47,Clay County,167,176,-9
18,Indiana,29,Missouri,51,Cole County,16,46,-30
18,Indiana,29,Missouri,53,Cooper County,0,4,-4
18,Indiana,29,Missouri,55,Crawford County,16,0,16
18,Indiana,29,Missouri,69,Dunklin County,0,11,-11
18,Indiana,29,Missouri,71,Franklin County,91,0,91
18,Indiana,29,Missouri,77,Greene County,12,55,-43
18,Indiana,29,Missouri,81,Harrison County,0,3,-3
18,Indiana,29,Missouri,83,Henry County,0,41,-41
18,Indiana,29,Missouri,95,Jackson County,166,193,-27
18,Indiana,29,Missouri,97,Jasper County,54,85,-31
18,Indiana,29,Missouri,99,Jefferson County,10,80,-70
18,Indiana,29,Missouri,101,Johnson County,48,84,-36
18,Indiana,29,Missouri,103,Knox County,0,4,-4
18,Indiana,29,Missouri,105,Laclede County,0,28,-28
18,Indiana,29,Missouri,109,Lawrence County,17,9,8
18,Indiana,29,Missouri,113,Lincoln County,29,0,29
18,Indiana,29,Missouri,121,Macon County,124,5,119
18,Indiana,29,Missouri,123,Madison County,0,10,-10
18,Indiana,29,Missouri,135,Moniteau County,0,24,-24
18,Indiana,29,Missouri,143,New Madrid County,0,18,-18
18,Indiana,29,Missouri,145,Newton County,0,12,-12
18,Indiana,29,Missouri,161,Phelps County,5,11,-6
18,Indiana,29,Missouri,165,Platte County,19,90,-71
18,Indiana,29,Missouri,169,Pulaski County,66,253,-187
18,Indiana,29,Missouri,175,Randolph County,17,76,-59
18,Indiana,29,Missouri,181,Ripley County,6,0,6
18,Indiana,29,Missouri,183,St. Charles County,254,188,66
18,Indiana,29,Missouri,186,Ste. Genevieve County,0,1,-1
18,Indiana,29,Missouri,187,St. Francois County,0,94,-94
18,Indiana,29,Missouri,189,St. Louis County,483,576,-93
18,Indiana,29,Missouri,195,Saline County,0,7,-7
18,Indiana,29,Missouri,197,Schuyler County,0,2,-2
18,Indiana,29,Missouri,199,Scotland County,0,1,-1
18,Indiana,29,Missouri,201,Scott County,0,48,-48
18,Indiana,29,Missouri,209,Stone County,0,13,-13
18,Indiana,29,Missouri,213,Taney County,0,102,-102
18,Indiana,29,Missouri,215,Texas County,2,5,-3
18,Indiana,29,Missouri,221,Washington County,0,32,-32
18,Indiana,29,Missouri,225,Webster County,0,25,-25
18,Indiana,29,Missouri,229,Wright County,8,0,8
18,Indiana,29,Missouri,510,St. Louis city,311,386,-75
18,Indiana,30,Montana,9,Carbon County,9,0,9
18,Indiana,30,Montana,13,Cascade County,0,21,-21
18,Indiana,30,Montana,29,Flathead County,0,12,-12
18,Indiana,30,Montana,31,Gallatin County,0,113,-113
18,Indiana,30,Montana,41,Hill County,0,2,-2
18,Indiana,30,Montana,49,Lewis and Clark County,63,155,-92
18,Indiana,30,Montana,61,Mineral County,0,15,-15
18,Indiana,30,Montana,63,Missoula County,0,91,-91
18,Indiana,30,Montana,89,Sanders County,0,42,-42
18,Indiana,30,Montana,93,Silver Bow County,197,0,197
18,Indiana,30,Montana,101,Toole County,0,65,-65
18,Indiana,30,Montana,111,Yellowstone County,153,25,128
18,Indiana,31,Nebraska,13,Box Butte County,0,3,-3
18,Indiana,31,Nebraska,35,Clay County,0,5,-5
18,Indiana,31,Nebraska,53,Dodge County,0,9,-9
18,Indiana,31,Nebraska,55,Douglas County,70,104,-34
18,Indiana,31,Nebraska,63,Frontier County,0,3,-3
18,Indiana,31,Nebraska,107,Knox County,0,3,-3
18,Indiana,31,Nebraska,109,Lancaster County,172,128,44
18,Indiana,31,Nebraska,111,Lincoln County,0,31,-31
18,Indiana,31,Nebraska,113,Logan County,0,14,-14
18,Indiana,31,Nebraska,119,Madison County,8,0,8
18,Indiana,31,Nebraska,129,Nuckolls County,0,45,-45
18,Indiana,31,Nebraska,141,Platte County,0,1,-1
18,Indiana,31,Nebraska,147,Richardson County,29,0,29
18,Indiana,31,Nebraska,153,Sarpy County,29,23,6
18,Indiana,31,Nebraska,159,Seward County,48,0,48
18,Indiana,31,Nebraska,169,Thayer County,0,8,-8
18,Indiana,32,Nevada,1,Churchill County,0,13,-13
18,Indiana,32,Nevada,3,Clark County,1256,857,399
18,Indiana,32,Nevada,5,Douglas County,29,0,29
18,Indiana,32,Nevada,19,Lyon County,56,0,56
18,Indiana,32,Nevada,31,Washoe County,107,95,12
18,Indiana,33,New Hampshire,1,Belknap County,25,0,25
18,Indiana,33,New Hampshire,3,Carroll County,42,0,42
18,Indiana,33,New Hampshire,5,Cheshire County,18,11,7
18,Indiana,33,New Hampshire,9,Grafton County,39,25,14
18,Indiana,33,New Hampshire,11,Hillsborough County,0,151,-151
18,Indiana,33,New Hampshire,13,Merrimack County,108,14,94
18,Indiana,33,New Hampshire,15,Rockingham County,26,148,-122
18,Indiana,33,New Hampshire,17,Strafford County,48,3,45
18,Indiana,34,New Jersey,1,Atlantic County,17,0,17
18,Indiana,34,New Jersey,3,Bergen County,96,39,57
18,Indiana,34,New Jersey,5,Burlington County,86,162,-76
18,Indiana,34,New Jersey,7,Camden County,2,69,-67
18,Indiana,34,New Jersey,9,Cape May County,0,14,-14
18,Indiana,34,New Jersey,11,Cumberland County,0,22,-22
18,Indiana,34,New Jersey,13,Essex County,205,188,17
18,Indiana,34,New Jersey,15,Gloucester County,13,0,13
18,Indiana,34,New Jersey,17,Hudson County,351,114,237
18,Indiana,34,New Jersey,19,Hunterdon County,10,0,10
18,Indiana,34,New Jersey,21,Mercer County,144,20,124
18,Indiana,34,New Jersey,23,Middlesex County,486,141,345
18,Indiana,34,New Jersey,25,Monmouth County,200,0,200
18,Indiana,34,New Jersey,27,Morris County,95,106,-11
18,Indiana,34,New Jersey,29,Ocean County,36,48,-12
18,Indiana,34,New Jersey,31,Passaic County,376,32,344
18,Indiana,34,New Jersey,33,Salem County,9,0,9
18,Indiana,34,New Jersey,35,Somerset County,92,50,42
18,Indiana,34,New Jersey,37,Sussex County,4,6,-2
18,Indiana,34,New Jersey,39,Union County,59,67,-8
18,Indiana,34,New Jersey,41,Warren County,0,4,-4
18,Indiana,35,New Mexico,1,Bernalillo County,197,376,-179
18,Indiana,35,New Mexico,5,Chaves County,153,6,147
18,Indiana,35,New Mexico,15,Eddy County,2,0,2
18,Indiana,35,New Mexico,27,Lincoln County,9,0,9
18,Indiana,35,New Mexico,28,Los Alamos County,0,19,-19
18,Indiana,35,New Mexico,31,McKinley County,9,0,9
18,Indiana,35,New Mexico,33,Mora County,66,0,66
18,Indiana,35,New Mexico,35,Otero County,11,21,-10
18,Indiana,35,New Mexico,39,Rio Arriba County,11,0,11
18,Indiana,35,New Mexico,43,Sandoval County,0,77,-77
18,Indiana,35,New Mexico,45,San Juan County,32,0,32
18,Indiana,35,New Mexico,49,Santa Fe County,0,28,-28
18,Indiana,35,New Mexico,55,Taos County,0,19,-19
18,Indiana,35,New Mexico,57,Torrance County,0,13,-13
18,Indiana,36,New York,1,Albany County,39,36,3
18,Indiana,36,New York,5,Bronx County,94,37,57
18,Indiana,36,New York,7,Broome County,62,32,30
18,Indiana,36,New York,11,Cayuga County,12,0,12
18,Indiana,36,New York,13,Chautauqua County,33,6,27
18,Indiana,36,New York,15,Chemung County,0,17,-17
18,Indiana,36,New York,21,Columbia County,0,24,-24
18,Indiana,36,New York,25,Delaware County,0,8,-8
18,Indiana,36,New York,27,Dutchess County,26,9,17
18,Indiana,36,New York,29,Erie County,363,202,161
18,Indiana,36,New York,45,Jefferson County,0,59,-59
18,Indiana,36,New York,47,Kings County,366,197,169
18,Indiana,36,New York,51,Livingston County,9,0,9
18,Indiana,36,New York,55,Monroe County,77,285,-208
18,Indiana,36,New York,59,Nassau County,138,65,73
18,Indiana,36,New York,61,New York County,405,418,-13
18,Indiana,36,New York,63,Niagara County,2,11,-9
18,Indiana,36,New York,65,Oneida County,25,87,-62
18,Indiana,36,New York,67,Onondaga County,7,36,-29
18,Indiana,36,New York,69,Ontario County,71,16,55
18,Indiana,36,New York,71,Orange County,31,0,31
18,Indiana,36,New York,75,Oswego County,10,0,10
18,Indiana,36,New York,77,Otsego County,0,11,-11
18,Indiana,36,New York,79,Putnam County,20,0,20
18,Indiana,36,New York,81,Queens County,110,43,67
18,Indiana,36,New York,83,Rensselaer County,17,0,17
18,Indiana,36,New York,85,Richmond County,55,4,51
18,Indiana,36,New York,87,Rockland County,16,28,-12
18,Indiana,36,New York,89,St. Lawrence County,16,14,2
18,Indiana,36,New York,91,Saratoga County,91,7,84
18,Indiana,36,New York,93,Schenectady County,14,0,14
18,Indiana,36,New York,97,Schuyler County,29,0,29
18,Indiana,36,New York,101,Steuben County,12,0,12
18,Indiana,36,New York,103,Suffolk County,92,10,82
18,Indiana,36,New York,105,Sullivan County,8,0,8
18,Indiana,36,New York,107,Tioga County,59,0,59
18,Indiana,36,New York,109,Tompkins County,0,88,-88
18,Indiana,36,New York,111,Ulster County,13,0,13
18,Indiana,36,New York,119,Westchester County,49,108,-59
18,Indiana,37,North Carolina,1,Alamance County,4,17,-13
18,Indiana,37,North Carolina,11,Avery County,0,8,-8
18,Indiana,37,North Carolina,19,Brunswick County,22,42,-20
18,Indiana,37,North Carolina,21,Buncombe County,35,113,-78
18,Indiana,37,North Carolina,23,Burke County,0,40,-40
18,Indiana,37,North Carolina,25,Cabarrus County,98,67,31
18,Indiana,37,North Carolina,31,Carteret County,10,13,-3
18,Indiana,37,North Carolina,35,Catawba County,80,0,80
18,Indiana,37,North Carolina,37,Chatham County,4,0,4
18,Indiana,37,North Carolina,41,Chowan County,26,0,26
18,Indiana,37,North Carolina,43,Clay County,34,0,34
18,Indiana,37,North Carolina,45,Cleveland County,6,0,6
18,Indiana,37,North Carolina,47,Columbus County,29,9,20
18,Indiana,37,North Carolina,49,Craven County,18,22,-4
18,Indiana,37,North Carolina,51,Cumberland County,381,177,204
18,Indiana,37,North Carolina,53,Currituck County,0,13,-13
18,Indiana,37,North Carolina,55,Dare County,0,12,-12
18,Indiana,37,North Carolina,57,Davidson County,5,30,-25
18,Indiana,37,North Carolina,61,Duplin County,0,14,-14
18,Indiana,37,North Carolina,63,Durham County,183,305,-122
18,Indiana,37,North Carolina,67,Forsyth County,67,188,-121
18,Indiana,37,North Carolina,71,Gaston County,0,18,-18
18,Indiana,37,North Carolina,75,Graham County,0,64,-64
18,Indiana,37,North Carolina,77,Granville County,5,0,5
18,Indiana,37,North Carolina,81,Guilford County,306,60,246
18,Indiana,37,North Carolina,85,Harnett County,50,155,-105
18,Indiana,37,North Carolina,89,Henderson County,30,0,30
18,Indiana,37,North Carolina,93,Hoke County,54,0,54
18,Indiana,37,North Carolina,97,Iredell County,0,204,-204
18,Indiana,37,North Carolina,99,Jackson County,38,0,38
18,Indiana,37,North Carolina,101,Johnston County,28,52,-24
18,Indiana,37,North Carolina,105,Lee County,0,2,-2
18,Indiana,37,North Carolina,109,Lincoln County,90,13,77
18,Indiana,37,North Carolina,113,Macon County,10,0,10
18,Indiana,37,North Carolina,119,Mecklenburg County,609,509,100
18,Indiana,37,North Carolina,121,Mitchell County,0,9,-9
18,Indiana,37,North Carolina,123,Montgomery County,0,2,-2
18,Indiana,37,North Carolina,125,Moore County,35,73,-38
18,Indiana,37,North Carolina,133,Onslow County,452,482,-30
18,Indiana,37,North Carolina,135,Orange County,54,40,14
18,Indiana,37,North Carolina,139,Pasquotank County,9,16,-7
18,Indiana,37,North Carolina,147,Pitt County,22,50,-28
18,Indiana,37,North Carolina,151,Randolph County,13,24,-11
18,Indiana,37,North Carolina,153,Richmond County,422,9,413
18,Indiana,37,North Carolina,157,Rockingham County,16,47,-31
18,Indiana,37,North Carolina,161,Rutherford County,0,4,-4
18,Indiana,37,North Carolina,179,Union County,39,5,34
18,Indiana,37,North Carolina,183,Wake County,275,562,-287
18,Indiana,37,North Carolina,189,Watauga County,46,0,46
18,Indiana,37,North Carolina,191,Wayne County,0,16,-16
18,Indiana,37,North Carolina,193,Wilkes County,23,0,23
18,Indiana,37,North Carolina,195,Wilson County,24,0,24
18,Indiana,37,North Carolina,199,Yancey County,0,28,-28
18,Indiana,38,North Dakota,15,Burleigh County,6,0,6
18,Indiana,38,North Dakota,17,Cass County,193,0,193
18,Indiana,38,North Dakota,19,Cavalier County,0,1,-1
18,Indiana,38,North Dakota,25,Dunn County,0,7,-7
18,Indiana,38,North Dakota,35,Grand Forks County,45,12,33
18,Indiana,38,North Dakota,61,Mountrail County,0,12,-12
18,Indiana,38,North Dakota,77,Richland County,0,4,-4
18,Indiana,38,North Dakota,79,Rolette County,0,20,-20
18,Indiana,38,North Dakota,89,Stark County,9,10,-1
18,Indiana,38,North Dakota,93,Stutsman County,14,2,12
18,Indiana,38,North Dakota,99,Walsh County,0,1,-1
18,Indiana,38,North Dakota,101,Ward County,114,131,-17
18,Indiana,38,North Dakota,105,Williams County,0,3,-3
18,Indiana,39,Ohio,1,Adams County,7,0,7
18,Indiana,39,Ohio,3,Allen County,162,442,-280
18,Indiana,39,Ohio,5,Ashland County,75,6,69
18,Indiana,39,Ohio,7,Ashtabula County,16,3,13
18,Indiana,39,Ohio,9,Athens County,0,89,-89
18,Indiana,39,Ohio,11,Auglaize County,8,44,-36
18,Indiana,39,Ohio,15,Brown County,204,29,175
18,Indiana,39,Ohio,17,Butler County,1131,729,402
18,Indiana,39,Ohio,19,Carroll County,15,0,15
18,Indiana,39,Ohio,21,Champaign County,0,10,-10
18,Indiana,39,Ohio,23,Clark County,100,132,-32
18,Indiana,39,Ohio,25,Clermont County,164,61,103
18,Indiana,39,Ohio,27,Clinton County,0,34,-34
18,Indiana,39,Ohio,29,Columbiana County,3,2,1
18,Indiana,39,Ohio,33,Crawford County,7,19,-12
18,Indiana,39,Ohio,35,Cuyahoga County,679,603,76
18,Indiana,39,Ohio,37,Darke County,156,211,-55
18,Indiana,39,Ohio,39,Defiance County,198,156,42
18,Indiana,39,Ohio,41,Delaware County,274,175,99
18,Indiana,39,Ohio,43,Erie County,30,80,-50
18,Indiana,39,Ohio,45,Fairfield County,0,130,-130
18,Indiana,39,Ohio,47,Fayette County,0,8,-8
18,Indiana,39,Ohio,49,Franklin County,940,1176,-236
18,Indiana,39,Ohio,51,Fulton County,35,7,28
18,Indiana,39,Ohio,55,Geauga County,40,0,40
18,Indiana,39,Ohio,57,Greene County,170,392,-222
18,Indiana,39,Ohio,59,Guernsey County,0,21,-21
18,Indiana,39,Ohio,61,Hamilton County,2163,1993,170
18,Indiana,39,Ohio,63,Hancock County,111,229,-118
18,Indiana,39,Ohio,65,Hardin County,17,170,-153
18,Indiana,39,Ohio,69,Henry County,27,2,25
18,Indiana,39,Ohio,71,Highland County,9,0,9
18,Indiana,39,Ohio,75,Holmes County,0,204,-204
18,Indiana,39,Ohio,77,Huron County,10,24,-14
18,Indiana,39,Ohio,81,Jefferson County,0,34,-34
18,Indiana,39,Ohio,83,Knox County,0,49,-49
18,Indiana,39,Ohio,85,Lake County,26,28,-2
18,Indiana,39,Ohio,87,Lawrence County,0,16,-16
18,Indiana,39,Ohio,89,Licking County,78,80,-2
18,Indiana,39,Ohio,91,Logan County,0,22,-22
18,Indiana,39,Ohio,93,Lorain County,120,135,-15
18,Indiana,39,Ohio,95,Lucas County,282,351,-69
18,Indiana,39,Ohio,97,Madison County,16,10,6
18,Indiana,39,Ohio,99,Mahoning County,54,57,-3
18,Indiana,39,Ohio,101,Marion County,126,148,-22
18,Indiana,39,Ohio,103,Medina County,39,148,-109
18,Indiana,39,Ohio,107,Mercer County,318,93,225
18,Indiana,39,Ohio,109,Miami County,212,191,21
18,Indiana,39,Ohio,111,Monroe County,8,1,7
18,Indiana,39,Ohio,113,Montgomery County,439,865,-426
18,Indiana,39,Ohio,115,Morgan County,14,0,14
18,Indiana,39,Ohio,117,Morrow County,184,47,137
18,Indiana,39,Ohio,119,Muskingum County,37,24,13
18,Indiana,39,Ohio,123,Ottawa County,0,28,-28
18,Indiana,39,Ohio,125,Paulding County,106,36,70
18,Indiana,39,Ohio,127,Perry County,18,25,-7
18,Indiana,39,Ohio,129,Pickaway County,3,21,-18
18,Indiana,39,Ohio,133,Portage County,57,88,-31
18,Indiana,39,Ohio,135,Preble County,204,135,69
18,Indiana,39,Ohio,137,Putnam County,139,34,105
18,Indiana,39,Ohio,139,Richland County,31,77,-46
18,Indiana,39,Ohio,141,Ross County,13,37,-24
18,Indiana,39,Ohio,143,Sandusky County,0,59,-59
18,Indiana,39,Ohio,145,Scioto County,12,13,-1
18,Indiana,39,Ohio,147,Seneca County,0,54,-54
18,Indiana,39,Ohio,149,Shelby County,49,32,17
18,Indiana,39,Ohio,151,Stark County,202,165,37
18,Indiana,39,Ohio,153,Summit County,101,251,-150
18,Indiana,39,Ohio,155,Trumbull County,187,11,176
18,Indiana,39,Ohio,157,Tuscarawas County,27,11,16
18,Indiana,39,Ohio,159,Union County,21,24,-3
18,Indiana,39,Ohio,161,Van Wert County,438,317,121
18,Indiana,39,Ohio,163,Vinton County,7,16,-9
18,Indiana,39,Ohio,165,Warren County,308,319,-11
18,Indiana,39,Ohio,167,Washington County,11,30,-19
18,Indiana,39,Ohio,169,Wayne County,14,141,-127
18,Indiana,39,Ohio,171,Williams County,418,158,260
18,Indiana,39,Ohio,173,Wood County,248,84,164
18,Indiana,39,Ohio,175,Wyandot County,0,21,-21
18,Indiana,4,Arizona,3,Cochise County,53,98,-45
18,Indiana,4,Arizona,5,Coconino County,14,11,3
18,Indiana,4,Arizona,9,Graham County,0,40,-40
18,Indiana,4,Arizona,12,La Paz County,27,0,27
18,Indiana,4,Arizona,13,Maricopa County,1286,2385,-1099
18,Indiana,4,Arizona,15,Mohave County,71,36,35
18,Indiana,4,Arizona,17,Navajo County,21,106,-85
18,Indiana,4,Arizona,19,Pima County,256,582,-326
18,Indiana,4,Arizona,21,Pinal County,461,373,88
18,Indiana,4,Arizona,25,Yavapai County,43,68,-25
18,Indiana,4,Arizona,27,Yuma County,139,76,63
18,Indiana,40,Oklahoma,11,Blaine County,16,0,16
18,Indiana,40,Oklahoma,13,Bryan County,0,37,-37
18,Indiana,40,Oklahoma,17,Canadian County,45,12,33
18,Indiana,40,Oklahoma,19,Carter County,0,11,-11
18,Indiana,40,Oklahoma,23,Choctaw County,2,0,2
18,Indiana,40,Oklahoma,27,Cleveland County,83,33,50
18,Indiana,40,Oklahoma,31,Comanche County,21,405,-384
18,Indiana,40,Oklahoma,33,Cotton County,27,0,27
18,Indiana,40,Oklahoma,35,Craig County,3,0,3
18,Indiana,40,Oklahoma,37,Creek County,0,4,-4
18,Indiana,40,Oklahoma,41,Delaware County,0,26,-26
18,Indiana,40,Oklahoma,47,Garfield County,69,0,69
18,Indiana,40,Oklahoma,51,Grady County,0,6,-6
18,Indiana,40,Oklahoma,65,Jackson County,15,6,9
18,Indiana,40,Oklahoma,67,Jefferson County,0,5,-5
18,Indiana,40,Oklahoma,69,Johnston County,0,21,-21
18,Indiana,40,Oklahoma,79,Le Flore County,0,6,-6
18,Indiana,40,Oklahoma,81,Lincoln County,0,4,-4
18,Indiana,40,Oklahoma,83,Logan County,0,143,-143
18,Indiana,40,Oklahoma,85,Love County,10,8,2
18,Indiana,40,Oklahoma,91,McIntosh County,0,12,-12
18,Indiana,40,Oklahoma,97,Mayes County,0,19,-19
18,Indiana,40,Oklahoma,101,Muskogee County,37,6,31
18,Indiana,40,Oklahoma,109,Oklahoma County,307,236,71
18,Indiana,40,Oklahoma,111,Okmulgee County,26,0,26
18,Indiana,40,Oklahoma,113,Osage County,13,0,13
18,Indiana,40,Oklahoma,119,Payne County,29,14,15
18,Indiana,40,Oklahoma,125,Pottawatomie County,18,7,11
18,Indiana,40,Oklahoma,131,Rogers County,28,13,15
18,Indiana,40,Oklahoma,135,Sequoyah County,0,11,-11
18,Indiana,40,Oklahoma,143,Tulsa County,271,457,-186
18,Indiana,40,Oklahoma,145,Wagoner County,0,33,-33
18,Indiana,41,Oregon,3,Benton County,16,38,-22
18,Indiana,41,Oregon,5,Clackamas County,21,58,-37
18,Indiana,41,Oregon,7,Clatsop County,0,17,-17
18,Indiana,41,Oregon,9,Columbia County,0,84,-84
18,Indiana,41,Oregon,11,Coos County,7,7,0
18,Indiana,41,Oregon,17,Deschutes County,84,0,84
18,Indiana,41,Oregon,27,Hood River County,3,0,3
18,Indiana,41,Oregon,29,Jackson County,26,29,-3
18,Indiana,41,Oregon,31,Jefferson County,22,0,22
18,Indiana,41,Oregon,33,Josephine County,50,19,31
18,Indiana,41,Oregon,39,Lane County,27,133,-106
18,Indiana,41,Oregon,43,Linn County,0,16,-16
18,Indiana,41,Oregon,47,Marion County,24,63,-39
18,Indiana,41,Oregon,51,Multnomah County,410,324,86
18,Indiana,41,Oregon,55,Sherman County,0,29,-29
18,Indiana,41,Oregon,59,Umatilla County,14,8,6
18,Indiana,41,Oregon,61,Union County,7,0,7
18,Indiana,41,Oregon,67,Washington County,348,56,292
18,Indiana,42,Pennsylvania,1,Adams County,25,31,-6
18,Indiana,42,Pennsylvania,3,Allegheny County,411,422,-11
18,Indiana,42,Pennsylvania,5,Armstrong County,16,0,16
18,Indiana,42,Pennsylvania,7,Beaver County,4,3,1
18,Indiana,42,Pennsylvania,9,Bedford County,10,0,10
18,Indiana,42,Pennsylvania,11,Berks County,24,25,-1
18,Indiana,42,Pennsylvania,13,Blair County,0,13,-13
18,Indiana,42,Pennsylvania,15,Bradford County,0,12,-12
18,Indiana,42,Pennsylvania,17,Bucks County,25,62,-37
18,Indiana,42,Pennsylvania,19,Butler County,41,30,11
18,Indiana,42,Pennsylvania,21,Cambria County,2,46,-44
18,Indiana,42,Pennsylvania,27,Centre County,12,106,-94
18,Indiana,42,Pennsylvania,29,Chester County,298,60,238
18,Indiana,42,Pennsylvania,33,Clearfield County,22,0,22
18,Indiana,42,Pennsylvania,35,Clinton County,0,21,-21
18,Indiana,42,Pennsylvania,41,Cumberland County,5,14,-9
18,Indiana,42,Pennsylvania,43,Dauphin County,40,176,-136
18,Indiana,42,Pennsylvania,45,Delaware County,104,40,64
18,Indiana,42,Pennsylvania,49,Erie County,98,200,-102
18,Indiana,42,Pennsylvania,51,Fayette County,3,0,3
18,Indiana,42,Pennsylvania,53,Forest County,12,0,12
18,Indiana,42,Pennsylvania,55,Franklin County,23,0,23
18,Indiana,42,Pennsylvania,59,Greene County,3,0,3
18,Indiana,42,Pennsylvania,61,Huntingdon County,36,0,36
18,Indiana,42,Pennsylvania,63,Indiana County,25,26,-1
18,Indiana,42,Pennsylvania,69,Lackawanna County,28,0,28
18,Indiana,42,Pennsylvania,71,Lancaster County,134,47,87
18,Indiana,42,Pennsylvania,73,Lawrence County,15,0,15
18,Indiana,42,Pennsylvania,75,Lebanon County,18,0,18
18,Indiana,42,Pennsylvania,77,Lehigh County,29,17,12
18,Indiana,42,Pennsylvania,79,Luzerne County,0,21,-21
18,Indiana,42,Pennsylvania,81,Lycoming County,1,38,-37
18,Indiana,42,Pennsylvania,83,McKean County,5,0,5
18,Indiana,42,Pennsylvania,85,Mercer County,9,32,-23
18,Indiana,42,Pennsylvania,91,Montgomery County,145,56,89
18,Indiana,42,Pennsylvania,95,Northampton County,70,56,14
18,Indiana,42,Pennsylvania,97,Northumberland County,0,6,-6
18,Indiana,42,Pennsylvania,99,Perry County,0,2,-2
18,Indiana,42,Pennsylvania,101,Philadelphia County,182,152,30
18,Indiana,42,Pennsylvania,103,Pike County,0,4,-4
18,Indiana,42,Pennsylvania,107,Schuylkill County,25,0,25
18,Indiana,42,Pennsylvania,109,Snyder County,30,0,30
18,Indiana,42,Pennsylvania,111,Somerset County,0,11,-11
18,Indiana,42,Pennsylvania,117,Tioga County,32,0,32
18,Indiana,42,Pennsylvania,119,Union County,11,101,-90
18,Indiana,42,Pennsylvania,121,Venango County,5,0,5
18,Indiana,42,Pennsylvania,125,Washington County,12,98,-86
18,Indiana,42,Pennsylvania,129,Westmoreland County,50,121,-71
18,Indiana,42,Pennsylvania,131,Wyoming County,37,0,37
18,Indiana,42,Pennsylvania,133,York County,6,142,-136
18,Indiana,44,Rhode Island,1,Bristol County,14,7,7
18,Indiana,44,Rhode Island,5,Newport County,58,6,52
18,Indiana,44,Rhode Island,7,Providence County,57,55,2
18,Indiana,45,South Carolina,1,Abbeville County,0,6,-6
18,Indiana,45,South Carolina,3,Aiken County,25,161,-136
18,Indiana,45,South Carolina,7,Anderson County,0,33,-33
18,Indiana,45,South Carolina,13,Beaufort County,129,147,-18
18,Indiana,45,South Carolina,15,Berkeley County,34,26,8
18,Indiana,45,South Carolina,19,Charleston County,472,346,126
18,Indiana,45,South Carolina,21,Cherokee County,0,21,-21
18,Indiana,45,South Carolina,29,Colleton County,0,16,-16
18,Indiana,45,South Carolina,31,Darlington County,0,88,-88
18,Indiana,45,South Carolina,35,Dorchester County,43,214,-171
18,Indiana,45,South Carolina,41,Florence County,0,59,-59
18,Indiana,45,South Carolina,43,Georgetown County,14,87,-73
18,Indiana,45,South Carolina,45,Greenville County,49,283,-234
18,Indiana,45,South Carolina,47,Greenwood County,0,17,-17
18,Indiana,45,South Carolina,49,Hampton County,0,26,-26
18,Indiana,45,South Carolina,51,Horry County,58,70,-12
18,Indiana,45,South Carolina,55,Kershaw County,6,0,6
18,Indiana,45,South Carolina,57,Lancaster County,8,0,8
18,Indiana,45,South Carolina,63,Lexington County,147,50,97
18,Indiana,45,South Carolina,69,Marlboro County,18,12,6
18,Indiana,45,South Carolina,71,Newberry County,0,11,-11
18,Indiana,45,South Carolina,73,Oconee County,10,130,-120
18,Indiana,45,South Carolina,75,Orangeburg County,0,32,-32
18,Indiana,45,South Carolina,77,Pickens County,46,47,-1
18,Indiana,45,South Carolina,79,Richland County,93,540,-447
18,Indiana,45,South Carolina,83,Spartanburg County,15,18,-3
18,Indiana,45,South Carolina,85,Sumter County,42,22,20
18,Indiana,45,South Carolina,87,Union County,40,3,37
18,Indiana,45,South Carolina,89,Williamsburg County,0,10,-10
18,Indiana,45,South Carolina,91,York County,46,12,34
18,Indiana,46,South Dakota,5,Beadle County,7,0,7
18,Indiana,46,South Dakota,11,Brookings County,76,20,56
18,Indiana,46,South Dakota,13,Brown County,13,71,-58
18,Indiana,46,South Dakota,27,Clay County,0,13,-13
18,Indiana,46,South Dakota,29,Codington County,8,0,8
18,Indiana,46,South Dakota,35,Davison County,4,0,4
18,Indiana,46,South Dakota,39,Deuel County,0,1,-1
18,Indiana,46,South Dakota,51,Grant County,0,8,-8
18,Indiana,46,South Dakota,53,Gregory County,0,12,-12
18,Indiana,46,South Dakota,65,Hughes County,0,1,-1
18,Indiana,46,South Dakota,81,Lawrence County,0,135,-135
18,Indiana,46,South Dakota,89,McPherson County,0,14,-14
18,Indiana,46,South Dakota,91,Marshall County,11,0,11
18,Indiana,46,South Dakota,99,Minnehaha County,116,115,1
18,Indiana,46,South Dakota,102,Oglala Lakota County,0,15,-15
18,Indiana,46,South Dakota,103,Pennington County,0,2,-2
18,Indiana,46,South Dakota,135,Yankton County,1,16,-15
18,Indiana,47,Tennessee,1,Anderson County,26,22,4
18,Indiana,47,Tennessee,3,Bedford County,34,38,-4
18,Indiana,47,Tennessee,9,Blount County,68,110,-42
18,Indiana,47,Tennessee,11,Bradley County,61,34,27
18,Indiana,47,Tennessee,13,Campbell County,0,169,-169
18,Indiana,47,Tennessee,15,Cannon County,25,0,25
18,Indiana,47,Tennessee,19,Carter County,28,23,5
18,Indiana,47,Tennessee,21,Cheatham County,8,0,8
18,Indiana,47,Tennessee,23,Chester County,59,17,42
18,Indiana,47,Tennessee,25,Claiborne County,42,0,42
18,Indiana,47,Tennessee,27,Clay County,15,0,15
18,Indiana,47,Tennessee,29,Cocke County,21,0,21
18,Indiana,47,Tennessee,31,Coffee County,5,300,-295
18,Indiana,47,Tennessee,35,Cumberland County,14,48,-34
18,Indiana,47,Tennessee,37,Davidson County,831,757,74
18,Indiana,47,Tennessee,39,Decatur County,0,5,-5
18,Indiana,47,Tennessee,43,Dickson County,0,19,-19
18,Indiana,47,Tennessee,45,Dyer County,25,0,25
18,Indiana,47,Tennessee,51,Franklin County,0,81,-81
18,Indiana,47,Tennessee,53,Gibson County,5,21,-16
18,Indiana,47,Tennessee,55,Giles County,39,31,8
18,Indiana,47,Tennessee,59,Greene County,0,19,-19
18,Indiana,47,Tennessee,63,Hamblen County,42,29,13
18,Indiana,47,Tennessee,65,Hamilton County,113,130,-17
18,Indiana,47,Tennessee,71,Hardin County,0,6,-6
18,Indiana,47,Tennessee,73,Hawkins County,6,0,6
18,Indiana,47,Tennessee,77,Henderson County,6,1,5
18,Indiana,47,Tennessee,79,Henry County,21,61,-40
18,Indiana,47,Tennessee,81,Hickman County,29,0,29
18,Indiana,47,Tennessee,85,Humphreys County,12,0,12
18,Indiana,47,Tennessee,87,Jackson County,34,4,30
18,Indiana,47,Tennessee,89,Jefferson County,142,30,112
18,Indiana,47,Tennessee,93,Knox County,360,513,-153
18,Indiana,47,Tennessee,97,Lauderdale County,0,26,-26
18,Indiana,47,Tennessee,101,Lewis County,32,0,32
18,Indiana,47,Tennessee,103,Lincoln County,0,57,-57
18,Indiana,47,Tennessee,105,Loudon County,3,8,-5
18,Indiana,47,Tennessee,107,McMinn County,0,10,-10
18,Indiana,47,Tennessee,109,McNairy County,9,0,9
18,Indiana,47,Tennessee,111,Macon County,0,31,-31
18,Indiana,47,Tennessee,113,Madison County,82,23,59
18,Indiana,47,Tennessee,119,Maury County,34,69,-35
18,Indiana,47,Tennessee,121,Meigs County,0,7,-7
18,Indiana,47,Tennessee,123,Monroe County,8,0,8
18,Indiana,47,Tennessee,125,Montgomery County,186,522,-336
18,Indiana,47,Tennessee,131,Obion County,0,1,-1
18,Indiana,47,Tennessee,137,Pickett County,0,25,-25
18,Indiana,47,Tennessee,141,Putnam County,52,78,-26
18,Indiana,47,Tennessee,143,Rhea County,9,0,9
18,Indiana,47,Tennessee,145,Roane County,0,15,-15
18,Indiana,47,Tennessee,147,Robertson County,29,30,-1
18,Indiana,47,Tennessee,149,Rutherford County,64,627,-563
18,Indiana,47,Tennessee,151,Scott County,0,86,-86
18,Indiana,47,Tennessee,155,Sevier County,84,103,-19
18,Indiana,47,Tennessee,157,Shelby County,203,549,-346
18,Indiana,47,Tennessee,163,Sullivan County,21,58,-37
18,Indiana,47,Tennessee,165,Sumner County,118,222,-104
18,Indiana,47,Tennessee,167,Tipton County,13,0,13
18,Indiana,47,Tennessee,171,Unicoi County,0,4,-4
18,Indiana,47,Tennessee,175,Van Buren County,9,0,9
18,Indiana,47,Tennessee,179,Washington County,118,128,-10
18,Indiana,47,Tennessee,181,Wayne County,10,0,10
18,Indiana,47,Tennessee,183,Weakley County,18,9,9
18,Indiana,47,Tennessee,185,White County,0,71,-71
18,Indiana,47,Tennessee,187,Williamson County,388,105,283
18,Indiana,47,Tennessee,189,Wilson County,4,134,-130
18,Indiana,48,Texas,5,Angelina County,17,98,-81
18,Indiana,48,Texas,7,Aransas County,0,40,-40
18,Indiana,48,Texas,11,Armstrong County,0,3,-3
18,Indiana,48,Texas,13,Atascosa County,9,0,9
18,Indiana,48,Texas,21,Bastrop County,0,9,-9
18,Indiana,48,Texas,25,Bee County,11,0,11
18,Indiana,48,Texas,27,Bell County,106,156,-50
18,Indiana,48,Texas,29,Bexar County,364,769,-405
18,Indiana,48,Texas,31,Blanco County,0,12,-12
18,Indiana,48,Texas,37,Bowie County,8,0,8
18,Indiana,48,Texas,39,Brazoria County,27,173,-146
18,Indiana,48,Texas,41,Brazos County,144,26,118
18,Indiana,48,Texas,43,Brewster County,37,0,37
18,Indiana,48,Texas,55,Caldwell County,4,0,4
18,Indiana,48,Texas,57,Calhoun County,0,106,-106
18,Indiana,48,Texas,59,Callahan County,25,0,25
18,Indiana,48,Texas,61,Cameron County,390,96,294
18,Indiana,48,Texas,73,Cherokee County,0,78,-78
18,Indiana,48,Texas,85,Collin County,335,250,85
18,Indiana,48,Texas,91,Comal County,17,0,17
18,Indiana,48,Texas,97,Cooke County,41,39,2
18,Indiana,48,Texas,99,Coryell County,82,278,-196
18,Indiana,48,Texas,113,Dallas County,506,818,-312
18,Indiana,48,Texas,119,Delta County,0,43,-43
18,Indiana,48,Texas,121,Denton County,307,362,-55
18,Indiana,48,Texas,123,DeWitt County,12,0,12
18,Indiana,48,Texas,135,Ector County,134,0,134
18,Indiana,48,Texas,139,Ellis County,10,0,10
18,Indiana,48,Texas,141,El Paso County,240,308,-68
18,Indiana,48,Texas,143,Erath County,103,0,103
18,Indiana,48,Texas,155,Foard County,0,12,-12
18,Indiana,48,Texas,157,Fort Bend County,123,112,11
18,Indiana,48,Texas,163,Frio County,63,0,63
18,Indiana,48,Texas,167,Galveston County,74,300,-226
18,Indiana,48,Texas,171,Gillespie County,35,0,35
18,Indiana,48,Texas,179,Gray County,27,0,27
18,Indiana,48,Texas,181,Grayson County,40,0,40
18,Indiana,48,Texas,183,Gregg County,164,28,136
18,Indiana,48,Texas,187,Guadalupe County,110,168,-58
18,Indiana,48,Texas,201,Harris County,627,1361,-734
18,Indiana,48,Texas,203,Harrison County,102,7,95
18,Indiana,48,Texas,209,Hays County,27,9,18
18,Indiana,48,Texas,213,Henderson County,15,4,11
18,Indiana,48,Texas,215,Hidalgo County,289,70,219
18,Indiana,48,Texas,221,Hood County,1,0,1
18,Indiana,48,Texas,223,Hopkins County,116,0,116
18,Indiana,48,Texas,227,Howard County,4,0,4
18,Indiana,48,Texas,231,Hunt County,6,0,6
18,Indiana,48,Texas,237,Jack County,0,5,-5
18,Indiana,48,Texas,245,Jefferson County,7,31,-24
18,Indiana,48,Texas,251,Johnson County,3,0,3
18,Indiana,48,Texas,265,Kerr County,0,4,-4
18,Indiana,48,Texas,271,Kinney County,13,0,13
18,Indiana,48,Texas,283,La Salle County,0,8,-8
18,Indiana,48,Texas,287,Lee County,62,0,62
18,Indiana,48,Texas,291,Liberty County,10,7,3
18,Indiana,48,Texas,295,Lipscomb County,0,3,-3
18,Indiana,48,Texas,303,Lubbock County,299,48,251
18,Indiana,48,Texas,309,McLennan County,48,12,36
18,Indiana,48,Texas,325,Medina County,0,7,-7
18,Indiana,48,Texas,329,Midland County,81,55,26
18,Indiana,48,Texas,337,Montague County,0,9,-9
18,Indiana,48,Texas,339,Montgomery County,88,69,19
18,Indiana,48,Texas,347,Nacogdoches County,101,0,101
18,Indiana,48,Texas,349,Navarro County,0,7,-7
18,Indiana,48,Texas,353,Nolan County,0,31,-31
18,Indiana,48,Texas,355,Nueces County,17,350,-333
18,Indiana,48,Texas,357,Ochiltree County,85,0,85
18,Indiana,48,Texas,361,Orange County,6,12,-6
18,Indiana,48,Texas,365,Panola County,31,0,31
18,Indiana,48,Texas,367,Parker County,0,37,-37
18,Indiana,48,Texas,373,Polk County,24,0,24
18,Indiana,48,Texas,375,Potter County,63,270,-207
18,Indiana,48,Texas,381,Randall County,88,31,57
18,Indiana,48,Texas,391,Refugio County,0,6,-6
18,Indiana,48,Texas,397,Rockwall County,0,111,-111
18,Indiana,48,Texas,423,Smith County,0,12,-12
18,Indiana,48,Texas,439,Tarrant County,210,1289,-1079
18,Indiana,48,Texas,441,Taylor County,68,47,21
18,Indiana,48,Texas,447,Throckmorton County,0,5,-5
18,Indiana,48,Texas,451,Tom Green County,0,117,-117
18,Indiana,48,Texas,453,Travis County,555,482,73
18,Indiana,48,Texas,465,Val Verde County,177,6,171
18,Indiana,48,Texas,469,Victoria County,0,5,-5
18,Indiana,48,Texas,471,Walker County,98,1,97
18,Indiana,48,Texas,473,Waller County,216,10,206
18,Indiana,48,Texas,479,Webb County,0,31,-31
18,Indiana,48,Texas,485,Wichita County,0,142,-142
18,Indiana,48,Texas,487,Wilbarger County,0,7,-7
18,Indiana,48,Texas,489,Willacy County,20,0,20
18,Indiana,48,Texas,491,Williamson County,35,208,-173
18,Indiana,48,Texas,495,Winkler County,17,0,17
18,Indiana,48,Texas,497,Wise County,0,113,-113
18,Indiana,49,Utah,3,Box Elder County,0,1,-1
18,Indiana,49,Utah,5,Cache County,102,20,82
18,Indiana,49,Utah,11,Davis County,108,66,42
18,Indiana,49,Utah,25,Kane County,0,54,-54
18,Indiana,49,Utah,31,Piute County,0,2,-2
18,Indiana,49,Utah,35,Salt Lake County,247,577,-330
18,Indiana,49,Utah,37,San Juan County,15,0,15
18,Indiana,49,Utah,39,Sanpete County,0,10,-10
18,Indiana,49,Utah,45,Tooele County,15,18,-3
18,Indiana,49,Utah,49,Utah County,260,211,49
18,Indiana,49,Utah,53,Washington County,0,30,-30
18,Indiana,49,Utah,57,Weber County,95,1,94
18,Indiana,5,Arkansas,1,Arkansas County,11,0,11
18,Indiana,5,Arkansas,3,Ashley County,0,28,-28
18,Indiana,5,Arkansas,5,Baxter County,64,0,64
18,Indiana,5,Arkansas,7,Benton County,28,218,-190
18,Indiana,5,Arkansas,15,Carroll County,0,4,-4
18,Indiana,5,Arkansas,21,Clay County,66,0,66
18,Indiana,5,Arkansas,23,Cleburne County,0,20,-20
18,Indiana,5,Arkansas,29,Conway County,11,0,11
18,Indiana,5,Arkansas,31,Craighead County,0,52,-52
18,Indiana,5,Arkansas,43,Drew County,14,0,14
18,Indiana,5,Arkansas,45,Faulkner County,73,53,20
18,Indiana,5,Arkansas,47,Franklin County,0,21,-21
18,Indiana,5,Arkansas,51,Garland County,1,35,-34
18,Indiana,5,Arkansas,59,Hot Spring County,0,11,-11
18,Indiana,5,Arkansas,63,Independence County,13,0,13
18,Indiana,5,Arkansas,69,Jefferson County,38,24,14
18,Indiana,5,Arkansas,71,Johnson County,27,0,27
18,Indiana,5,Arkansas,77,Lee County,57,0,57
18,Indiana,5,Arkansas,85,Lonoke County,5,35,-30
18,Indiana,5,Arkansas,87,Madison County,7,0,7
18,Indiana,5,Arkansas,89,Marion County,0,14,-14
18,Indiana,5,Arkansas,93,Mississippi County,45,0,45
18,Indiana,5,Arkansas,99,Nevada County,4,0,4
18,Indiana,5,Arkansas,103,Ouachita County,23,13,10
18,Indiana,5,Arkansas,107,Phillips County,30,0,30
18,Indiana,5,Arkansas,115,Pope County,87,0,87
18,Indiana,5,Arkansas,119,Pulaski County,236,196,40
18,Indiana,5,Arkansas,123,St. Francis County,30,0,30
18,Indiana,5,Arkansas,125,Saline County,0,34,-34
18,Indiana,5,Arkansas,131,Sebastian County,0,17,-17
18,Indiana,5,Arkansas,135,Sharp County,19,1,18
18,Indiana,5,Arkansas,141,Van Buren County,0,24,-24
18,Indiana,5,Arkansas,143,Washington County,62,0,62
18,Indiana,5,Arkansas,145,White County,11,80,-69
18,Indiana,50,Vermont,3,Bennington County,10,0,10
18,Indiana,50,Vermont,5,Caledonia County,50,0,50
18,Indiana,50,Vermont,7,Chittenden County,94,2,92
18,Indiana,50,Vermont,19,Orleans County,26,0,26
18,Indiana,50,Vermont,21,Rutland County,11,0,11
18,Indiana,50,Vermont,23,Washington County,0,13,-13
18,Indiana,50,Vermont,27,Windsor County,59,17,42
18,Indiana,51,Virginia,3,Albemarle County,96,86,10
18,Indiana,51,Virginia,9,Amherst County,89,0,89
18,Indiana,51,Virginia,13,Arlington County,123,243,-120
18,Indiana,51,Virginia,27,Buchanan County,0,2,-2
18,Indiana,51,Virginia,31,Campbell County,90,0,90
18,Indiana,51,Virginia,35,Carroll County,19,33,-14
18,Indiana,51,Virginia,41,Chesterfield County,93,106,-13
18,Indiana,51,Virginia,47,Culpeper County,0,31,-31
18,Indiana,51,Virginia,51,Dickenson County,9,0,9
18,Indiana,51,Virginia,59,Fairfax County,319,308,11
18,Indiana,51,Virginia,61,Fauquier County,9,7,2
18,Indiana,51,Virginia,69,Frederick County,0,34,-34
18,Indiana,51,Virginia,71,Giles County,38,22,16
18,Indiana,51,Virginia,87,Henrico County,12,46,-34
18,Indiana,51,Virginia,93,Isle of Wight County,0,15,-15
18,Indiana,51,Virginia,95,James City County,20,43,-23
18,Indiana,51,Virginia,99,King George County,0,18,-18
18,Indiana,51,Virginia,105,Lee County,34,23,11
18,Indiana,51,Virginia,107,Loudoun County,187,99,88
18,Indiana,51,Virginia,121,Montgomery County,70,21,49
18,Indiana,51,Virginia,139,Page County,0,7,-7
18,Indiana,51,Virginia,143,Pittsylvania County,15,0,15
18,Indiana,51,Virginia,149,Prince George County,51,35,16
18,Indiana,51,Virginia,153,Prince William County,94,35,59
18,Indiana,51,Virginia,161,Roanoke County,52,8,44
18,Indiana,51,Virginia,165,Rockingham County,23,0,23
18,Indiana,51,Virginia,167,Russell County,0,3,-3
18,Indiana,51,Virginia,169,Scott County,0,8,-8
18,Indiana,51,Virginia,171,Shenandoah County,1,31,-30
18,Indiana,51,Virginia,175,Southampton County,50,4,46
18,Indiana,51,Virginia,177,Spotsylvania County,18,58,-40
18,Indiana,51,Virginia,179,Stafford County,0,108,-108
18,Indiana,51,Virginia,185,Tazewell County,0,11,-11
18,Indiana,51,Virginia,187,Warren County,23,0,23
18,Indiana,51,Virginia,191,Washington County,17,0,17
18,Indiana,51,Virginia,193,Westmoreland County,11,0,11
18,Indiana,51,Virginia,510,Alexandria city,48,33,15
18,Indiana,51,Virginia,530,Buena Vista city,0,5,-5
18,Indiana,51,Virginia,540,Charlottesville city,5,24,-19
18,Indiana,51,Virginia,550,Chesapeake city,233,44,189
18,Indiana,51,Virginia,590,Danville city,15,0,15
18,Indiana,51,Virginia,600,Fairfax city,0,56,-56
18,Indiana,51,Virginia,610,Falls Church city,50,9,41
18,Indiana,51,Virginia,630,Fredericksburg city,13,12,1
18,Indiana,51,Virginia,650,Hampton city,54,47,7
18,Indiana,51,Virginia,660,Harrisonburg city,33,0,33
18,Indiana,51,Virginia,670,Hopewell city,0,103,-103
18,Indiana,51,Virginia,680,Lynchburg city,0,61,-61
18,Indiana,51,Virginia,700,Newport News city,109,17,92
18,Indiana,51,Virginia,710,Norfolk city,67,133,-66
18,Indiana,51,Virginia,730,Petersburg city,0,31,-31
18,Indiana,51,Virginia,740,Portsmouth city,52,16,36
18,Indiana,51,Virginia,750,Radford city,7,14,-7
18,Indiana,51,Virginia,760,Richmond city,47,0,47
18,Indiana,51,Virginia,770,Roanoke city,16,138,-122
18,Indiana,51,Virginia,800,Suffolk city,9,0,9
18,Indiana,51,Virginia,810,Virginia Beach city,122,263,-141
18,Indiana,51,Virginia,830,Williamsburg city,0,41,-41
18,Indiana,53,Washington,5,Benton County,128,9,119
18,Indiana,53,Washington,7,Chelan County,16,0,16
18,Indiana,53,Washington,9,Clallam County,0,6,-6
18,Indiana,53,Washington,11,Clark County,49,48,1
18,Indiana,53,Washington,15,Cowlitz County,9,0,9
18,Indiana,53,Washington,29,Island County,28,0,28
18,Indiana,53,Washington,31,Jefferson County,0,2,-2
18,Indiana,53,Washington,33,King County,505,731,-226
18,Indiana,53,Washington,35,Kitsap County,94,124,-30
18,Indiana,53,Washington,37,Kittitas County,0,9,-9
18,Indiana,53,Washington,41,Lewis County,0,10,-10
18,Indiana,53,Washington,45,Mason County,0,17,-17
18,Indiana,53,Washington,49,Pacific County,0,2,-2
18,Indiana,53,Washington,53,Pierce County,570,253,317
18,Indiana,53,Washington,55,San Juan County,0,2,-2
18,Indiana,53,Washington,57,Skagit County,77,16,61
18,Indiana,53,Washington,61,Snohomish County,115,168,-53
18,Indiana,53,Washington,63,Spokane County,182,29,153
18,Indiana,53,Washington,65,Stevens County,53,8,45
18,Indiana,53,Washington,67,Thurston County,90,39,51
18,Indiana,53,Washington,71,Walla Walla County,160,0,160
18,Indiana,53,Washington,75,Whitman County,1,36,-35
18,Indiana,53,Washington,77,Yakima County,18,0,18
18,Indiana,54,West Virginia,1,Barbour County,178,0,178
18,Indiana,54,West Virginia,7,Braxton County,0,6,-6
18,Indiana,54,West Virginia,9,Brooke County,0,12,-12
18,Indiana,54,West Virginia,11,Cabell County,0,23,-23
18,Indiana,54,West Virginia,19,Fayette County,0,14,-14
18,Indiana,54,West Virginia,21,Gilmer County,0,7,-7
18,Indiana,54,West Virginia,29,Hancock County,2,0,2
18,Indiana,54,West Virginia,33,Harrison County,0,12,-12
18,Indiana,54,West Virginia,39,Kanawha County,37,184,-147
18,Indiana,54,West Virginia,47,McDowell County,0,12,-12
18,Indiana,54,West Virginia,49,Marion County,0,73,-73
18,Indiana,54,West Virginia,55,Mercer County,34,10,24
18,Indiana,54,West Virginia,61,Monongalia County,0,7,-7
18,Indiana,54,West Virginia,65,Morgan County,0,4,-4
18,Indiana,54,West Virginia,69,Ohio County,0,14,-14
18,Indiana,54,West Virginia,75,Pocahontas County,13,0,13
18,Indiana,54,West Virginia,77,Preston County,4,52,-48
18,Indiana,54,West Virginia,79,Putnam County,0,20,-20
18,Indiana,54,West Virginia,81,Raleigh County,11,0,11
18,Indiana,54,West Virginia,87,Roane County,0,7,-7
18,Indiana,54,West Virginia,89,Summers County,0,33,-33
18,Indiana,54,West Virginia,91,Taylor County,0,1,-1
18,Indiana,54,West Virginia,95,Tyler County,7,7,0
18,Indiana,54,West Virginia,97,Upshur County,0,12,-12
18,Indiana,54,West Virginia,99,Wayne County,8,8,0
18,Indiana,54,West Virginia,103,Wetzel County,0,5,-5
18,Indiana,54,West Virginia,107,Wood County,0,13,-13
18,Indiana,55,Wisconsin,3,Ashland County,0,21,-21
18,Indiana,55,Wisconsin,5,Barron County,13,32,-19
18,Indiana,55,Wisconsin,7,Bayfield County,0,9,-9
18,Indiana,55,Wisconsin,9,Brown County,145,19,126
18,Indiana,55,Wisconsin,11,Buffalo County,0,27,-27
18,Indiana,55,Wisconsin,13,Burnett County,0,4,-4
18,Indiana,55,Wisconsin,15,Calumet County,0,9,-9
18,Indiana,55,Wisconsin,17,Chippewa County,0,12,-12
18,Indiana,55,Wisconsin,19,Clark County,0,3,-3
18,Indiana,55,Wisconsin,21,Columbia County,0,3,-3
18,Indiana,55,Wisconsin,23,Crawford County,0,19,-19
18,Indiana,55,Wisconsin,25,Dane County,469,267,202
18,Indiana,55,Wisconsin,27,Dodge County,14,94,-80
18,Indiana,55,Wisconsin,29,Door County,40,10,30
18,Indiana,55,Wisconsin,31,Douglas County,0,4,-4
18,Indiana,55,Wisconsin,33,Dunn County,0,10,-10
18,Indiana,55,Wisconsin,35,Eau Claire County,0,65,-65
18,Indiana,55,Wisconsin,39,Fond du Lac County,129,18,111
18,Indiana,55,Wisconsin,41,Forest County,0,16,-16
18,Indiana,55,Wisconsin,43,Grant County,3,14,-11
18,Indiana,55,Wisconsin,45,Green County,0,17,-17
18,Indiana,55,Wisconsin,47,Green Lake County,15,23,-8
18,Indiana,55,Wisconsin,49,Iowa County,0,2,-2
18,Indiana,55,Wisconsin,55,Jefferson County,34,0,34
18,Indiana,55,Wisconsin,57,Juneau County,4,12,-8
18,Indiana,55,Wisconsin,59,Kenosha County,4,222,-218
18,Indiana,55,Wisconsin,61,Kewaunee County,0,6,-6
18,Indiana,55,Wisconsin,63,La Crosse County,14,12,2
18,Indiana,55,Wisconsin,67,Langlade County,20,0,20
18,Indiana,55,Wisconsin,69,Lincoln County,0,25,-25
18,Indiana,55,Wisconsin,71,Manitowoc County,8,0,8
18,Indiana,55,Wisconsin,73,Marathon County,57,15,42
18,Indiana,55,Wisconsin,75,Marinette County,22,0,22
18,Indiana,55,Wisconsin,78,Menominee County,0,2,-2
18,Indiana,55,Wisconsin,79,Milwaukee County,934,659,275
18,Indiana,55,Wisconsin,81,Monroe County,54,1,53
18,Indiana,55,Wisconsin,83,Oconto County,46,1,45
18,Indiana,55,Wisconsin,85,Oneida County,41,1,40
18,Indiana,55,Wisconsin,87,Outagamie County,47,46,1
18,Indiana,55,Wisconsin,89,Ozaukee County,34,153,-119
18,Indiana,55,Wisconsin,93,Pierce County,0,21,-21
18,Indiana,55,Wisconsin,95,Polk County,27,0,27
18,Indiana,55,Wisconsin,97,Portage County,13,0,13
18,Indiana,55,Wisconsin,99,Price County,0,5,-5
18,Indiana,55,Wisconsin,101,Racine County,179,49,130
18,Indiana,55,Wisconsin,103,Richland County,0,3,-3
18,Indiana,55,Wisconsin,105,Rock County,243,104,139
18,Indiana,55,Wisconsin,107,Rusk County,0,2,-2
18,Indiana,55,Wisconsin,109,St. Croix County,11,9,2
18,Indiana,55,Wisconsin,111,Sauk County,0,62,-62
18,Indiana,55,Wisconsin,113,Sawyer County,0,19,-19
18,Indiana,55,Wisconsin,117,Sheboygan County,67,62,5
18,Indiana,55,Wisconsin,121,Trempealeau County,0,25,-25
18,Indiana,55,Wisconsin,123,Vernon County,0,6,-6
18,Indiana,55,Wisconsin,127,Walworth County,40,43,-3
18,Indiana,55,Wisconsin,131,Washington County,45,33,12
18,Indiana,55,Wisconsin,133,Waukesha County,266,205,61
18,Indiana,55,Wisconsin,135,Waupaca County,22,0,22
18,Indiana,55,Wisconsin,139,Winnebago County,25,41,-16
18,Indiana,56,Wyoming,1,Albany County,7,75,-68
18,Indiana,56,Wyoming,5,Campbell County,0,10,-10
18,Indiana,56,Wyoming,13,Fremont County,0,8,-8
18,Indiana,56,Wyoming,17,Hot Springs County,10,21,-11
18,Indiana,56,Wyoming,19,Johnson County,0,5,-5
18,Indiana,56,Wyoming,21,Laramie County,104,53,51
18,Indiana,56,Wyoming,23,Lincoln County,0,7,-7
18,Indiana,56,Wyoming,25,Natrona County,25,0,25
18,Indiana,56,Wyoming,29,Park County,2,13,-11
18,Indiana,56,Wyoming,33,Sheridan County,0,48,-48
18,Indiana,56,Wyoming,37,Sweetwater County,0,11,-11
18,Indiana,56,Wyoming,39,Teton County,0,4,-4
18,Indiana,6,California,1,Alameda County,386,387,-1
18,Indiana,6,California,7,Butte County,0,109,-109
18,Indiana,6,California,13,Contra Costa County,56,174,-118
18,Indiana,6,California,15,Del Norte County,78,0,78
18,Indiana,6,California,17,El Dorado County,2,15,-13
18,Indiana,6,California,19,Fresno County,133,2,131
18,Indiana,6,California,21,Glenn County,26,0,26
18,Indiana,6,California,23,Humboldt County,0,6,-6
18,Indiana,6,California,25,Imperial County,25,0,25
18,Indiana,6,California,29,Kern County,115,32,83
18,Indiana,6,California,31,Kings County,26,0,26
18,Indiana,6,California,37,Los Angeles County,1734,1541,193
18,Indiana,6,California,39,Madera County,0,21,-21
18,Indiana,6,California,41,Marin County,46,22,24
18,Indiana,6,California,47,Merced County,10,11,-1
18,Indiana,6,California,53,Monterey County,50,69,-19
18,Indiana,6,California,55,Napa County,23,60,-37
18,Indiana,6,California,57,Nevada County,0,27,-27
18,Indiana,6,California,59,Orange County,678,454,224
18,Indiana,6,California,61,Placer County,8,114,-106
18,Indiana,6,California,65,Riverside County,309,401,-92
18,Indiana,6,California,67,Sacramento County,262,137,125
18,Indiana,6,California,71,San Bernardino County,240,308,-68
18,Indiana,6,California,73,San Diego County,1654,1215,439
18,Indiana,6,California,75,San Francisco County,231,159,72
18,Indiana,6,California,77,San Joaquin County,40,23,17
18,Indiana,6,California,79,San Luis Obispo County,60,0,60
18,Indiana,6,California,81,San Mateo County,121,40,81
18,Indiana,6,California,83,Santa Barbara County,32,23,9
18,Indiana,6,California,85,Santa Clara County,393,816,-423
18,Indiana,6,California,87,Santa Cruz County,42,77,-35
18,Indiana,6,California,89,Shasta County,0,31,-31
18,Indiana,6,California,95,Solano County,117,78,39
18,Indiana,6,California,97,Sonoma County,32,62,-30
18,Indiana,6,California,99,Stanislaus County,114,11,103
18,Indiana,6,California,107,Tulare County,115,251,-136
18,Indiana,6,California,109,Tuolumne County,17,4,13
18,Indiana,6,California,111,Ventura County,145,302,-157
18,Indiana,6,California,113,Yolo County,17,67,-50
18,Indiana,72,Puerto Rico,5,Aguadilla Municipio,0,23,-23
18,Indiana,72,Puerto Rico,25,Caguas Municipio,0,64,-64
18,Indiana,72,Puerto Rico,31,Carolina Municipio,0,34,-34
18,Indiana,72,Puerto Rico,59,Guayanilla Municipio,13,0,13
18,Indiana,72,Puerto Rico,63,Gurabo Municipio,0,17,-17
18,Indiana,72,Puerto Rico,95,Maunabo Municipio,12,0,12
18,Indiana,72,Puerto Rico,99,Moca Municipio,21,0,21
18,Indiana,72,Puerto Rico,109,Patillas Municipio,25,0,25
18,Indiana,72,Puerto Rico,113,Ponce Municipio,0,11,-11
18,Indiana,72,Puerto Rico,127,San Juan Municipio,142,0,142
18,Indiana,8,Colorado,1,Adams County,3,133,-130
18,Indiana,8,Colorado,5,Arapahoe County,157,403,-246
18,Indiana,8,Colorado,7,Archuleta County,0,11,-11
18,Indiana,8,Colorado,13,Boulder County,31,271,-240
18,Indiana,8,Colorado,14,Broomfield County,10,77,-67
18,Indiana,8,Colorado,31,Denver County,229,470,-241
18,Indiana,8,Colorado,35,Douglas County,160,168,-8
18,Indiana,8,Colorado,37,Eagle County,0,9,-9
18,Indiana,8,Colorado,41,El Paso County,666,459,207
18,Indiana,8,Colorado,43,Fremont County,29,81,-52
18,Indiana,8,Colorado,59,Jefferson County,212,123,89
18,Indiana,8,Colorado,67,La Plata County,4,0,4
18,Indiana,8,Colorado,69,Larimer County,59,110,-51
18,Indiana,8,Colorado,75,Logan County,8,9,-1
18,Indiana,8,Colorado,77,Mesa County,13,20,-7
18,Indiana,8,Colorado,83,Montezuma County,0,43,-43
18,Indiana,8,Colorado,85,Montrose County,41,16,25
18,Indiana,8,Colorado,93,Park County,190,0,190
18,Indiana,8,Colorado,97,Pitkin County,0,1,-1
18,Indiana,8,Colorado,99,Prowers County,0,13,-13
18,Indiana,8,Colorado,101,Pueblo County,59,37,22
18,Indiana,8,Colorado,105,Rio Grande County,11,0,11
18,Indiana,8,Colorado,107,Routt County,0,6,-6
18,Indiana,8,Colorado,113,San Miguel County,0,2,-2
18,Indiana,8,Colorado,117,Summit County,26,9,17
18,Indiana,8,Colorado,119,Teller County,11,0,11
18,Indiana,8,Colorado,123,Weld County,113,102,11
18,Indiana,9,Connecticut,1,Fairfield County,240,65,175
18,Indiana,9,Connecticut,3,Hartford County,150,121,29
18,Indiana,9,Connecticut,5,Litchfield County,0,15,-15
18,Indiana,9,Connecticut,7,Middlesex County,57,12,45
18,Indiana,9,Connecticut,9,New Haven County,299,72,227
18,Indiana,9,Connecticut,11,New London County,7,125,-118
18,Indiana,9,Connecticut,15,Windham County,0,58,-58
18,Indiana,AFR,Africa,,-,1907,0,0
18,Indiana,ASI,Asia,,-,13364,0,0
18,Indiana,CAM,Central America,,-,2417,0,0
18,Indiana,CAR,Caribbean,,-,750,0,0
18,Indiana,EUR,Europe,,-,3540,0,0
18,Indiana,ISL,U.S. Island Areas,,-,71,0,0
18,Indiana,NAM,Northern America,,-,575,0,0
18,Indiana,OCE,Oceania and At Sea,,-,407,0,0
18,Indiana,SAM,South America,,-,1351,0,0
19,Iowa,1,Alabama,1,Autauga County,0,51,-51
19,Iowa,1,Alabama,3,Baldwin County,7,64,-57
19,Iowa,1,Alabama,19,Cherokee County,0,13,-13
19,Iowa,1,Alabama,21,Chilton County,31,14,17
19,Iowa,1,Alabama,23,Choctaw County,0,7,-7
19,Iowa,1,Alabama,31,Coffee County,3,0,3
19,Iowa,1,Alabama,33,Colbert County,22,0,22
19,Iowa,1,Alabama,45,Dale County,30,0,30
19,Iowa,1,Alabama,53,Escambia County,0,32,-32
19,Iowa,1,Alabama,55,Etowah County,52,0,52
19,Iowa,1,Alabama,73,Jefferson County,63,40,23
19,Iowa,1,Alabama,77,Lauderdale County,0,19,-19
19,Iowa,1,Alabama,81,Lee County,101,18,83
19,Iowa,1,Alabama,89,Madison County,24,63,-39
19,Iowa,1,Alabama,95,Marshall County,25,6,19
19,Iowa,1,Alabama,97,Mobile County,16,66,-50
19,Iowa,1,Alabama,101,Montgomery County,0,50,-50
19,Iowa,1,Alabama,111,Randolph County,0,7,-7
19,Iowa,1,Alabama,113,Russell County,59,0,59
19,Iowa,1,Alabama,117,Shelby County,83,41,42
19,Iowa,1,Alabama,123,Tallapoosa County,1,0,1
19,Iowa,1,Alabama,125,Tuscaloosa County,0,17,-17
19,Iowa,1,Alabama,133,Winston County,14,0,14
19,Iowa,10,Delaware,1,Kent County,17,0,17
19,Iowa,10,Delaware,3,New Castle County,0,16,-16
19,Iowa,10,Delaware,5,Sussex County,112,0,112
19,Iowa,11,District of Columbia,1,District of Columbia,49,88,-39
19,Iowa,12,Florida,1,Alachua County,294,24,270
19,Iowa,12,Florida,5,Bay County,3,128,-125
19,Iowa,12,Florida,9,Brevard County,17,154,-137
19,Iowa,12,Florida,11,Broward County,257,9,248
19,Iowa,12,Florida,13,Calhoun County,0,176,-176
19,Iowa,12,Florida,15,Charlotte County,21,148,-127
19,Iowa,12,Florida,17,Citrus County,16,29,-13
19,Iowa,12,Florida,19,Clay County,21,328,-307
19,Iowa,12,Florida,21,Collier County,11,118,-107
19,Iowa,12,Florida,31,Duval County,444,535,-91
19,Iowa,12,Florida,33,Escambia County,11,113,-102
19,Iowa,12,Florida,35,Flagler County,0,19,-19
19,Iowa,12,Florida,39,Gadsden County,9,0,9
19,Iowa,12,Florida,49,Hardee County,0,7,-7
19,Iowa,12,Florida,53,Hernando County,22,13,9
19,Iowa,12,Florida,55,Highlands County,111,0,111
19,Iowa,12,Florida,57,Hillsborough County,306,205,101
19,Iowa,12,Florida,61,Indian River County,1,0,1
19,Iowa,12,Florida,63,Jackson County,0,13,-13
19,Iowa,12,Florida,67,Lafayette County,0,7,-7
19,Iowa,12,Florida,69,Lake County,47,9,38
19,Iowa,12,Florida,71,Lee County,150,173,-23
19,Iowa,12,Florida,73,Leon County,41,186,-145
19,Iowa,12,Florida,75,Levy County,32,0,32
19,Iowa,12,Florida,81,Manatee County,70,95,-25
19,Iowa,12,Florida,83,Marion County,11,53,-42
19,Iowa,12,Florida,85,Martin County,0,103,-103
19,Iowa,12,Florida,86,Miami-Dade County,257,8,249
19,Iowa,12,Florida,87,Monroe County,0,26,-26
19,Iowa,12,Florida,89,Nassau County,11,0,11
19,Iowa,12,Florida,91,Okaloosa County,74,51,23
19,Iowa,12,Florida,93,Okeechobee County,0,22,-22
19,Iowa,12,Florida,95,Orange County,237,375,-138
19,Iowa,12,Florida,97,Osceola County,42,0,42
19,Iowa,12,Florida,99,Palm Beach County,59,112,-53
19,Iowa,12,Florida,101,Pasco County,54,190,-136
19,Iowa,12,Florida,103,Pinellas County,139,300,-161
19,Iowa,12,Florida,105,Polk County,45,69,-24
19,Iowa,12,Florida,107,Putnam County,0,20,-20
19,Iowa,12,Florida,109,St. Johns County,21,0,21
19,Iowa,12,Florida,111,St. Lucie County,29,39,-10
19,Iowa,12,Florida,113,Santa Rosa County,25,0,25
19,Iowa,12,Florida,115,Sarasota County,48,143,-95
19,Iowa,12,Florida,117,Seminole County,19,104,-85
19,Iowa,12,Florida,119,Sumter County,0,30,-30
19,Iowa,12,Florida,127,Volusia County,22,146,-124
19,Iowa,12,Florida,129,Wakulla County,15,0,15
19,Iowa,12,Florida,131,Walton County,15,0,15
19,Iowa,13,Georgia,1,Appling County,24,0,24
19,Iowa,13,Georgia,15,Bartow County,0,30,-30
19,Iowa,13,Georgia,29,Bryan County,0,15,-15
19,Iowa,13,Georgia,31,Bulloch County,13,0,13
19,Iowa,13,Georgia,39,Camden County,51,15,36
19,Iowa,13,Georgia,45,Carroll County,8,0,8
19,Iowa,13,Georgia,51,Chatham County,19,17,2
19,Iowa,13,Georgia,53,Chattahoochee County,3,30,-27
19,Iowa,13,Georgia,59,Clarke County,6,59,-53
19,Iowa,13,Georgia,67,Cobb County,91,145,-54
19,Iowa,13,Georgia,73,Columbia County,15,139,-124
19,Iowa,13,Georgia,77,Coweta County,29,128,-99
19,Iowa,13,Georgia,89,DeKalb County,129,71,58
19,Iowa,13,Georgia,111,Fannin County,5,0,5
19,Iowa,13,Georgia,117,Forsyth County,33,77,-44
19,Iowa,13,Georgia,121,Fulton County,118,163,-45
19,Iowa,13,Georgia,135,Gwinnett County,374,14,360
19,Iowa,13,Georgia,139,Hall County,113,18,95
19,Iowa,13,Georgia,145,Harris County,0,8,-8
19,Iowa,13,Georgia,153,Houston County,97,0,97
19,Iowa,13,Georgia,163,Jefferson County,0,32,-32
19,Iowa,13,Georgia,179,Liberty County,2,0,2
19,Iowa,13,Georgia,183,Long County,15,0,15
19,Iowa,13,Georgia,185,Lowndes County,0,4,-4
19,Iowa,13,Georgia,215,Muscogee County,11,102,-91
19,Iowa,13,Georgia,217,Newton County,8,0,8
19,Iowa,13,Georgia,219,Oconee County,0,34,-34
19,Iowa,13,Georgia,221,Oglethorpe County,0,1,-1
19,Iowa,13,Georgia,223,Paulding County,0,76,-76
19,Iowa,13,Georgia,233,Polk County,5,0,5
19,Iowa,13,Georgia,237,Putnam County,4,0,4
19,Iowa,13,Georgia,241,Rabun County,5,0,5
19,Iowa,13,Georgia,245,Richmond County,0,61,-61
19,Iowa,13,Georgia,247,Rockdale County,50,171,-121
19,Iowa,13,Georgia,255,Spalding County,0,2,-2
19,Iowa,13,Georgia,291,Union County,16,0,16
19,Iowa,13,Georgia,305,Wayne County,0,47,-47
19,Iowa,13,Georgia,313,Whitfield County,24,9,15
19,Iowa,15,Hawaii,1,Hawaii County,47,112,-65
19,Iowa,15,Hawaii,3,Honolulu County,142,320,-178
19,Iowa,15,Hawaii,7,Kauai County,0,17,-17
19,Iowa,16,Idaho,1,Ada County,151,38,113
19,Iowa,16,Idaho,5,Bannock County,41,23,18
19,Iowa,16,Idaho,11,Bingham County,29,0,29
19,Iowa,16,Idaho,17,Bonner County,0,22,-22
19,Iowa,16,Idaho,19,Bonneville County,6,0,6
19,Iowa,16,Idaho,27,Canyon County,82,98,-16
19,Iowa,16,Idaho,31,Cassia County,10,0,10
19,Iowa,16,Idaho,41,Franklin County,0,1,-1
19,Iowa,16,Idaho,45,Gem County,85,32,53
19,Iowa,16,Idaho,65,Madison County,48,0,48
19,Iowa,16,Idaho,67,Minidoka County,24,0,24
19,Iowa,16,Idaho,69,Nez Perce County,16,0,16
19,Iowa,16,Idaho,73,Owyhee County,13,0,13
19,Iowa,16,Idaho,75,Payette County,0,39,-39
19,Iowa,17,Illinois,1,Adams County,58,124,-66
19,Iowa,17,Illinois,5,Bond County,59,13,46
19,Iowa,17,Illinois,7,Boone County,46,12,34
19,Iowa,17,Illinois,11,Bureau County,40,29,11
19,Iowa,17,Illinois,15,Carroll County,160,83,77
19,Iowa,17,Illinois,17,Cass County,0,1,-1
19,Iowa,17,Illinois,19,Champaign County,230,204,26
19,Iowa,17,Illinois,21,Christian County,0,2,-2
19,Iowa,17,Illinois,27,Clinton County,0,9,-9
19,Iowa,17,Illinois,29,Coles County,0,19,-19
19,Iowa,17,Illinois,31,Cook County,3996,2166,1830
19,Iowa,17,Illinois,37,DeKalb County,94,50,44
19,Iowa,17,Illinois,39,De Witt County,69,3,66
19,Iowa,17,Illinois,43,DuPage County,910,246,664
19,Iowa,17,Illinois,45,Edgar County,7,0,7
19,Iowa,17,Illinois,49,Effingham County,3,1,2
19,Iowa,17,Illinois,53,Ford County,0,3,-3
19,Iowa,17,Illinois,57,Fulton County,0,42,-42
19,Iowa,17,Illinois,63,Grundy County,21,15,6
19,Iowa,17,Illinois,67,Hancock County,419,151,268
19,Iowa,17,Illinois,71,Henderson County,90,141,-51
19,Iowa,17,Illinois,73,Henry County,471,144,327
19,Iowa,17,Illinois,75,Iroquois County,4,8,-4
19,Iowa,17,Illinois,77,Jackson County,4,0,4
19,Iowa,17,Illinois,79,Jasper County,0,3,-3
19,Iowa,17,Illinois,83,Jersey County,22,0,22
19,Iowa,17,Illinois,85,Jo Daviess County,481,394,87
19,Iowa,17,Illinois,89,Kane County,566,113,453
19,Iowa,17,Illinois,91,Kankakee County,8,17,-9
19,Iowa,17,Illinois,93,Kendall County,93,35,58
19,Iowa,17,Illinois,95,Knox County,111,37,74
19,Iowa,17,Illinois,97,Lake County,487,493,-6
19,Iowa,17,Illinois,99,LaSalle County,73,2,71
19,Iowa,17,Illinois,103,Lee County,62,0,62
19,Iowa,17,Illinois,105,Livingston County,5,0,5
19,Iowa,17,Illinois,107,Logan County,0,5,-5
19,Iowa,17,Illinois,109,McDonough County,55,226,-171
19,Iowa,17,Illinois,111,McHenry County,464,297,167
19,Iowa,17,Illinois,113,McLean County,250,301,-51
19,Iowa,17,Illinois,115,Macon County,117,56,61
19,Iowa,17,Illinois,117,Macoupin County,0,16,-16
19,Iowa,17,Illinois,119,Madison County,354,16,338
19,Iowa,17,Illinois,125,Mason County,0,23,-23
19,Iowa,17,Illinois,127,Massac County,0,9,-9
19,Iowa,17,Illinois,131,Mercer County,80,64,16
19,Iowa,17,Illinois,133,Monroe County,0,65,-65
19,Iowa,17,Illinois,135,Montgomery County,8,1,7
19,Iowa,17,Illinois,137,Morgan County,77,4,73
19,Iowa,17,Illinois,139,Moultrie County,0,14,-14
19,Iowa,17,Illinois,141,Ogle County,90,39,51
19,Iowa,17,Illinois,143,Peoria County,245,204,41
19,Iowa,17,Illinois,147,Piatt County,14,0,14
19,Iowa,17,Illinois,149,Pike County,22,30,-8
19,Iowa,17,Illinois,161,Rock Island County,2051,1776,275
19,Iowa,17,Illinois,163,St. Clair County,26,27,-1
19,Iowa,17,Illinois,165,Saline County,3,0,3
19,Iowa,17,Illinois,167,Sangamon County,67,107,-40
19,Iowa,17,Illinois,177,Stephenson County,49,7,42
19,Iowa,17,Illinois,179,Tazewell County,153,51,102
19,Iowa,17,Illinois,183,Vermilion County,3,13,-10
19,Iowa,17,Illinois,187,Warren County,62,96,-34
19,Iowa,17,Illinois,189,Washington County,0,4,-4
19,Iowa,17,Illinois,195,Whiteside County,370,284,86
19,Iowa,17,Illinois,197,Will County,447,257,190
19,Iowa,17,Illinois,199,Williamson County,22,0,22
19,Iowa,17,Illinois,201,Winnebago County,339,87,252
19,Iowa,17,Illinois,203,Woodford County,40,52,-12
19,Iowa,18,Indiana,1,Adams County,38,11,27
19,Iowa,18,Indiana,3,Allen County,210,267,-57
19,Iowa,18,Indiana,5,Bartholomew County,35,0,35
19,Iowa,18,Indiana,7,Benton County,0,3,-3
19,Iowa,18,Indiana,9,Blackford County,0,46,-46
19,Iowa,18,Indiana,19,Clark County,45,12,33
19,Iowa,18,Indiana,21,Clay County,0,8,-8
19,Iowa,18,Indiana,31,Decatur County,9,0,9
19,Iowa,18,Indiana,35,Delaware County,21,45,-24
19,Iowa,18,Indiana,39,Elkhart County,22,21,1
19,Iowa,18,Indiana,41,Fayette County,65,0,65
19,Iowa,18,Indiana,51,Gibson County,0,21,-21
19,Iowa,18,Indiana,53,Grant County,17,27,-10
19,Iowa,18,Indiana,55,Greene County,29,0,29
19,Iowa,18,Indiana,57,Hamilton County,77,98,-21
19,Iowa,18,Indiana,59,Hancock County,22,0,22
19,Iowa,18,Indiana,63,Hendricks County,24,21,3
19,Iowa,18,Indiana,67,Howard County,44,0,44
19,Iowa,18,Indiana,69,Huntington County,6,10,-4
19,Iowa,18,Indiana,75,Jay County,0,5,-5
19,Iowa,18,Indiana,81,Johnson County,18,0,18
19,Iowa,18,Indiana,83,Knox County,32,0,32
19,Iowa,18,Indiana,87,LaGrange County,22,0,22
19,Iowa,18,Indiana,89,Lake County,151,205,-54
19,Iowa,18,Indiana,91,LaPorte County,0,9,-9
19,Iowa,18,Indiana,93,Lawrence County,2,0,2
19,Iowa,18,Indiana,95,Madison County,40,22,18
19,Iowa,18,Indiana,97,Marion County,446,222,224
19,Iowa,18,Indiana,99,Marshall County,13,0,13
19,Iowa,18,Indiana,103,Miami County,17,0,17
19,Iowa,18,Indiana,105,Monroe County,109,118,-9
19,Iowa,18,Indiana,107,Montgomery County,97,0,97
19,Iowa,18,Indiana,111,Newton County,4,30,-26
19,Iowa,18,Indiana,113,Noble County,0,13,-13
19,Iowa,18,Indiana,121,Parke County,0,4,-4
19,Iowa,18,Indiana,127,Porter County,11,10,1
19,Iowa,18,Indiana,141,St. Joseph County,162,40,122
19,Iowa,18,Indiana,151,Steuben County,12,0,12
19,Iowa,18,Indiana,157,Tippecanoe County,75,254,-179
19,Iowa,18,Indiana,163,Vanderburgh County,36,8,28
19,Iowa,18,Indiana,167,Vigo County,81,19,62
19,Iowa,18,Indiana,169,Wabash County,0,22,-22
19,Iowa,18,Indiana,175,Washington County,29,0,29
19,Iowa,18,Indiana,177,Wayne County,44,0,44
19,Iowa,18,Indiana,181,White County,19,0,19
19,Iowa,19,Iowa,1,Adair County,813,514,299
19,Iowa,19,Iowa,3,Adams County,356,89,267
19,Iowa,19,Iowa,5,Allamakee County,295,273,22
19,Iowa,19,Iowa,7,Appanoose County,610,511,99
19,Iowa,19,Iowa,9,Audubon County,467,303,164
19,Iowa,19,Iowa,11,Benton County,1548,1445,103
19,Iowa,19,Iowa,13,Black Hawk County,5412,5688,-276
19,Iowa,19,Iowa,15,Boone County,1550,1169,381
19,Iowa,19,Iowa,17,Bremer County,1086,1272,-186
19,Iowa,19,Iowa,19,Buchanan County,1103,850,253
19,Iowa,19,Iowa,21,Buena Vista County,526,825,-299
19,Iowa,19,Iowa,23,Butler County,628,512,116
19,Iowa,19,Iowa,25,Calhoun County,966,992,-26
19,Iowa,19,Iowa,27,Carroll County,877,656,221
19,Iowa,19,Iowa,29,Cass County,634,556,78
19,Iowa,19,Iowa,31,Cedar County,714,763,-49
19,Iowa,19,Iowa,33,Cerro Gordo County,1794,1309,485
19,Iowa,19,Iowa,35,Cherokee County,534,278,256
19,Iowa,19,Iowa,37,Chickasaw County,594,298,296
19,Iowa,19,Iowa,39,Clarke County,310,376,-66
19,Iowa,19,Iowa,41,Clay County,959,1068,-109
19,Iowa,19,Iowa,43,Clayton County,695,382,313
19,Iowa,19,Iowa,45,Clinton County,902,819,83
19,Iowa,19,Iowa,47,Crawford County,594,474,120
19,Iowa,19,Iowa,49,Dallas County,5386,5494,-108
19,Iowa,19,Iowa,51,Davis County,407,281,126
19,Iowa,19,Iowa,53,Decatur County,354,354,0
19,Iowa,19,Iowa,55,Delaware County,843,497,346
19,Iowa,19,Iowa,57,Des Moines County,890,1051,-161
19,Iowa,19,Iowa,59,Dickinson County,638,434,204
19,Iowa,19,Iowa,61,Dubuque County,2031,1878,153
19,Iowa,19,Iowa,63,Emmet County,352,334,18
19,Iowa,19,Iowa,65,Fayette County,650,853,-203
19,Iowa,19,Iowa,67,Floyd County,489,318,171
19,Iowa,19,Iowa,69,Franklin County,447,286,161
19,Iowa,19,Iowa,71,Fremont County,444,166,278
19,Iowa,19,Iowa,73,Greene County,575,452,123
19,Iowa,19,Iowa,75,Grundy County,615,342,273
19,Iowa,19,Iowa,77,Guthrie County,592,478,114
19,Iowa,19,Iowa,79,Hamilton County,788,435,353
19,Iowa,19,Iowa,81,Hancock County,424,415,9
19,Iowa,19,Iowa,83,Hardin County,943,681,262
19,Iowa,19,Iowa,85,Harrison County,737,310,427
19,Iowa,19,Iowa,87,Henry County,875,865,10
19,Iowa,19,Iowa,89,Howard County,248,239,9
19,Iowa,19,Iowa,91,Humboldt County,485,537,-52
19,Iowa,19,Iowa,93,Ida County,321,267,54
19,Iowa,19,Iowa,95,Iowa County,677,716,-39
19,Iowa,19,Iowa,97,Jackson County,458,566,-108
19,Iowa,19,Iowa,99,Jasper County,1908,2196,-288
19,Iowa,19,Iowa,101,Jefferson County,641,539,102
19,Iowa,19,Iowa,103,Johnson County,5647,7084,-1437
19,Iowa,19,Iowa,105,Jones County,995,788,207
19,Iowa,19,Iowa,107,Keokuk County,537,442,95
19,Iowa,19,Iowa,109,Kossuth County,660,425,235
19,Iowa,19,Iowa,111,Lee County,1214,584,630
19,Iowa,19,Iowa,113,Linn County,6283,6416,-133
19,Iowa,19,Iowa,115,Louisa County,222,384,-162
19,Iowa,19,Iowa,117,Lucas County,279,390,-111
19,Iowa,19,Iowa,119,Lyon County,249,211,38
19,Iowa,19,Iowa,121,Madison County,800,669,131
19,Iowa,19,Iowa,123,Mahaska County,1184,742,442
19,Iowa,19,Iowa,125,Marion County,1262,1735,-473
19,Iowa,19,Iowa,127,Marshall County,1306,1323,-17
19,Iowa,19,Iowa,129,Mills County,488,672,-184
19,Iowa,19,Iowa,131,Mitchell County,315,151,164
19,Iowa,19,Iowa,133,Monona County,467,412,55
19,Iowa,19,Iowa,135,Monroe County,640,380,260
19,Iowa,19,Iowa,137,Montgomery County,462,373,89
19,Iowa,19,Iowa,139,Muscatine County,1086,728,358
19,Iowa,19,Iowa,141,O'Brien County,468,789,-321
19,Iowa,19,Iowa,143,Osceola County,555,239,316
19,Iowa,19,Iowa,145,Page County,627,754,-127
19,Iowa,19,Iowa,147,Palo Alto County,525,583,-58
19,Iowa,19,Iowa,149,Plymouth County,1035,547,488
19,Iowa,19,Iowa,151,Pocahontas County,385,298,87
19,Iowa,19,Iowa,153,Polk County,13973,16324,-2351
19,Iowa,19,Iowa,155,Pottawattamie County,2315,2030,285
19,Iowa,19,Iowa,157,Poweshiek County,1062,950,112
19,Iowa,19,Iowa,159,Ringgold County,217,138,79
19,Iowa,19,Iowa,161,Sac County,376,385,-9
19,Iowa,19,Iowa,163,Scott County,2951,1929,1022
19,Iowa,19,Iowa,165,Shelby County,414,391,23
19,Iowa,19,Iowa,167,Sioux County,835,694,141
19,Iowa,19,Iowa,169,Story County,4037,8373,-4336
19,Iowa,19,Iowa,171,Tama County,849,726,123
19,Iowa,19,Iowa,173,Taylor County,279,284,-5
19,Iowa,19,Iowa,175,Union County,854,663,191
19,Iowa,19,Iowa,177,Van Buren County,267,150,117
19,Iowa,19,Iowa,179,Wapello County,1381,1203,178
19,Iowa,19,Iowa,181,Warren County,2516,3214,-698
19,Iowa,19,Iowa,183,Washington County,856,779,77
19,Iowa,19,Iowa,185,Wayne County,317,108,209
19,Iowa,19,Iowa,187,Webster County,1629,2350,-721
19,Iowa,19,Iowa,189,Winnebago County,677,595,82
19,Iowa,19,Iowa,191,Winneshiek County,413,599,-186
19,Iowa,19,Iowa,193,Woodbury County,2231,1968,263
19,Iowa,19,Iowa,195,Worth County,177,328,-151
19,Iowa,19,Iowa,197,Wright County,662,458,204
19,Iowa,2,Alaska,20,Anchorage Municipality,460,143,317
19,Iowa,2,Alaska,90,Fairbanks North Star Borough,121,0,121
19,Iowa,2,Alaska,110,Juneau City and Borough,11,9,2
19,Iowa,2,Alaska,150,Kodiak Island Borough,135,0,135
19,Iowa,2,Alaska,170,Matanuska-Susitna Borough,155,14,141
19,Iowa,2,Alaska,195,Petersburg Borough,4,0,4
19,Iowa,2,Alaska,220,Sitka City and Borough,5,0,5
19,Iowa,20,Kansas,5,Atchison County,31,30,1
19,Iowa,20,Kansas,7,Barber County,10,0,10
19,Iowa,20,Kansas,15,Butler County,59,24,35
19,Iowa,20,Kansas,21,Cherokee County,21,0,21
19,Iowa,20,Kansas,35,Cowley County,0,9,-9
19,Iowa,20,Kansas,41,Dickinson County,0,36,-36
19,Iowa,20,Kansas,43,Doniphan County,0,3,-3
19,Iowa,20,Kansas,45,Douglas County,258,100,158
19,Iowa,20,Kansas,47,Edwards County,0,1,-1
19,Iowa,20,Kansas,51,Ellis County,0,63,-63
19,Iowa,20,Kansas,57,Ford County,119,6,113
19,Iowa,20,Kansas,59,Franklin County,5,0,5
19,Iowa,20,Kansas,61,Geary County,0,124,-124
19,Iowa,20,Kansas,79,Harvey County,36,1,35
19,Iowa,20,Kansas,85,Jackson County,0,5,-5
19,Iowa,20,Kansas,87,Jefferson County,12,0,12
19,Iowa,20,Kansas,91,Johnson County,512,743,-231
19,Iowa,20,Kansas,95,Kingman County,0,1,-1
19,Iowa,20,Kansas,97,Kiowa County,27,1,26
19,Iowa,20,Kansas,103,Leavenworth County,102,131,-29
19,Iowa,20,Kansas,107,Linn County,0,10,-10
19,Iowa,20,Kansas,111,Lyon County,55,17,38
19,Iowa,20,Kansas,113,McPherson County,31,0,31
19,Iowa,20,Kansas,121,Miami County,39,4,35
19,Iowa,20,Kansas,123,Mitchell County,9,0,9
19,Iowa,20,Kansas,125,Montgomery County,0,111,-111
19,Iowa,20,Kansas,139,Osage County,11,0,11
19,Iowa,20,Kansas,141,Osborne County,0,3,-3
19,Iowa,20,Kansas,145,Pawnee County,0,15,-15
19,Iowa,20,Kansas,147,Phillips County,0,4,-4
19,Iowa,20,Kansas,151,Pratt County,10,0,10
19,Iowa,20,Kansas,155,Reno County,171,0,171
19,Iowa,20,Kansas,157,Republic County,0,36,-36
19,Iowa,20,Kansas,161,Riley County,8,59,-51
19,Iowa,20,Kansas,165,Rush County,4,0,4
19,Iowa,20,Kansas,169,Saline County,28,14,14
19,Iowa,20,Kansas,173,Sedgwick County,270,209,61
19,Iowa,20,Kansas,175,Seward County,23,0,23
19,Iowa,20,Kansas,177,Shawnee County,173,80,93
19,Iowa,20,Kansas,187,Stanton County,15,0,15
19,Iowa,20,Kansas,195,Trego County,0,2,-2
19,Iowa,20,Kansas,197,Wabaunsee County,11,0,11
19,Iowa,20,Kansas,209,Wyandotte County,3,64,-61
19,Iowa,21,Kentucky,1,Adair County,2,0,2
19,Iowa,21,Kentucky,9,Barren County,12,0,12
19,Iowa,21,Kentucky,19,Boyd County,0,17,-17
19,Iowa,21,Kentucky,25,Breathitt County,0,17,-17
19,Iowa,21,Kentucky,33,Caldwell County,2,0,2
19,Iowa,21,Kentucky,37,Campbell County,0,17,-17
19,Iowa,21,Kentucky,43,Carter County,0,5,-5
19,Iowa,21,Kentucky,45,Casey County,0,5,-5
19,Iowa,21,Kentucky,47,Christian County,43,255,-212
19,Iowa,21,Kentucky,51,Clay County,7,0,7
19,Iowa,21,Kentucky,59,Daviess County,16,0,16
19,Iowa,21,Kentucky,67,Fayette County,19,68,-49
19,Iowa,21,Kentucky,71,Floyd County,0,7,-7
19,Iowa,21,Kentucky,73,Franklin County,40,0,40
19,Iowa,21,Kentucky,83,Graves County,0,92,-92
19,Iowa,21,Kentucky,93,Hardin County,73,112,-39
19,Iowa,21,Kentucky,105,Hickman County,0,4,-4
19,Iowa,21,Kentucky,111,Jefferson County,108,121,-13
19,Iowa,21,Kentucky,113,Jessamine County,0,5,-5
19,Iowa,21,Kentucky,139,Livingston County,0,34,-34
19,Iowa,21,Kentucky,141,Logan County,9,43,-34
19,Iowa,21,Kentucky,145,McCracken County,0,49,-49
19,Iowa,21,Kentucky,157,Marshall County,22,0,22
19,Iowa,21,Kentucky,159,Martin County,8,0,8
19,Iowa,21,Kentucky,163,Meade County,10,23,-13
19,Iowa,21,Kentucky,191,Pendleton County,0,51,-51
19,Iowa,21,Kentucky,199,Pulaski County,28,0,28
19,Iowa,21,Kentucky,213,Simpson County,8,0,8
19,Iowa,21,Kentucky,219,Todd County,0,5,-5
19,Iowa,21,Kentucky,227,Warren County,55,37,18
19,Iowa,22,Louisiana,5,Ascension Parish,8,146,-138
19,Iowa,22,Louisiana,11,Beauregard Parish,32,0,32
19,Iowa,22,Louisiana,17,Caddo Parish,55,0,55
19,Iowa,22,Louisiana,21,Caldwell Parish,0,7,-7
19,Iowa,22,Louisiana,23,Cameron Parish,0,9,-9
19,Iowa,22,Louisiana,33,East Baton Rouge Parish,35,8,27
19,Iowa,22,Louisiana,43,Grant Parish,11,0,11
19,Iowa,22,Louisiana,47,Iberville Parish,11,0,11
19,Iowa,22,Louisiana,51,Jefferson Parish,0,122,-122
19,Iowa,22,Louisiana,55,Lafayette Parish,42,0,42
19,Iowa,22,Louisiana,57,Lafourche Parish,0,11,-11
19,Iowa,22,Louisiana,63,Livingston Parish,2,0,2
19,Iowa,22,Louisiana,71,Orleans Parish,93,244,-151
19,Iowa,22,Louisiana,73,Ouachita Parish,15,18,-3
19,Iowa,22,Louisiana,83,Richland Parish,7,0,7
19,Iowa,22,Louisiana,87,St. Bernard Parish,6,0,6
19,Iowa,22,Louisiana,89,St. Charles Parish,11,4,7
19,Iowa,22,Louisiana,97,St. Landry Parish,0,3,-3
19,Iowa,22,Louisiana,103,St. Tammany Parish,18,0,18
19,Iowa,22,Louisiana,105,Tangipahoa Parish,0,28,-28
19,Iowa,22,Louisiana,115,Vernon Parish,34,0,34
19,Iowa,23,Maine,1,Androscoggin County,2,7,-5
19,Iowa,23,Maine,5,Cumberland County,53,44,9
19,Iowa,23,Maine,9,Hancock County,0,3,-3
19,Iowa,23,Maine,11,Kennebec County,0,36,-36
19,Iowa,23,Maine,15,Lincoln County,12,0,12
19,Iowa,23,Maine,19,Penobscot County,20,12,8
19,Iowa,23,Maine,23,Sagadahoc County,26,0,26
19,Iowa,23,Maine,31,York County,16,153,-137
19,Iowa,24,Maryland,3,Anne Arundel County,53,40,13
19,Iowa,24,Maryland,5,Baltimore County,41,20,21
19,Iowa,24,Maryland,9,Calvert County,0,11,-11
19,Iowa,24,Maryland,11,Caroline County,0,25,-25
19,Iowa,24,Maryland,15,Cecil County,2,16,-14
19,Iowa,24,Maryland,17,Charles County,99,0,99
19,Iowa,24,Maryland,21,Frederick County,1,48,-47
19,Iowa,24,Maryland,25,Harford County,2,6,-4
19,Iowa,24,Maryland,27,Howard County,124,20,104
19,Iowa,24,Maryland,31,Montgomery County,69,174,-105
19,Iowa,24,Maryland,33,Prince George's County,11,16,-5
19,Iowa,24,Maryland,35,Queen Anne's County,0,35,-35
19,Iowa,24,Maryland,37,St. Mary's County,15,0,15
19,Iowa,24,Maryland,41,Talbot County,0,15,-15
19,Iowa,24,Maryland,43,Washington County,7,0,7
19,Iowa,24,Maryland,510,Baltimore city,98,103,-5
19,Iowa,25,Massachusetts,1,Barnstable County,139,0,139
19,Iowa,25,Massachusetts,9,Essex County,80,0,80
19,Iowa,25,Massachusetts,11,Franklin County,9,78,-69
19,Iowa,25,Massachusetts,15,Hampshire County,37,6,31
19,Iowa,25,Massachusetts,17,Middlesex County,37,166,-129
19,Iowa,25,Massachusetts,21,Norfolk County,0,2,-2
19,Iowa,25,Massachusetts,23,Plymouth County,5,7,-2
19,Iowa,25,Massachusetts,25,Suffolk County,14,119,-105
19,Iowa,25,Massachusetts,27,Worcester County,26,9,17
19,Iowa,26,Michigan,5,Allegan County,7,11,-4
19,Iowa,26,Michigan,7,Alpena County,3,0,3
19,Iowa,26,Michigan,15,Barry County,4,24,-20
19,Iowa,26,Michigan,21,Berrien County,29,116,-87
19,Iowa,26,Michigan,31,Cheboygan County,0,9,-9
19,Iowa,26,Michigan,33,Chippewa County,5,0,5
19,Iowa,26,Michigan,35,Clare County,0,10,-10
19,Iowa,26,Michigan,45,Eaton County,14,15,-1
19,Iowa,26,Michigan,49,Genesee County,74,0,74
19,Iowa,26,Michigan,55,Grand Traverse County,0,5,-5
19,Iowa,26,Michigan,59,Hillsdale County,21,0,21
19,Iowa,26,Michigan,61,Houghton County,0,13,-13
19,Iowa,26,Michigan,65,Ingham County,60,72,-12
19,Iowa,26,Michigan,67,Ionia County,50,3,47
19,Iowa,26,Michigan,71,Iron County,0,2,-2
19,Iowa,26,Michigan,73,Isabella County,4,6,-2
19,Iowa,26,Michigan,75,Jackson County,38,27,11
19,Iowa,26,Michigan,77,Kalamazoo County,24,151,-127
19,Iowa,26,Michigan,79,Kalkaska County,11,0,11
19,Iowa,26,Michigan,81,Kent County,92,129,-37
19,Iowa,26,Michigan,85,Lake County,5,0,5
19,Iowa,26,Michigan,87,Lapeer County,4,31,-27
19,Iowa,26,Michigan,93,Livingston County,34,0,34
19,Iowa,26,Michigan,97,Mackinac County,4,0,4
19,Iowa,26,Michigan,99,Macomb County,63,19,44
19,Iowa,26,Michigan,103,Marquette County,0,12,-12
19,Iowa,26,Michigan,107,Mecosta County,30,0,30
19,Iowa,26,Michigan,117,Montcalm County,19,19,0
19,Iowa,26,Michigan,123,Newaygo County,5,12,-7
19,Iowa,26,Michigan,125,Oakland County,126,72,54
19,Iowa,26,Michigan,127,Oceana County,11,25,-14
19,Iowa,26,Michigan,129,Ogemaw County,0,10,-10
19,Iowa,26,Michigan,131,Ontonagon County,0,4,-4
19,Iowa,26,Michigan,139,Ottawa County,23,31,-8
19,Iowa,26,Michigan,145,Saginaw County,73,17,56
19,Iowa,26,Michigan,147,St. Clair County,6,39,-33
19,Iowa,26,Michigan,149,St. Joseph County,0,62,-62
19,Iowa,26,Michigan,157,Tuscola County,1,0,1
19,Iowa,26,Michigan,161,Washtenaw County,26,139,-113
19,Iowa,26,Michigan,163,Wayne County,67,112,-45
19,Iowa,27,Minnesota,3,Anoka County,464,199,265
19,Iowa,27,Minnesota,5,Becker County,11,0,11
19,Iowa,27,Minnesota,7,Beltrami County,15,28,-13
19,Iowa,27,Minnesota,9,Benton County,33,0,33
19,Iowa,27,Minnesota,11,Big Stone County,4,4,0
19,Iowa,27,Minnesota,13,Blue Earth County,66,201,-135
19,Iowa,27,Minnesota,15,Brown County,26,17,9
19,Iowa,27,Minnesota,17,Carlton County,0,4,-4
19,Iowa,27,Minnesota,19,Carver County,268,199,69
19,Iowa,27,Minnesota,21,Cass County,58,42,16
19,Iowa,27,Minnesota,23,Chippewa County,0,41,-41
19,Iowa,27,Minnesota,25,Chisago County,100,0,100
19,Iowa,27,Minnesota,27,Clay County,216,58,158
19,Iowa,27,Minnesota,31,Cook County,0,19,-19
19,Iowa,27,Minnesota,33,Cottonwood County,63,27,36
19,Iowa,27,Minnesota,35,Crow Wing County,133,76,57
19,Iowa,27,Minnesota,37,Dakota County,675,368,307
19,Iowa,27,Minnesota,39,Dodge County,35,31,4
19,Iowa,27,Minnesota,41,Douglas County,0,25,-25
19,Iowa,27,Minnesota,43,Faribault County,79,33,46
19,Iowa,27,Minnesota,45,Fillmore County,155,45,110
19,Iowa,27,Minnesota,47,Freeborn County,154,83,71
19,Iowa,27,Minnesota,49,Goodhue County,52,1,51
19,Iowa,27,Minnesota,53,Hennepin County,1294,1193,101
19,Iowa,27,Minnesota,55,Houston County,140,33,107
19,Iowa,27,Minnesota,57,Hubbard County,14,1,13
19,Iowa,27,Minnesota,59,Isanti County,8,2,6
19,Iowa,27,Minnesota,61,Itasca County,9,21,-12
19,Iowa,27,Minnesota,63,Jackson County,161,25,136
19,Iowa,27,Minnesota,65,Kanabec County,88,0,88
19,Iowa,27,Minnesota,67,Kandiyohi County,15,34,-19
19,Iowa,27,Minnesota,71,Koochiching County,0,57,-57
19,Iowa,27,Minnesota,73,Lac qui Parle County,0,19,-19
19,Iowa,27,Minnesota,75,Lake County,0,14,-14
19,Iowa,27,Minnesota,79,Le Sueur County,123,10,113
19,Iowa,27,Minnesota,81,Lincoln County,37,42,-5
19,Iowa,27,Minnesota,83,Lyon County,30,116,-86
19,Iowa,27,Minnesota,85,McLeod County,28,3,25
19,Iowa,27,Minnesota,91,Martin County,360,42,318
19,Iowa,27,Minnesota,95,Mille Lacs County,9,0,9
19,Iowa,27,Minnesota,97,Morrison County,5,8,-3
19,Iowa,27,Minnesota,99,Mower County,324,243,81
19,Iowa,27,Minnesota,101,Murray County,32,1,31
19,Iowa,27,Minnesota,103,Nicollet County,14,48,-34
19,Iowa,27,Minnesota,105,Nobles County,92,44,48
19,Iowa,27,Minnesota,107,Norman County,0,3,-3
19,Iowa,27,Minnesota,109,Olmsted County,654,349,305
19,Iowa,27,Minnesota,111,Otter Tail County,72,64,8
19,Iowa,27,Minnesota,115,Pine County,100,20,80
19,Iowa,27,Minnesota,117,Pipestone County,6,18,-12
19,Iowa,27,Minnesota,119,Polk County,16,2,14
19,Iowa,27,Minnesota,121,Pope County,0,11,-11
19,Iowa,27,Minnesota,123,Ramsey County,606,666,-60
19,Iowa,27,Minnesota,127,Redwood County,18,8,10
19,Iowa,27,Minnesota,129,Renville County,0,39,-39
19,Iowa,27,Minnesota,131,Rice County,29,83,-54
19,Iowa,27,Minnesota,133,Rock County,137,97,40
19,Iowa,27,Minnesota,135,Roseau County,1,10,-9
19,Iowa,27,Minnesota,137,St. Louis County,117,107,10
19,Iowa,27,Minnesota,139,Scott County,117,175,-58
19,Iowa,27,Minnesota,141,Sherburne County,173,72,101
19,Iowa,27,Minnesota,145,Stearns County,94,442,-348
19,Iowa,27,Minnesota,147,Steele County,220,91,129
19,Iowa,27,Minnesota,149,Stevens County,5,21,-16
19,Iowa,27,Minnesota,151,Swift County,0,24,-24
19,Iowa,27,Minnesota,153,Todd County,0,24,-24
19,Iowa,27,Minnesota,157,Wabasha County,0,16,-16
19,Iowa,27,Minnesota,159,Wadena County,0,32,-32
19,Iowa,27,Minnesota,161,Waseca County,18,20,-2
19,Iowa,27,Minnesota,163,Washington County,323,107,216
19,Iowa,27,Minnesota,165,Watonwan County,4,0,4
19,Iowa,27,Minnesota,167,Wilkin County,0,6,-6
19,Iowa,27,Minnesota,169,Winona County,265,53,212
19,Iowa,27,Minnesota,171,Wright County,25,173,-148
19,Iowa,27,Minnesota,173,Yellow Medicine County,0,3,-3
19,Iowa,28,Mississippi,1,Adams County,34,0,34
19,Iowa,28,Mississippi,7,Attala County,19,0,19
19,Iowa,28,Mississippi,11,Bolivar County,0,32,-32
19,Iowa,28,Mississippi,17,Chickasaw County,0,4,-4
19,Iowa,28,Mississippi,35,Forrest County,12,7,5
19,Iowa,28,Mississippi,39,George County,31,0,31
19,Iowa,28,Mississippi,47,Harrison County,5,40,-35
19,Iowa,28,Mississippi,49,Hinds County,0,54,-54
19,Iowa,28,Mississippi,51,Holmes County,0,7,-7
19,Iowa,28,Mississippi,67,Jones County,36,0,36
19,Iowa,28,Mississippi,71,Lafayette County,1,0,1
19,Iowa,28,Mississippi,73,Lamar County,1,0,1
19,Iowa,28,Mississippi,83,Leflore County,0,12,-12
19,Iowa,28,Mississippi,87,Lowndes County,25,0,25
19,Iowa,28,Mississippi,91,Marion County,0,24,-24
19,Iowa,28,Mississippi,95,Monroe County,0,14,-14
19,Iowa,28,Mississippi,99,Neshoba County,0,12,-12
19,Iowa,28,Mississippi,105,Oktibbeha County,31,0,31
19,Iowa,28,Mississippi,111,Perry County,48,0,48
19,Iowa,28,Mississippi,121,Rankin County,20,0,20
19,Iowa,28,Mississippi,131,Stone County,7,0,7
19,Iowa,28,Mississippi,137,Tate County,0,20,-20
19,Iowa,28,Mississippi,139,Tippah County,3,0,3
19,Iowa,28,Mississippi,143,Tunica County,13,0,13
19,Iowa,28,Mississippi,145,Union County,0,18,-18
19,Iowa,28,Mississippi,149,Warren County,13,0,13
19,Iowa,28,Mississippi,151,Washington County,26,0,26
19,Iowa,28,Mississippi,153,Wayne County,12,0,12
19,Iowa,29,Missouri,1,Adair County,70,125,-55
19,Iowa,29,Missouri,5,Atchison County,80,40,40
19,Iowa,29,Missouri,7,Audrain County,7,13,-6
19,Iowa,29,Missouri,9,Barry County,3,18,-15
19,Iowa,29,Missouri,11,Barton County,1,2,-1
19,Iowa,29,Missouri,13,Bates County,0,9,-9
19,Iowa,29,Missouri,15,Benton County,0,52,-52
19,Iowa,29,Missouri,19,Boone County,261,118,143
19,Iowa,29,Missouri,21,Buchanan County,340,90,250
19,Iowa,29,Missouri,25,Caldwell County,0,8,-8
19,Iowa,29,Missouri,27,Callaway County,0,25,-25
19,Iowa,29,Missouri,29,Camden County,32,60,-28
19,Iowa,29,Missouri,31,Cape Girardeau County,11,34,-23
19,Iowa,29,Missouri,33,Carroll County,40,9,31
19,Iowa,29,Missouri,35,Carter County,2,0,2
19,Iowa,29,Missouri,37,Cass County,129,23,106
19,Iowa,29,Missouri,39,Cedar County,5,53,-48
19,Iowa,29,Missouri,43,Christian County,73,8,65
19,Iowa,29,Missouri,45,Clark County,8,75,-67
19,Iowa,29,Missouri,47,Clay County,120,245,-125
19,Iowa,29,Missouri,49,Clinton County,20,73,-53
19,Iowa,29,Missouri,51,Cole County,153,6,147
19,Iowa,29,Missouri,53,Cooper County,0,9,-9
19,Iowa,29,Missouri,57,Dade County,0,5,-5
19,Iowa,29,Missouri,59,Dallas County,7,0,7
19,Iowa,29,Missouri,61,Daviess County,40,6,34
19,Iowa,29,Missouri,71,Franklin County,28,94,-66
19,Iowa,29,Missouri,73,Gasconade County,0,12,-12
19,Iowa,29,Missouri,75,Gentry County,26,12,14
19,Iowa,29,Missouri,77,Greene County,84,237,-153
19,Iowa,29,Missouri,79,Grundy County,36,5,31
19,Iowa,29,Missouri,81,Harrison County,37,52,-15
19,Iowa,29,Missouri,83,Henry County,22,9,13
19,Iowa,29,Missouri,87,Holt County,0,23,-23
19,Iowa,29,Missouri,93,Iron County,0,1,-1
19,Iowa,29,Missouri,95,Jackson County,422,680,-258
19,Iowa,29,Missouri,97,Jasper County,0,50,-50
19,Iowa,29,Missouri,99,Jefferson County,53,53,0
19,Iowa,29,Missouri,101,Johnson County,77,0,77
19,Iowa,29,Missouri,103,Knox County,0,16,-16
19,Iowa,29,Missouri,105,Laclede County,47,35,12
19,Iowa,29,Missouri,107,Lafayette County,33,0,33
19,Iowa,29,Missouri,109,Lawrence County,38,323,-285
19,Iowa,29,Missouri,111,Lewis County,44,3,41
19,Iowa,29,Missouri,113,Lincoln County,3,0,3
19,Iowa,29,Missouri,115,Linn County,36,0,36
19,Iowa,29,Missouri,117,Livingston County,15,51,-36
19,Iowa,29,Missouri,119,McDonald County,49,0,49
19,Iowa,29,Missouri,121,Macon County,17,0,17
19,Iowa,29,Missouri,125,Maries County,0,9,-9
19,Iowa,29,Missouri,127,Marion County,0,35,-35
19,Iowa,29,Missouri,129,Mercer County,19,10,9
19,Iowa,29,Missouri,131,Miller County,0,41,-41
19,Iowa,29,Missouri,141,Morgan County,0,10,-10
19,Iowa,29,Missouri,147,Nodaway County,77,440,-363
19,Iowa,29,Missouri,149,Oregon County,6,16,-10
19,Iowa,29,Missouri,159,Pettis County,13,23,-10
19,Iowa,29,Missouri,161,Phelps County,0,3,-3
19,Iowa,29,Missouri,163,Pike County,108,0,108
19,Iowa,29,Missouri,165,Platte County,74,191,-117
19,Iowa,29,Missouri,167,Polk County,55,8,47
19,Iowa,29,Missouri,169,Pulaski County,0,294,-294
19,Iowa,29,Missouri,171,Putnam County,76,48,28
19,Iowa,29,Missouri,173,Ralls County,0,4,-4
19,Iowa,29,Missouri,175,Randolph County,12,19,-7
19,Iowa,29,Missouri,177,Ray County,0,7,-7
19,Iowa,29,Missouri,183,St. Charles County,345,176,169
19,Iowa,29,Missouri,187,St. Francois County,0,124,-124
19,Iowa,29,Missouri,189,St. Louis County,268,376,-108
19,Iowa,29,Missouri,195,Saline County,63,62,1
19,Iowa,29,Missouri,197,Schuyler County,35,22,13
19,Iowa,29,Missouri,199,Scotland County,38,44,-6
19,Iowa,29,Missouri,201,Scott County,19,23,-4
19,Iowa,29,Missouri,203,Shannon County,0,1,-1
19,Iowa,29,Missouri,209,Stone County,11,1,10
19,Iowa,29,Missouri,211,Sullivan County,27,107,-80
19,Iowa,29,Missouri,213,Taney County,86,81,5
19,Iowa,29,Missouri,215,Texas County,16,0,16
19,Iowa,29,Missouri,219,Warren County,0,24,-24
19,Iowa,29,Missouri,221,Washington County,10,0,10
19,Iowa,29,Missouri,225,Webster County,0,34,-34
19,Iowa,29,Missouri,227,Worth County,6,11,-5
19,Iowa,29,Missouri,510,St. Louis city,425,130,295
19,Iowa,30,Montana,1,Beaverhead County,0,39,-39
19,Iowa,30,Montana,13,Cascade County,16,10,6
19,Iowa,30,Montana,15,Chouteau County,0,10,-10
19,Iowa,30,Montana,27,Fergus County,56,22,34
19,Iowa,30,Montana,29,Flathead County,11,10,1
19,Iowa,30,Montana,31,Gallatin County,43,102,-59
19,Iowa,30,Montana,47,Lake County,4,0,4
19,Iowa,30,Montana,63,Missoula County,4,18,-14
19,Iowa,30,Montana,83,Richland County,8,0,8
19,Iowa,30,Montana,93,Silver Bow County,5,16,-11
19,Iowa,30,Montana,95,Stillwater County,25,0,25
19,Iowa,30,Montana,111,Yellowstone County,0,27,-27
19,Iowa,31,Nebraska,1,Adams County,45,3,42
19,Iowa,31,Nebraska,3,Antelope County,0,29,-29
19,Iowa,31,Nebraska,11,Boone County,0,1,-1
19,Iowa,31,Nebraska,13,Box Butte County,11,0,11
19,Iowa,31,Nebraska,15,Boyd County,4,0,4
19,Iowa,31,Nebraska,19,Buffalo County,179,94,85
19,Iowa,31,Nebraska,21,Burt County,10,6,4
19,Iowa,31,Nebraska,23,Butler County,0,2,-2
19,Iowa,31,Nebraska,25,Cass County,37,19,18
19,Iowa,31,Nebraska,27,Cedar County,42,37,5
19,Iowa,31,Nebraska,31,Cherry County,6,0,6
19,Iowa,31,Nebraska,33,Cheyenne County,0,1,-1
19,Iowa,31,Nebraska,35,Clay County,50,33,17
19,Iowa,31,Nebraska,37,Colfax County,60,4,56
19,Iowa,31,Nebraska,39,Cuming County,0,2,-2
19,Iowa,31,Nebraska,41,Custer County,120,5,115
19,Iowa,31,Nebraska,43,Dakota County,567,465,102
19,Iowa,31,Nebraska,47,Dawson County,10,10,0
19,Iowa,31,Nebraska,51,Dixon County,127,21,106
19,Iowa,31,Nebraska,53,Dodge County,116,46,70
19,Iowa,31,Nebraska,55,Douglas County,2862,3371,-509
19,Iowa,31,Nebraska,57,Dundy County,43,0,43
19,Iowa,31,Nebraska,59,Fillmore County,0,6,-6
19,Iowa,31,Nebraska,61,Franklin County,7,5,2
19,Iowa,31,Nebraska,63,Frontier County,0,25,-25
19,Iowa,31,Nebraska,65,Furnas County,40,0,40
19,Iowa,31,Nebraska,67,Gage County,14,30,-16
19,Iowa,31,Nebraska,73,Gosper County,1,0,1
19,Iowa,31,Nebraska,75,Grant County,0,1,-1
19,Iowa,31,Nebraska,77,Greeley County,0,3,-3
19,Iowa,31,Nebraska,79,Hall County,61,96,-35
19,Iowa,31,Nebraska,81,Hamilton County,0,1,-1
19,Iowa,31,Nebraska,89,Holt County,0,1,-1
19,Iowa,31,Nebraska,93,Howard County,19,0,19
19,Iowa,31,Nebraska,95,Jefferson County,7,15,-8
19,Iowa,31,Nebraska,97,Johnson County,10,0,10
19,Iowa,31,Nebraska,99,Kearney County,0,1,-1
19,Iowa,31,Nebraska,103,Keya Paha County,0,2,-2
19,Iowa,31,Nebraska,107,Knox County,33,16,17
19,Iowa,31,Nebraska,109,Lancaster County,611,862,-251
19,Iowa,31,Nebraska,111,Lincoln County,15,52,-37
19,Iowa,31,Nebraska,113,Logan County,0,2,-2
19,Iowa,31,Nebraska,115,Loup County,0,6,-6
19,Iowa,31,Nebraska,117,McPherson County,0,2,-2
19,Iowa,31,Nebraska,119,Madison County,173,135,38
19,Iowa,31,Nebraska,121,Merrick County,107,0,107
19,Iowa,31,Nebraska,123,Morrill County,0,11,-11
19,Iowa,31,Nebraska,127,Nemaha County,28,12,16
19,Iowa,31,Nebraska,129,Nuckolls County,2,0,2
19,Iowa,31,Nebraska,131,Otoe County,173,121,52
19,Iowa,31,Nebraska,137,Phelps County,0,54,-54
19,Iowa,31,Nebraska,139,Pierce County,4,0,4
19,Iowa,31,Nebraska,141,Platte County,17,33,-16
19,Iowa,31,Nebraska,143,Polk County,0,1,-1
19,Iowa,31,Nebraska,145,Red Willow County,0,16,-16
19,Iowa,31,Nebraska,147,Richardson County,27,0,27
19,Iowa,31,Nebraska,151,Saline County,78,60,18
19,Iowa,31,Nebraska,153,Sarpy County,1032,1162,-130
19,Iowa,31,Nebraska,155,Saunders County,85,28,57
19,Iowa,31,Nebraska,157,Scotts Bluff County,70,7,63
19,Iowa,31,Nebraska,159,Seward County,16,33,-17
19,Iowa,31,Nebraska,161,Sheridan County,5,0,5
19,Iowa,31,Nebraska,163,Sherman County,3,0,3
19,Iowa,31,Nebraska,169,Thayer County,7,4,3
19,Iowa,31,Nebraska,173,Thurston County,5,29,-24
19,Iowa,31,Nebraska,175,Valley County,0,24,-24
19,Iowa,31,Nebraska,177,Washington County,81,89,-8
19,Iowa,31,Nebraska,179,Wayne County,42,109,-67
19,Iowa,31,Nebraska,185,York County,0,23,-23
19,Iowa,32,Nevada,3,Clark County,410,643,-233
19,Iowa,32,Nevada,5,Douglas County,10,0,10
19,Iowa,32,Nevada,7,Elko County,42,0,42
19,Iowa,32,Nevada,17,Lincoln County,7,0,7
19,Iowa,32,Nevada,23,Nye County,15,0,15
19,Iowa,32,Nevada,31,Washoe County,106,6,100
19,Iowa,32,Nevada,510,Carson City,3,0,3
19,Iowa,33,New Hampshire,1,Belknap County,14,15,-1
19,Iowa,33,New Hampshire,5,Cheshire County,18,0,18
19,Iowa,33,New Hampshire,9,Grafton County,0,6,-6
19,Iowa,33,New Hampshire,11,Hillsborough County,32,0,32
19,Iowa,33,New Hampshire,13,Merrimack County,0,11,-11
19,Iowa,33,New Hampshire,15,Rockingham County,0,44,-44
19,Iowa,33,New Hampshire,17,Strafford County,10,8,2
19,Iowa,34,New Jersey,1,Atlantic County,51,0,51
19,Iowa,34,New Jersey,3,Bergen County,24,0,24
19,Iowa,34,New Jersey,5,Burlington County,11,0,11
19,Iowa,34,New Jersey,7,Camden County,17,0,17
19,Iowa,34,New Jersey,11,Cumberland County,33,0,33
19,Iowa,34,New Jersey,13,Essex County,39,0,39
19,Iowa,34,New Jersey,15,Gloucester County,59,0,59
19,Iowa,34,New Jersey,17,Hudson County,49,16,33
19,Iowa,34,New Jersey,21,Mercer County,34,15,19
19,Iowa,34,New Jersey,23,Middlesex County,16,17,-1
19,Iowa,34,New Jersey,25,Monmouth County,112,4,108
19,Iowa,34,New Jersey,27,Morris County,44,13,31
19,Iowa,34,New Jersey,35,Somerset County,23,0,23
19,Iowa,34,New Jersey,37,Sussex County,0,2,-2
19,Iowa,34,New Jersey,39,Union County,10,0,10
19,Iowa,35,New Mexico,1,Bernalillo County,113,110,3
19,Iowa,35,New Mexico,5,Chaves County,33,11,22
19,Iowa,35,New Mexico,9,Curry County,0,14,-14
19,Iowa,35,New Mexico,13,Doña Ana County,42,0,42
19,Iowa,35,New Mexico,15,Eddy County,9,0,9
19,Iowa,35,New Mexico,25,Lea County,2,0,2
19,Iowa,35,New Mexico,27,Lincoln County,16,0,16
19,Iowa,35,New Mexico,28,Los Alamos County,0,9,-9
19,Iowa,35,New Mexico,29,Luna County,15,0,15
19,Iowa,35,New Mexico,43,Sandoval County,4,78,-74
19,Iowa,35,New Mexico,45,San Juan County,44,12,32
19,Iowa,35,New Mexico,49,Santa Fe County,26,0,26
19,Iowa,35,New Mexico,51,Sierra County,47,0,47
19,Iowa,35,New Mexico,55,Taos County,18,0,18
19,Iowa,36,New York,1,Albany County,0,4,-4
19,Iowa,36,New York,3,Allegany County,5,0,5
19,Iowa,36,New York,5,Bronx County,17,0,17
19,Iowa,36,New York,9,Cattaraugus County,0,4,-4
19,Iowa,36,New York,11,Cayuga County,4,44,-40
19,Iowa,36,New York,21,Columbia County,5,0,5
19,Iowa,36,New York,23,Cortland County,1,0,1
19,Iowa,36,New York,27,Dutchess County,18,0,18
19,Iowa,36,New York,29,Erie County,23,189,-166
19,Iowa,36,New York,31,Essex County,0,3,-3
19,Iowa,36,New York,33,Franklin County,6,0,6
19,Iowa,36,New York,37,Genesee County,0,33,-33
19,Iowa,36,New York,39,Greene County,7,0,7
19,Iowa,36,New York,45,Jefferson County,11,58,-47
19,Iowa,36,New York,47,Kings County,42,38,4
19,Iowa,36,New York,53,Madison County,0,21,-21
19,Iowa,36,New York,55,Monroe County,60,84,-24
19,Iowa,36,New York,57,Montgomery County,30,0,30
19,Iowa,36,New York,59,Nassau County,19,14,5
19,Iowa,36,New York,61,New York County,30,193,-163
19,Iowa,36,New York,65,Oneida County,0,14,-14
19,Iowa,36,New York,67,Onondaga County,16,0,16
19,Iowa,36,New York,69,Ontario County,0,11,-11
19,Iowa,36,New York,71,Orange County,0,41,-41
19,Iowa,36,New York,75,Oswego County,0,14,-14
19,Iowa,36,New York,79,Putnam County,1,0,1
19,Iowa,36,New York,81,Queens County,122,0,122
19,Iowa,36,New York,89,St. Lawrence County,6,0,6
19,Iowa,36,New York,97,Schuyler County,0,4,-4
19,Iowa,36,New York,101,Steuben County,5,7,-2
19,Iowa,36,New York,103,Suffolk County,30,22,8
19,Iowa,36,New York,109,Tompkins County,6,41,-35
19,Iowa,36,New York,111,Ulster County,6,0,6
19,Iowa,36,New York,113,Warren County,6,0,6
19,Iowa,36,New York,115,Washington County,5,30,-25
19,Iowa,36,New York,117,Wayne County,0,7,-7
19,Iowa,36,New York,119,Westchester County,69,0,69
19,Iowa,36,New York,121,Wyoming County,12,0,12
19,Iowa,37,North Carolina,1,Alamance County,3,0,3
19,Iowa,37,North Carolina,3,Alexander County,3,0,3
19,Iowa,37,North Carolina,13,Beaufort County,0,7,-7
19,Iowa,37,North Carolina,19,Brunswick County,28,0,28
19,Iowa,37,North Carolina,21,Buncombe County,10,0,10
19,Iowa,37,North Carolina,25,Cabarrus County,66,0,66
19,Iowa,37,North Carolina,29,Camden County,30,0,30
19,Iowa,37,North Carolina,31,Carteret County,32,0,32
19,Iowa,37,North Carolina,35,Catawba County,0,68,-68
19,Iowa,37,North Carolina,37,Chatham County,60,0,60
19,Iowa,37,North Carolina,45,Cleveland County,16,0,16
19,Iowa,37,North Carolina,49,Craven County,78,17,61
19,Iowa,37,North Carolina,51,Cumberland County,34,77,-43
19,Iowa,37,North Carolina,53,Currituck County,10,0,10
19,Iowa,37,North Carolina,57,Davidson County,0,16,-16
19,Iowa,37,North Carolina,61,Duplin County,2,0,2
19,Iowa,37,North Carolina,63,Durham County,81,67,14
19,Iowa,37,North Carolina,67,Forsyth County,7,4,3
19,Iowa,37,North Carolina,77,Granville County,0,1,-1
19,Iowa,37,North Carolina,81,Guilford County,56,0,56
19,Iowa,37,North Carolina,85,Harnett County,0,120,-120
19,Iowa,37,North Carolina,97,Iredell County,59,46,13
19,Iowa,37,North Carolina,99,Jackson County,3,0,3
19,Iowa,37,North Carolina,101,Johnston County,43,0,43
19,Iowa,37,North Carolina,105,Lee County,20,0,20
19,Iowa,37,North Carolina,119,Mecklenburg County,42,118,-76
19,Iowa,37,North Carolina,129,New Hanover County,13,62,-49
19,Iowa,37,North Carolina,133,Onslow County,110,70,40
19,Iowa,37,North Carolina,135,Orange County,92,117,-25
19,Iowa,37,North Carolina,147,Pitt County,0,82,-82
19,Iowa,37,North Carolina,151,Randolph County,22,0,22
19,Iowa,37,North Carolina,163,Sampson County,19,0,19
19,Iowa,37,North Carolina,165,Scotland County,0,37,-37
19,Iowa,37,North Carolina,171,Surry County,0,7,-7
19,Iowa,37,North Carolina,175,Transylvania County,0,4,-4
19,Iowa,37,North Carolina,179,Union County,0,9,-9
19,Iowa,37,North Carolina,183,Wake County,275,496,-221
19,Iowa,37,North Carolina,185,Warren County,0,21,-21
19,Iowa,37,North Carolina,191,Wayne County,7,0,7
19,Iowa,37,North Carolina,195,Wilson County,4,0,4
19,Iowa,38,North Dakota,3,Barnes County,10,2,8
19,Iowa,38,North Dakota,11,Bowman County,0,1,-1
19,Iowa,38,North Dakota,15,Burleigh County,92,7,85
19,Iowa,38,North Dakota,17,Cass County,281,410,-129
19,Iowa,38,North Dakota,25,Dunn County,17,0,17
19,Iowa,38,North Dakota,27,Eddy County,0,4,-4
19,Iowa,38,North Dakota,35,Grand Forks County,30,42,-12
19,Iowa,38,North Dakota,43,Kidder County,1,6,-5
19,Iowa,38,North Dakota,45,LaMoure County,0,10,-10
19,Iowa,38,North Dakota,47,Logan County,49,0,49
19,Iowa,38,North Dakota,53,McKenzie County,0,34,-34
19,Iowa,38,North Dakota,55,McLean County,0,8,-8
19,Iowa,38,North Dakota,59,Morton County,4,32,-28
19,Iowa,38,North Dakota,67,Pembina County,0,3,-3
19,Iowa,38,North Dakota,71,Ramsey County,0,3,-3
19,Iowa,38,North Dakota,77,Richland County,0,41,-41
19,Iowa,38,North Dakota,81,Sargent County,4,0,4
19,Iowa,38,North Dakota,85,Sioux County,25,0,25
19,Iowa,38,North Dakota,89,Stark County,0,134,-134
19,Iowa,38,North Dakota,101,Ward County,131,93,38
19,Iowa,38,North Dakota,103,Wells County,3,0,3
19,Iowa,38,North Dakota,105,Williams County,68,0,68
19,Iowa,39,Ohio,7,Ashtabula County,0,1,-1
19,Iowa,39,Ohio,9,Athens County,19,0,19
19,Iowa,39,Ohio,17,Butler County,17,8,9
19,Iowa,39,Ohio,19,Carroll County,1,14,-13
19,Iowa,39,Ohio,21,Champaign County,10,0,10
19,Iowa,39,Ohio,25,Clermont County,6,50,-44
19,Iowa,39,Ohio,33,Crawford County,0,9,-9
19,Iowa,39,Ohio,35,Cuyahoga County,45,75,-30
19,Iowa,39,Ohio,37,Darke County,16,0,16
19,Iowa,39,Ohio,41,Delaware County,0,15,-15
19,Iowa,39,Ohio,45,Fairfield County,0,17,-17
19,Iowa,39,Ohio,47,Fayette County,0,102,-102
19,Iowa,39,Ohio,49,Franklin County,241,277,-36
19,Iowa,39,Ohio,51,Fulton County,5,0,5
19,Iowa,39,Ohio,57,Greene County,27,239,-212
19,Iowa,39,Ohio,61,Hamilton County,46,34,12
19,Iowa,39,Ohio,81,Jefferson County,0,9,-9
19,Iowa,39,Ohio,85,Lake County,6,46,-40
19,Iowa,39,Ohio,87,Lawrence County,0,4,-4
19,Iowa,39,Ohio,89,Licking County,0,179,-179
19,Iowa,39,Ohio,93,Lorain County,8,27,-19
19,Iowa,39,Ohio,95,Lucas County,9,11,-2
19,Iowa,39,Ohio,99,Mahoning County,82,8,74
19,Iowa,39,Ohio,101,Marion County,246,0,246
19,Iowa,39,Ohio,103,Medina County,0,9,-9
19,Iowa,39,Ohio,109,Miami County,62,10,52
19,Iowa,39,Ohio,113,Montgomery County,85,23,62
19,Iowa,39,Ohio,119,Muskingum County,33,0,33
19,Iowa,39,Ohio,123,Ottawa County,13,0,13
19,Iowa,39,Ohio,133,Portage County,8,0,8
19,Iowa,39,Ohio,137,Putnam County,29,0,29
19,Iowa,39,Ohio,143,Sandusky County,0,14,-14
19,Iowa,39,Ohio,145,Scioto County,59,0,59
19,Iowa,39,Ohio,151,Stark County,18,9,9
19,Iowa,39,Ohio,153,Summit County,69,23,46
19,Iowa,39,Ohio,155,Trumbull County,6,14,-8
19,Iowa,39,Ohio,161,Van Wert County,0,8,-8
19,Iowa,39,Ohio,165,Warren County,17,17,0
19,Iowa,39,Ohio,169,Wayne County,2,28,-26
19,Iowa,39,Ohio,171,Williams County,23,8,15
19,Iowa,39,Ohio,173,Wood County,13,35,-22
19,Iowa,4,Arizona,3,Cochise County,0,48,-48
19,Iowa,4,Arizona,5,Coconino County,0,63,-63
19,Iowa,4,Arizona,7,Gila County,16,0,16
19,Iowa,4,Arizona,12,La Paz County,96,68,28
19,Iowa,4,Arizona,13,Maricopa County,1152,2295,-1143
19,Iowa,4,Arizona,15,Mohave County,59,82,-23
19,Iowa,4,Arizona,17,Navajo County,68,11,57
19,Iowa,4,Arizona,19,Pima County,241,220,21
19,Iowa,4,Arizona,21,Pinal County,372,263,109
19,Iowa,4,Arizona,25,Yavapai County,4,28,-24
19,Iowa,4,Arizona,27,Yuma County,25,20,5
19,Iowa,40,Oklahoma,1,Adair County,5,3,2
19,Iowa,40,Oklahoma,5,Atoka County,0,15,-15
19,Iowa,40,Oklahoma,11,Blaine County,0,16,-16
19,Iowa,40,Oklahoma,15,Caddo County,0,16,-16
19,Iowa,40,Oklahoma,17,Canadian County,0,59,-59
19,Iowa,40,Oklahoma,19,Carter County,0,67,-67
19,Iowa,40,Oklahoma,27,Cleveland County,6,23,-17
19,Iowa,40,Oklahoma,29,Coal County,0,2,-2
19,Iowa,40,Oklahoma,31,Comanche County,43,43,0
19,Iowa,40,Oklahoma,37,Creek County,4,0,4
19,Iowa,40,Oklahoma,41,Delaware County,0,21,-21
19,Iowa,40,Oklahoma,47,Garfield County,1,0,1
19,Iowa,40,Oklahoma,61,Haskell County,111,0,111
19,Iowa,40,Oklahoma,71,Kay County,0,110,-110
19,Iowa,40,Oklahoma,79,Le Flore County,0,9,-9
19,Iowa,40,Oklahoma,81,Lincoln County,6,0,6
19,Iowa,40,Oklahoma,87,McClain County,32,0,32
19,Iowa,40,Oklahoma,89,McCurtain County,217,0,217
19,Iowa,40,Oklahoma,95,Marshall County,8,0,8
19,Iowa,40,Oklahoma,97,Mayes County,0,31,-31
19,Iowa,40,Oklahoma,101,Muskogee County,0,32,-32
19,Iowa,40,Oklahoma,103,Noble County,0,4,-4
19,Iowa,40,Oklahoma,105,Nowata County,0,9,-9
19,Iowa,40,Oklahoma,109,Oklahoma County,116,419,-303
19,Iowa,40,Oklahoma,113,Osage County,0,15,-15
19,Iowa,40,Oklahoma,115,Ottawa County,1,10,-9
19,Iowa,40,Oklahoma,119,Payne County,38,41,-3
19,Iowa,40,Oklahoma,121,Pittsburg County,33,0,33
19,Iowa,40,Oklahoma,125,Pottawatomie County,11,8,3
19,Iowa,40,Oklahoma,131,Rogers County,16,2,14
19,Iowa,40,Oklahoma,133,Seminole County,29,6,23
19,Iowa,40,Oklahoma,135,Sequoyah County,0,19,-19
19,Iowa,40,Oklahoma,139,Texas County,21,0,21
19,Iowa,40,Oklahoma,143,Tulsa County,57,187,-130
19,Iowa,40,Oklahoma,145,Wagoner County,19,0,19
19,Iowa,40,Oklahoma,147,Washington County,31,13,18
19,Iowa,40,Oklahoma,149,Washita County,0,4,-4
19,Iowa,40,Oklahoma,151,Woods County,0,6,-6
19,Iowa,41,Oregon,5,Clackamas County,15,128,-113
19,Iowa,41,Oregon,7,Clatsop County,0,1,-1
19,Iowa,41,Oregon,9,Columbia County,21,0,21
19,Iowa,41,Oregon,11,Coos County,15,0,15
19,Iowa,41,Oregon,13,Crook County,0,33,-33
19,Iowa,41,Oregon,15,Curry County,6,0,6
19,Iowa,41,Oregon,19,Douglas County,18,6,12
19,Iowa,41,Oregon,29,Jackson County,33,19,14
19,Iowa,41,Oregon,31,Jefferson County,0,20,-20
19,Iowa,41,Oregon,33,Josephine County,3,0,3
19,Iowa,41,Oregon,35,Klamath County,6,27,-21
19,Iowa,41,Oregon,39,Lane County,143,113,30
19,Iowa,41,Oregon,41,Lincoln County,0,7,-7
19,Iowa,41,Oregon,45,Malheur County,0,5,-5
19,Iowa,41,Oregon,47,Marion County,18,12,6
19,Iowa,41,Oregon,51,Multnomah County,86,170,-84
19,Iowa,41,Oregon,59,Umatilla County,10,0,10
19,Iowa,41,Oregon,67,Washington County,110,123,-13
19,Iowa,42,Pennsylvania,3,Allegheny County,77,102,-25
19,Iowa,42,Pennsylvania,5,Armstrong County,0,22,-22
19,Iowa,42,Pennsylvania,9,Bedford County,0,4,-4
19,Iowa,42,Pennsylvania,11,Berks County,15,9,6
19,Iowa,42,Pennsylvania,15,Bradford County,102,0,102
19,Iowa,42,Pennsylvania,17,Bucks County,10,15,-5
19,Iowa,42,Pennsylvania,21,Cambria County,19,0,19
19,Iowa,42,Pennsylvania,27,Centre County,16,60,-44
19,Iowa,42,Pennsylvania,29,Chester County,58,10,48
19,Iowa,42,Pennsylvania,31,Clarion County,11,0,11
19,Iowa,42,Pennsylvania,35,Clinton County,44,0,44
19,Iowa,42,Pennsylvania,39,Crawford County,6,0,6
19,Iowa,42,Pennsylvania,41,Cumberland County,12,18,-6
19,Iowa,42,Pennsylvania,43,Dauphin County,19,106,-87
19,Iowa,42,Pennsylvania,45,Delaware County,71,35,36
19,Iowa,42,Pennsylvania,55,Franklin County,369,0,369
19,Iowa,42,Pennsylvania,61,Huntingdon County,17,0,17
19,Iowa,42,Pennsylvania,69,Lackawanna County,0,37,-37
19,Iowa,42,Pennsylvania,71,Lancaster County,54,91,-37
19,Iowa,42,Pennsylvania,75,Lebanon County,7,7,0
19,Iowa,42,Pennsylvania,77,Lehigh County,0,9,-9
19,Iowa,42,Pennsylvania,79,Luzerne County,11,0,11
19,Iowa,42,Pennsylvania,81,Lycoming County,17,0,17
19,Iowa,42,Pennsylvania,85,Mercer County,22,0,22
19,Iowa,42,Pennsylvania,89,Monroe County,10,0,10
19,Iowa,42,Pennsylvania,91,Montgomery County,10,22,-12
19,Iowa,42,Pennsylvania,93,Montour County,0,20,-20
19,Iowa,42,Pennsylvania,99,Perry County,0,19,-19
19,Iowa,42,Pennsylvania,101,Philadelphia County,129,101,28
19,Iowa,42,Pennsylvania,107,Schuylkill County,9,4,5
19,Iowa,42,Pennsylvania,119,Union County,0,12,-12
19,Iowa,42,Pennsylvania,121,Venango County,0,25,-25
19,Iowa,42,Pennsylvania,125,Washington County,0,32,-32
19,Iowa,42,Pennsylvania,127,Wayne County,17,0,17
19,Iowa,42,Pennsylvania,129,Westmoreland County,0,23,-23
19,Iowa,42,Pennsylvania,133,York County,34,8,26
19,Iowa,44,Rhode Island,1,Bristol County,4,27,-23
19,Iowa,44,Rhode Island,3,Kent County,4,0,4
19,Iowa,44,Rhode Island,5,Newport County,0,37,-37
19,Iowa,44,Rhode Island,7,Providence County,62,15,47
19,Iowa,44,Rhode Island,9,Washington County,5,0,5
19,Iowa,45,South Carolina,3,Aiken County,0,117,-117
19,Iowa,45,South Carolina,13,Beaufort County,13,0,13
19,Iowa,45,South Carolina,15,Berkeley County,9,23,-14
19,Iowa,45,South Carolina,19,Charleston County,0,8,-8
19,Iowa,45,South Carolina,35,Dorchester County,52,16,36
19,Iowa,45,South Carolina,41,Florence County,7,0,7
19,Iowa,45,South Carolina,45,Greenville County,220,21,199
19,Iowa,45,South Carolina,47,Greenwood County,7,0,7
19,Iowa,45,South Carolina,51,Horry County,23,6,17
19,Iowa,45,South Carolina,57,Lancaster County,0,20,-20
19,Iowa,45,South Carolina,63,Lexington County,34,0,34
19,Iowa,45,South Carolina,65,McCormick County,0,7,-7
19,Iowa,45,South Carolina,73,Oconee County,34,0,34
19,Iowa,45,South Carolina,79,Richland County,36,126,-90
19,Iowa,45,South Carolina,83,Spartanburg County,7,0,7
19,Iowa,45,South Carolina,85,Sumter County,12,22,-10
19,Iowa,45,South Carolina,87,Union County,8,0,8
19,Iowa,45,South Carolina,91,York County,0,8,-8
19,Iowa,46,South Dakota,3,Aurora County,0,3,-3
19,Iowa,46,South Dakota,5,Beadle County,32,0,32
19,Iowa,46,South Dakota,9,Bon Homme County,23,7,16
19,Iowa,46,South Dakota,11,Brookings County,74,324,-250
19,Iowa,46,South Dakota,13,Brown County,18,9,9
19,Iowa,46,South Dakota,15,Brule County,10,12,-2
19,Iowa,46,South Dakota,17,Buffalo County,1,0,1
19,Iowa,46,South Dakota,19,Butte County,13,0,13
19,Iowa,46,South Dakota,23,Charles Mix County,6,22,-16
19,Iowa,46,South Dakota,27,Clay County,122,308,-186
19,Iowa,46,South Dakota,29,Codington County,43,15,28
19,Iowa,46,South Dakota,33,Custer County,0,26,-26
19,Iowa,46,South Dakota,35,Davison County,2,13,-11
19,Iowa,46,South Dakota,37,Day County,0,7,-7
19,Iowa,46,South Dakota,39,Deuel County,2,2,0
19,Iowa,46,South Dakota,41,Dewey County,6,0,6
19,Iowa,46,South Dakota,53,Gregory County,0,4,-4
19,Iowa,46,South Dakota,55,Haakon County,0,1,-1
19,Iowa,46,South Dakota,57,Hamlin County,6,30,-24
19,Iowa,46,South Dakota,59,Hand County,8,0,8
19,Iowa,46,South Dakota,65,Hughes County,0,178,-178
19,Iowa,46,South Dakota,67,Hutchinson County,4,3,1
19,Iowa,46,South Dakota,73,Jerauld County,0,8,-8
19,Iowa,46,South Dakota,75,Jones County,0,21,-21
19,Iowa,46,South Dakota,77,Kingsbury County,2,0,2
19,Iowa,46,South Dakota,79,Lake County,37,27,10
19,Iowa,46,South Dakota,81,Lawrence County,64,10,54
19,Iowa,46,South Dakota,83,Lincoln County,47,260,-213
19,Iowa,46,South Dakota,85,Lyman County,0,13,-13
19,Iowa,46,South Dakota,87,McCook County,0,13,-13
19,Iowa,46,South Dakota,91,Marshall County,0,9,-9
19,Iowa,46,South Dakota,93,Meade County,6,34,-28
19,Iowa,46,South Dakota,97,Miner County,0,3,-3
19,Iowa,46,South Dakota,99,Minnehaha County,557,629,-72
19,Iowa,46,South Dakota,101,Moody County,7,0,7
19,Iowa,46,South Dakota,102,Oglala Lakota County,16,73,-57
19,Iowa,46,South Dakota,103,Pennington County,163,112,51
19,Iowa,46,South Dakota,105,Perkins County,0,2,-2
19,Iowa,46,South Dakota,109,Roberts County,0,3,-3
19,Iowa,46,South Dakota,115,Spink County,7,0,7
19,Iowa,46,South Dakota,121,Todd County,77,0,77
19,Iowa,46,South Dakota,125,Turner County,7,22,-15
19,Iowa,46,South Dakota,127,Union County,502,537,-35
19,Iowa,46,South Dakota,135,Yankton County,100,57,43
19,Iowa,46,South Dakota,137,Ziebach County,2,0,2
19,Iowa,47,Tennessee,5,Benton County,15,0,15
19,Iowa,47,Tennessee,11,Bradley County,85,0,85
19,Iowa,47,Tennessee,23,Chester County,53,0,53
19,Iowa,47,Tennessee,31,Coffee County,0,16,-16
19,Iowa,47,Tennessee,35,Cumberland County,0,15,-15
19,Iowa,47,Tennessee,37,Davidson County,24,81,-57
19,Iowa,47,Tennessee,45,Dyer County,10,0,10
19,Iowa,47,Tennessee,57,Grainger County,12,0,12
19,Iowa,47,Tennessee,59,Greene County,0,6,-6
19,Iowa,47,Tennessee,65,Hamilton County,28,17,11
19,Iowa,47,Tennessee,73,Hawkins County,24,0,24
19,Iowa,47,Tennessee,79,Henry County,7,0,7
19,Iowa,47,Tennessee,81,Hickman County,0,5,-5
19,Iowa,47,Tennessee,93,Knox County,0,173,-173
19,Iowa,47,Tennessee,103,Lincoln County,0,4,-4
19,Iowa,47,Tennessee,105,Loudon County,20,0,20
19,Iowa,47,Tennessee,113,Madison County,0,10,-10
19,Iowa,47,Tennessee,115,Marion County,0,3,-3
19,Iowa,47,Tennessee,117,Marshall County,9,0,9
19,Iowa,47,Tennessee,119,Maury County,13,18,-5
19,Iowa,47,Tennessee,125,Montgomery County,105,31,74
19,Iowa,47,Tennessee,133,Overton County,15,0,15
19,Iowa,47,Tennessee,141,Putnam County,25,0,25
19,Iowa,47,Tennessee,147,Robertson County,7,0,7
19,Iowa,47,Tennessee,149,Rutherford County,34,129,-95
19,Iowa,47,Tennessee,151,Scott County,0,12,-12
19,Iowa,47,Tennessee,157,Shelby County,442,105,337
19,Iowa,47,Tennessee,163,Sullivan County,0,149,-149
19,Iowa,47,Tennessee,165,Sumner County,0,7,-7
19,Iowa,47,Tennessee,167,Tipton County,3,0,3
19,Iowa,47,Tennessee,177,Warren County,9,0,9
19,Iowa,47,Tennessee,179,Washington County,58,17,41
19,Iowa,47,Tennessee,187,Williamson County,48,0,48
19,Iowa,48,Texas,7,Aransas County,48,0,48
19,Iowa,48,Texas,13,Atascosa County,0,69,-69
19,Iowa,48,Texas,21,Bastrop County,0,20,-20
19,Iowa,48,Texas,27,Bell County,154,277,-123
19,Iowa,48,Texas,29,Bexar County,290,229,61
19,Iowa,48,Texas,37,Bowie County,6,28,-22
19,Iowa,48,Texas,39,Brazoria County,20,182,-162
19,Iowa,48,Texas,41,Brazos County,86,20,66
19,Iowa,48,Texas,53,Burnet County,8,0,8
19,Iowa,48,Texas,55,Caldwell County,20,7,13
19,Iowa,48,Texas,61,Cameron County,59,71,-12
19,Iowa,48,Texas,71,Chambers County,18,0,18
19,Iowa,48,Texas,73,Cherokee County,7,0,7
19,Iowa,48,Texas,85,Collin County,85,218,-133
19,Iowa,48,Texas,91,Comal County,16,0,16
19,Iowa,48,Texas,97,Cooke County,13,72,-59
19,Iowa,48,Texas,113,Dallas County,400,417,-17
19,Iowa,48,Texas,121,Denton County,31,184,-153
19,Iowa,48,Texas,127,Dimmit County,114,0,114
19,Iowa,48,Texas,135,Ector County,40,0,40
19,Iowa,48,Texas,139,Ellis County,24,74,-50
19,Iowa,48,Texas,141,El Paso County,121,160,-39
19,Iowa,48,Texas,143,Erath County,18,0,18
19,Iowa,48,Texas,145,Falls County,22,0,22
19,Iowa,48,Texas,157,Fort Bend County,18,154,-136
19,Iowa,48,Texas,159,Franklin County,0,3,-3
19,Iowa,48,Texas,167,Galveston County,3,10,-7
19,Iowa,48,Texas,181,Grayson County,0,10,-10
19,Iowa,48,Texas,183,Gregg County,29,0,29
19,Iowa,48,Texas,187,Guadalupe County,79,0,79
19,Iowa,48,Texas,189,Hale County,13,0,13
19,Iowa,48,Texas,199,Hardin County,22,0,22
19,Iowa,48,Texas,201,Harris County,293,241,52
19,Iowa,48,Texas,203,Harrison County,0,10,-10
19,Iowa,48,Texas,209,Hays County,29,30,-1
19,Iowa,48,Texas,213,Henderson County,0,2,-2
19,Iowa,48,Texas,215,Hidalgo County,154,503,-349
19,Iowa,48,Texas,231,Hunt County,7,12,-5
19,Iowa,48,Texas,245,Jefferson County,13,258,-245
19,Iowa,48,Texas,251,Johnson County,1,39,-38
19,Iowa,48,Texas,257,Kaufman County,14,0,14
19,Iowa,48,Texas,259,Kendall County,0,18,-18
19,Iowa,48,Texas,281,Lampasas County,16,0,16
19,Iowa,48,Texas,291,Liberty County,10,2,8
19,Iowa,48,Texas,303,Lubbock County,102,0,102
19,Iowa,48,Texas,309,McLennan County,83,248,-165
19,Iowa,48,Texas,315,Marion County,0,10,-10
19,Iowa,48,Texas,323,Maverick County,16,0,16
19,Iowa,48,Texas,329,Midland County,3,75,-72
19,Iowa,48,Texas,331,Milam County,49,0,49
19,Iowa,48,Texas,337,Montague County,0,3,-3
19,Iowa,48,Texas,339,Montgomery County,18,135,-117
19,Iowa,48,Texas,343,Morris County,2,0,2
19,Iowa,48,Texas,347,Nacogdoches County,0,11,-11
19,Iowa,48,Texas,355,Nueces County,52,87,-35
19,Iowa,48,Texas,361,Orange County,2,0,2
19,Iowa,48,Texas,363,Palo Pinto County,0,9,-9
19,Iowa,48,Texas,367,Parker County,31,20,11
19,Iowa,48,Texas,375,Potter County,230,24,206
19,Iowa,48,Texas,379,Rains County,0,5,-5
19,Iowa,48,Texas,381,Randall County,46,22,24
19,Iowa,48,Texas,389,Reeves County,28,0,28
19,Iowa,48,Texas,401,Rusk County,0,5,-5
19,Iowa,48,Texas,409,San Patricio County,2,43,-41
19,Iowa,48,Texas,423,Smith County,33,0,33
19,Iowa,48,Texas,439,Tarrant County,242,940,-698
19,Iowa,48,Texas,441,Taylor County,16,43,-27
19,Iowa,48,Texas,447,Throckmorton County,0,10,-10
19,Iowa,48,Texas,449,Titus County,0,32,-32
19,Iowa,48,Texas,451,Tom Green County,64,123,-59
19,Iowa,48,Texas,453,Travis County,209,479,-270
19,Iowa,48,Texas,457,Tyler County,0,20,-20
19,Iowa,48,Texas,467,Van Zandt County,5,3,2
19,Iowa,48,Texas,469,Victoria County,0,58,-58
19,Iowa,48,Texas,471,Walker County,3,0,3
19,Iowa,48,Texas,479,Webb County,81,0,81
19,Iowa,48,Texas,485,Wichita County,0,18,-18
19,Iowa,48,Texas,487,Wilbarger County,0,5,-5
19,Iowa,48,Texas,491,Williamson County,110,144,-34
19,Iowa,48,Texas,497,Wise County,0,163,-163
19,Iowa,49,Utah,1,Beaver County,10,0,10
19,Iowa,49,Utah,3,Box Elder County,0,8,-8
19,Iowa,49,Utah,5,Cache County,16,0,16
19,Iowa,49,Utah,11,Davis County,14,69,-55
19,Iowa,49,Utah,13,Duchesne County,0,5,-5
19,Iowa,49,Utah,23,Juab County,4,0,4
19,Iowa,49,Utah,27,Millard County,0,19,-19
19,Iowa,49,Utah,29,Morgan County,0,17,-17
19,Iowa,49,Utah,35,Salt Lake County,198,56,142
19,Iowa,49,Utah,39,Sanpete County,8,6,2
19,Iowa,49,Utah,41,Sevier County,12,2,10
19,Iowa,49,Utah,45,Tooele County,19,0,19
19,Iowa,49,Utah,47,Uintah County,18,0,18
19,Iowa,49,Utah,49,Utah County,154,67,87
19,Iowa,49,Utah,53,Washington County,69,0,69
19,Iowa,49,Utah,57,Weber County,27,65,-38
19,Iowa,5,Arkansas,5,Baxter County,78,94,-16
19,Iowa,5,Arkansas,7,Benton County,278,80,198
19,Iowa,5,Arkansas,9,Boone County,0,16,-16
19,Iowa,5,Arkansas,15,Carroll County,0,24,-24
19,Iowa,5,Arkansas,31,Craighead County,17,56,-39
19,Iowa,5,Arkansas,33,Crawford County,10,0,10
19,Iowa,5,Arkansas,35,Crittenden County,20,0,20
19,Iowa,5,Arkansas,37,Cross County,0,7,-7
19,Iowa,5,Arkansas,41,Desha County,0,19,-19
19,Iowa,5,Arkansas,45,Faulkner County,0,2,-2
19,Iowa,5,Arkansas,51,Garland County,5,27,-22
19,Iowa,5,Arkansas,55,Greene County,11,0,11
19,Iowa,5,Arkansas,59,Hot Spring County,53,0,53
19,Iowa,5,Arkansas,65,Izard County,16,8,8
19,Iowa,5,Arkansas,69,Jefferson County,0,50,-50
19,Iowa,5,Arkansas,83,Logan County,0,9,-9
19,Iowa,5,Arkansas,89,Marion County,106,0,106
19,Iowa,5,Arkansas,93,Mississippi County,13,4,9
19,Iowa,5,Arkansas,101,Newton County,0,38,-38
19,Iowa,5,Arkansas,109,Pike County,0,3,-3
19,Iowa,5,Arkansas,113,Polk County,3,0,3
19,Iowa,5,Arkansas,115,Pope County,18,0,18
19,Iowa,5,Arkansas,119,Pulaski County,90,94,-4
19,Iowa,5,Arkansas,123,St. Francis County,0,24,-24
19,Iowa,5,Arkansas,125,Saline County,0,46,-46
19,Iowa,5,Arkansas,127,Scott County,64,0,64
19,Iowa,5,Arkansas,141,Van Buren County,4,0,4
19,Iowa,5,Arkansas,143,Washington County,81,18,63
19,Iowa,5,Arkansas,145,White County,49,0,49
19,Iowa,50,Vermont,1,Addison County,5,31,-26
19,Iowa,50,Vermont,3,Bennington County,4,0,4
19,Iowa,50,Vermont,5,Caledonia County,17,0,17
19,Iowa,50,Vermont,7,Chittenden County,17,36,-19
19,Iowa,50,Vermont,19,Orleans County,19,0,19
19,Iowa,50,Vermont,21,Rutland County,153,0,153
19,Iowa,50,Vermont,27,Windsor County,3,36,-33
19,Iowa,51,Virginia,1,Accomack County,3,13,-10
19,Iowa,51,Virginia,3,Albemarle County,0,9,-9
19,Iowa,51,Virginia,13,Arlington County,5,31,-26
19,Iowa,51,Virginia,33,Caroline County,0,23,-23
19,Iowa,51,Virginia,41,Chesterfield County,28,21,7
19,Iowa,51,Virginia,59,Fairfax County,291,127,164
19,Iowa,51,Virginia,61,Fauquier County,0,10,-10
19,Iowa,51,Virginia,67,Franklin County,28,0,28
19,Iowa,51,Virginia,87,Henrico County,0,62,-62
19,Iowa,51,Virginia,89,Henry County,23,0,23
19,Iowa,51,Virginia,95,James City County,9,0,9
19,Iowa,51,Virginia,99,King George County,0,29,-29
19,Iowa,51,Virginia,107,Loudoun County,10,88,-78
19,Iowa,51,Virginia,113,Madison County,10,0,10
19,Iowa,51,Virginia,121,Montgomery County,31,10,21
19,Iowa,51,Virginia,135,Nottoway County,0,15,-15
19,Iowa,51,Virginia,153,Prince William County,99,193,-94
19,Iowa,51,Virginia,171,Shenandoah County,1,0,1
19,Iowa,51,Virginia,177,Spotsylvania County,0,18,-18
19,Iowa,51,Virginia,185,Tazewell County,0,2,-2
19,Iowa,51,Virginia,191,Washington County,37,0,37
19,Iowa,51,Virginia,510,Alexandria city,23,92,-69
19,Iowa,51,Virginia,550,Chesapeake city,25,31,-6
19,Iowa,51,Virginia,650,Hampton city,29,0,29
19,Iowa,51,Virginia,660,Harrisonburg city,18,0,18
19,Iowa,51,Virginia,680,Lynchburg city,0,29,-29
19,Iowa,51,Virginia,683,Manassas city,0,20,-20
19,Iowa,51,Virginia,700,Newport News city,0,73,-73
19,Iowa,51,Virginia,710,Norfolk city,8,4,4
19,Iowa,51,Virginia,730,Petersburg city,17,0,17
19,Iowa,51,Virginia,740,Portsmouth city,8,0,8
19,Iowa,51,Virginia,760,Richmond city,25,0,25
19,Iowa,51,Virginia,770,Roanoke city,4,0,4
19,Iowa,51,Virginia,810,Virginia Beach city,25,50,-25
19,Iowa,51,Virginia,820,Waynesboro city,28,0,28
19,Iowa,53,Washington,1,Adams County,14,0,14
19,Iowa,53,Washington,5,Benton County,4,4,0
19,Iowa,53,Washington,11,Clark County,36,51,-15
19,Iowa,53,Washington,13,Columbia County,5,0,5
19,Iowa,53,Washington,15,Cowlitz County,0,16,-16
19,Iowa,53,Washington,17,Douglas County,18,0,18
19,Iowa,53,Washington,21,Franklin County,0,149,-149
19,Iowa,53,Washington,25,Grant County,7,0,7
19,Iowa,53,Washington,27,Grays Harbor County,25,0,25
19,Iowa,53,Washington,29,Island County,0,1,-1
19,Iowa,53,Washington,31,Jefferson County,3,0,3
19,Iowa,53,Washington,33,King County,394,229,165
19,Iowa,53,Washington,35,Kitsap County,8,48,-40
19,Iowa,53,Washington,37,Kittitas County,0,46,-46
19,Iowa,53,Washington,41,Lewis County,0,50,-50
19,Iowa,53,Washington,53,Pierce County,84,120,-36
19,Iowa,53,Washington,55,San Juan County,0,2,-2
19,Iowa,53,Washington,57,Skagit County,13,32,-19
19,Iowa,53,Washington,59,Skamania County,0,2,-2
19,Iowa,53,Washington,61,Snohomish County,370,63,307
19,Iowa,53,Washington,63,Spokane County,142,287,-145
19,Iowa,53,Washington,65,Stevens County,14,11,3
19,Iowa,53,Washington,67,Thurston County,38,25,13
19,Iowa,53,Washington,69,Wahkiakum County,59,0,59
19,Iowa,53,Washington,71,Walla Walla County,50,0,50
19,Iowa,53,Washington,73,Whatcom County,16,8,8
19,Iowa,53,Washington,75,Whitman County,175,49,126
19,Iowa,53,Washington,77,Yakima County,49,0,49
19,Iowa,54,West Virginia,11,Cabell County,8,12,-4
19,Iowa,54,West Virginia,25,Greenbrier County,17,0,17
19,Iowa,54,West Virginia,33,Harrison County,19,0,19
19,Iowa,54,West Virginia,39,Kanawha County,45,32,13
19,Iowa,54,West Virginia,51,Marshall County,2,0,2
19,Iowa,54,West Virginia,55,Mercer County,21,0,21
19,Iowa,54,West Virginia,59,Mingo County,0,2,-2
19,Iowa,54,West Virginia,61,Monongalia County,44,0,44
19,Iowa,54,West Virginia,75,Pocahontas County,20,0,20
19,Iowa,54,West Virginia,79,Putnam County,35,0,35
19,Iowa,54,West Virginia,107,Wood County,0,6,-6
19,Iowa,55,Wisconsin,1,Adams County,11,57,-46
19,Iowa,55,Wisconsin,3,Ashland County,0,12,-12
19,Iowa,55,Wisconsin,5,Barron County,42,13,29
19,Iowa,55,Wisconsin,7,Bayfield County,17,13,4
19,Iowa,55,Wisconsin,9,Brown County,44,62,-18
19,Iowa,55,Wisconsin,11,Buffalo County,14,1,13
19,Iowa,55,Wisconsin,13,Burnett County,0,17,-17
19,Iowa,55,Wisconsin,15,Calumet County,34,14,20
19,Iowa,55,Wisconsin,17,Chippewa County,0,16,-16
19,Iowa,55,Wisconsin,19,Clark County,17,8,9
19,Iowa,55,Wisconsin,21,Columbia County,16,34,-18
19,Iowa,55,Wisconsin,23,Crawford County,181,126,55
19,Iowa,55,Wisconsin,25,Dane County,705,1246,-541
19,Iowa,55,Wisconsin,27,Dodge County,11,175,-164
19,Iowa,55,Wisconsin,29,Door County,10,61,-51
19,Iowa,55,Wisconsin,31,Douglas County,17,4,13
19,Iowa,55,Wisconsin,33,Dunn County,68,64,4
19,Iowa,55,Wisconsin,35,Eau Claire County,145,205,-60
19,Iowa,55,Wisconsin,39,Fond du Lac County,202,3,199
19,Iowa,55,Wisconsin,43,Grant County,305,294,11
19,Iowa,55,Wisconsin,45,Green County,64,3,61
19,Iowa,55,Wisconsin,47,Green Lake County,0,14,-14
19,Iowa,55,Wisconsin,49,Iowa County,0,55,-55
19,Iowa,55,Wisconsin,53,Jackson County,0,9,-9
19,Iowa,55,Wisconsin,55,Jefferson County,21,14,7
19,Iowa,55,Wisconsin,57,Juneau County,22,17,5
19,Iowa,55,Wisconsin,59,Kenosha County,69,44,25
19,Iowa,55,Wisconsin,61,Kewaunee County,0,10,-10
19,Iowa,55,Wisconsin,63,La Crosse County,232,182,50
19,Iowa,55,Wisconsin,65,Lafayette County,62,13,49
19,Iowa,55,Wisconsin,67,Langlade County,48,17,31
19,Iowa,55,Wisconsin,69,Lincoln County,0,4,-4
19,Iowa,55,Wisconsin,71,Manitowoc County,23,0,23
19,Iowa,55,Wisconsin,73,Marathon County,44,16,28
19,Iowa,55,Wisconsin,77,Marquette County,6,0,6
19,Iowa,55,Wisconsin,78,Menominee County,21,0,21
19,Iowa,55,Wisconsin,79,Milwaukee County,374,197,177
19,Iowa,55,Wisconsin,81,Monroe County,25,175,-150
19,Iowa,55,Wisconsin,83,Oconto County,13,22,-9
19,Iowa,55,Wisconsin,85,Oneida County,0,1,-1
19,Iowa,55,Wisconsin,87,Outagamie County,115,38,77
19,Iowa,55,Wisconsin,89,Ozaukee County,34,51,-17
19,Iowa,55,Wisconsin,93,Pierce County,37,68,-31
19,Iowa,55,Wisconsin,95,Polk County,20,19,1
19,Iowa,55,Wisconsin,97,Portage County,35,27,8
19,Iowa,55,Wisconsin,101,Racine County,40,93,-53
19,Iowa,55,Wisconsin,103,Richland County,16,3,13
19,Iowa,55,Wisconsin,105,Rock County,99,23,76
19,Iowa,55,Wisconsin,107,Rusk County,0,8,-8
19,Iowa,55,Wisconsin,109,St. Croix County,65,0,65
19,Iowa,55,Wisconsin,111,Sauk County,0,72,-72
19,Iowa,55,Wisconsin,117,Sheboygan County,11,92,-81
19,Iowa,55,Wisconsin,119,Taylor County,0,16,-16
19,Iowa,55,Wisconsin,121,Trempealeau County,62,25,37
19,Iowa,55,Wisconsin,123,Vernon County,13,9,4
19,Iowa,55,Wisconsin,125,Vilas County,0,2,-2
19,Iowa,55,Wisconsin,127,Walworth County,59,99,-40
19,Iowa,55,Wisconsin,129,Washburn County,0,16,-16
19,Iowa,55,Wisconsin,131,Washington County,40,218,-178
19,Iowa,55,Wisconsin,133,Waukesha County,293,212,81
19,Iowa,55,Wisconsin,135,Waupaca County,0,38,-38
19,Iowa,55,Wisconsin,137,Waushara County,0,10,-10
19,Iowa,55,Wisconsin,139,Winnebago County,33,105,-72
19,Iowa,55,Wisconsin,141,Wood County,49,7,42
19,Iowa,56,Wyoming,1,Albany County,119,9,110
19,Iowa,56,Wyoming,5,Campbell County,44,0,44
19,Iowa,56,Wyoming,13,Fremont County,0,20,-20
19,Iowa,56,Wyoming,15,Goshen County,0,13,-13
19,Iowa,56,Wyoming,19,Johnson County,14,0,14
19,Iowa,56,Wyoming,21,Laramie County,3,120,-117
19,Iowa,56,Wyoming,23,Lincoln County,0,69,-69
19,Iowa,56,Wyoming,25,Natrona County,10,40,-30
19,Iowa,56,Wyoming,27,Niobrara County,0,3,-3
19,Iowa,56,Wyoming,29,Park County,12,2,10
19,Iowa,56,Wyoming,33,Sheridan County,0,3,-3
19,Iowa,56,Wyoming,37,Sweetwater County,7,17,-10
19,Iowa,56,Wyoming,39,Teton County,10,0,10
19,Iowa,56,Wyoming,43,Washakie County,8,0,8
19,Iowa,6,California,1,Alameda County,176,135,41
19,Iowa,6,California,7,Butte County,0,2,-2
19,Iowa,6,California,13,Contra Costa County,28,14,14
19,Iowa,6,California,15,Del Norte County,0,4,-4
19,Iowa,6,California,17,El Dorado County,8,0,8
19,Iowa,6,California,19,Fresno County,77,35,42
19,Iowa,6,California,23,Humboldt County,37,33,4
19,Iowa,6,California,25,Imperial County,11,0,11
19,Iowa,6,California,29,Kern County,38,0,38
19,Iowa,6,California,35,Lassen County,0,1,-1
19,Iowa,6,California,37,Los Angeles County,534,644,-110
19,Iowa,6,California,41,Marin County,28,0,28
19,Iowa,6,California,43,Mariposa County,0,9,-9
19,Iowa,6,California,45,Mendocino County,0,13,-13
19,Iowa,6,California,47,Merced County,6,9,-3
19,Iowa,6,California,53,Monterey County,57,14,43
19,Iowa,6,California,55,Napa County,37,0,37
19,Iowa,6,California,59,Orange County,746,372,374
19,Iowa,6,California,61,Placer County,27,2,25
19,Iowa,6,California,65,Riverside County,156,116,40
19,Iowa,6,California,67,Sacramento County,117,186,-69
19,Iowa,6,California,71,San Bernardino County,204,273,-69
19,Iowa,6,California,73,San Diego County,321,433,-112
19,Iowa,6,California,75,San Francisco County,112,65,47
19,Iowa,6,California,77,San Joaquin County,149,356,-207
19,Iowa,6,California,79,San Luis Obispo County,14,22,-8
19,Iowa,6,California,81,San Mateo County,28,29,-1
19,Iowa,6,California,83,Santa Barbara County,38,75,-37
19,Iowa,6,California,85,Santa Clara County,180,234,-54
19,Iowa,6,California,87,Santa Cruz County,38,0,38
19,Iowa,6,California,89,Shasta County,49,43,6
19,Iowa,6,California,93,Siskiyou County,16,0,16
19,Iowa,6,California,95,Solano County,7,18,-11
19,Iowa,6,California,97,Sonoma County,19,0,19
19,Iowa,6,California,99,Stanislaus County,69,67,2
19,Iowa,6,California,103,Tehama County,0,18,-18
19,Iowa,6,California,107,Tulare County,0,60,-60
19,Iowa,6,California,109,Tuolumne County,17,0,17
19,Iowa,6,California,111,Ventura County,104,20,84
19,Iowa,6,California,113,Yolo County,0,53,-53
19,Iowa,6,California,115,Yuba County,0,3,-3
19,Iowa,72,Puerto Rico,11,Añasco Municipio,0,21,-21
19,Iowa,72,Puerto Rico,23,Cabo Rojo Municipio,1,0,1
19,Iowa,72,Puerto Rico,25,Caguas Municipio,4,0,4
19,Iowa,72,Puerto Rico,61,Guaynabo Municipio,0,12,-12
19,Iowa,72,Puerto Rico,97,Mayagüez Municipio,0,15,-15
19,Iowa,72,Puerto Rico,113,Ponce Municipio,5,0,5
19,Iowa,72,Puerto Rico,127,San Juan Municipio,18,0,18
19,Iowa,8,Colorado,1,Adams County,154,194,-40
19,Iowa,8,Colorado,3,Alamosa County,34,0,34
19,Iowa,8,Colorado,5,Arapahoe County,452,253,199
19,Iowa,8,Colorado,13,Boulder County,100,337,-237
19,Iowa,8,Colorado,14,Broomfield County,23,0,23
19,Iowa,8,Colorado,15,Chaffee County,30,0,30
19,Iowa,8,Colorado,19,Clear Creek County,14,0,14
19,Iowa,8,Colorado,29,Delta County,19,18,1
19,Iowa,8,Colorado,31,Denver County,289,581,-292
19,Iowa,8,Colorado,35,Douglas County,68,98,-30
19,Iowa,8,Colorado,37,Eagle County,4,21,-17
19,Iowa,8,Colorado,41,El Paso County,427,772,-345
19,Iowa,8,Colorado,43,Fremont County,34,0,34
19,Iowa,8,Colorado,45,Garfield County,25,0,25
19,Iowa,8,Colorado,49,Grand County,27,0,27
19,Iowa,8,Colorado,59,Jefferson County,105,254,-149
19,Iowa,8,Colorado,63,Kit Carson County,0,1,-1
19,Iowa,8,Colorado,67,La Plata County,8,51,-43
19,Iowa,8,Colorado,69,Larimer County,254,263,-9
19,Iowa,8,Colorado,73,Lincoln County,4,0,4
19,Iowa,8,Colorado,75,Logan County,8,0,8
19,Iowa,8,Colorado,77,Mesa County,14,85,-71
19,Iowa,8,Colorado,87,Morgan County,6,5,1
19,Iowa,8,Colorado,91,Ouray County,0,10,-10
19,Iowa,8,Colorado,93,Park County,15,0,15
19,Iowa,8,Colorado,95,Phillips County,0,7,-7
19,Iowa,8,Colorado,99,Prowers County,3,0,3
19,Iowa,8,Colorado,101,Pueblo County,84,141,-57
19,Iowa,8,Colorado,117,Summit County,0,16,-16
19,Iowa,8,Colorado,121,Washington County,2,0,2
19,Iowa,8,Colorado,123,Weld County,124,75,49
19,Iowa,9,Connecticut,1,Fairfield County,17,0,17
19,Iowa,9,Connecticut,3,Hartford County,67,79,-12
19,Iowa,9,Connecticut,7,Middlesex County,44,0,44
19,Iowa,9,Connecticut,9,New Haven County,22,30,-8
19,Iowa,9,Connecticut,11,New London County,21,11,10
19,Iowa,9,Connecticut,15,Windham County,2,0,2
19,Iowa,AFR,Africa,,-,1539,0,0
19,Iowa,ASI,Asia,,-,6510,0,0
19,Iowa,CAM,Central America,,-,1100,0,0
19,Iowa,CAR,Caribbean,,-,239,0,0
19,Iowa,EUR,Europe,,-,1973,0,0
19,Iowa,ISL,U.S. Island Areas,,-,22,0,0
19,Iowa,NAM,Northern America,,-,240,0,0
19,Iowa,OCE,Oceania and At Sea,,-,253,0,0
19,Iowa,SAM,South America,,-,782,0,0
20,Kansas,1,Alabama,1,Autauga County,47,0,47
20,Kansas,1,Alabama,3,Baldwin County,21,0,21
20,Kansas,1,Alabama,15,Calhoun County,13,0,13
20,Kansas,1,Alabama,17,Chambers County,0,10,-10
20,Kansas,1,Alabama,19,Cherokee County,81,0,81
20,Kansas,1,Alabama,31,Coffee County,27,23,4
20,Kansas,1,Alabama,45,Dale County,49,167,-118
20,Kansas,1,Alabama,55,Etowah County,24,0,24
20,Kansas,1,Alabama,61,Geneva County,0,2,-2
20,Kansas,1,Alabama,69,Houston County,11,38,-27
20,Kansas,1,Alabama,73,Jefferson County,74,106,-32
20,Kansas,1,Alabama,77,Lauderdale County,27,0,27
20,Kansas,1,Alabama,81,Lee County,93,60,33
20,Kansas,1,Alabama,89,Madison County,28,102,-74
20,Kansas,1,Alabama,97,Mobile County,44,52,-8
20,Kansas,1,Alabama,101,Montgomery County,23,31,-8
20,Kansas,1,Alabama,103,Morgan County,19,113,-94
20,Kansas,1,Alabama,107,Pickens County,0,9,-9
20,Kansas,1,Alabama,113,Russell County,10,24,-14
20,Kansas,1,Alabama,115,St. Clair County,4,0,4
20,Kansas,1,Alabama,117,Shelby County,0,103,-103
20,Kansas,1,Alabama,123,Tallapoosa County,22,0,22
20,Kansas,1,Alabama,125,Tuscaloosa County,53,50,3
20,Kansas,1,Alabama,129,Washington County,0,17,-17
20,Kansas,1,Alabama,133,Winston County,0,2,-2
20,Kansas,10,Delaware,3,New Castle County,48,30,18
20,Kansas,11,District of Columbia,1,District of Columbia,36,35,1
20,Kansas,12,Florida,1,Alachua County,0,18,-18
20,Kansas,12,Florida,5,Bay County,54,69,-15
20,Kansas,12,Florida,9,Brevard County,29,101,-72
20,Kansas,12,Florida,11,Broward County,82,146,-64
20,Kansas,12,Florida,13,Calhoun County,34,0,34
20,Kansas,12,Florida,15,Charlotte County,14,65,-51
20,Kansas,12,Florida,17,Citrus County,0,33,-33
20,Kansas,12,Florida,19,Clay County,25,0,25
20,Kansas,12,Florida,21,Collier County,39,145,-106
20,Kansas,12,Florida,23,Columbia County,58,0,58
20,Kansas,12,Florida,31,Duval County,150,95,55
20,Kansas,12,Florida,33,Escambia County,275,51,224
20,Kansas,12,Florida,45,Gulf County,35,0,35
20,Kansas,12,Florida,51,Hendry County,30,0,30
20,Kansas,12,Florida,53,Hernando County,0,99,-99
20,Kansas,12,Florida,55,Highlands County,14,0,14
20,Kansas,12,Florida,57,Hillsborough County,480,237,243
20,Kansas,12,Florida,61,Indian River County,31,0,31
20,Kansas,12,Florida,63,Jackson County,0,14,-14
20,Kansas,12,Florida,65,Jefferson County,3,0,3
20,Kansas,12,Florida,69,Lake County,27,81,-54
20,Kansas,12,Florida,71,Lee County,64,41,23
20,Kansas,12,Florida,73,Leon County,6,0,6
20,Kansas,12,Florida,75,Levy County,6,0,6
20,Kansas,12,Florida,81,Manatee County,22,151,-129
20,Kansas,12,Florida,83,Marion County,66,195,-129
20,Kansas,12,Florida,85,Martin County,0,25,-25
20,Kansas,12,Florida,86,Miami-Dade County,466,58,408
20,Kansas,12,Florida,87,Monroe County,0,75,-75
20,Kansas,12,Florida,91,Okaloosa County,120,82,38
20,Kansas,12,Florida,95,Orange County,113,102,11
20,Kansas,12,Florida,97,Osceola County,15,19,-4
20,Kansas,12,Florida,99,Palm Beach County,55,174,-119
20,Kansas,12,Florida,101,Pasco County,0,129,-129
20,Kansas,12,Florida,103,Pinellas County,188,242,-54
20,Kansas,12,Florida,105,Polk County,85,87,-2
20,Kansas,12,Florida,107,Putnam County,0,10,-10
20,Kansas,12,Florida,109,St. Johns County,140,181,-41
20,Kansas,12,Florida,111,St. Lucie County,18,0,18
20,Kansas,12,Florida,113,Santa Rosa County,169,0,169
20,Kansas,12,Florida,115,Sarasota County,33,54,-21
20,Kansas,12,Florida,117,Seminole County,82,86,-4
20,Kansas,12,Florida,119,Sumter County,31,12,19
20,Kansas,12,Florida,121,Suwannee County,0,19,-19
20,Kansas,12,Florida,127,Volusia County,22,103,-81
20,Kansas,12,Florida,129,Wakulla County,25,0,25
20,Kansas,12,Florida,131,Walton County,0,17,-17
20,Kansas,13,Georgia,9,Baldwin County,0,1,-1
20,Kansas,13,Georgia,15,Bartow County,27,0,27
20,Kansas,13,Georgia,17,Ben Hill County,82,0,82
20,Kansas,13,Georgia,19,Berrien County,18,0,18
20,Kansas,13,Georgia,21,Bibb County,0,14,-14
20,Kansas,13,Georgia,23,Bleckley County,0,11,-11
20,Kansas,13,Georgia,27,Brooks County,0,4,-4
20,Kansas,13,Georgia,29,Bryan County,0,151,-151
20,Kansas,13,Georgia,31,Bulloch County,57,0,57
20,Kansas,13,Georgia,35,Butts County,5,0,5
20,Kansas,13,Georgia,39,Camden County,0,1,-1
20,Kansas,13,Georgia,51,Chatham County,61,1017,-956
20,Kansas,13,Georgia,53,Chattahoochee County,108,43,65
20,Kansas,13,Georgia,55,Chattooga County,0,67,-67
20,Kansas,13,Georgia,57,Cherokee County,69,9,60
20,Kansas,13,Georgia,59,Clarke County,22,4,18
20,Kansas,13,Georgia,67,Cobb County,136,233,-97
20,Kansas,13,Georgia,73,Columbia County,100,212,-112
20,Kansas,13,Georgia,75,Cook County,5,0,5
20,Kansas,13,Georgia,77,Coweta County,52,16,36
20,Kansas,13,Georgia,87,Decatur County,14,0,14
20,Kansas,13,Georgia,89,DeKalb County,69,197,-128
20,Kansas,13,Georgia,95,Dougherty County,0,10,-10
20,Kansas,13,Georgia,97,Douglas County,0,16,-16
20,Kansas,13,Georgia,103,Effingham County,25,0,25
20,Kansas,13,Georgia,113,Fayette County,13,56,-43
20,Kansas,13,Georgia,115,Floyd County,8,7,1
20,Kansas,13,Georgia,121,Fulton County,112,278,-166
20,Kansas,13,Georgia,127,Glynn County,1,0,1
20,Kansas,13,Georgia,135,Gwinnett County,110,226,-116
20,Kansas,13,Georgia,145,Harris County,22,3,19
20,Kansas,13,Georgia,151,Henry County,14,0,14
20,Kansas,13,Georgia,153,Houston County,76,119,-43
20,Kansas,13,Georgia,161,Jeff Davis County,0,42,-42
20,Kansas,13,Georgia,175,Laurens County,6,0,6
20,Kansas,13,Georgia,179,Liberty County,327,99,228
20,Kansas,13,Georgia,183,Long County,0,36,-36
20,Kansas,13,Georgia,185,Lowndes County,0,5,-5
20,Kansas,13,Georgia,199,Meriwether County,0,3,-3
20,Kansas,13,Georgia,213,Murray County,0,6,-6
20,Kansas,13,Georgia,215,Muscogee County,379,209,170
20,Kansas,13,Georgia,217,Newton County,9,0,9
20,Kansas,13,Georgia,219,Oconee County,0,17,-17
20,Kansas,13,Georgia,223,Paulding County,14,0,14
20,Kansas,13,Georgia,233,Polk County,0,37,-37
20,Kansas,13,Georgia,237,Putnam County,0,39,-39
20,Kansas,13,Georgia,245,Richmond County,68,46,22
20,Kansas,13,Georgia,251,Screven County,5,0,5
20,Kansas,13,Georgia,267,Tattnall County,139,0,139
20,Kansas,13,Georgia,275,Thomas County,13,8,5
20,Kansas,13,Georgia,285,Troup County,1,19,-18
20,Kansas,13,Georgia,291,Union County,87,0,87
20,Kansas,13,Georgia,295,Walker County,9,0,9
20,Kansas,13,Georgia,299,Ware County,97,0,97
20,Kansas,13,Georgia,313,Whitfield County,0,1,-1
20,Kansas,15,Hawaii,1,Hawaii County,25,0,25
20,Kansas,15,Hawaii,3,Honolulu County,270,442,-172
20,Kansas,15,Hawaii,7,Kauai County,10,0,10
20,Kansas,15,Hawaii,9,Maui County,135,16,119
20,Kansas,16,Idaho,1,Ada County,20,80,-60
20,Kansas,16,Idaho,11,Bingham County,24,7,17
20,Kansas,16,Idaho,17,Bonner County,0,46,-46
20,Kansas,16,Idaho,19,Bonneville County,0,7,-7
20,Kansas,16,Idaho,27,Canyon County,19,54,-35
20,Kansas,16,Idaho,39,Elmore County,2,0,2
20,Kansas,16,Idaho,51,Jefferson County,0,57,-57
20,Kansas,16,Idaho,57,Latah County,0,25,-25
20,Kansas,16,Idaho,59,Lemhi County,0,1,-1
20,Kansas,16,Idaho,61,Lewis County,0,2,-2
20,Kansas,16,Idaho,65,Madison County,0,36,-36
20,Kansas,16,Idaho,75,Payette County,0,151,-151
20,Kansas,16,Idaho,83,Twin Falls County,36,99,-63
20,Kansas,17,Illinois,1,Adams County,0,1,-1
20,Kansas,17,Illinois,5,Bond County,0,4,-4
20,Kansas,17,Illinois,7,Boone County,5,4,1
20,Kansas,17,Illinois,11,Bureau County,0,33,-33
20,Kansas,17,Illinois,13,Calhoun County,8,0,8
20,Kansas,17,Illinois,15,Carroll County,0,3,-3
20,Kansas,17,Illinois,19,Champaign County,93,69,24
20,Kansas,17,Illinois,21,Christian County,2,0,2
20,Kansas,17,Illinois,23,Clark County,0,12,-12
20,Kansas,17,Illinois,29,Coles County,12,0,12
20,Kansas,17,Illinois,31,Cook County,793,570,223
20,Kansas,17,Illinois,35,Cumberland County,0,39,-39
20,Kansas,17,Illinois,37,DeKalb County,9,11,-2
20,Kansas,17,Illinois,43,DuPage County,148,200,-52
20,Kansas,17,Illinois,51,Fayette County,0,13,-13
20,Kansas,17,Illinois,57,Fulton County,0,8,-8
20,Kansas,17,Illinois,61,Greene County,11,0,11
20,Kansas,17,Illinois,67,Hancock County,11,7,4
20,Kansas,17,Illinois,75,Iroquois County,9,0,9
20,Kansas,17,Illinois,77,Jackson County,34,0,34
20,Kansas,17,Illinois,89,Kane County,31,13,18
20,Kansas,17,Illinois,91,Kankakee County,7,24,-17
20,Kansas,17,Illinois,93,Kendall County,5,0,5
20,Kansas,17,Illinois,95,Knox County,8,0,8
20,Kansas,17,Illinois,97,Lake County,44,229,-185
20,Kansas,17,Illinois,99,LaSalle County,21,2,19
20,Kansas,17,Illinois,101,Lawrence County,0,8,-8
20,Kansas,17,Illinois,105,Livingston County,6,0,6
20,Kansas,17,Illinois,107,Logan County,10,8,2
20,Kansas,17,Illinois,109,McDonough County,0,10,-10
20,Kansas,17,Illinois,111,McHenry County,51,76,-25
20,Kansas,17,Illinois,113,McLean County,69,12,57
20,Kansas,17,Illinois,115,Macon County,20,7,13
20,Kansas,17,Illinois,117,Macoupin County,3,2,1
20,Kansas,17,Illinois,119,Madison County,9,18,-9
20,Kansas,17,Illinois,121,Marion County,0,3,-3
20,Kansas,17,Illinois,131,Mercer County,12,0,12
20,Kansas,17,Illinois,133,Monroe County,25,0,25
20,Kansas,17,Illinois,137,Morgan County,101,0,101
20,Kansas,17,Illinois,141,Ogle County,24,14,10
20,Kansas,17,Illinois,143,Peoria County,64,0,64
20,Kansas,17,Illinois,149,Pike County,3,0,3
20,Kansas,17,Illinois,161,Rock Island County,130,0,130
20,Kansas,17,Illinois,163,St. Clair County,87,135,-48
20,Kansas,17,Illinois,167,Sangamon County,75,20,55
20,Kansas,17,Illinois,177,Stephenson County,0,34,-34
20,Kansas,17,Illinois,179,Tazewell County,43,13,30
20,Kansas,17,Illinois,181,Union County,121,0,121
20,Kansas,17,Illinois,183,Vermilion County,25,5,20
20,Kansas,17,Illinois,185,Wabash County,12,0,12
20,Kansas,17,Illinois,195,Whiteside County,6,0,6
20,Kansas,17,Illinois,197,Will County,211,149,62
20,Kansas,17,Illinois,199,Williamson County,0,57,-57
20,Kansas,17,Illinois,201,Winnebago County,0,6,-6
20,Kansas,18,Indiana,3,Allen County,10,116,-106
20,Kansas,18,Indiana,7,Benton County,0,18,-18
20,Kansas,18,Indiana,17,Cass County,0,7,-7
20,Kansas,18,Indiana,21,Clay County,0,25,-25
20,Kansas,18,Indiana,23,Clinton County,0,52,-52
20,Kansas,18,Indiana,35,Delaware County,0,30,-30
20,Kansas,18,Indiana,39,Elkhart County,134,40,94
20,Kansas,18,Indiana,43,Floyd County,0,18,-18
20,Kansas,18,Indiana,53,Grant County,11,10,1
20,Kansas,18,Indiana,55,Greene County,0,3,-3
20,Kansas,18,Indiana,57,Hamilton County,25,66,-41
20,Kansas,18,Indiana,63,Hendricks County,9,76,-67
20,Kansas,18,Indiana,65,Henry County,0,4,-4
20,Kansas,18,Indiana,71,Jackson County,0,56,-56
20,Kansas,18,Indiana,81,Johnson County,17,26,-9
20,Kansas,18,Indiana,83,Knox County,0,8,-8
20,Kansas,18,Indiana,85,Kosciusko County,3,66,-63
20,Kansas,18,Indiana,87,LaGrange County,0,2,-2
20,Kansas,18,Indiana,89,Lake County,64,115,-51
20,Kansas,18,Indiana,91,LaPorte County,179,2,177
20,Kansas,18,Indiana,95,Madison County,0,2,-2
20,Kansas,18,Indiana,97,Marion County,132,182,-50
20,Kansas,18,Indiana,105,Monroe County,82,79,3
20,Kansas,18,Indiana,107,Montgomery County,6,0,6
20,Kansas,18,Indiana,109,Morgan County,0,20,-20
20,Kansas,18,Indiana,127,Porter County,114,0,114
20,Kansas,18,Indiana,137,Ripley County,0,7,-7
20,Kansas,18,Indiana,141,St. Joseph County,78,125,-47
20,Kansas,18,Indiana,145,Shelby County,4,0,4
20,Kansas,18,Indiana,157,Tippecanoe County,0,74,-74
20,Kansas,18,Indiana,163,Vanderburgh County,0,4,-4
20,Kansas,18,Indiana,167,Vigo County,40,0,40
20,Kansas,18,Indiana,177,Wayne County,19,0,19
20,Kansas,18,Indiana,179,Wells County,9,34,-25
20,Kansas,18,Indiana,181,White County,0,29,-29
20,Kansas,19,Iowa,5,Allamakee County,12,10,2
20,Kansas,19,Iowa,7,Appanoose County,49,0,49
20,Kansas,19,Iowa,9,Audubon County,0,7,-7
20,Kansas,19,Iowa,11,Benton County,0,2,-2
20,Kansas,19,Iowa,13,Black Hawk County,247,112,135
20,Kansas,19,Iowa,15,Boone County,30,62,-32
20,Kansas,19,Iowa,19,Buchanan County,0,11,-11
20,Kansas,19,Iowa,21,Buena Vista County,0,27,-27
20,Kansas,19,Iowa,23,Butler County,0,39,-39
20,Kansas,19,Iowa,27,Carroll County,20,0,20
20,Kansas,19,Iowa,29,Cass County,10,0,10
20,Kansas,19,Iowa,31,Cedar County,13,0,13
20,Kansas,19,Iowa,33,Cerro Gordo County,22,0,22
20,Kansas,19,Iowa,43,Clayton County,6,0,6
20,Kansas,19,Iowa,47,Crawford County,39,2,37
20,Kansas,19,Iowa,49,Dallas County,4,82,-78
20,Kansas,19,Iowa,51,Davis County,0,2,-2
20,Kansas,19,Iowa,53,Decatur County,0,24,-24
20,Kansas,19,Iowa,57,Des Moines County,0,106,-106
20,Kansas,19,Iowa,61,Dubuque County,0,5,-5
20,Kansas,19,Iowa,63,Emmet County,0,4,-4
20,Kansas,19,Iowa,67,Floyd County,50,0,50
20,Kansas,19,Iowa,71,Fremont County,31,0,31
20,Kansas,19,Iowa,75,Grundy County,0,9,-9
20,Kansas,19,Iowa,77,Guthrie County,0,5,-5
20,Kansas,19,Iowa,79,Hamilton County,40,14,26
20,Kansas,19,Iowa,81,Hancock County,6,31,-25
20,Kansas,19,Iowa,83,Hardin County,24,1,23
20,Kansas,19,Iowa,85,Harrison County,14,0,14
20,Kansas,19,Iowa,87,Henry County,0,19,-19
20,Kansas,19,Iowa,91,Humboldt County,18,0,18
20,Kansas,19,Iowa,103,Johnson County,152,277,-125
20,Kansas,19,Iowa,111,Lee County,4,0,4
20,Kansas,19,Iowa,113,Linn County,67,81,-14
20,Kansas,19,Iowa,117,Lucas County,6,0,6
20,Kansas,19,Iowa,121,Madison County,6,0,6
20,Kansas,19,Iowa,123,Mahaska County,2,38,-36
20,Kansas,19,Iowa,125,Marion County,65,4,61
20,Kansas,19,Iowa,127,Marshall County,0,39,-39
20,Kansas,19,Iowa,129,Mills County,13,5,8
20,Kansas,19,Iowa,133,Monona County,0,20,-20
20,Kansas,19,Iowa,135,Monroe County,1,0,1
20,Kansas,19,Iowa,137,Montgomery County,0,55,-55
20,Kansas,19,Iowa,139,Muscatine County,204,10,194
20,Kansas,19,Iowa,141,O'Brien County,0,29,-29
20,Kansas,19,Iowa,145,Page County,18,57,-39
20,Kansas,19,Iowa,147,Palo Alto County,0,1,-1
20,Kansas,19,Iowa,149,Plymouth County,2,0,2
20,Kansas,19,Iowa,153,Polk County,148,460,-312
20,Kansas,19,Iowa,155,Pottawattamie County,166,129,37
20,Kansas,19,Iowa,157,Poweshiek County,0,27,-27
20,Kansas,19,Iowa,159,Ringgold County,0,16,-16
20,Kansas,19,Iowa,163,Scott County,93,4,89
20,Kansas,19,Iowa,167,Sioux County,0,25,-25
20,Kansas,19,Iowa,169,Story County,168,114,54
20,Kansas,19,Iowa,175,Union County,48,0,48
20,Kansas,19,Iowa,177,Van Buren County,0,20,-20
20,Kansas,19,Iowa,181,Warren County,29,4,25
20,Kansas,19,Iowa,183,Washington County,0,11,-11
20,Kansas,19,Iowa,187,Webster County,9,22,-13
20,Kansas,19,Iowa,189,Winnebago County,16,0,16
20,Kansas,19,Iowa,193,Woodbury County,54,31,23
20,Kansas,2,Alaska,16,Aleutians West Census Area,0,7,-7
20,Kansas,2,Alaska,20,Anchorage Municipality,369,262,107
20,Kansas,2,Alaska,68,Denali Borough,0,23,-23
20,Kansas,2,Alaska,90,Fairbanks North Star Borough,198,340,-142
20,Kansas,2,Alaska,100,Haines Borough,0,5,-5
20,Kansas,2,Alaska,110,Juneau City and Borough,0,16,-16
20,Kansas,2,Alaska,122,Kenai Peninsula Borough,0,14,-14
20,Kansas,2,Alaska,150,Kodiak Island Borough,10,0,10
20,Kansas,2,Alaska,158,Kusilvak Census Area,5,0,5
20,Kansas,2,Alaska,164,Lake and Peninsula Borough,0,8,-8
20,Kansas,2,Alaska,180,Nome Census Area,0,4,-4
20,Kansas,2,Alaska,261,Valdez-Cordova Census Area,13,20,-7
20,Kansas,2,Alaska,275,Wrangell City and Borough,0,2,-2
20,Kansas,20,Kansas,1,Allen County,1219,546,673
20,Kansas,20,Kansas,3,Anderson County,207,364,-157
20,Kansas,20,Kansas,5,Atchison County,543,415,128
20,Kansas,20,Kansas,7,Barber County,191,81,110
20,Kansas,20,Kansas,9,Barton County,1274,1134,140
20,Kansas,20,Kansas,11,Bourbon County,366,215,151
20,Kansas,20,Kansas,13,Brown County,538,304,234
20,Kansas,20,Kansas,15,Butler County,3204,3067,137
20,Kansas,20,Kansas,17,Chase County,66,149,-83
20,Kansas,20,Kansas,19,Chautauqua County,160,159,1
20,Kansas,20,Kansas,21,Cherokee County,382,311,71
20,Kansas,20,Kansas,23,Cheyenne County,37,37,0
20,Kansas,20,Kansas,25,Clark County,219,83,136
20,Kansas,20,Kansas,27,Clay County,210,446,-236
20,Kansas,20,Kansas,29,Cloud County,265,495,-230
20,Kansas,20,Kansas,31,Coffey County,243,371,-128
20,Kansas,20,Kansas,33,Comanche County,22,54,-32
20,Kansas,20,Kansas,35,Cowley County,1577,1451,126
20,Kansas,20,Kansas,37,Crawford County,904,1760,-856
20,Kansas,20,Kansas,39,Decatur County,97,126,-29
20,Kansas,20,Kansas,41,Dickinson County,1232,816,416
20,Kansas,20,Kansas,43,Doniphan County,69,264,-195
20,Kansas,20,Kansas,45,Douglas County,4402,7094,-2692
20,Kansas,20,Kansas,47,Edwards County,78,85,-7
20,Kansas,20,Kansas,49,Elk County,131,92,39
20,Kansas,20,Kansas,51,Ellis County,1371,1876,-505
20,Kansas,20,Kansas,53,Ellsworth County,460,503,-43
20,Kansas,20,Kansas,55,Finney County,1946,862,1084
20,Kansas,20,Kansas,57,Ford County,846,892,-46
20,Kansas,20,Kansas,59,Franklin County,2213,828,1385
20,Kansas,20,Kansas,61,Geary County,1837,1894,-57
20,Kansas,20,Kansas,63,Gove County,103,90,13
20,Kansas,20,Kansas,65,Graham County,137,67,70
20,Kansas,20,Kansas,67,Grant County,307,186,121
20,Kansas,20,Kansas,69,Gray County,341,275,66
20,Kansas,20,Kansas,71,Greeley County,44,12,32
20,Kansas,20,Kansas,73,Greenwood County,398,221,177
20,Kansas,20,Kansas,75,Hamilton County,93,64,29
20,Kansas,20,Kansas,77,Harper County,220,106,114
20,Kansas,20,Kansas,79,Harvey County,1632,1111,521
20,Kansas,20,Kansas,81,Haskell County,278,96,182
20,Kansas,20,Kansas,83,Hodgeman County,101,97,4
20,Kansas,20,Kansas,85,Jackson County,511,574,-63
20,Kansas,20,Kansas,87,Jefferson County,987,906,81
20,Kansas,20,Kansas,89,Jewell County,89,102,-13
20,Kansas,20,Kansas,91,Johnson County,10923,12163,-1240
20,Kansas,20,Kansas,93,Kearny County,86,161,-75
20,Kansas,20,Kansas,95,Kingman County,412,247,165
20,Kansas,20,Kansas,97,Kiowa County,157,64,93
20,Kansas,20,Kansas,99,Labette County,578,795,-217
20,Kansas,20,Kansas,101,Lane County,86,46,40
20,Kansas,20,Kansas,103,Leavenworth County,2089,3125,-1036
20,Kansas,20,Kansas,105,Lincoln County,152,188,-36
20,Kansas,20,Kansas,107,Linn County,269,293,-24
20,Kansas,20,Kansas,109,Logan County,72,99,-27
20,Kansas,20,Kansas,111,Lyon County,1433,1539,-106
20,Kansas,20,Kansas,113,McPherson County,1369,1021,348
20,Kansas,20,Kansas,115,Marion County,394,480,-86
20,Kansas,20,Kansas,117,Marshall County,408,367,41
20,Kansas,20,Kansas,119,Meade County,156,209,-53
20,Kansas,20,Kansas,121,Miami County,1807,1542,265
20,Kansas,20,Kansas,123,Mitchell County,352,388,-36
20,Kansas,20,Kansas,125,Montgomery County,895,1106,-211
20,Kansas,20,Kansas,127,Morris County,513,166,347
20,Kansas,20,Kansas,129,Morton County,63,58,5
20,Kansas,20,Kansas,131,Nemaha County,437,533,-96
20,Kansas,20,Kansas,133,Neosho County,614,846,-232
20,Kansas,20,Kansas,135,Ness County,54,63,-9
20,Kansas,20,Kansas,137,Norton County,605,515,90
20,Kansas,20,Kansas,139,Osage County,1328,691,637
20,Kansas,20,Kansas,141,Osborne County,179,184,-5
20,Kansas,20,Kansas,143,Ottawa County,462,232,230
20,Kansas,20,Kansas,145,Pawnee County,608,735,-127
20,Kansas,20,Kansas,147,Phillips County,116,191,-75
20,Kansas,20,Kansas,149,Pottawatomie County,1073,1281,-208
20,Kansas,20,Kansas,151,Pratt County,345,417,-72
20,Kansas,20,Kansas,153,Rawlins County,67,86,-19
20,Kansas,20,Kansas,155,Reno County,2068,3109,-1041
20,Kansas,20,Kansas,157,Republic County,75,73,2
20,Kansas,20,Kansas,159,Rice County,517,804,-287
20,Kansas,20,Kansas,161,Riley County,4523,5953,-1430
20,Kansas,20,Kansas,163,Rooks County,164,191,-27
20,Kansas,20,Kansas,165,Rush County,182,119,63
20,Kansas,20,Kansas,167,Russell County,573,609,-36
20,Kansas,20,Kansas,169,Saline County,1968,2201,-233
20,Kansas,20,Kansas,171,Scott County,220,514,-294
20,Kansas,20,Kansas,173,Sedgwick County,10056,9132,924
20,Kansas,20,Kansas,175,Seward County,705,577,128
20,Kansas,20,Kansas,177,Shawnee County,5597,5176,421
20,Kansas,20,Kansas,179,Sheridan County,74,132,-58
20,Kansas,20,Kansas,181,Sherman County,181,249,-68
20,Kansas,20,Kansas,183,Smith County,151,68,83
20,Kansas,20,Kansas,185,Stafford County,232,149,83
20,Kansas,20,Kansas,187,Stanton County,67,27,40
20,Kansas,20,Kansas,189,Stevens County,159,164,-5
20,Kansas,20,Kansas,191,Sumner County,725,1037,-312
20,Kansas,20,Kansas,193,Thomas County,637,365,272
20,Kansas,20,Kansas,195,Trego County,113,116,-3
20,Kansas,20,Kansas,197,Wabaunsee County,163,437,-274
20,Kansas,20,Kansas,199,Wallace County,98,55,43
20,Kansas,20,Kansas,201,Washington County,286,152,134
20,Kansas,20,Kansas,203,Wichita County,172,27,145
20,Kansas,20,Kansas,205,Wilson County,660,354,306
20,Kansas,20,Kansas,207,Woodson County,170,162,8
20,Kansas,20,Kansas,209,Wyandotte County,6532,4256,2276
20,Kansas,21,Kentucky,9,Barren County,0,7,-7
20,Kansas,21,Kentucky,15,Boone County,0,45,-45
20,Kansas,21,Kentucky,19,Boyd County,10,1,9
20,Kansas,21,Kentucky,25,Breathitt County,0,42,-42
20,Kansas,21,Kentucky,35,Calloway County,4,17,-13
20,Kansas,21,Kentucky,37,Campbell County,27,0,27
20,Kansas,21,Kentucky,45,Casey County,0,6,-6
20,Kansas,21,Kentucky,47,Christian County,95,139,-44
20,Kansas,21,Kentucky,49,Clark County,13,0,13
20,Kansas,21,Kentucky,51,Clay County,9,0,9
20,Kansas,21,Kentucky,59,Daviess County,0,38,-38
20,Kansas,21,Kentucky,63,Elliott County,10,0,10
20,Kansas,21,Kentucky,67,Fayette County,26,109,-83
20,Kansas,21,Kentucky,77,Gallatin County,0,33,-33
20,Kansas,21,Kentucky,83,Graves County,14,0,14
20,Kansas,21,Kentucky,93,Hardin County,152,261,-109
20,Kansas,21,Kentucky,101,Henderson County,0,16,-16
20,Kansas,21,Kentucky,109,Jackson County,6,0,6
20,Kansas,21,Kentucky,111,Jefferson County,334,260,74
20,Kansas,21,Kentucky,113,Jessamine County,0,19,-19
20,Kansas,21,Kentucky,125,Laurel County,0,15,-15
20,Kansas,21,Kentucky,151,Madison County,24,0,24
20,Kansas,21,Kentucky,157,Marshall County,0,72,-72
20,Kansas,21,Kentucky,163,Meade County,0,43,-43
20,Kansas,21,Kentucky,197,Powell County,114,0,114
20,Kansas,21,Kentucky,199,Pulaski County,21,0,21
20,Kansas,21,Kentucky,211,Shelby County,21,0,21
20,Kansas,21,Kentucky,217,Taylor County,13,0,13
20,Kansas,21,Kentucky,227,Warren County,0,82,-82
20,Kansas,21,Kentucky,229,Washington County,77,0,77
20,Kansas,22,Louisiana,1,Acadia Parish,0,21,-21
20,Kansas,22,Louisiana,5,Ascension Parish,20,0,20
20,Kansas,22,Louisiana,11,Beauregard Parish,0,21,-21
20,Kansas,22,Louisiana,15,Bossier Parish,0,11,-11
20,Kansas,22,Louisiana,17,Caddo Parish,81,10,71
20,Kansas,22,Louisiana,19,Calcasieu Parish,88,34,54
20,Kansas,22,Louisiana,31,De Soto Parish,41,0,41
20,Kansas,22,Louisiana,33,East Baton Rouge Parish,0,164,-164
20,Kansas,22,Louisiana,45,Iberia Parish,35,24,11
20,Kansas,22,Louisiana,49,Jackson Parish,1,0,1
20,Kansas,22,Louisiana,51,Jefferson Parish,0,111,-111
20,Kansas,22,Louisiana,55,Lafayette Parish,11,17,-6
20,Kansas,22,Louisiana,57,Lafourche Parish,20,0,20
20,Kansas,22,Louisiana,59,LaSalle Parish,0,6,-6
20,Kansas,22,Louisiana,61,Lincoln Parish,10,35,-25
20,Kansas,22,Louisiana,63,Livingston Parish,32,0,32
20,Kansas,22,Louisiana,69,Natchitoches Parish,11,0,11
20,Kansas,22,Louisiana,71,Orleans Parish,48,38,10
20,Kansas,22,Louisiana,73,Ouachita Parish,29,9,20
20,Kansas,22,Louisiana,75,Plaquemines Parish,2,17,-15
20,Kansas,22,Louisiana,79,Rapides Parish,0,15,-15
20,Kansas,22,Louisiana,83,Richland Parish,5,0,5
20,Kansas,22,Louisiana,87,St. Bernard Parish,16,0,16
20,Kansas,22,Louisiana,97,St. Landry Parish,4,0,4
20,Kansas,22,Louisiana,99,St. Martin Parish,5,0,5
20,Kansas,22,Louisiana,103,St. Tammany Parish,26,12,14
20,Kansas,22,Louisiana,105,Tangipahoa Parish,0,151,-151
20,Kansas,22,Louisiana,109,Terrebonne Parish,0,14,-14
20,Kansas,22,Louisiana,115,Vernon Parish,326,17,309
20,Kansas,23,Maine,1,Androscoggin County,0,37,-37
20,Kansas,23,Maine,3,Aroostook County,6,0,6
20,Kansas,23,Maine,5,Cumberland County,83,129,-46
20,Kansas,23,Maine,11,Kennebec County,0,27,-27
20,Kansas,23,Maine,13,Knox County,0,20,-20
20,Kansas,23,Maine,17,Oxford County,12,32,-20
20,Kansas,23,Maine,19,Penobscot County,0,40,-40
20,Kansas,23,Maine,21,Piscataquis County,2,0,2
20,Kansas,23,Maine,31,York County,23,10,13
20,Kansas,24,Maryland,3,Anne Arundel County,62,100,-38
20,Kansas,24,Maryland,5,Baltimore County,111,167,-56
20,Kansas,24,Maryland,13,Carroll County,0,33,-33
20,Kansas,24,Maryland,15,Cecil County,5,0,5
20,Kansas,24,Maryland,17,Charles County,0,96,-96
20,Kansas,24,Maryland,21,Frederick County,3,11,-8
20,Kansas,24,Maryland,25,Harford County,10,42,-32
20,Kansas,24,Maryland,27,Howard County,59,8,51
20,Kansas,24,Maryland,31,Montgomery County,192,150,42
20,Kansas,24,Maryland,33,Prince George's County,99,62,37
20,Kansas,24,Maryland,37,St. Mary's County,58,19,39
20,Kansas,24,Maryland,43,Washington County,0,17,-17
20,Kansas,24,Maryland,45,Wicomico County,24,0,24
20,Kansas,24,Maryland,510,Baltimore city,96,23,73
20,Kansas,25,Massachusetts,3,Berkshire County,0,18,-18
20,Kansas,25,Massachusetts,5,Bristol County,0,4,-4
20,Kansas,25,Massachusetts,9,Essex County,0,30,-30
20,Kansas,25,Massachusetts,13,Hampden County,24,0,24
20,Kansas,25,Massachusetts,15,Hampshire County,71,126,-55
20,Kansas,25,Massachusetts,17,Middlesex County,205,116,89
20,Kansas,25,Massachusetts,19,Nantucket County,0,54,-54
20,Kansas,25,Massachusetts,21,Norfolk County,138,53,85
20,Kansas,25,Massachusetts,23,Plymouth County,54,0,54
20,Kansas,25,Massachusetts,25,Suffolk County,106,117,-11
20,Kansas,25,Massachusetts,27,Worcester County,15,0,15
20,Kansas,26,Michigan,9,Antrim County,0,3,-3
20,Kansas,26,Michigan,15,Barry County,0,17,-17
20,Kansas,26,Michigan,17,Bay County,13,32,-19
20,Kansas,26,Michigan,25,Calhoun County,132,6,126
20,Kansas,26,Michigan,29,Charlevoix County,2,0,2
20,Kansas,26,Michigan,31,Cheboygan County,0,9,-9
20,Kansas,26,Michigan,33,Chippewa County,7,12,-5
20,Kansas,26,Michigan,43,Dickinson County,0,7,-7
20,Kansas,26,Michigan,47,Emmet County,0,13,-13
20,Kansas,26,Michigan,49,Genesee County,39,44,-5
20,Kansas,26,Michigan,51,Gladwin County,5,0,5
20,Kansas,26,Michigan,55,Grand Traverse County,0,34,-34
20,Kansas,26,Michigan,57,Gratiot County,0,7,-7
20,Kansas,26,Michigan,59,Hillsdale County,5,0,5
20,Kansas,26,Michigan,61,Houghton County,15,0,15
20,Kansas,26,Michigan,65,Ingham County,2,28,-26
20,Kansas,26,Michigan,73,Isabella County,6,6,0
20,Kansas,26,Michigan,75,Jackson County,0,49,-49
20,Kansas,26,Michigan,77,Kalamazoo County,0,197,-197
20,Kansas,26,Michigan,81,Kent County,70,19,51
20,Kansas,26,Michigan,85,Lake County,0,3,-3
20,Kansas,26,Michigan,89,Leelanau County,0,17,-17
20,Kansas,26,Michigan,91,Lenawee County,5,5,0
20,Kansas,26,Michigan,93,Livingston County,0,12,-12
20,Kansas,26,Michigan,99,Macomb County,13,95,-82
20,Kansas,26,Michigan,105,Mason County,0,20,-20
20,Kansas,26,Michigan,107,Mecosta County,0,53,-53
20,Kansas,26,Michigan,111,Midland County,0,26,-26
20,Kansas,26,Michigan,115,Monroe County,0,3,-3
20,Kansas,26,Michigan,119,Montmorency County,0,7,-7
20,Kansas,26,Michigan,121,Muskegon County,0,22,-22
20,Kansas,26,Michigan,125,Oakland County,309,128,181
20,Kansas,26,Michigan,139,Ottawa County,23,0,23
20,Kansas,26,Michigan,145,Saginaw County,0,7,-7
20,Kansas,26,Michigan,147,St. Clair County,73,101,-28
20,Kansas,26,Michigan,149,St. Joseph County,7,15,-8
20,Kansas,26,Michigan,157,Tuscola County,30,54,-24
20,Kansas,26,Michigan,159,Van Buren County,53,0,53
20,Kansas,26,Michigan,161,Washtenaw County,49,202,-153
20,Kansas,26,Michigan,163,Wayne County,79,73,6
20,Kansas,27,Minnesota,1,Aitkin County,0,27,-27
20,Kansas,27,Minnesota,3,Anoka County,36,21,15
20,Kansas,27,Minnesota,5,Becker County,2,6,-4
20,Kansas,27,Minnesota,7,Beltrami County,46,11,35
20,Kansas,27,Minnesota,9,Benton County,14,0,14
20,Kansas,27,Minnesota,13,Blue Earth County,30,0,30
20,Kansas,27,Minnesota,15,Brown County,0,11,-11
20,Kansas,27,Minnesota,17,Carlton County,2,0,2
20,Kansas,27,Minnesota,19,Carver County,8,0,8
20,Kansas,27,Minnesota,27,Clay County,9,31,-22
20,Kansas,27,Minnesota,33,Cottonwood County,9,0,9
20,Kansas,27,Minnesota,35,Crow Wing County,2,0,2
20,Kansas,27,Minnesota,37,Dakota County,39,6,33
20,Kansas,27,Minnesota,41,Douglas County,0,6,-6
20,Kansas,27,Minnesota,43,Faribault County,12,0,12
20,Kansas,27,Minnesota,47,Freeborn County,0,4,-4
20,Kansas,27,Minnesota,49,Goodhue County,17,0,17
20,Kansas,27,Minnesota,53,Hennepin County,207,326,-119
20,Kansas,27,Minnesota,57,Hubbard County,65,2,63
20,Kansas,27,Minnesota,59,Isanti County,0,3,-3
20,Kansas,27,Minnesota,65,Kanabec County,4,0,4
20,Kansas,27,Minnesota,67,Kandiyohi County,0,2,-2
20,Kansas,27,Minnesota,79,Le Sueur County,68,15,53
20,Kansas,27,Minnesota,81,Lincoln County,16,0,16
20,Kansas,27,Minnesota,83,Lyon County,19,0,19
20,Kansas,27,Minnesota,85,McLeod County,20,0,20
20,Kansas,27,Minnesota,87,Mahnomen County,4,0,4
20,Kansas,27,Minnesota,91,Martin County,0,17,-17
20,Kansas,27,Minnesota,93,Meeker County,0,8,-8
20,Kansas,27,Minnesota,99,Mower County,0,8,-8
20,Kansas,27,Minnesota,103,Nicollet County,20,0,20
20,Kansas,27,Minnesota,105,Nobles County,15,0,15
20,Kansas,27,Minnesota,109,Olmsted County,146,13,133
20,Kansas,27,Minnesota,113,Pennington County,24,0,24
20,Kansas,27,Minnesota,119,Polk County,0,29,-29
20,Kansas,27,Minnesota,121,Pope County,7,0,7
20,Kansas,27,Minnesota,123,Ramsey County,105,287,-182
20,Kansas,27,Minnesota,133,Rock County,58,0,58
20,Kansas,27,Minnesota,135,Roseau County,2,0,2
20,Kansas,27,Minnesota,137,St. Louis County,2,17,-15
20,Kansas,27,Minnesota,139,Scott County,25,0,25
20,Kansas,27,Minnesota,141,Sherburne County,7,73,-66
20,Kansas,27,Minnesota,145,Stearns County,0,8,-8
20,Kansas,27,Minnesota,147,Steele County,12,1,11
20,Kansas,27,Minnesota,149,Stevens County,0,2,-2
20,Kansas,27,Minnesota,153,Todd County,0,17,-17
20,Kansas,27,Minnesota,159,Wadena County,6,0,6
20,Kansas,27,Minnesota,161,Waseca County,17,0,17
20,Kansas,27,Minnesota,163,Washington County,72,115,-43
20,Kansas,27,Minnesota,169,Winona County,41,7,34
20,Kansas,27,Minnesota,171,Wright County,0,29,-29
20,Kansas,27,Minnesota,173,Yellow Medicine County,8,0,8
20,Kansas,28,Mississippi,11,Bolivar County,15,0,15
20,Kansas,28,Mississippi,33,DeSoto County,72,0,72
20,Kansas,28,Mississippi,35,Forrest County,24,0,24
20,Kansas,28,Mississippi,47,Harrison County,24,119,-95
20,Kansas,28,Mississippi,71,Lafayette County,8,7,1
20,Kansas,28,Mississippi,73,Lamar County,0,63,-63
20,Kansas,28,Mississippi,75,Lauderdale County,14,0,14
20,Kansas,28,Mississippi,89,Madison County,0,14,-14
20,Kansas,28,Mississippi,93,Marshall County,7,0,7
20,Kansas,28,Mississippi,99,Neshoba County,0,10,-10
20,Kansas,28,Mississippi,103,Noxubee County,1,0,1
20,Kansas,28,Mississippi,107,Panola County,4,0,4
20,Kansas,28,Mississippi,133,Sunflower County,0,9,-9
20,Kansas,29,Missouri,1,Adair County,30,17,13
20,Kansas,29,Missouri,3,Andrew County,131,275,-144
20,Kansas,29,Missouri,5,Atchison County,0,17,-17
20,Kansas,29,Missouri,7,Audrain County,17,15,2
20,Kansas,29,Missouri,9,Barry County,17,70,-53
20,Kansas,29,Missouri,11,Barton County,86,57,29
20,Kansas,29,Missouri,13,Bates County,346,193,153
20,Kansas,29,Missouri,15,Benton County,24,70,-46
20,Kansas,29,Missouri,19,Boone County,778,227,551
20,Kansas,29,Missouri,21,Buchanan County,457,525,-68
20,Kansas,29,Missouri,23,Butler County,24,0,24
20,Kansas,29,Missouri,25,Caldwell County,28,37,-9
20,Kansas,29,Missouri,27,Callaway County,0,25,-25
20,Kansas,29,Missouri,29,Camden County,25,301,-276
20,Kansas,29,Missouri,31,Cape Girardeau County,20,9,11
20,Kansas,29,Missouri,37,Cass County,1031,976,55
20,Kansas,29,Missouri,39,Cedar County,10,18,-8
20,Kansas,29,Missouri,43,Christian County,30,111,-81
20,Kansas,29,Missouri,47,Clay County,2262,2303,-41
20,Kansas,29,Missouri,49,Clinton County,218,91,127
20,Kansas,29,Missouri,51,Cole County,65,61,4
20,Kansas,29,Missouri,53,Cooper County,0,32,-32
20,Kansas,29,Missouri,55,Crawford County,0,3,-3
20,Kansas,29,Missouri,57,Dade County,0,8,-8
20,Kansas,29,Missouri,61,Daviess County,45,22,23
20,Kansas,29,Missouri,63,DeKalb County,29,57,-28
20,Kansas,29,Missouri,67,Douglas County,25,26,-1
20,Kansas,29,Missouri,71,Franklin County,7,13,-6
20,Kansas,29,Missouri,73,Gasconade County,0,53,-53
20,Kansas,29,Missouri,75,Gentry County,40,0,40
20,Kansas,29,Missouri,77,Greene County,665,754,-89
20,Kansas,29,Missouri,79,Grundy County,19,3,16
20,Kansas,29,Missouri,81,Harrison County,45,9,36
20,Kansas,29,Missouri,83,Henry County,55,57,-2
20,Kansas,29,Missouri,85,Hickory County,39,61,-22
20,Kansas,29,Missouri,87,Holt County,13,14,-1
20,Kansas,29,Missouri,91,Howell County,5,37,-32
20,Kansas,29,Missouri,93,Iron County,0,3,-3
20,Kansas,29,Missouri,95,Jackson County,11346,7791,3555
20,Kansas,29,Missouri,97,Jasper County,487,848,-361
20,Kansas,29,Missouri,99,Jefferson County,25,51,-26
20,Kansas,29,Missouri,101,Johnson County,157,180,-23
20,Kansas,29,Missouri,105,Laclede County,38,34,4
20,Kansas,29,Missouri,107,Lafayette County,56,360,-304
20,Kansas,29,Missouri,109,Lawrence County,18,105,-87
20,Kansas,29,Missouri,115,Linn County,4,0,4
20,Kansas,29,Missouri,117,Livingston County,19,38,-19
20,Kansas,29,Missouri,119,McDonald County,33,34,-1
20,Kansas,29,Missouri,121,Macon County,7,4,3
20,Kansas,29,Missouri,123,Madison County,0,21,-21
20,Kansas,29,Missouri,125,Maries County,0,9,-9
20,Kansas,29,Missouri,127,Marion County,0,24,-24
20,Kansas,29,Missouri,129,Mercer County,0,2,-2
20,Kansas,29,Missouri,131,Miller County,39,5,34
20,Kansas,29,Missouri,135,Moniteau County,0,21,-21
20,Kansas,29,Missouri,137,Monroe County,0,1,-1
20,Kansas,29,Missouri,139,Montgomery County,0,23,-23
20,Kansas,29,Missouri,141,Morgan County,0,76,-76
20,Kansas,29,Missouri,145,Newton County,72,162,-90
20,Kansas,29,Missouri,147,Nodaway County,118,140,-22
20,Kansas,29,Missouri,155,Pemiscot County,0,6,-6
20,Kansas,29,Missouri,159,Pettis County,19,121,-102
20,Kansas,29,Missouri,161,Phelps County,67,197,-130
20,Kansas,29,Missouri,163,Pike County,11,7,4
20,Kansas,29,Missouri,165,Platte County,1254,1232,22
20,Kansas,29,Missouri,167,Polk County,52,17,35
20,Kansas,29,Missouri,169,Pulaski County,219,334,-115
20,Kansas,29,Missouri,171,Putnam County,0,16,-16
20,Kansas,29,Missouri,173,Ralls County,17,2,15
20,Kansas,29,Missouri,175,Randolph County,9,42,-33
20,Kansas,29,Missouri,177,Ray County,41,196,-155
20,Kansas,29,Missouri,183,St. Charles County,242,236,6
20,Kansas,29,Missouri,185,St. Clair County,7,190,-183
20,Kansas,29,Missouri,186,Ste. Genevieve County,0,14,-14
20,Kansas,29,Missouri,187,St. Francois County,39,11,28
20,Kansas,29,Missouri,189,St. Louis County,424,728,-304
20,Kansas,29,Missouri,195,Saline County,7,57,-50
20,Kansas,29,Missouri,203,Shannon County,0,29,-29
20,Kansas,29,Missouri,205,Shelby County,21,8,13
20,Kansas,29,Missouri,207,Stoddard County,0,9,-9
20,Kansas,29,Missouri,209,Stone County,62,98,-36
20,Kansas,29,Missouri,211,Sullivan County,10,0,10
20,Kansas,29,Missouri,213,Taney County,173,84,89
20,Kansas,29,Missouri,215,Texas County,0,64,-64
20,Kansas,29,Missouri,217,Vernon County,89,184,-95
20,Kansas,29,Missouri,219,Warren County,2,0,2
20,Kansas,29,Missouri,221,Washington County,0,1,-1
20,Kansas,29,Missouri,223,Wayne County,0,2,-2
20,Kansas,29,Missouri,225,Webster County,26,64,-38
20,Kansas,29,Missouri,227,Worth County,0,5,-5
20,Kansas,29,Missouri,229,Wright County,187,18,169
20,Kansas,29,Missouri,510,St. Louis city,385,240,145
20,Kansas,30,Montana,3,Big Horn County,11,0,11
20,Kansas,30,Montana,9,Carbon County,0,13,-13
20,Kansas,30,Montana,13,Cascade County,45,0,45
20,Kansas,30,Montana,17,Custer County,0,39,-39
20,Kansas,30,Montana,29,Flathead County,10,19,-9
20,Kansas,30,Montana,31,Gallatin County,0,25,-25
20,Kansas,30,Montana,37,Golden Valley County,0,8,-8
20,Kansas,30,Montana,41,Hill County,0,36,-36
20,Kansas,30,Montana,49,Lewis and Clark County,44,12,32
20,Kansas,30,Montana,53,Lincoln County,0,18,-18
20,Kansas,30,Montana,57,Madison County,4,0,4
20,Kansas,30,Montana,63,Missoula County,23,30,-7
20,Kansas,30,Montana,67,Park County,2,0,2
20,Kansas,30,Montana,79,Prairie County,11,0,11
20,Kansas,30,Montana,83,Richland County,0,99,-99
20,Kansas,30,Montana,85,Roosevelt County,11,5,6
20,Kansas,30,Montana,89,Sanders County,13,0,13
20,Kansas,30,Montana,93,Silver Bow County,7,0,7
20,Kansas,30,Montana,99,Teton County,11,0,11
20,Kansas,30,Montana,101,Toole County,0,4,-4
20,Kansas,30,Montana,105,Valley County,43,0,43
20,Kansas,30,Montana,111,Yellowstone County,72,42,30
20,Kansas,31,Nebraska,1,Adams County,0,31,-31
20,Kansas,31,Nebraska,11,Boone County,7,0,7
20,Kansas,31,Nebraska,13,Box Butte County,40,0,40
20,Kansas,31,Nebraska,19,Buffalo County,259,138,121
20,Kansas,31,Nebraska,21,Burt County,0,1,-1
20,Kansas,31,Nebraska,23,Butler County,22,4,18
20,Kansas,31,Nebraska,25,Cass County,54,6,48
20,Kansas,31,Nebraska,29,Chase County,0,4,-4
20,Kansas,31,Nebraska,33,Cheyenne County,16,59,-43
20,Kansas,31,Nebraska,35,Clay County,36,13,23
20,Kansas,31,Nebraska,37,Colfax County,0,5,-5
20,Kansas,31,Nebraska,41,Custer County,28,43,-15
20,Kansas,31,Nebraska,45,Dawes County,0,13,-13
20,Kansas,31,Nebraska,47,Dawson County,102,0,102
20,Kansas,31,Nebraska,53,Dodge County,9,118,-109
20,Kansas,31,Nebraska,55,Douglas County,885,569,316
20,Kansas,31,Nebraska,57,Dundy County,3,159,-156
20,Kansas,31,Nebraska,59,Fillmore County,8,0,8
20,Kansas,31,Nebraska,61,Franklin County,23,31,-8
20,Kansas,31,Nebraska,63,Frontier County,3,1,2
20,Kansas,31,Nebraska,65,Furnas County,6,1,5
20,Kansas,31,Nebraska,67,Gage County,29,106,-77
20,Kansas,31,Nebraska,73,Gosper County,0,13,-13
20,Kansas,31,Nebraska,77,Greeley County,2,10,-8
20,Kansas,31,Nebraska,79,Hall County,44,198,-154
20,Kansas,31,Nebraska,81,Hamilton County,20,0,20
20,Kansas,31,Nebraska,83,Harlan County,0,2,-2
20,Kansas,31,Nebraska,87,Hitchcock County,15,11,4
20,Kansas,31,Nebraska,89,Holt County,0,36,-36
20,Kansas,31,Nebraska,93,Howard County,0,24,-24
20,Kansas,31,Nebraska,95,Jefferson County,12,34,-22
20,Kansas,31,Nebraska,99,Kearney County,0,2,-2
20,Kansas,31,Nebraska,107,Knox County,21,0,21
20,Kansas,31,Nebraska,109,Lancaster County,710,329,381
20,Kansas,31,Nebraska,111,Lincoln County,28,13,15
20,Kansas,31,Nebraska,117,McPherson County,0,2,-2
20,Kansas,31,Nebraska,119,Madison County,26,28,-2
20,Kansas,31,Nebraska,121,Merrick County,1,8,-7
20,Kansas,31,Nebraska,123,Morrill County,1,0,1
20,Kansas,31,Nebraska,125,Nance County,7,5,2
20,Kansas,31,Nebraska,127,Nemaha County,0,4,-4
20,Kansas,31,Nebraska,129,Nuckolls County,42,13,29
20,Kansas,31,Nebraska,131,Otoe County,0,33,-33
20,Kansas,31,Nebraska,133,Pawnee County,18,3,15
20,Kansas,31,Nebraska,135,Perkins County,2,0,2
20,Kansas,31,Nebraska,137,Phelps County,3,8,-5
20,Kansas,31,Nebraska,139,Pierce County,0,14,-14
20,Kansas,31,Nebraska,141,Platte County,11,98,-87
20,Kansas,31,Nebraska,143,Polk County,0,1,-1
20,Kansas,31,Nebraska,145,Red Willow County,5,131,-126
20,Kansas,31,Nebraska,147,Richardson County,100,39,61
20,Kansas,31,Nebraska,149,Rock County,0,8,-8
20,Kansas,31,Nebraska,151,Saline County,2,2,0
20,Kansas,31,Nebraska,153,Sarpy County,204,232,-28
20,Kansas,31,Nebraska,155,Saunders County,0,16,-16
20,Kansas,31,Nebraska,157,Scotts Bluff County,4,6,-2
20,Kansas,31,Nebraska,159,Seward County,0,120,-120
20,Kansas,31,Nebraska,161,Sheridan County,0,1,-1
20,Kansas,31,Nebraska,167,Stanton County,51,0,51
20,Kansas,31,Nebraska,169,Thayer County,9,14,-5
20,Kansas,31,Nebraska,173,Thurston County,10,0,10
20,Kansas,31,Nebraska,175,Valley County,0,3,-3
20,Kansas,31,Nebraska,177,Washington County,14,5,9
20,Kansas,31,Nebraska,181,Webster County,1,21,-20
20,Kansas,31,Nebraska,185,York County,17,58,-41
20,Kansas,32,Nevada,1,Churchill County,96,0,96
20,Kansas,32,Nevada,3,Clark County,506,566,-60
20,Kansas,32,Nevada,5,Douglas County,5,0,5
20,Kansas,32,Nevada,7,Elko County,4,0,4
20,Kansas,32,Nevada,15,Lander County,20,0,20
20,Kansas,32,Nevada,23,Nye County,32,0,32
20,Kansas,32,Nevada,31,Washoe County,116,71,45
20,Kansas,33,New Hampshire,1,Belknap County,49,23,26
20,Kansas,33,New Hampshire,3,Carroll County,0,4,-4
20,Kansas,33,New Hampshire,5,Cheshire County,63,0,63
20,Kansas,33,New Hampshire,9,Grafton County,0,5,-5
20,Kansas,33,New Hampshire,11,Hillsborough County,33,0,33
20,Kansas,33,New Hampshire,13,Merrimack County,0,113,-113
20,Kansas,33,New Hampshire,15,Rockingham County,6,5,1
20,Kansas,34,New Jersey,3,Bergen County,22,0,22
20,Kansas,34,New Jersey,5,Burlington County,0,49,-49
20,Kansas,34,New Jersey,7,Camden County,0,31,-31
20,Kansas,34,New Jersey,9,Cape May County,5,24,-19
20,Kansas,34,New Jersey,13,Essex County,48,58,-10
20,Kansas,34,New Jersey,15,Gloucester County,18,0,18
20,Kansas,34,New Jersey,17,Hudson County,112,0,112
20,Kansas,34,New Jersey,19,Hunterdon County,11,0,11
20,Kansas,34,New Jersey,21,Mercer County,0,157,-157
20,Kansas,34,New Jersey,23,Middlesex County,127,0,127
20,Kansas,34,New Jersey,25,Monmouth County,91,8,83
20,Kansas,34,New Jersey,27,Morris County,43,70,-27
20,Kansas,34,New Jersey,29,Ocean County,15,0,15
20,Kansas,34,New Jersey,31,Passaic County,98,0,98
20,Kansas,34,New Jersey,33,Salem County,15,24,-9
20,Kansas,34,New Jersey,35,Somerset County,13,33,-20
20,Kansas,34,New Jersey,37,Sussex County,40,0,40
20,Kansas,34,New Jersey,39,Union County,156,47,109
20,Kansas,34,New Jersey,41,Warren County,74,14,60
20,Kansas,35,New Mexico,1,Bernalillo County,257,70,187
20,Kansas,35,New Mexico,3,Catron County,17,0,17
20,Kansas,35,New Mexico,5,Chaves County,0,7,-7
20,Kansas,35,New Mexico,9,Curry County,196,44,152
20,Kansas,35,New Mexico,13,Doña Ana County,99,0,99
20,Kansas,35,New Mexico,15,Eddy County,18,0,18
20,Kansas,35,New Mexico,25,Lea County,4,97,-93
20,Kansas,35,New Mexico,28,Los Alamos County,8,0,8
20,Kansas,35,New Mexico,29,Luna County,0,26,-26
20,Kansas,35,New Mexico,31,McKinley County,0,9,-9
20,Kansas,35,New Mexico,35,Otero County,14,15,-1
20,Kansas,35,New Mexico,39,Rio Arriba County,6,0,6
20,Kansas,35,New Mexico,41,Roosevelt County,9,17,-8
20,Kansas,35,New Mexico,43,Sandoval County,25,0,25
20,Kansas,35,New Mexico,45,San Juan County,23,3,20
20,Kansas,35,New Mexico,47,San Miguel County,0,6,-6
20,Kansas,35,New Mexico,49,Santa Fe County,61,3,58
20,Kansas,35,New Mexico,51,Sierra County,2,14,-12
20,Kansas,35,New Mexico,53,Socorro County,0,4,-4
20,Kansas,35,New Mexico,57,Torrance County,28,0,28
20,Kansas,35,New Mexico,59,Union County,0,2,-2
20,Kansas,35,New Mexico,61,Valencia County,18,27,-9
20,Kansas,36,New York,1,Albany County,146,0,146
20,Kansas,36,New York,5,Bronx County,150,0,150
20,Kansas,36,New York,7,Broome County,3,0,3
20,Kansas,36,New York,9,Cattaraugus County,0,85,-85
20,Kansas,36,New York,13,Chautauqua County,1,0,1
20,Kansas,36,New York,21,Columbia County,96,7,89
20,Kansas,36,New York,25,Delaware County,0,9,-9
20,Kansas,36,New York,29,Erie County,173,22,151
20,Kansas,36,New York,31,Essex County,0,9,-9
20,Kansas,36,New York,35,Fulton County,58,12,46
20,Kansas,36,New York,45,Jefferson County,40,238,-198
20,Kansas,36,New York,47,Kings County,226,77,149
20,Kansas,36,New York,51,Livingston County,0,4,-4
20,Kansas,36,New York,55,Monroe County,55,10,45
20,Kansas,36,New York,59,Nassau County,97,16,81
20,Kansas,36,New York,61,New York County,161,326,-165
20,Kansas,36,New York,63,Niagara County,47,27,20
20,Kansas,36,New York,65,Oneida County,23,17,6
20,Kansas,36,New York,67,Onondaga County,0,42,-42
20,Kansas,36,New York,69,Ontario County,0,53,-53
20,Kansas,36,New York,71,Orange County,198,88,110
20,Kansas,36,New York,75,Oswego County,8,0,8
20,Kansas,36,New York,81,Queens County,59,39,20
20,Kansas,36,New York,87,Rockland County,44,0,44
20,Kansas,36,New York,91,Saratoga County,76,5,71
20,Kansas,36,New York,101,Steuben County,5,0,5
20,Kansas,36,New York,103,Suffolk County,0,14,-14
20,Kansas,36,New York,109,Tompkins County,0,9,-9
20,Kansas,36,New York,111,Ulster County,0,1,-1
20,Kansas,36,New York,119,Westchester County,3,28,-25
20,Kansas,36,New York,123,Yates County,0,9,-9
20,Kansas,37,North Carolina,1,Alamance County,33,0,33
20,Kansas,37,North Carolina,19,Brunswick County,24,0,24
20,Kansas,37,North Carolina,21,Buncombe County,0,36,-36
20,Kansas,37,North Carolina,25,Cabarrus County,28,0,28
20,Kansas,37,North Carolina,35,Catawba County,25,5,20
20,Kansas,37,North Carolina,37,Chatham County,0,19,-19
20,Kansas,37,North Carolina,45,Cleveland County,0,14,-14
20,Kansas,37,North Carolina,49,Craven County,79,30,49
20,Kansas,37,North Carolina,51,Cumberland County,348,387,-39
20,Kansas,37,North Carolina,57,Davidson County,0,32,-32
20,Kansas,37,North Carolina,63,Durham County,51,134,-83
20,Kansas,37,North Carolina,67,Forsyth County,92,110,-18
20,Kansas,37,North Carolina,71,Gaston County,0,61,-61
20,Kansas,37,North Carolina,77,Granville County,7,0,7
20,Kansas,37,North Carolina,79,Greene County,0,20,-20
20,Kansas,37,North Carolina,81,Guilford County,68,116,-48
20,Kansas,37,North Carolina,83,Halifax County,3,0,3
20,Kansas,37,North Carolina,85,Harnett County,112,108,4
20,Kansas,37,North Carolina,91,Hertford County,0,24,-24
20,Kansas,37,North Carolina,93,Hoke County,5,116,-111
20,Kansas,37,North Carolina,97,Iredell County,0,9,-9
20,Kansas,37,North Carolina,105,Lee County,42,8,34
20,Kansas,37,North Carolina,109,Lincoln County,22,0,22
20,Kansas,37,North Carolina,115,Madison County,0,18,-18
20,Kansas,37,North Carolina,117,Martin County,24,0,24
20,Kansas,37,North Carolina,119,Mecklenburg County,132,86,46
20,Kansas,37,North Carolina,125,Moore County,22,343,-321
20,Kansas,37,North Carolina,129,New Hanover County,26,12,14
20,Kansas,37,North Carolina,133,Onslow County,278,115,163
20,Kansas,37,North Carolina,135,Orange County,39,36,3
20,Kansas,37,North Carolina,141,Pender County,0,26,-26
20,Kansas,37,North Carolina,147,Pitt County,42,10,32
20,Kansas,37,North Carolina,149,Polk County,45,0,45
20,Kansas,37,North Carolina,151,Randolph County,103,0,103
20,Kansas,37,North Carolina,153,Richmond County,0,14,-14
20,Kansas,37,North Carolina,161,Rutherford County,0,1,-1
20,Kansas,37,North Carolina,165,Scotland County,20,0,20
20,Kansas,37,North Carolina,171,Surry County,0,21,-21
20,Kansas,37,North Carolina,183,Wake County,87,41,46
20,Kansas,37,North Carolina,189,Watauga County,35,0,35
20,Kansas,37,North Carolina,191,Wayne County,12,4,8
20,Kansas,38,North Dakota,3,Barnes County,2,81,-79
20,Kansas,38,North Dakota,5,Benson County,4,16,-12
20,Kansas,38,North Dakota,9,Bottineau County,0,1,-1
20,Kansas,38,North Dakota,15,Burleigh County,5,13,-8
20,Kansas,38,North Dakota,17,Cass County,65,57,8
20,Kansas,38,North Dakota,35,Grand Forks County,0,20,-20
20,Kansas,38,North Dakota,53,McKenzie County,13,0,13
20,Kansas,38,North Dakota,77,Richland County,0,11,-11
20,Kansas,38,North Dakota,89,Stark County,44,0,44
20,Kansas,38,North Dakota,93,Stutsman County,0,2,-2
20,Kansas,38,North Dakota,95,Towner County,14,0,14
20,Kansas,38,North Dakota,101,Ward County,17,13,4
20,Kansas,38,North Dakota,105,Williams County,53,0,53
20,Kansas,39,Ohio,3,Allen County,0,60,-60
20,Kansas,39,Ohio,5,Ashland County,11,0,11
20,Kansas,39,Ohio,11,Auglaize County,0,3,-3
20,Kansas,39,Ohio,13,Belmont County,59,0,59
20,Kansas,39,Ohio,17,Butler County,163,53,110
20,Kansas,39,Ohio,21,Champaign County,0,25,-25
20,Kansas,39,Ohio,23,Clark County,7,1,6
20,Kansas,39,Ohio,25,Clermont County,0,81,-81
20,Kansas,39,Ohio,29,Columbiana County,30,22,8
20,Kansas,39,Ohio,31,Coshocton County,0,17,-17
20,Kansas,39,Ohio,35,Cuyahoga County,76,119,-43
20,Kansas,39,Ohio,41,Delaware County,4,0,4
20,Kansas,39,Ohio,45,Fairfield County,0,8,-8
20,Kansas,39,Ohio,49,Franklin County,227,79,148
20,Kansas,39,Ohio,57,Greene County,0,19,-19
20,Kansas,39,Ohio,61,Hamilton County,134,90,44
20,Kansas,39,Ohio,63,Hancock County,0,46,-46
20,Kansas,39,Ohio,77,Huron County,53,0,53
20,Kansas,39,Ohio,81,Jefferson County,36,10,26
20,Kansas,39,Ohio,85,Lake County,0,154,-154
20,Kansas,39,Ohio,87,Lawrence County,20,0,20
20,Kansas,39,Ohio,89,Licking County,13,34,-21
20,Kansas,39,Ohio,91,Logan County,19,2,17
20,Kansas,39,Ohio,93,Lorain County,20,36,-16
20,Kansas,39,Ohio,95,Lucas County,99,43,56
20,Kansas,39,Ohio,97,Madison County,0,12,-12
20,Kansas,39,Ohio,99,Mahoning County,0,47,-47
20,Kansas,39,Ohio,103,Medina County,0,6,-6
20,Kansas,39,Ohio,109,Miami County,8,29,-21
20,Kansas,39,Ohio,111,Monroe County,154,0,154
20,Kansas,39,Ohio,113,Montgomery County,73,42,31
20,Kansas,39,Ohio,123,Ottawa County,2,7,-5
20,Kansas,39,Ohio,135,Preble County,0,18,-18
20,Kansas,39,Ohio,137,Putnam County,4,0,4
20,Kansas,39,Ohio,139,Richland County,80,6,74
20,Kansas,39,Ohio,147,Seneca County,0,4,-4
20,Kansas,39,Ohio,151,Stark County,3,31,-28
20,Kansas,39,Ohio,153,Summit County,3,24,-21
20,Kansas,39,Ohio,155,Trumbull County,12,0,12
20,Kansas,39,Ohio,159,Union County,2,33,-31
20,Kansas,39,Ohio,165,Warren County,0,148,-148
20,Kansas,39,Ohio,169,Wayne County,18,0,18
20,Kansas,39,Ohio,171,Williams County,12,0,12
20,Kansas,39,Ohio,173,Wood County,77,40,37
20,Kansas,4,Arizona,1,Apache County,17,19,-2
20,Kansas,4,Arizona,3,Cochise County,133,101,32
20,Kansas,4,Arizona,5,Coconino County,24,14,10
20,Kansas,4,Arizona,7,Gila County,0,49,-49
20,Kansas,4,Arizona,9,Graham County,0,5,-5
20,Kansas,4,Arizona,12,La Paz County,0,14,-14
20,Kansas,4,Arizona,13,Maricopa County,1421,1593,-172
20,Kansas,4,Arizona,15,Mohave County,44,0,44
20,Kansas,4,Arizona,17,Navajo County,5,18,-13
20,Kansas,4,Arizona,19,Pima County,130,332,-202
20,Kansas,4,Arizona,21,Pinal County,65,87,-22
20,Kansas,4,Arizona,25,Yavapai County,33,70,-37
20,Kansas,4,Arizona,27,Yuma County,124,126,-2
20,Kansas,40,Oklahoma,3,Alfalfa County,0,84,-84
20,Kansas,40,Oklahoma,5,Atoka County,0,13,-13
20,Kansas,40,Oklahoma,7,Beaver County,133,62,71
20,Kansas,40,Oklahoma,9,Beckham County,12,0,12
20,Kansas,40,Oklahoma,11,Blaine County,4,59,-55
20,Kansas,40,Oklahoma,13,Bryan County,76,41,35
20,Kansas,40,Oklahoma,15,Caddo County,19,6,13
20,Kansas,40,Oklahoma,17,Canadian County,70,165,-95
20,Kansas,40,Oklahoma,19,Carter County,31,4,27
20,Kansas,40,Oklahoma,21,Cherokee County,5,81,-76
20,Kansas,40,Oklahoma,25,Cimarron County,8,6,2
20,Kansas,40,Oklahoma,27,Cleveland County,537,490,47
20,Kansas,40,Oklahoma,31,Comanche County,211,680,-469
20,Kansas,40,Oklahoma,33,Cotton County,0,8,-8
20,Kansas,40,Oklahoma,35,Craig County,9,39,-30
20,Kansas,40,Oklahoma,37,Creek County,113,50,63
20,Kansas,40,Oklahoma,39,Custer County,39,30,9
20,Kansas,40,Oklahoma,41,Delaware County,76,268,-192
20,Kansas,40,Oklahoma,43,Dewey County,41,0,41
20,Kansas,40,Oklahoma,45,Ellis County,2,56,-54
20,Kansas,40,Oklahoma,47,Garfield County,69,219,-150
20,Kansas,40,Oklahoma,51,Grady County,39,84,-45
20,Kansas,40,Oklahoma,53,Grant County,10,24,-14
20,Kansas,40,Oklahoma,55,Greer County,0,2,-2
20,Kansas,40,Oklahoma,59,Harper County,42,1,41
20,Kansas,40,Oklahoma,63,Hughes County,0,10,-10
20,Kansas,40,Oklahoma,65,Jackson County,75,92,-17
20,Kansas,40,Oklahoma,67,Jefferson County,0,2,-2
20,Kansas,40,Oklahoma,69,Johnston County,0,34,-34
20,Kansas,40,Oklahoma,71,Kay County,253,576,-323
20,Kansas,40,Oklahoma,73,Kingfisher County,13,6,7
20,Kansas,40,Oklahoma,77,Latimer County,0,15,-15
20,Kansas,40,Oklahoma,79,Le Flore County,6,15,-9
20,Kansas,40,Oklahoma,81,Lincoln County,21,2,19
20,Kansas,40,Oklahoma,83,Logan County,12,84,-72
20,Kansas,40,Oklahoma,87,McClain County,27,25,2
20,Kansas,40,Oklahoma,89,McCurtain County,10,0,10
20,Kansas,40,Oklahoma,91,McIntosh County,0,16,-16
20,Kansas,40,Oklahoma,93,Major County,10,16,-6
20,Kansas,40,Oklahoma,95,Marshall County,13,25,-12
20,Kansas,40,Oklahoma,97,Mayes County,84,58,26
20,Kansas,40,Oklahoma,101,Muskogee County,27,27,0
20,Kansas,40,Oklahoma,103,Noble County,0,88,-88
20,Kansas,40,Oklahoma,105,Nowata County,123,81,42
20,Kansas,40,Oklahoma,107,Okfuskee County,0,3,-3
20,Kansas,40,Oklahoma,109,Oklahoma County,1061,1317,-256
20,Kansas,40,Oklahoma,111,Okmulgee County,0,4,-4
20,Kansas,40,Oklahoma,113,Osage County,31,49,-18
20,Kansas,40,Oklahoma,115,Ottawa County,35,223,-188
20,Kansas,40,Oklahoma,117,Pawnee County,102,30,72
20,Kansas,40,Oklahoma,119,Payne County,107,186,-79
20,Kansas,40,Oklahoma,121,Pittsburg County,18,9,9
20,Kansas,40,Oklahoma,123,Pontotoc County,19,17,2
20,Kansas,40,Oklahoma,125,Pottawatomie County,116,93,23
20,Kansas,40,Oklahoma,127,Pushmataha County,0,33,-33
20,Kansas,40,Oklahoma,131,Rogers County,170,161,9
20,Kansas,40,Oklahoma,133,Seminole County,41,0,41
20,Kansas,40,Oklahoma,135,Sequoyah County,0,22,-22
20,Kansas,40,Oklahoma,137,Stephens County,0,73,-73
20,Kansas,40,Oklahoma,139,Texas County,129,260,-131
20,Kansas,40,Oklahoma,141,Tillman County,0,7,-7
20,Kansas,40,Oklahoma,143,Tulsa County,864,1205,-341
20,Kansas,40,Oklahoma,145,Wagoner County,85,51,34
20,Kansas,40,Oklahoma,147,Washington County,153,341,-188
20,Kansas,40,Oklahoma,149,Washita County,6,4,2
20,Kansas,40,Oklahoma,151,Woods County,139,36,103
20,Kansas,40,Oklahoma,153,Woodward County,7,122,-115
20,Kansas,41,Oregon,1,Baker County,0,2,-2
20,Kansas,41,Oregon,3,Benton County,0,218,-218
20,Kansas,41,Oregon,5,Clackamas County,19,10,9
20,Kansas,41,Oregon,7,Clatsop County,0,9,-9
20,Kansas,41,Oregon,9,Columbia County,11,7,4
20,Kansas,41,Oregon,17,Deschutes County,20,137,-117
20,Kansas,41,Oregon,19,Douglas County,9,0,9
20,Kansas,41,Oregon,25,Harney County,0,13,-13
20,Kansas,41,Oregon,29,Jackson County,99,7,92
20,Kansas,41,Oregon,31,Jefferson County,33,8,25
20,Kansas,41,Oregon,33,Josephine County,12,0,12
20,Kansas,41,Oregon,35,Klamath County,3,0,3
20,Kansas,41,Oregon,37,Lake County,0,69,-69
20,Kansas,41,Oregon,39,Lane County,21,60,-39
20,Kansas,41,Oregon,41,Lincoln County,33,73,-40
20,Kansas,41,Oregon,43,Linn County,0,94,-94
20,Kansas,41,Oregon,47,Marion County,13,68,-55
20,Kansas,41,Oregon,51,Multnomah County,234,139,95
20,Kansas,41,Oregon,53,Polk County,33,0,33
20,Kansas,41,Oregon,59,Umatilla County,23,0,23
20,Kansas,41,Oregon,61,Union County,1,4,-3
20,Kansas,41,Oregon,63,Wallowa County,0,24,-24
20,Kansas,41,Oregon,65,Wasco County,0,6,-6
20,Kansas,41,Oregon,67,Washington County,44,56,-12
20,Kansas,41,Oregon,71,Yamhill County,0,53,-53
20,Kansas,42,Pennsylvania,1,Adams County,0,10,-10
20,Kansas,42,Pennsylvania,3,Allegheny County,104,63,41
20,Kansas,42,Pennsylvania,5,Armstrong County,0,11,-11
20,Kansas,42,Pennsylvania,7,Beaver County,0,41,-41
20,Kansas,42,Pennsylvania,11,Berks County,0,7,-7
20,Kansas,42,Pennsylvania,13,Blair County,0,8,-8
20,Kansas,42,Pennsylvania,15,Bradford County,0,6,-6
20,Kansas,42,Pennsylvania,17,Bucks County,0,75,-75
20,Kansas,42,Pennsylvania,19,Butler County,75,40,35
20,Kansas,42,Pennsylvania,27,Centre County,31,17,14
20,Kansas,42,Pennsylvania,29,Chester County,33,127,-94
20,Kansas,42,Pennsylvania,35,Clinton County,0,5,-5
20,Kansas,42,Pennsylvania,39,Crawford County,20,10,10
20,Kansas,42,Pennsylvania,41,Cumberland County,28,105,-77
20,Kansas,42,Pennsylvania,43,Dauphin County,10,0,10
20,Kansas,42,Pennsylvania,45,Delaware County,29,30,-1
20,Kansas,42,Pennsylvania,49,Erie County,0,33,-33
20,Kansas,42,Pennsylvania,57,Fulton County,28,0,28
20,Kansas,42,Pennsylvania,61,Huntingdon County,22,8,14
20,Kansas,42,Pennsylvania,63,Indiana County,24,0,24
20,Kansas,42,Pennsylvania,69,Lackawanna County,0,15,-15
20,Kansas,42,Pennsylvania,71,Lancaster County,60,30,30
20,Kansas,42,Pennsylvania,73,Lawrence County,13,0,13
20,Kansas,42,Pennsylvania,77,Lehigh County,36,78,-42
20,Kansas,42,Pennsylvania,79,Luzerne County,63,0,63
20,Kansas,42,Pennsylvania,87,Mifflin County,24,0,24
20,Kansas,42,Pennsylvania,91,Montgomery County,18,35,-17
20,Kansas,42,Pennsylvania,95,Northampton County,46,0,46
20,Kansas,42,Pennsylvania,101,Philadelphia County,41,102,-61
20,Kansas,42,Pennsylvania,107,Schuylkill County,0,35,-35
20,Kansas,42,Pennsylvania,109,Snyder County,0,4,-4
20,Kansas,42,Pennsylvania,125,Washington County,30,0,30
20,Kansas,42,Pennsylvania,129,Westmoreland County,3,0,3
20,Kansas,42,Pennsylvania,133,York County,8,0,8
20,Kansas,44,Rhode Island,1,Bristol County,0,24,-24
20,Kansas,44,Rhode Island,5,Newport County,31,54,-23
20,Kansas,45,South Carolina,3,Aiken County,0,33,-33
20,Kansas,45,South Carolina,7,Anderson County,0,25,-25
20,Kansas,45,South Carolina,13,Beaufort County,0,31,-31
20,Kansas,45,South Carolina,15,Berkeley County,0,40,-40
20,Kansas,45,South Carolina,19,Charleston County,0,16,-16
20,Kansas,45,South Carolina,35,Dorchester County,0,121,-121
20,Kansas,45,South Carolina,43,Georgetown County,0,43,-43
20,Kansas,45,South Carolina,45,Greenville County,58,52,6
20,Kansas,45,South Carolina,51,Horry County,43,13,30
20,Kansas,45,South Carolina,55,Kershaw County,65,0,65
20,Kansas,45,South Carolina,63,Lexington County,0,110,-110
20,Kansas,45,South Carolina,79,Richland County,157,320,-163
20,Kansas,45,South Carolina,83,Spartanburg County,9,9,0
20,Kansas,45,South Carolina,85,Sumter County,176,12,164
20,Kansas,45,South Carolina,91,York County,25,47,-22
20,Kansas,46,South Dakota,9,Bon Homme County,0,5,-5
20,Kansas,46,South Dakota,11,Brookings County,29,2,27
20,Kansas,46,South Dakota,13,Brown County,42,0,42
20,Kansas,46,South Dakota,17,Buffalo County,14,0,14
20,Kansas,46,South Dakota,23,Charles Mix County,5,1,4
20,Kansas,46,South Dakota,27,Clay County,10,0,10
20,Kansas,46,South Dakota,29,Codington County,0,10,-10
20,Kansas,46,South Dakota,35,Davison County,27,33,-6
20,Kansas,46,South Dakota,53,Gregory County,0,24,-24
20,Kansas,46,South Dakota,55,Haakon County,0,1,-1
20,Kansas,46,South Dakota,57,Hamlin County,0,18,-18
20,Kansas,46,South Dakota,65,Hughes County,0,42,-42
20,Kansas,46,South Dakota,73,Jerauld County,1,0,1
20,Kansas,46,South Dakota,79,Lake County,0,3,-3
20,Kansas,46,South Dakota,81,Lawrence County,0,15,-15
20,Kansas,46,South Dakota,85,Lyman County,0,3,-3
20,Kansas,46,South Dakota,89,McPherson County,0,30,-30
20,Kansas,46,South Dakota,91,Marshall County,0,5,-5
20,Kansas,46,South Dakota,93,Meade County,0,30,-30
20,Kansas,46,South Dakota,97,Miner County,0,31,-31
20,Kansas,46,South Dakota,99,Minnehaha County,229,206,23
20,Kansas,46,South Dakota,103,Pennington County,15,106,-91
20,Kansas,46,South Dakota,105,Perkins County,54,0,54
20,Kansas,46,South Dakota,115,Spink County,0,33,-33
20,Kansas,46,South Dakota,129,Walworth County,0,1,-1
20,Kansas,46,South Dakota,135,Yankton County,12,12,0
20,Kansas,47,Tennessee,1,Anderson County,67,0,67
20,Kansas,47,Tennessee,3,Bedford County,22,0,22
20,Kansas,47,Tennessee,11,Bradley County,14,86,-72
20,Kansas,47,Tennessee,21,Cheatham County,0,12,-12
20,Kansas,47,Tennessee,23,Chester County,0,8,-8
20,Kansas,47,Tennessee,37,Davidson County,230,156,74
20,Kansas,47,Tennessee,45,Dyer County,8,0,8
20,Kansas,47,Tennessee,53,Gibson County,0,8,-8
20,Kansas,47,Tennessee,63,Hamblen County,22,0,22
20,Kansas,47,Tennessee,65,Hamilton County,0,112,-112
20,Kansas,47,Tennessee,77,Henderson County,29,0,29
20,Kansas,47,Tennessee,79,Henry County,0,6,-6
20,Kansas,47,Tennessee,81,Hickman County,0,5,-5
20,Kansas,47,Tennessee,89,Jefferson County,11,0,11
20,Kansas,47,Tennessee,93,Knox County,24,100,-76
20,Kansas,47,Tennessee,105,Loudon County,28,0,28
20,Kansas,47,Tennessee,119,Maury County,20,0,20
20,Kansas,47,Tennessee,125,Montgomery County,344,233,111
20,Kansas,47,Tennessee,131,Obion County,0,12,-12
20,Kansas,47,Tennessee,141,Putnam County,6,2,4
20,Kansas,47,Tennessee,143,Rhea County,7,0,7
20,Kansas,47,Tennessee,145,Roane County,0,51,-51
20,Kansas,47,Tennessee,149,Rutherford County,25,14,11
20,Kansas,47,Tennessee,155,Sevier County,0,20,-20
20,Kansas,47,Tennessee,157,Shelby County,144,21,123
20,Kansas,47,Tennessee,161,Stewart County,0,25,-25
20,Kansas,47,Tennessee,163,Sullivan County,10,0,10
20,Kansas,47,Tennessee,165,Sumner County,116,0,116
20,Kansas,47,Tennessee,177,Warren County,20,115,-95
20,Kansas,47,Tennessee,179,Washington County,17,0,17
20,Kansas,47,Tennessee,183,Weakley County,3,0,3
20,Kansas,47,Tennessee,187,Williamson County,83,677,-594
20,Kansas,47,Tennessee,189,Wilson County,0,26,-26
20,Kansas,48,Texas,1,Anderson County,37,25,12
20,Kansas,48,Texas,3,Andrews County,99,0,99
20,Kansas,48,Texas,5,Angelina County,0,17,-17
20,Kansas,48,Texas,7,Aransas County,75,3,72
20,Kansas,48,Texas,9,Archer County,15,0,15
20,Kansas,48,Texas,19,Bandera County,4,0,4
20,Kansas,48,Texas,27,Bell County,733,1122,-389
20,Kansas,48,Texas,29,Bexar County,304,688,-384
20,Kansas,48,Texas,31,Blanco County,21,0,21
20,Kansas,48,Texas,33,Borden County,0,2,-2
20,Kansas,48,Texas,35,Bosque County,0,35,-35
20,Kansas,48,Texas,37,Bowie County,21,34,-13
20,Kansas,48,Texas,39,Brazoria County,78,278,-200
20,Kansas,48,Texas,41,Brazos County,37,90,-53
20,Kansas,48,Texas,53,Burnet County,0,18,-18
20,Kansas,48,Texas,55,Caldwell County,6,0,6
20,Kansas,48,Texas,59,Callahan County,0,25,-25
20,Kansas,48,Texas,61,Cameron County,65,16,49
20,Kansas,48,Texas,63,Camp County,0,8,-8
20,Kansas,48,Texas,67,Cass County,0,11,-11
20,Kansas,48,Texas,71,Chambers County,1,0,1
20,Kansas,48,Texas,73,Cherokee County,0,48,-48
20,Kansas,48,Texas,75,Childress County,15,0,15
20,Kansas,48,Texas,85,Collin County,292,842,-550
20,Kansas,48,Texas,91,Comal County,49,0,49
20,Kansas,48,Texas,97,Cooke County,4,0,4
20,Kansas,48,Texas,99,Coryell County,95,72,23
20,Kansas,48,Texas,113,Dallas County,499,601,-102
20,Kansas,48,Texas,117,Deaf Smith County,44,2,42
20,Kansas,48,Texas,121,Denton County,355,363,-8
20,Kansas,48,Texas,123,DeWitt County,21,0,21
20,Kansas,48,Texas,129,Donley County,7,15,-8
20,Kansas,48,Texas,135,Ector County,29,0,29
20,Kansas,48,Texas,139,Ellis County,176,9,167
20,Kansas,48,Texas,141,El Paso County,861,568,293
20,Kansas,48,Texas,143,Erath County,7,0,7
20,Kansas,48,Texas,147,Fannin County,10,0,10
20,Kansas,48,Texas,157,Fort Bend County,147,48,99
20,Kansas,48,Texas,159,Franklin County,0,6,-6
20,Kansas,48,Texas,161,Freestone County,0,32,-32
20,Kansas,48,Texas,165,Gaines County,15,0,15
20,Kansas,48,Texas,167,Galveston County,51,294,-243
20,Kansas,48,Texas,169,Garza County,0,12,-12
20,Kansas,48,Texas,181,Grayson County,61,0,61
20,Kansas,48,Texas,183,Gregg County,66,43,23
20,Kansas,48,Texas,187,Guadalupe County,3,208,-205
20,Kansas,48,Texas,189,Hale County,67,56,11
20,Kansas,48,Texas,193,Hamilton County,14,0,14
20,Kansas,48,Texas,195,Hansford County,0,6,-6
20,Kansas,48,Texas,199,Hardin County,35,0,35
20,Kansas,48,Texas,201,Harris County,841,645,196
20,Kansas,48,Texas,203,Harrison County,29,0,29
20,Kansas,48,Texas,207,Haskell County,0,24,-24
20,Kansas,48,Texas,209,Hays County,0,47,-47
20,Kansas,48,Texas,211,Hemphill County,0,73,-73
20,Kansas,48,Texas,213,Henderson County,31,137,-106
20,Kansas,48,Texas,215,Hidalgo County,163,147,16
20,Kansas,48,Texas,217,Hill County,11,46,-35
20,Kansas,48,Texas,221,Hood County,16,0,16
20,Kansas,48,Texas,227,Howard County,10,8,2
20,Kansas,48,Texas,231,Hunt County,36,0,36
20,Kansas,48,Texas,233,Hutchinson County,11,0,11
20,Kansas,48,Texas,237,Jack County,0,11,-11
20,Kansas,48,Texas,241,Jasper County,7,0,7
20,Kansas,48,Texas,245,Jefferson County,34,31,3
20,Kansas,48,Texas,249,Jim Wells County,22,0,22
20,Kansas,48,Texas,251,Johnson County,13,64,-51
20,Kansas,48,Texas,253,Jones County,19,0,19
20,Kansas,48,Texas,257,Kaufman County,43,0,43
20,Kansas,48,Texas,259,Kendall County,4,0,4
20,Kansas,48,Texas,273,Kleberg County,0,3,-3
20,Kansas,48,Texas,277,Lamar County,45,0,45
20,Kansas,48,Texas,279,Lamb County,0,32,-32
20,Kansas,48,Texas,281,Lampasas County,73,0,73
20,Kansas,48,Texas,285,Lavaca County,0,6,-6
20,Kansas,48,Texas,287,Lee County,0,5,-5
20,Kansas,48,Texas,291,Liberty County,208,186,22
20,Kansas,48,Texas,293,Limestone County,0,1,-1
20,Kansas,48,Texas,295,Lipscomb County,4,0,4
20,Kansas,48,Texas,299,Llano County,4,0,4
20,Kansas,48,Texas,303,Lubbock County,80,206,-126
20,Kansas,48,Texas,309,McLennan County,160,128,32
20,Kansas,48,Texas,321,Matagorda County,18,0,18
20,Kansas,48,Texas,323,Maverick County,0,35,-35
20,Kansas,48,Texas,325,Medina County,19,0,19
20,Kansas,48,Texas,329,Midland County,68,0,68
20,Kansas,48,Texas,331,Milam County,12,11,1
20,Kansas,48,Texas,333,Mills County,0,14,-14
20,Kansas,48,Texas,337,Montague County,8,4,4
20,Kansas,48,Texas,339,Montgomery County,97,198,-101
20,Kansas,48,Texas,341,Moore County,22,0,22
20,Kansas,48,Texas,343,Morris County,6,0,6
20,Kansas,48,Texas,345,Motley County,0,16,-16
20,Kansas,48,Texas,347,Nacogdoches County,27,0,27
20,Kansas,48,Texas,349,Navarro County,0,18,-18
20,Kansas,48,Texas,355,Nueces County,53,45,8
20,Kansas,48,Texas,357,Ochiltree County,0,36,-36
20,Kansas,48,Texas,365,Panola County,89,0,89
20,Kansas,48,Texas,367,Parker County,60,30,30
20,Kansas,48,Texas,369,Parmer County,68,0,68
20,Kansas,48,Texas,373,Polk County,126,0,126
20,Kansas,48,Texas,375,Potter County,145,85,60
20,Kansas,48,Texas,379,Rains County,6,0,6
20,Kansas,48,Texas,381,Randall County,75,123,-48
20,Kansas,48,Texas,387,Red River County,11,0,11
20,Kansas,48,Texas,389,Reeves County,0,16,-16
20,Kansas,48,Texas,395,Robertson County,209,0,209
20,Kansas,48,Texas,397,Rockwall County,14,53,-39
20,Kansas,48,Texas,407,San Jacinto County,0,3,-3
20,Kansas,48,Texas,409,San Patricio County,243,45,198
20,Kansas,48,Texas,413,Schleicher County,15,0,15
20,Kansas,48,Texas,415,Scurry County,0,7,-7
20,Kansas,48,Texas,423,Smith County,10,174,-164
20,Kansas,48,Texas,425,Somervell County,56,0,56
20,Kansas,48,Texas,437,Swisher County,21,3,18
20,Kansas,48,Texas,439,Tarrant County,664,987,-323
20,Kansas,48,Texas,441,Taylor County,90,235,-145
20,Kansas,48,Texas,449,Titus County,0,10,-10
20,Kansas,48,Texas,451,Tom Green County,75,107,-32
20,Kansas,48,Texas,453,Travis County,311,257,54
20,Kansas,48,Texas,457,Tyler County,0,2,-2
20,Kansas,48,Texas,459,Upshur County,12,0,12
20,Kansas,48,Texas,463,Uvalde County,8,0,8
20,Kansas,48,Texas,465,Val Verde County,6,0,6
20,Kansas,48,Texas,467,Van Zandt County,0,6,-6
20,Kansas,48,Texas,469,Victoria County,0,17,-17
20,Kansas,48,Texas,471,Walker County,27,0,27
20,Kansas,48,Texas,473,Waller County,0,2,-2
20,Kansas,48,Texas,475,Ward County,10,0,10
20,Kansas,48,Texas,477,Washington County,88,0,88
20,Kansas,48,Texas,481,Wharton County,30,0,30
20,Kansas,48,Texas,485,Wichita County,235,162,73
20,Kansas,48,Texas,491,Williamson County,119,312,-193
20,Kansas,48,Texas,499,Wood County,0,8,-8
20,Kansas,49,Utah,5,Cache County,173,0,173
20,Kansas,49,Utah,11,Davis County,161,9,152
20,Kansas,49,Utah,13,Duchesne County,37,0,37
20,Kansas,49,Utah,25,Kane County,4,0,4
20,Kansas,49,Utah,27,Millard County,62,0,62
20,Kansas,49,Utah,35,Salt Lake County,163,184,-21
20,Kansas,49,Utah,39,Sanpete County,45,0,45
20,Kansas,49,Utah,45,Tooele County,21,13,8
20,Kansas,49,Utah,47,Uintah County,48,0,48
20,Kansas,49,Utah,49,Utah County,84,127,-43
20,Kansas,49,Utah,53,Washington County,0,129,-129
20,Kansas,49,Utah,57,Weber County,17,9,8
20,Kansas,5,Arkansas,1,Arkansas County,0,15,-15
20,Kansas,5,Arkansas,5,Baxter County,11,0,11
20,Kansas,5,Arkansas,7,Benton County,309,241,68
20,Kansas,5,Arkansas,9,Boone County,20,24,-4
20,Kansas,5,Arkansas,15,Carroll County,43,0,43
20,Kansas,5,Arkansas,23,Cleburne County,0,11,-11
20,Kansas,5,Arkansas,27,Columbia County,0,14,-14
20,Kansas,5,Arkansas,33,Crawford County,9,0,9
20,Kansas,5,Arkansas,35,Crittenden County,19,0,19
20,Kansas,5,Arkansas,45,Faulkner County,121,44,77
20,Kansas,5,Arkansas,47,Franklin County,0,27,-27
20,Kansas,5,Arkansas,49,Fulton County,0,7,-7
20,Kansas,5,Arkansas,51,Garland County,186,0,186
20,Kansas,5,Arkansas,59,Hot Spring County,12,0,12
20,Kansas,5,Arkansas,65,Izard County,43,0,43
20,Kansas,5,Arkansas,67,Jackson County,60,0,60
20,Kansas,5,Arkansas,71,Johnson County,11,12,-1
20,Kansas,5,Arkansas,81,Little River County,0,9,-9
20,Kansas,5,Arkansas,83,Logan County,6,0,6
20,Kansas,5,Arkansas,85,Lonoke County,3,0,3
20,Kansas,5,Arkansas,87,Madison County,8,17,-9
20,Kansas,5,Arkansas,101,Newton County,0,30,-30
20,Kansas,5,Arkansas,105,Perry County,0,4,-4
20,Kansas,5,Arkansas,113,Polk County,10,33,-23
20,Kansas,5,Arkansas,115,Pope County,15,23,-8
20,Kansas,5,Arkansas,119,Pulaski County,205,83,122
20,Kansas,5,Arkansas,123,St. Francis County,0,12,-12
20,Kansas,5,Arkansas,125,Saline County,33,54,-21
20,Kansas,5,Arkansas,127,Scott County,2,0,2
20,Kansas,5,Arkansas,131,Sebastian County,43,243,-200
20,Kansas,5,Arkansas,139,Union County,0,31,-31
20,Kansas,5,Arkansas,143,Washington County,212,502,-290
20,Kansas,5,Arkansas,145,White County,25,27,-2
20,Kansas,5,Arkansas,147,Woodruff County,0,3,-3
20,Kansas,50,Vermont,7,Chittenden County,0,6,-6
20,Kansas,50,Vermont,17,Orange County,0,6,-6
20,Kansas,50,Vermont,19,Orleans County,0,3,-3
20,Kansas,50,Vermont,25,Windham County,44,5,39
20,Kansas,51,Virginia,3,Albemarle County,0,15,-15
20,Kansas,51,Virginia,13,Arlington County,71,15,56
20,Kansas,51,Virginia,23,Botetourt County,23,0,23
20,Kansas,51,Virginia,33,Caroline County,3,0,3
20,Kansas,51,Virginia,35,Carroll County,9,0,9
20,Kansas,51,Virginia,36,Charles City County,128,0,128
20,Kansas,51,Virginia,41,Chesterfield County,139,288,-149
20,Kansas,51,Virginia,53,Dinwiddie County,0,16,-16
20,Kansas,51,Virginia,59,Fairfax County,331,599,-268
20,Kansas,51,Virginia,69,Frederick County,0,35,-35
20,Kansas,51,Virginia,79,Greene County,77,0,77
20,Kansas,51,Virginia,83,Halifax County,5,0,5
20,Kansas,51,Virginia,87,Henrico County,13,0,13
20,Kansas,51,Virginia,93,Isle of Wight County,0,10,-10
20,Kansas,51,Virginia,95,James City County,0,15,-15
20,Kansas,51,Virginia,99,King George County,2,0,2
20,Kansas,51,Virginia,107,Loudoun County,33,77,-44
20,Kansas,51,Virginia,149,Prince George County,99,54,45
20,Kansas,51,Virginia,153,Prince William County,141,35,106
20,Kansas,51,Virginia,165,Rockingham County,5,0,5
20,Kansas,51,Virginia,167,Russell County,50,0,50
20,Kansas,51,Virginia,179,Stafford County,44,0,44
20,Kansas,51,Virginia,183,Sussex County,26,0,26
20,Kansas,51,Virginia,199,York County,74,17,57
20,Kansas,51,Virginia,510,Alexandria city,40,19,21
20,Kansas,51,Virginia,520,Bristol city,0,105,-105
20,Kansas,51,Virginia,540,Charlottesville city,17,9,8
20,Kansas,51,Virginia,550,Chesapeake city,49,70,-21
20,Kansas,51,Virginia,595,Emporia city,7,0,7
20,Kansas,51,Virginia,630,Fredericksburg city,70,0,70
20,Kansas,51,Virginia,640,Galax city,8,0,8
20,Kansas,51,Virginia,650,Hampton city,0,46,-46
20,Kansas,51,Virginia,660,Harrisonburg city,0,46,-46
20,Kansas,51,Virginia,680,Lynchburg city,0,45,-45
20,Kansas,51,Virginia,683,Manassas city,9,0,9
20,Kansas,51,Virginia,700,Newport News city,31,134,-103
20,Kansas,51,Virginia,710,Norfolk city,2,34,-32
20,Kansas,51,Virginia,730,Petersburg city,58,0,58
20,Kansas,51,Virginia,760,Richmond city,0,47,-47
20,Kansas,51,Virginia,770,Roanoke city,0,76,-76
20,Kansas,51,Virginia,790,Staunton city,44,0,44
20,Kansas,51,Virginia,810,Virginia Beach city,17,21,-4
20,Kansas,51,Virginia,820,Waynesboro city,239,0,239
20,Kansas,53,Washington,5,Benton County,0,10,-10
20,Kansas,53,Washington,9,Clallam County,0,33,-33
20,Kansas,53,Washington,11,Clark County,35,95,-60
20,Kansas,53,Washington,15,Cowlitz County,16,31,-15
20,Kansas,53,Washington,25,Grant County,0,84,-84
20,Kansas,53,Washington,27,Grays Harbor County,92,6,86
20,Kansas,53,Washington,29,Island County,4,51,-47
20,Kansas,53,Washington,31,Jefferson County,0,2,-2
20,Kansas,53,Washington,33,King County,348,438,-90
20,Kansas,53,Washington,35,Kitsap County,27,236,-209
20,Kansas,53,Washington,37,Kittitas County,42,0,42
20,Kansas,53,Washington,39,Klickitat County,0,5,-5
20,Kansas,53,Washington,45,Mason County,9,73,-64
20,Kansas,53,Washington,53,Pierce County,750,546,204
20,Kansas,53,Washington,55,San Juan County,30,0,30
20,Kansas,53,Washington,57,Skagit County,22,0,22
20,Kansas,53,Washington,61,Snohomish County,48,162,-114
20,Kansas,53,Washington,63,Spokane County,4,29,-25
20,Kansas,53,Washington,67,Thurston County,17,274,-257
20,Kansas,53,Washington,71,Walla Walla County,0,14,-14
20,Kansas,53,Washington,73,Whatcom County,0,21,-21
20,Kansas,53,Washington,75,Whitman County,0,23,-23
20,Kansas,53,Washington,77,Yakima County,0,78,-78
20,Kansas,54,West Virginia,11,Cabell County,6,41,-35
20,Kansas,54,West Virginia,23,Grant County,0,5,-5
20,Kansas,54,West Virginia,33,Harrison County,0,3,-3
20,Kansas,54,West Virginia,37,Jefferson County,0,7,-7
20,Kansas,54,West Virginia,39,Kanawha County,17,12,5
20,Kansas,54,West Virginia,45,Logan County,0,9,-9
20,Kansas,54,West Virginia,49,Marion County,19,0,19
20,Kansas,54,West Virginia,61,Monongalia County,62,6,56
20,Kansas,54,West Virginia,67,Nicholas County,35,0,35
20,Kansas,54,West Virginia,71,Pendleton County,0,4,-4
20,Kansas,54,West Virginia,77,Preston County,5,0,5
20,Kansas,54,West Virginia,79,Putnam County,0,32,-32
20,Kansas,54,West Virginia,97,Upshur County,31,0,31
20,Kansas,55,Wisconsin,1,Adams County,0,9,-9
20,Kansas,55,Wisconsin,7,Bayfield County,0,6,-6
20,Kansas,55,Wisconsin,9,Brown County,42,54,-12
20,Kansas,55,Wisconsin,17,Chippewa County,0,7,-7
20,Kansas,55,Wisconsin,19,Clark County,8,0,8
20,Kansas,55,Wisconsin,25,Dane County,8,41,-33
20,Kansas,55,Wisconsin,29,Door County,48,0,48
20,Kansas,55,Wisconsin,31,Douglas County,1,0,1
20,Kansas,55,Wisconsin,33,Dunn County,0,2,-2
20,Kansas,55,Wisconsin,47,Green Lake County,0,5,-5
20,Kansas,55,Wisconsin,57,Juneau County,0,5,-5
20,Kansas,55,Wisconsin,59,Kenosha County,57,0,57
20,Kansas,55,Wisconsin,61,Kewaunee County,0,2,-2
20,Kansas,55,Wisconsin,63,La Crosse County,0,72,-72
20,Kansas,55,Wisconsin,71,Manitowoc County,0,4,-4
20,Kansas,55,Wisconsin,75,Marinette County,0,4,-4
20,Kansas,55,Wisconsin,79,Milwaukee County,47,135,-88
20,Kansas,55,Wisconsin,81,Monroe County,94,0,94
20,Kansas,55,Wisconsin,87,Outagamie County,0,9,-9
20,Kansas,55,Wisconsin,89,Ozaukee County,11,0,11
20,Kansas,55,Wisconsin,91,Pepin County,15,0,15
20,Kansas,55,Wisconsin,97,Portage County,0,5,-5
20,Kansas,55,Wisconsin,99,Price County,0,24,-24
20,Kansas,55,Wisconsin,103,Richland County,0,1,-1
20,Kansas,55,Wisconsin,105,Rock County,47,64,-17
20,Kansas,55,Wisconsin,109,St. Croix County,0,10,-10
20,Kansas,55,Wisconsin,111,Sauk County,0,17,-17
20,Kansas,55,Wisconsin,113,Sawyer County,0,1,-1
20,Kansas,55,Wisconsin,117,Sheboygan County,19,31,-12
20,Kansas,55,Wisconsin,119,Taylor County,0,11,-11
20,Kansas,55,Wisconsin,123,Vernon County,0,8,-8
20,Kansas,55,Wisconsin,127,Walworth County,0,4,-4
20,Kansas,55,Wisconsin,131,Washington County,0,8,-8
20,Kansas,55,Wisconsin,133,Waukesha County,0,7,-7
20,Kansas,55,Wisconsin,137,Waushara County,0,4,-4
20,Kansas,55,Wisconsin,139,Winnebago County,0,4,-4
20,Kansas,56,Wyoming,1,Albany County,39,11,28
20,Kansas,56,Wyoming,3,Big Horn County,78,12,66
20,Kansas,56,Wyoming,7,Carbon County,0,8,-8
20,Kansas,56,Wyoming,11,Crook County,0,1,-1
20,Kansas,56,Wyoming,13,Fremont County,8,0,8
20,Kansas,56,Wyoming,15,Goshen County,0,3,-3
20,Kansas,56,Wyoming,21,Laramie County,64,111,-47
20,Kansas,56,Wyoming,25,Natrona County,51,59,-8
20,Kansas,56,Wyoming,29,Park County,0,2,-2
20,Kansas,56,Wyoming,31,Platte County,37,0,37
20,Kansas,56,Wyoming,39,Teton County,0,23,-23
20,Kansas,56,Wyoming,45,Weston County,4,0,4
20,Kansas,6,California,1,Alameda County,9,101,-92
20,Kansas,6,California,7,Butte County,54,0,54
20,Kansas,6,California,9,Calaveras County,25,0,25
20,Kansas,6,California,13,Contra Costa County,95,77,18
20,Kansas,6,California,17,El Dorado County,26,8,18
20,Kansas,6,California,19,Fresno County,120,251,-131
20,Kansas,6,California,21,Glenn County,44,11,33
20,Kansas,6,California,23,Humboldt County,0,16,-16
20,Kansas,6,California,25,Imperial County,64,0,64
20,Kansas,6,California,29,Kern County,199,23,176
20,Kansas,6,California,31,Kings County,19,3,16
20,Kansas,6,California,35,Lassen County,11,0,11
20,Kansas,6,California,37,Los Angeles County,1198,793,405
20,Kansas,6,California,39,Madera County,8,0,8
20,Kansas,6,California,41,Marin County,53,166,-113
20,Kansas,6,California,47,Merced County,36,79,-43
20,Kansas,6,California,53,Monterey County,0,155,-155
20,Kansas,6,California,55,Napa County,0,19,-19
20,Kansas,6,California,59,Orange County,641,278,363
20,Kansas,6,California,61,Placer County,26,172,-146
20,Kansas,6,California,65,Riverside County,668,406,262
20,Kansas,6,California,67,Sacramento County,86,266,-180
20,Kansas,6,California,69,San Benito County,0,46,-46
20,Kansas,6,California,71,San Bernardino County,818,210,608
20,Kansas,6,California,73,San Diego County,716,470,246
20,Kansas,6,California,75,San Francisco County,83,62,21
20,Kansas,6,California,77,San Joaquin County,17,178,-161
20,Kansas,6,California,79,San Luis Obispo County,14,54,-40
20,Kansas,6,California,81,San Mateo County,25,92,-67
20,Kansas,6,California,83,Santa Barbara County,115,68,47
20,Kansas,6,California,85,Santa Clara County,111,263,-152
20,Kansas,6,California,93,Siskiyou County,17,27,-10
20,Kansas,6,California,95,Solano County,168,47,121
20,Kansas,6,California,97,Sonoma County,23,136,-113
20,Kansas,6,California,99,Stanislaus County,66,11,55
20,Kansas,6,California,101,Sutter County,6,0,6
20,Kansas,6,California,103,Tehama County,46,0,46
20,Kansas,6,California,107,Tulare County,89,15,74
20,Kansas,6,California,109,Tuolumne County,6,0,6
20,Kansas,6,California,111,Ventura County,95,23,72
20,Kansas,6,California,113,Yolo County,41,142,-101
20,Kansas,6,California,115,Yuba County,0,44,-44
20,Kansas,72,Puerto Rico,19,Barranquitas Municipio,41,0,41
20,Kansas,72,Puerto Rico,21,Bayamón Municipio,48,0,48
20,Kansas,72,Puerto Rico,25,Caguas Municipio,9,0,9
20,Kansas,72,Puerto Rico,41,Cidra Municipio,0,67,-67
20,Kansas,72,Puerto Rico,53,Fajardo Municipio,43,0,43
20,Kansas,72,Puerto Rico,61,Guaynabo Municipio,0,83,-83
20,Kansas,72,Puerto Rico,103,Naguabo Municipio,9,0,9
20,Kansas,72,Puerto Rico,113,Ponce Municipio,30,19,11
20,Kansas,72,Puerto Rico,117,Rincón Municipio,9,0,9
20,Kansas,72,Puerto Rico,125,San Germán Municipio,8,0,8
20,Kansas,72,Puerto Rico,127,San Juan Municipio,20,0,20
20,Kansas,8,Colorado,1,Adams County,536,307,229
20,Kansas,8,Colorado,3,Alamosa County,0,1,-1
20,Kansas,8,Colorado,5,Arapahoe County,542,400,142
20,Kansas,8,Colorado,7,Archuleta County,5,0,5
20,Kansas,8,Colorado,9,Baca County,14,52,-38
20,Kansas,8,Colorado,11,Bent County,0,9,-9
20,Kansas,8,Colorado,13,Boulder County,115,144,-29
20,Kansas,8,Colorado,14,Broomfield County,7,46,-39
20,Kansas,8,Colorado,15,Chaffee County,12,27,-15
20,Kansas,8,Colorado,19,Clear Creek County,4,0,4
20,Kansas,8,Colorado,23,Costilla County,0,50,-50
20,Kansas,8,Colorado,25,Crowley County,0,30,-30
20,Kansas,8,Colorado,27,Custer County,0,3,-3
20,Kansas,8,Colorado,29,Delta County,8,8,0
20,Kansas,8,Colorado,31,Denver County,386,908,-522
20,Kansas,8,Colorado,33,Dolores County,0,5,-5
20,Kansas,8,Colorado,35,Douglas County,133,198,-65
20,Kansas,8,Colorado,37,Eagle County,136,28,108
20,Kansas,8,Colorado,39,Elbert County,1,41,-40
20,Kansas,8,Colorado,41,El Paso County,1100,1533,-433
20,Kansas,8,Colorado,43,Fremont County,65,53,12
20,Kansas,8,Colorado,45,Garfield County,0,339,-339
20,Kansas,8,Colorado,49,Grand County,17,0,17
20,Kansas,8,Colorado,51,Gunnison County,2,18,-16
20,Kansas,8,Colorado,53,Hinsdale County,0,3,-3
20,Kansas,8,Colorado,59,Jefferson County,388,418,-30
20,Kansas,8,Colorado,61,Kiowa County,23,2,21
20,Kansas,8,Colorado,63,Kit Carson County,121,2,119
20,Kansas,8,Colorado,65,Lake County,3,0,3
20,Kansas,8,Colorado,67,La Plata County,29,75,-46
20,Kansas,8,Colorado,69,Larimer County,401,341,60
20,Kansas,8,Colorado,75,Logan County,4,0,4
20,Kansas,8,Colorado,77,Mesa County,159,73,86
20,Kansas,8,Colorado,81,Moffat County,61,43,18
20,Kansas,8,Colorado,83,Montezuma County,15,0,15
20,Kansas,8,Colorado,85,Montrose County,0,13,-13
20,Kansas,8,Colorado,87,Morgan County,50,2,48
20,Kansas,8,Colorado,89,Otero County,23,20,3
20,Kansas,8,Colorado,95,Phillips County,20,19,1
20,Kansas,8,Colorado,99,Prowers County,28,77,-49
20,Kansas,8,Colorado,101,Pueblo County,180,142,38
20,Kansas,8,Colorado,103,Rio Blanco County,0,2,-2
20,Kansas,8,Colorado,105,Rio Grande County,0,22,-22
20,Kansas,8,Colorado,107,Routt County,13,35,-22
20,Kansas,8,Colorado,109,Saguache County,0,1,-1
20,Kansas,8,Colorado,113,San Miguel County,0,9,-9
20,Kansas,8,Colorado,117,Summit County,0,7,-7
20,Kansas,8,Colorado,119,Teller County,25,0,25
20,Kansas,8,Colorado,121,Washington County,0,17,-17
20,Kansas,8,Colorado,123,Weld County,90,211,-121
20,Kansas,8,Colorado,125,Yuma County,4,4,0
20,Kansas,9,Connecticut,1,Fairfield County,79,53,26
20,Kansas,9,Connecticut,3,Hartford County,106,20,86
20,Kansas,9,Connecticut,7,Middlesex County,70,0,70
20,Kansas,9,Connecticut,9,New Haven County,105,60,45
20,Kansas,9,Connecticut,11,New London County,0,7,-7
20,Kansas,AFR,Africa,,-,1217,0,0
20,Kansas,ASI,Asia,,-,8333,0,0
20,Kansas,CAM,Central America,,-,1787,0,0
20,Kansas,CAR,Caribbean,,-,291,0,0
20,Kansas,EUR,Europe,,-,2857,0,0
20,Kansas,ISL,U.S. Island Areas,,-,37,0,0
20,Kansas,NAM,Northern America,,-,278,0,0
20,Kansas,OCE,Oceania and At Sea,,-,221,0,0
20,Kansas,SAM,South America,,-,1158,0,0
21,Kentucky,1,Alabama,1,Autauga County,18,0,18
21,Kentucky,1,Alabama,3,Baldwin County,80,70,10
21,Kentucky,1,Alabama,5,Barbour County,8,0,8
21,Kentucky,1,Alabama,9,Blount County,49,2,47
21,Kentucky,1,Alabama,15,Calhoun County,0,123,-123
21,Kentucky,1,Alabama,21,Chilton County,18,0,18
21,Kentucky,1,Alabama,31,Coffee County,95,7,88
21,Kentucky,1,Alabama,33,Colbert County,16,20,-4
21,Kentucky,1,Alabama,43,Cullman County,50,22,28
21,Kentucky,1,Alabama,45,Dale County,34,135,-101
21,Kentucky,1,Alabama,47,Dallas County,24,0,24
21,Kentucky,1,Alabama,49,DeKalb County,97,1,96
21,Kentucky,1,Alabama,51,Elmore County,48,12,36
21,Kentucky,1,Alabama,55,Etowah County,0,33,-33
21,Kentucky,1,Alabama,57,Fayette County,9,0,9
21,Kentucky,1,Alabama,59,Franklin County,0,20,-20
21,Kentucky,1,Alabama,61,Geneva County,8,0,8
21,Kentucky,1,Alabama,67,Henry County,0,20,-20
21,Kentucky,1,Alabama,69,Houston County,47,6,41
21,Kentucky,1,Alabama,71,Jackson County,37,7,30
21,Kentucky,1,Alabama,73,Jefferson County,206,332,-126
21,Kentucky,1,Alabama,77,Lauderdale County,66,108,-42
21,Kentucky,1,Alabama,81,Lee County,85,244,-159
21,Kentucky,1,Alabama,83,Limestone County,2,69,-67
21,Kentucky,1,Alabama,89,Madison County,199,209,-10
21,Kentucky,1,Alabama,95,Marshall County,111,18,93
21,Kentucky,1,Alabama,97,Mobile County,46,153,-107
21,Kentucky,1,Alabama,99,Monroe County,0,17,-17
21,Kentucky,1,Alabama,101,Montgomery County,48,76,-28
21,Kentucky,1,Alabama,103,Morgan County,43,139,-96
21,Kentucky,1,Alabama,107,Pickens County,0,5,-5
21,Kentucky,1,Alabama,109,Pike County,55,0,55
21,Kentucky,1,Alabama,113,Russell County,35,40,-5
21,Kentucky,1,Alabama,115,St. Clair County,18,10,8
21,Kentucky,1,Alabama,117,Shelby County,129,112,17
21,Kentucky,1,Alabama,119,Sumter County,21,3,18
21,Kentucky,1,Alabama,121,Talladega County,49,38,11
21,Kentucky,1,Alabama,123,Tallapoosa County,17,0,17
21,Kentucky,1,Alabama,125,Tuscaloosa County,105,119,-14
21,Kentucky,1,Alabama,127,Walker County,0,2,-2
21,Kentucky,1,Alabama,131,Wilcox County,0,1,-1
21,Kentucky,10,Delaware,1,Kent County,49,10,39
21,Kentucky,10,Delaware,3,New Castle County,88,66,22
21,Kentucky,10,Delaware,5,Sussex County,22,11,11
21,Kentucky,11,District of Columbia,1,District of Columbia,197,219,-22
21,Kentucky,12,Florida,1,Alachua County,58,126,-68
21,Kentucky,12,Florida,5,Bay County,79,404,-325
21,Kentucky,12,Florida,9,Brevard County,106,652,-546
21,Kentucky,12,Florida,11,Broward County,561,398,163
21,Kentucky,12,Florida,15,Charlotte County,33,88,-55
21,Kentucky,12,Florida,17,Citrus County,84,177,-93
21,Kentucky,12,Florida,19,Clay County,50,0,50
21,Kentucky,12,Florida,21,Collier County,52,368,-316
21,Kentucky,12,Florida,23,Columbia County,485,0,485
21,Kentucky,12,Florida,27,DeSoto County,0,20,-20
21,Kentucky,12,Florida,29,Dixie County,0,98,-98
21,Kentucky,12,Florida,31,Duval County,546,264,282
21,Kentucky,12,Florida,33,Escambia County,145,302,-157
21,Kentucky,12,Florida,35,Flagler County,12,19,-7
21,Kentucky,12,Florida,37,Franklin County,0,20,-20
21,Kentucky,12,Florida,41,Gilchrist County,6,0,6
21,Kentucky,12,Florida,43,Glades County,0,80,-80
21,Kentucky,12,Florida,45,Gulf County,0,13,-13
21,Kentucky,12,Florida,51,Hendry County,17,11,6
21,Kentucky,12,Florida,53,Hernando County,8,110,-102
21,Kentucky,12,Florida,55,Highlands County,37,4,33
21,Kentucky,12,Florida,57,Hillsborough County,393,594,-201
21,Kentucky,12,Florida,61,Indian River County,23,118,-95
21,Kentucky,12,Florida,63,Jackson County,72,0,72
21,Kentucky,12,Florida,67,Lafayette County,20,0,20
21,Kentucky,12,Florida,69,Lake County,46,338,-292
21,Kentucky,12,Florida,71,Lee County,449,606,-157
21,Kentucky,12,Florida,73,Leon County,67,216,-149
21,Kentucky,12,Florida,75,Levy County,0,16,-16
21,Kentucky,12,Florida,79,Madison County,0,59,-59
21,Kentucky,12,Florida,81,Manatee County,82,290,-208
21,Kentucky,12,Florida,83,Marion County,68,84,-16
21,Kentucky,12,Florida,85,Martin County,67,11,56
21,Kentucky,12,Florida,86,Miami-Dade County,532,291,241
21,Kentucky,12,Florida,87,Monroe County,67,0,67
21,Kentucky,12,Florida,89,Nassau County,25,184,-159
21,Kentucky,12,Florida,91,Okaloosa County,254,57,197
21,Kentucky,12,Florida,93,Okeechobee County,41,37,4
21,Kentucky,12,Florida,95,Orange County,427,375,52
21,Kentucky,12,Florida,97,Osceola County,71,47,24
21,Kentucky,12,Florida,99,Palm Beach County,501,383,118
21,Kentucky,12,Florida,101,Pasco County,96,248,-152
21,Kentucky,12,Florida,103,Pinellas County,460,451,9
21,Kentucky,12,Florida,105,Polk County,255,216,39
21,Kentucky,12,Florida,107,Putnam County,78,8,70
21,Kentucky,12,Florida,109,St. Johns County,57,0,57
21,Kentucky,12,Florida,111,St. Lucie County,7,91,-84
21,Kentucky,12,Florida,113,Santa Rosa County,168,144,24
21,Kentucky,12,Florida,115,Sarasota County,200,190,10
21,Kentucky,12,Florida,117,Seminole County,153,36,117
21,Kentucky,12,Florida,119,Sumter County,249,68,181
21,Kentucky,12,Florida,123,Taylor County,0,26,-26
21,Kentucky,12,Florida,127,Volusia County,269,220,49
21,Kentucky,12,Florida,129,Wakulla County,1,0,1
21,Kentucky,12,Florida,131,Walton County,59,33,26
21,Kentucky,12,Florida,133,Washington County,0,10,-10
21,Kentucky,13,Georgia,9,Baldwin County,24,4,20
21,Kentucky,13,Georgia,11,Banks County,11,0,11
21,Kentucky,13,Georgia,13,Barrow County,0,44,-44
21,Kentucky,13,Georgia,15,Bartow County,1,27,-26
21,Kentucky,13,Georgia,17,Ben Hill County,0,24,-24
21,Kentucky,13,Georgia,19,Berrien County,0,7,-7
21,Kentucky,13,Georgia,21,Bibb County,10,80,-70
21,Kentucky,13,Georgia,27,Brooks County,14,0,14
21,Kentucky,13,Georgia,29,Bryan County,39,0,39
21,Kentucky,13,Georgia,31,Bulloch County,0,43,-43
21,Kentucky,13,Georgia,33,Burke County,0,54,-54
21,Kentucky,13,Georgia,35,Butts County,0,8,-8
21,Kentucky,13,Georgia,39,Camden County,18,40,-22
21,Kentucky,13,Georgia,45,Carroll County,8,11,-3
21,Kentucky,13,Georgia,47,Catoosa County,22,0,22
21,Kentucky,13,Georgia,51,Chatham County,164,140,24
21,Kentucky,13,Georgia,53,Chattahoochee County,68,14,54
21,Kentucky,13,Georgia,57,Cherokee County,18,38,-20
21,Kentucky,13,Georgia,59,Clarke County,38,25,13
21,Kentucky,13,Georgia,63,Clayton County,6,64,-58
21,Kentucky,13,Georgia,67,Cobb County,357,339,18
21,Kentucky,13,Georgia,71,Colquitt County,0,18,-18
21,Kentucky,13,Georgia,73,Columbia County,72,34,38
21,Kentucky,13,Georgia,75,Cook County,4,0,4
21,Kentucky,13,Georgia,77,Coweta County,310,0,310
21,Kentucky,13,Georgia,83,Dade County,0,15,-15
21,Kentucky,13,Georgia,87,Decatur County,9,0,9
21,Kentucky,13,Georgia,89,DeKalb County,317,236,81
21,Kentucky,13,Georgia,91,Dodge County,0,18,-18
21,Kentucky,13,Georgia,95,Dougherty County,45,0,45
21,Kentucky,13,Georgia,97,Douglas County,9,13,-4
21,Kentucky,13,Georgia,103,Effingham County,44,61,-17
21,Kentucky,13,Georgia,105,Elbert County,15,0,15
21,Kentucky,13,Georgia,109,Evans County,11,16,-5
21,Kentucky,13,Georgia,111,Fannin County,12,0,12
21,Kentucky,13,Georgia,113,Fayette County,0,34,-34
21,Kentucky,13,Georgia,115,Floyd County,23,174,-151
21,Kentucky,13,Georgia,117,Forsyth County,90,60,30
21,Kentucky,13,Georgia,119,Franklin County,0,8,-8
21,Kentucky,13,Georgia,121,Fulton County,453,550,-97
21,Kentucky,13,Georgia,127,Glynn County,0,20,-20
21,Kentucky,13,Georgia,129,Gordon County,20,0,20
21,Kentucky,13,Georgia,131,Grady County,19,0,19
21,Kentucky,13,Georgia,133,Greene County,12,0,12
21,Kentucky,13,Georgia,135,Gwinnett County,173,289,-116
21,Kentucky,13,Georgia,137,Habersham County,216,0,216
21,Kentucky,13,Georgia,139,Hall County,32,25,7
21,Kentucky,13,Georgia,145,Harris County,15,0,15
21,Kentucky,13,Georgia,151,Henry County,63,0,63
21,Kentucky,13,Georgia,153,Houston County,6,3,3
21,Kentucky,13,Georgia,157,Jackson County,126,0,126
21,Kentucky,13,Georgia,159,Jasper County,18,0,18
21,Kentucky,13,Georgia,171,Lamar County,0,5,-5
21,Kentucky,13,Georgia,173,Lanier County,6,0,6
21,Kentucky,13,Georgia,175,Laurens County,10,0,10
21,Kentucky,13,Georgia,177,Lee County,2,0,2
21,Kentucky,13,Georgia,179,Liberty County,384,256,128
21,Kentucky,13,Georgia,183,Long County,0,77,-77
21,Kentucky,13,Georgia,185,Lowndes County,140,25,115
21,Kentucky,13,Georgia,195,Madison County,0,46,-46
21,Kentucky,13,Georgia,199,Meriwether County,12,0,12
21,Kentucky,13,Georgia,207,Monroe County,15,0,15
21,Kentucky,13,Georgia,209,Montgomery County,0,21,-21
21,Kentucky,13,Georgia,211,Morgan County,3,35,-32
21,Kentucky,13,Georgia,215,Muscogee County,269,387,-118
21,Kentucky,13,Georgia,217,Newton County,9,0,9
21,Kentucky,13,Georgia,219,Oconee County,35,0,35
21,Kentucky,13,Georgia,223,Paulding County,96,0,96
21,Kentucky,13,Georgia,225,Peach County,0,19,-19
21,Kentucky,13,Georgia,227,Pickens County,0,41,-41
21,Kentucky,13,Georgia,235,Pulaski County,129,0,129
21,Kentucky,13,Georgia,245,Richmond County,78,89,-11
21,Kentucky,13,Georgia,247,Rockdale County,80,0,80
21,Kentucky,13,Georgia,255,Spalding County,6,0,6
21,Kentucky,13,Georgia,257,Stephens County,0,16,-16
21,Kentucky,13,Georgia,259,Stewart County,0,9,-9
21,Kentucky,13,Georgia,267,Tattnall County,0,12,-12
21,Kentucky,13,Georgia,281,Towns County,46,0,46
21,Kentucky,13,Georgia,283,Treutlen County,146,0,146
21,Kentucky,13,Georgia,285,Troup County,0,111,-111
21,Kentucky,13,Georgia,289,Twiggs County,0,17,-17
21,Kentucky,13,Georgia,291,Union County,21,0,21
21,Kentucky,13,Georgia,293,Upson County,0,7,-7
21,Kentucky,13,Georgia,295,Walker County,26,0,26
21,Kentucky,13,Georgia,305,Wayne County,31,24,7
21,Kentucky,13,Georgia,313,Whitfield County,154,0,154
21,Kentucky,13,Georgia,315,Wilcox County,0,1,-1
21,Kentucky,15,Hawaii,1,Hawaii County,39,33,6
21,Kentucky,15,Hawaii,3,Honolulu County,428,196,232
21,Kentucky,15,Hawaii,9,Maui County,0,40,-40
21,Kentucky,16,Idaho,1,Ada County,52,0,52
21,Kentucky,16,Idaho,5,Bannock County,0,153,-153
21,Kentucky,16,Idaho,11,Bingham County,2,0,2
21,Kentucky,16,Idaho,19,Bonneville County,0,44,-44
21,Kentucky,16,Idaho,27,Canyon County,41,71,-30
21,Kentucky,16,Idaho,39,Elmore County,0,5,-5
21,Kentucky,16,Idaho,41,Franklin County,17,0,17
21,Kentucky,16,Idaho,53,Jerome County,0,9,-9
21,Kentucky,16,Idaho,57,Latah County,51,9,42
21,Kentucky,16,Idaho,61,Lewis County,17,0,17
21,Kentucky,16,Idaho,71,Oneida County,0,50,-50
21,Kentucky,17,Illinois,3,Alexander County,135,3,132
21,Kentucky,17,Illinois,5,Bond County,0,10,-10
21,Kentucky,17,Illinois,7,Boone County,18,0,18
21,Kentucky,17,Illinois,11,Bureau County,11,0,11
21,Kentucky,17,Illinois,19,Champaign County,80,93,-13
21,Kentucky,17,Illinois,21,Christian County,17,11,6
21,Kentucky,17,Illinois,27,Clinton County,69,0,69
21,Kentucky,17,Illinois,29,Coles County,7,2,5
21,Kentucky,17,Illinois,31,Cook County,1465,425,1040
21,Kentucky,17,Illinois,33,Crawford County,12,0,12
21,Kentucky,17,Illinois,37,DeKalb County,43,21,22
21,Kentucky,17,Illinois,43,DuPage County,161,181,-20
21,Kentucky,17,Illinois,47,Edwards County,5,0,5
21,Kentucky,17,Illinois,49,Effingham County,0,14,-14
21,Kentucky,17,Illinois,53,Ford County,95,2,93
21,Kentucky,17,Illinois,55,Franklin County,44,59,-15
21,Kentucky,17,Illinois,59,Gallatin County,4,11,-7
21,Kentucky,17,Illinois,61,Greene County,2,0,2
21,Kentucky,17,Illinois,63,Grundy County,46,0,46
21,Kentucky,17,Illinois,69,Hardin County,0,3,-3
21,Kentucky,17,Illinois,75,Iroquois County,35,9,26
21,Kentucky,17,Illinois,77,Jackson County,15,237,-222
21,Kentucky,17,Illinois,81,Jefferson County,12,50,-38
21,Kentucky,17,Illinois,83,Jersey County,5,0,5
21,Kentucky,17,Illinois,87,Johnson County,7,8,-1
21,Kentucky,17,Illinois,89,Kane County,66,196,-130
21,Kentucky,17,Illinois,91,Kankakee County,16,0,16
21,Kentucky,17,Illinois,93,Kendall County,43,0,43
21,Kentucky,17,Illinois,97,Lake County,274,264,10
21,Kentucky,17,Illinois,99,LaSalle County,60,76,-16
21,Kentucky,17,Illinois,101,Lawrence County,0,72,-72
21,Kentucky,17,Illinois,105,Livingston County,70,46,24
21,Kentucky,17,Illinois,107,Logan County,0,1,-1
21,Kentucky,17,Illinois,109,McDonough County,0,1,-1
21,Kentucky,17,Illinois,111,McHenry County,174,95,79
21,Kentucky,17,Illinois,113,McLean County,23,79,-56
21,Kentucky,17,Illinois,115,Macon County,116,42,74
21,Kentucky,17,Illinois,117,Macoupin County,11,0,11
21,Kentucky,17,Illinois,119,Madison County,187,15,172
21,Kentucky,17,Illinois,121,Marion County,47,55,-8
21,Kentucky,17,Illinois,125,Mason County,43,27,16
21,Kentucky,17,Illinois,127,Massac County,533,89,444
21,Kentucky,17,Illinois,133,Monroe County,3,42,-39
21,Kentucky,17,Illinois,135,Montgomery County,0,34,-34
21,Kentucky,17,Illinois,137,Morgan County,15,0,15
21,Kentucky,17,Illinois,139,Moultrie County,0,3,-3
21,Kentucky,17,Illinois,141,Ogle County,5,31,-26
21,Kentucky,17,Illinois,143,Peoria County,192,20,172
21,Kentucky,17,Illinois,147,Piatt County,0,10,-10
21,Kentucky,17,Illinois,149,Pike County,2,0,2
21,Kentucky,17,Illinois,151,Pope County,123,36,87
21,Kentucky,17,Illinois,153,Pulaski County,0,47,-47
21,Kentucky,17,Illinois,157,Randolph County,7,0,7
21,Kentucky,17,Illinois,159,Richland County,31,0,31
21,Kentucky,17,Illinois,161,Rock Island County,1,53,-52
21,Kentucky,17,Illinois,163,St. Clair County,203,100,103
21,Kentucky,17,Illinois,165,Saline County,149,147,2
21,Kentucky,17,Illinois,167,Sangamon County,138,206,-68
21,Kentucky,17,Illinois,169,Schuyler County,0,17,-17
21,Kentucky,17,Illinois,173,Shelby County,0,8,-8
21,Kentucky,17,Illinois,179,Tazewell County,31,21,10
21,Kentucky,17,Illinois,183,Vermilion County,12,13,-1
21,Kentucky,17,Illinois,185,Wabash County,2,0,2
21,Kentucky,17,Illinois,187,Warren County,0,6,-6
21,Kentucky,17,Illinois,189,Washington County,43,0,43
21,Kentucky,17,Illinois,191,Wayne County,13,0,13
21,Kentucky,17,Illinois,193,White County,45,19,26
21,Kentucky,17,Illinois,195,Whiteside County,75,32,43
21,Kentucky,17,Illinois,197,Will County,91,58,33
21,Kentucky,17,Illinois,199,Williamson County,144,77,67
21,Kentucky,17,Illinois,201,Winnebago County,114,90,24
21,Kentucky,17,Illinois,203,Woodford County,27,9,18
21,Kentucky,18,Indiana,1,Adams County,0,36,-36
21,Kentucky,18,Indiana,3,Allen County,205,116,89
21,Kentucky,18,Indiana,5,Bartholomew County,169,57,112
21,Kentucky,18,Indiana,7,Benton County,17,0,17
21,Kentucky,18,Indiana,11,Boone County,24,18,6
21,Kentucky,18,Indiana,15,Carroll County,0,44,-44
21,Kentucky,18,Indiana,17,Cass County,52,4,48
21,Kentucky,18,Indiana,19,Clark County,1526,1496,30
21,Kentucky,18,Indiana,21,Clay County,7,0,7
21,Kentucky,18,Indiana,23,Clinton County,0,21,-21
21,Kentucky,18,Indiana,25,Crawford County,0,105,-105
21,Kentucky,18,Indiana,27,Daviess County,0,17,-17
21,Kentucky,18,Indiana,29,Dearborn County,302,236,66
21,Kentucky,18,Indiana,31,Decatur County,48,115,-67
21,Kentucky,18,Indiana,33,DeKalb County,9,26,-17
21,Kentucky,18,Indiana,35,Delaware County,213,84,129
21,Kentucky,18,Indiana,37,Dubois County,123,24,99
21,Kentucky,18,Indiana,39,Elkhart County,152,65,87
21,Kentucky,18,Indiana,41,Fayette County,0,9,-9
21,Kentucky,18,Indiana,43,Floyd County,1107,793,314
21,Kentucky,18,Indiana,45,Fountain County,31,5,26
21,Kentucky,18,Indiana,47,Franklin County,51,21,30
21,Kentucky,18,Indiana,49,Fulton County,3,0,3
21,Kentucky,18,Indiana,51,Gibson County,103,107,-4
21,Kentucky,18,Indiana,53,Grant County,14,33,-19
21,Kentucky,18,Indiana,55,Greene County,3,0,3
21,Kentucky,18,Indiana,57,Hamilton County,195,217,-22
21,Kentucky,18,Indiana,59,Hancock County,60,82,-22
21,Kentucky,18,Indiana,61,Harrison County,301,311,-10
21,Kentucky,18,Indiana,63,Hendricks County,184,164,20
21,Kentucky,18,Indiana,65,Henry County,75,28,47
21,Kentucky,18,Indiana,67,Howard County,105,58,47
21,Kentucky,18,Indiana,69,Huntington County,0,16,-16
21,Kentucky,18,Indiana,71,Jackson County,81,82,-1
21,Kentucky,18,Indiana,73,Jasper County,0,3,-3
21,Kentucky,18,Indiana,75,Jay County,0,75,-75
21,Kentucky,18,Indiana,77,Jefferson County,289,522,-233
21,Kentucky,18,Indiana,79,Jennings County,33,54,-21
21,Kentucky,18,Indiana,81,Johnson County,106,87,19
21,Kentucky,18,Indiana,83,Knox County,104,22,82
21,Kentucky,18,Indiana,85,Kosciusko County,8,22,-14
21,Kentucky,18,Indiana,87,LaGrange County,9,18,-9
21,Kentucky,18,Indiana,89,Lake County,79,82,-3
21,Kentucky,18,Indiana,91,LaPorte County,0,23,-23
21,Kentucky,18,Indiana,93,Lawrence County,31,54,-23
21,Kentucky,18,Indiana,95,Madison County,48,333,-285
21,Kentucky,18,Indiana,97,Marion County,1243,636,607
21,Kentucky,18,Indiana,99,Marshall County,0,12,-12
21,Kentucky,18,Indiana,101,Martin County,0,10,-10
21,Kentucky,18,Indiana,103,Miami County,57,25,32
21,Kentucky,18,Indiana,105,Monroe County,218,226,-8
21,Kentucky,18,Indiana,107,Montgomery County,39,67,-28
21,Kentucky,18,Indiana,109,Morgan County,0,36,-36
21,Kentucky,18,Indiana,113,Noble County,24,31,-7
21,Kentucky,18,Indiana,115,Ohio County,0,32,-32
21,Kentucky,18,Indiana,117,Orange County,87,13,74
21,Kentucky,18,Indiana,119,Owen County,24,109,-85
21,Kentucky,18,Indiana,121,Parke County,0,50,-50
21,Kentucky,18,Indiana,123,Perry County,157,268,-111
21,Kentucky,18,Indiana,125,Pike County,36,22,14
21,Kentucky,18,Indiana,127,Porter County,240,7,233
21,Kentucky,18,Indiana,129,Posey County,82,110,-28
21,Kentucky,18,Indiana,133,Putnam County,47,64,-17
21,Kentucky,18,Indiana,135,Randolph County,0,42,-42
21,Kentucky,18,Indiana,137,Ripley County,29,15,14
21,Kentucky,18,Indiana,139,Rush County,5,18,-13
21,Kentucky,18,Indiana,141,St. Joseph County,216,147,69
21,Kentucky,18,Indiana,143,Scott County,135,56,79
21,Kentucky,18,Indiana,145,Shelby County,31,23,8
21,Kentucky,18,Indiana,147,Spencer County,131,171,-40
21,Kentucky,18,Indiana,149,Starke County,36,41,-5
21,Kentucky,18,Indiana,151,Steuben County,30,91,-61
21,Kentucky,18,Indiana,155,Switzerland County,451,39,412
21,Kentucky,18,Indiana,157,Tippecanoe County,93,298,-205
21,Kentucky,18,Indiana,159,Tipton County,12,0,12
21,Kentucky,18,Indiana,161,Union County,0,28,-28
21,Kentucky,18,Indiana,163,Vanderburgh County,922,1027,-105
21,Kentucky,18,Indiana,165,Vermillion County,0,5,-5
21,Kentucky,18,Indiana,167,Vigo County,99,153,-54
21,Kentucky,18,Indiana,171,Warren County,38,23,15
21,Kentucky,18,Indiana,173,Warrick County,447,246,201
21,Kentucky,18,Indiana,175,Washington County,72,139,-67
21,Kentucky,18,Indiana,177,Wayne County,167,50,117
21,Kentucky,18,Indiana,179,Wells County,0,8,-8
21,Kentucky,18,Indiana,181,White County,2,0,2
21,Kentucky,18,Indiana,183,Whitley County,0,9,-9
21,Kentucky,19,Iowa,7,Appanoose County,17,0,17
21,Kentucky,19,Iowa,11,Benton County,43,0,43
21,Kentucky,19,Iowa,13,Black Hawk County,105,10,95
21,Kentucky,19,Iowa,19,Buchanan County,10,0,10
21,Kentucky,19,Iowa,33,Cerro Gordo County,0,8,-8
21,Kentucky,19,Iowa,45,Clinton County,10,46,-36
21,Kentucky,19,Iowa,49,Dallas County,15,25,-10
21,Kentucky,19,Iowa,59,Dickinson County,0,2,-2
21,Kentucky,19,Iowa,61,Dubuque County,0,17,-17
21,Kentucky,19,Iowa,67,Floyd County,100,11,89
21,Kentucky,19,Iowa,95,Iowa County,7,17,-10
21,Kentucky,19,Iowa,103,Johnson County,41,39,2
21,Kentucky,19,Iowa,109,Kossuth County,42,0,42
21,Kentucky,19,Iowa,111,Lee County,191,0,191
21,Kentucky,19,Iowa,113,Linn County,37,0,37
21,Kentucky,19,Iowa,125,Marion County,2,0,2
21,Kentucky,19,Iowa,127,Marshall County,0,3,-3
21,Kentucky,19,Iowa,131,Mitchell County,18,0,18
21,Kentucky,19,Iowa,139,Muscatine County,44,0,44
21,Kentucky,19,Iowa,151,Pocahontas County,5,0,5
21,Kentucky,19,Iowa,153,Polk County,61,158,-97
21,Kentucky,19,Iowa,155,Pottawattamie County,0,24,-24
21,Kentucky,19,Iowa,163,Scott County,48,28,20
21,Kentucky,19,Iowa,167,Sioux County,15,8,7
21,Kentucky,19,Iowa,169,Story County,90,2,88
21,Kentucky,19,Iowa,173,Taylor County,18,0,18
21,Kentucky,19,Iowa,175,Union County,0,9,-9
21,Kentucky,19,Iowa,179,Wapello County,17,6,11
21,Kentucky,19,Iowa,181,Warren County,23,0,23
21,Kentucky,19,Iowa,185,Wayne County,4,0,4
21,Kentucky,19,Iowa,191,Winneshiek County,4,0,4
21,Kentucky,19,Iowa,193,Woodbury County,0,49,-49
21,Kentucky,2,Alaska,20,Anchorage Municipality,389,233,156
21,Kentucky,2,Alaska,50,Bethel Census Area,6,0,6
21,Kentucky,2,Alaska,70,Dillingham Census Area,5,0,5
21,Kentucky,2,Alaska,90,Fairbanks North Star Borough,54,77,-23
21,Kentucky,2,Alaska,110,Juneau City and Borough,0,94,-94
21,Kentucky,2,Alaska,122,Kenai Peninsula Borough,0,46,-46
21,Kentucky,2,Alaska,170,Matanuska-Susitna Borough,117,103,14
21,Kentucky,2,Alaska,275,Wrangell City and Borough,16,0,16
21,Kentucky,20,Kansas,11,Bourbon County,0,5,-5
21,Kentucky,20,Kansas,13,Brown County,72,0,72
21,Kentucky,20,Kansas,15,Butler County,41,0,41
21,Kentucky,20,Kansas,23,Cheyenne County,0,4,-4
21,Kentucky,20,Kansas,35,Cowley County,67,0,67
21,Kentucky,20,Kansas,37,Crawford County,0,77,-77
21,Kentucky,20,Kansas,41,Dickinson County,0,14,-14
21,Kentucky,20,Kansas,45,Douglas County,2,0,2
21,Kentucky,20,Kansas,51,Ellis County,26,0,26
21,Kentucky,20,Kansas,61,Geary County,174,114,60
21,Kentucky,20,Kansas,69,Gray County,0,14,-14
21,Kentucky,20,Kansas,79,Harvey County,7,0,7
21,Kentucky,20,Kansas,91,Johnson County,83,114,-31
21,Kentucky,20,Kansas,103,Leavenworth County,257,119,138
21,Kentucky,20,Kansas,111,Lyon County,0,88,-88
21,Kentucky,20,Kansas,113,McPherson County,0,3,-3
21,Kentucky,20,Kansas,117,Marshall County,0,4,-4
21,Kentucky,20,Kansas,125,Montgomery County,1,6,-5
21,Kentucky,20,Kansas,127,Morris County,0,13,-13
21,Kentucky,20,Kansas,133,Neosho County,0,10,-10
21,Kentucky,20,Kansas,155,Reno County,45,0,45
21,Kentucky,20,Kansas,161,Riley County,31,74,-43
21,Kentucky,20,Kansas,169,Saline County,33,0,33
21,Kentucky,20,Kansas,173,Sedgwick County,109,0,109
21,Kentucky,20,Kansas,177,Shawnee County,114,239,-125
21,Kentucky,20,Kansas,189,Stevens County,16,0,16
21,Kentucky,20,Kansas,209,Wyandotte County,127,72,55
21,Kentucky,21,Kentucky,1,Adair County,1440,809,631
21,Kentucky,21,Kentucky,3,Allen County,885,708,177
21,Kentucky,21,Kentucky,5,Anderson County,1475,1352,123
21,Kentucky,21,Kentucky,7,Ballard County,240,275,-35
21,Kentucky,21,Kentucky,9,Barren County,2267,1773,494
21,Kentucky,21,Kentucky,11,Bath County,1363,620,743
21,Kentucky,21,Kentucky,13,Bell County,750,938,-188
21,Kentucky,21,Kentucky,15,Boone County,5501,5647,-146
21,Kentucky,21,Kentucky,17,Bourbon County,1447,953,494
21,Kentucky,21,Kentucky,19,Boyd County,1961,1825,136
21,Kentucky,21,Kentucky,21,Boyle County,1555,1770,-215
21,Kentucky,21,Kentucky,23,Bracken County,380,297,83
21,Kentucky,21,Kentucky,25,Breathitt County,444,414,30
21,Kentucky,21,Kentucky,27,Breckinridge County,1185,512,673
21,Kentucky,21,Kentucky,29,Bullitt County,4608,3718,890
21,Kentucky,21,Kentucky,31,Butler County,844,469,375
21,Kentucky,21,Kentucky,33,Caldwell County,477,343,134
21,Kentucky,21,Kentucky,35,Calloway County,996,1721,-725
21,Kentucky,21,Kentucky,37,Campbell County,3544,2946,598
21,Kentucky,21,Kentucky,39,Carlisle County,124,91,33
21,Kentucky,21,Kentucky,41,Carroll County,866,495,371
21,Kentucky,21,Kentucky,43,Carter County,982,1249,-267
21,Kentucky,21,Kentucky,45,Casey County,747,568,179
21,Kentucky,21,Kentucky,47,Christian County,1902,1900,2
21,Kentucky,21,Kentucky,49,Clark County,1608,1941,-333
21,Kentucky,21,Kentucky,51,Clay County,751,359,392
21,Kentucky,21,Kentucky,53,Clinton County,114,279,-165
21,Kentucky,21,Kentucky,55,Crittenden County,556,170,386
21,Kentucky,21,Kentucky,57,Cumberland County,117,223,-106
21,Kentucky,21,Kentucky,59,Daviess County,3327,2485,842
21,Kentucky,21,Kentucky,61,Edmonson County,605,582,23
21,Kentucky,21,Kentucky,63,Elliott County,488,687,-199
21,Kentucky,21,Kentucky,65,Estill County,585,728,-143
21,Kentucky,21,Kentucky,67,Fayette County,12430,14886,-2456
21,Kentucky,21,Kentucky,69,Fleming County,748,563,185
21,Kentucky,21,Kentucky,71,Floyd County,1497,1628,-131
21,Kentucky,21,Kentucky,73,Franklin County,1736,3117,-1381
21,Kentucky,21,Kentucky,75,Fulton County,138,369,-231
21,Kentucky,21,Kentucky,77,Gallatin County,467,454,13
21,Kentucky,21,Kentucky,79,Garrard County,937,774,163
21,Kentucky,21,Kentucky,81,Grant County,1595,1523,72
21,Kentucky,21,Kentucky,83,Graves County,578,827,-249
21,Kentucky,21,Kentucky,85,Grayson County,835,820,15
21,Kentucky,21,Kentucky,87,Green County,524,458,66
21,Kentucky,21,Kentucky,89,Greenup County,1418,1250,168
21,Kentucky,21,Kentucky,91,Hancock County,260,404,-144
21,Kentucky,21,Kentucky,93,Hardin County,5284,4921,363
21,Kentucky,21,Kentucky,95,Harlan County,772,569,203
21,Kentucky,21,Kentucky,97,Harrison County,659,862,-203
21,Kentucky,21,Kentucky,99,Hart County,931,605,326
21,Kentucky,21,Kentucky,101,Henderson County,1021,1435,-414
21,Kentucky,21,Kentucky,103,Henry County,783,1161,-378
21,Kentucky,21,Kentucky,105,Hickman County,126,143,-17
21,Kentucky,21,Kentucky,107,Hopkins County,1286,1738,-452
21,Kentucky,21,Kentucky,109,Jackson County,729,344,385
21,Kentucky,21,Kentucky,111,Jefferson County,15476,15260,216
21,Kentucky,21,Kentucky,113,Jessamine County,3121,3150,-29
21,Kentucky,21,Kentucky,115,Johnson County,828,808,20
21,Kentucky,21,Kentucky,117,Kenton County,7020,6247,773
21,Kentucky,21,Kentucky,119,Knott County,556,822,-266
21,Kentucky,21,Kentucky,121,Knox County,1326,1153,173
21,Kentucky,21,Kentucky,123,Larue County,818,786,32
21,Kentucky,21,Kentucky,125,Laurel County,2391,3103,-712
21,Kentucky,21,Kentucky,127,Lawrence County,580,205,375
21,Kentucky,21,Kentucky,129,Lee County,512,396,116
21,Kentucky,21,Kentucky,131,Leslie County,1154,230,924
21,Kentucky,21,Kentucky,133,Letcher County,866,240,626
21,Kentucky,21,Kentucky,135,Lewis County,383,363,20
21,Kentucky,21,Kentucky,137,Lincoln County,1038,1483,-445
21,Kentucky,21,Kentucky,139,Livingston County,476,180,296
21,Kentucky,21,Kentucky,141,Logan County,1146,788,358
21,Kentucky,21,Kentucky,143,Lyon County,637,773,-136
21,Kentucky,21,Kentucky,145,McCracken County,1624,1594,30
21,Kentucky,21,Kentucky,147,McCreary County,363,372,-9
21,Kentucky,21,Kentucky,149,McLean County,242,369,-127
21,Kentucky,21,Kentucky,151,Madison County,4842,6026,-1184
21,Kentucky,21,Kentucky,153,Magoffin County,868,409,459
21,Kentucky,21,Kentucky,155,Marion County,907,1034,-127
21,Kentucky,21,Kentucky,157,Marshall County,858,1047,-189
21,Kentucky,21,Kentucky,159,Martin County,478,464,14
21,Kentucky,21,Kentucky,161,Mason County,753,721,32
21,Kentucky,21,Kentucky,163,Meade County,1192,1826,-634
21,Kentucky,21,Kentucky,165,Menifee County,220,280,-60
21,Kentucky,21,Kentucky,167,Mercer County,949,1412,-463
21,Kentucky,21,Kentucky,169,Metcalfe County,376,375,1
21,Kentucky,21,Kentucky,171,Monroe County,276,411,-135
21,Kentucky,21,Kentucky,173,Montgomery County,1546,1762,-216
21,Kentucky,21,Kentucky,175,Morgan County,731,627,104
21,Kentucky,21,Kentucky,177,Muhlenberg County,1195,1004,191
21,Kentucky,21,Kentucky,179,Nelson County,1729,2019,-290
21,Kentucky,21,Kentucky,181,Nicholas County,359,281,78
21,Kentucky,21,Kentucky,183,Ohio County,678,1115,-437
21,Kentucky,21,Kentucky,185,Oldham County,3955,3933,22
21,Kentucky,21,Kentucky,187,Owen County,535,790,-255
21,Kentucky,21,Kentucky,189,Owsley County,223,181,42
21,Kentucky,21,Kentucky,191,Pendleton County,708,509,199
21,Kentucky,21,Kentucky,193,Perry County,1542,693,849
21,Kentucky,21,Kentucky,195,Pike County,1594,1756,-162
21,Kentucky,21,Kentucky,197,Powell County,608,561,47
21,Kentucky,21,Kentucky,199,Pulaski County,2385,1921,464
21,Kentucky,21,Kentucky,201,Robertson County,132,67,65
21,Kentucky,21,Kentucky,203,Rockcastle County,994,655,339
21,Kentucky,21,Kentucky,205,Rowan County,1931,2356,-425
21,Kentucky,21,Kentucky,207,Russell County,541,429,112
21,Kentucky,21,Kentucky,209,Scott County,2567,2318,249
21,Kentucky,21,Kentucky,211,Shelby County,2376,2297,79
21,Kentucky,21,Kentucky,213,Simpson County,747,608,139
21,Kentucky,21,Kentucky,215,Spencer County,887,1424,-537
21,Kentucky,21,Kentucky,217,Taylor County,1588,1402,186
21,Kentucky,21,Kentucky,219,Todd County,284,365,-81
21,Kentucky,21,Kentucky,221,Trigg County,499,760,-261
21,Kentucky,21,Kentucky,223,Trimble County,709,449,260
21,Kentucky,21,Kentucky,225,Union County,653,466,187
21,Kentucky,21,Kentucky,227,Warren County,3958,7321,-3363
21,Kentucky,21,Kentucky,229,Washington County,1109,634,475
21,Kentucky,21,Kentucky,231,Wayne County,660,427,233
21,Kentucky,21,Kentucky,233,Webster County,766,424,342
21,Kentucky,21,Kentucky,235,Whitley County,1413,1772,-359
21,Kentucky,21,Kentucky,237,Wolfe County,305,486,-181
21,Kentucky,21,Kentucky,239,Woodford County,1799,1033,766
21,Kentucky,22,Louisiana,1,Acadia Parish,7,1,6
21,Kentucky,22,Louisiana,5,Ascension Parish,0,79,-79
21,Kentucky,22,Louisiana,7,Assumption Parish,10,0,10
21,Kentucky,22,Louisiana,15,Bossier Parish,11,37,-26
21,Kentucky,22,Louisiana,17,Caddo Parish,9,87,-78
21,Kentucky,22,Louisiana,19,Calcasieu Parish,0,130,-130
21,Kentucky,22,Louisiana,23,Cameron Parish,12,0,12
21,Kentucky,22,Louisiana,33,East Baton Rouge Parish,57,22,35
21,Kentucky,22,Louisiana,41,Franklin Parish,0,1,-1
21,Kentucky,22,Louisiana,43,Grant Parish,27,21,6
21,Kentucky,22,Louisiana,51,Jefferson Parish,18,109,-91
21,Kentucky,22,Louisiana,55,Lafayette Parish,308,89,219
21,Kentucky,22,Louisiana,57,Lafourche Parish,0,74,-74
21,Kentucky,22,Louisiana,59,LaSalle Parish,0,6,-6
21,Kentucky,22,Louisiana,61,Lincoln Parish,0,3,-3
21,Kentucky,22,Louisiana,63,Livingston Parish,6,0,6
21,Kentucky,22,Louisiana,69,Natchitoches Parish,13,15,-2
21,Kentucky,22,Louisiana,71,Orleans Parish,75,75,0
21,Kentucky,22,Louisiana,73,Ouachita Parish,17,37,-20
21,Kentucky,22,Louisiana,87,St. Bernard Parish,0,19,-19
21,Kentucky,22,Louisiana,89,St. Charles Parish,0,9,-9
21,Kentucky,22,Louisiana,95,St. John the Baptist Parish,25,0,25
21,Kentucky,22,Louisiana,101,St. Mary Parish,64,1,63
21,Kentucky,22,Louisiana,103,St. Tammany Parish,0,14,-14
21,Kentucky,22,Louisiana,105,Tangipahoa Parish,31,36,-5
21,Kentucky,22,Louisiana,109,Terrebonne Parish,12,0,12
21,Kentucky,22,Louisiana,113,Vermilion Parish,0,1,-1
21,Kentucky,22,Louisiana,115,Vernon Parish,304,48,256
21,Kentucky,22,Louisiana,117,Washington Parish,0,7,-7
21,Kentucky,23,Maine,1,Androscoggin County,0,1,-1
21,Kentucky,23,Maine,3,Aroostook County,0,53,-53
21,Kentucky,23,Maine,5,Cumberland County,61,5,56
21,Kentucky,23,Maine,7,Franklin County,0,34,-34
21,Kentucky,23,Maine,9,Hancock County,6,22,-16
21,Kentucky,23,Maine,11,Kennebec County,53,1,52
21,Kentucky,23,Maine,13,Knox County,34,3,31
21,Kentucky,23,Maine,17,Oxford County,49,0,49
21,Kentucky,23,Maine,19,Penobscot County,0,5,-5
21,Kentucky,23,Maine,27,Waldo County,24,43,-19
21,Kentucky,23,Maine,29,Washington County,5,0,5
21,Kentucky,23,Maine,31,York County,58,132,-74
21,Kentucky,24,Maryland,1,Allegany County,0,39,-39
21,Kentucky,24,Maryland,3,Anne Arundel County,384,106,278
21,Kentucky,24,Maryland,5,Baltimore County,305,133,172
21,Kentucky,24,Maryland,9,Calvert County,30,0,30
21,Kentucky,24,Maryland,11,Caroline County,15,11,4
21,Kentucky,24,Maryland,13,Carroll County,40,0,40
21,Kentucky,24,Maryland,15,Cecil County,82,0,82
21,Kentucky,24,Maryland,17,Charles County,95,68,27
21,Kentucky,24,Maryland,19,Dorchester County,31,0,31
21,Kentucky,24,Maryland,21,Frederick County,109,49,60
21,Kentucky,24,Maryland,23,Garrett County,0,4,-4
21,Kentucky,24,Maryland,25,Harford County,68,176,-108
21,Kentucky,24,Maryland,27,Howard County,0,52,-52
21,Kentucky,24,Maryland,31,Montgomery County,245,117,128
21,Kentucky,24,Maryland,33,Prince George's County,126,22,104
21,Kentucky,24,Maryland,43,Washington County,16,0,16
21,Kentucky,24,Maryland,45,Wicomico County,38,21,17
21,Kentucky,24,Maryland,510,Baltimore city,96,7,89
21,Kentucky,25,Massachusetts,1,Barnstable County,42,91,-49
21,Kentucky,25,Massachusetts,3,Berkshire County,8,26,-18
21,Kentucky,25,Massachusetts,5,Bristol County,27,26,1
21,Kentucky,25,Massachusetts,9,Essex County,24,48,-24
21,Kentucky,25,Massachusetts,11,Franklin County,68,18,50
21,Kentucky,25,Massachusetts,13,Hampden County,9,38,-29
21,Kentucky,25,Massachusetts,15,Hampshire County,0,80,-80
21,Kentucky,25,Massachusetts,17,Middlesex County,97,153,-56
21,Kentucky,25,Massachusetts,19,Nantucket County,10,0,10
21,Kentucky,25,Massachusetts,21,Norfolk County,137,75,62
21,Kentucky,25,Massachusetts,23,Plymouth County,5,51,-46
21,Kentucky,25,Massachusetts,25,Suffolk County,101,61,40
21,Kentucky,25,Massachusetts,27,Worcester County,166,8,158
21,Kentucky,26,Michigan,5,Allegan County,17,0,17
21,Kentucky,26,Michigan,7,Alpena County,0,27,-27
21,Kentucky,26,Michigan,15,Barry County,20,5,15
21,Kentucky,26,Michigan,17,Bay County,53,30,23
21,Kentucky,26,Michigan,19,Benzie County,28,0,28
21,Kentucky,26,Michigan,21,Berrien County,80,99,-19
21,Kentucky,26,Michigan,23,Branch County,16,0,16
21,Kentucky,26,Michigan,25,Calhoun County,113,152,-39
21,Kentucky,26,Michigan,27,Cass County,34,32,2
21,Kentucky,26,Michigan,29,Charlevoix County,0,6,-6
21,Kentucky,26,Michigan,31,Cheboygan County,0,3,-3
21,Kentucky,26,Michigan,33,Chippewa County,31,5,26
21,Kentucky,26,Michigan,35,Clare County,4,0,4
21,Kentucky,26,Michigan,37,Clinton County,46,73,-27
21,Kentucky,26,Michigan,39,Crawford County,0,2,-2
21,Kentucky,26,Michigan,41,Delta County,0,1,-1
21,Kentucky,26,Michigan,45,Eaton County,107,12,95
21,Kentucky,26,Michigan,47,Emmet County,24,27,-3
21,Kentucky,26,Michigan,49,Genesee County,12,118,-106
21,Kentucky,26,Michigan,51,Gladwin County,0,11,-11
21,Kentucky,26,Michigan,55,Grand Traverse County,46,13,33
21,Kentucky,26,Michigan,57,Gratiot County,0,7,-7
21,Kentucky,26,Michigan,59,Hillsdale County,0,8,-8
21,Kentucky,26,Michigan,61,Houghton County,26,0,26
21,Kentucky,26,Michigan,63,Huron County,112,0,112
21,Kentucky,26,Michigan,65,Ingham County,216,71,145
21,Kentucky,26,Michigan,69,Iosco County,26,15,11
21,Kentucky,26,Michigan,71,Iron County,28,0,28
21,Kentucky,26,Michigan,73,Isabella County,20,0,20
21,Kentucky,26,Michigan,75,Jackson County,76,18,58
21,Kentucky,26,Michigan,77,Kalamazoo County,140,30,110
21,Kentucky,26,Michigan,79,Kalkaska County,14,0,14
21,Kentucky,26,Michigan,81,Kent County,104,287,-183
21,Kentucky,26,Michigan,85,Lake County,0,8,-8
21,Kentucky,26,Michigan,87,Lapeer County,18,0,18
21,Kentucky,26,Michigan,89,Leelanau County,0,14,-14
21,Kentucky,26,Michigan,91,Lenawee County,0,42,-42
21,Kentucky,26,Michigan,93,Livingston County,60,0,60
21,Kentucky,26,Michigan,99,Macomb County,125,305,-180
21,Kentucky,26,Michigan,101,Manistee County,21,3,18
21,Kentucky,26,Michigan,109,Menominee County,4,9,-5
21,Kentucky,26,Michigan,111,Midland County,8,4,4
21,Kentucky,26,Michigan,113,Missaukee County,0,11,-11
21,Kentucky,26,Michigan,115,Monroe County,56,45,11
21,Kentucky,26,Michigan,117,Montcalm County,0,46,-46
21,Kentucky,26,Michigan,119,Montmorency County,4,7,-3
21,Kentucky,26,Michigan,121,Muskegon County,0,29,-29
21,Kentucky,26,Michigan,123,Newaygo County,12,6,6
21,Kentucky,26,Michigan,125,Oakland County,245,491,-246
21,Kentucky,26,Michigan,133,Osceola County,0,30,-30
21,Kentucky,26,Michigan,137,Otsego County,0,4,-4
21,Kentucky,26,Michigan,139,Ottawa County,0,77,-77
21,Kentucky,26,Michigan,141,Presque Isle County,0,2,-2
21,Kentucky,26,Michigan,145,Saginaw County,9,19,-10
21,Kentucky,26,Michigan,147,St. Clair County,63,14,49
21,Kentucky,26,Michigan,149,St. Joseph County,15,4,11
21,Kentucky,26,Michigan,151,Sanilac County,19,0,19
21,Kentucky,26,Michigan,155,Shiawassee County,32,34,-2
21,Kentucky,26,Michigan,157,Tuscola County,9,0,9
21,Kentucky,26,Michigan,159,Van Buren County,13,6,7
21,Kentucky,26,Michigan,161,Washtenaw County,252,192,60
21,Kentucky,26,Michigan,163,Wayne County,513,325,188
21,Kentucky,26,Michigan,165,Wexford County,0,10,-10
21,Kentucky,27,Minnesota,3,Anoka County,3,40,-37
21,Kentucky,27,Minnesota,5,Becker County,18,2,16
21,Kentucky,27,Minnesota,17,Carlton County,0,16,-16
21,Kentucky,27,Minnesota,19,Carver County,14,0,14
21,Kentucky,27,Minnesota,23,Chippewa County,23,0,23
21,Kentucky,27,Minnesota,29,Clearwater County,0,16,-16
21,Kentucky,27,Minnesota,41,Douglas County,0,4,-4
21,Kentucky,27,Minnesota,53,Hennepin County,236,115,121
21,Kentucky,27,Minnesota,55,Houston County,0,4,-4
21,Kentucky,27,Minnesota,61,Itasca County,0,1,-1
21,Kentucky,27,Minnesota,65,Kanabec County,7,0,7
21,Kentucky,27,Minnesota,67,Kandiyohi County,34,0,34
21,Kentucky,27,Minnesota,75,Lake County,0,1,-1
21,Kentucky,27,Minnesota,99,Mower County,9,0,9
21,Kentucky,27,Minnesota,105,Nobles County,191,0,191
21,Kentucky,27,Minnesota,111,Otter Tail County,20,7,13
21,Kentucky,27,Minnesota,113,Pennington County,33,10,23
21,Kentucky,27,Minnesota,115,Pine County,0,4,-4
21,Kentucky,27,Minnesota,123,Ramsey County,89,66,23
21,Kentucky,27,Minnesota,137,St. Louis County,9,7,2
21,Kentucky,27,Minnesota,139,Scott County,0,10,-10
21,Kentucky,27,Minnesota,141,Sherburne County,0,4,-4
21,Kentucky,27,Minnesota,143,Sibley County,0,12,-12
21,Kentucky,27,Minnesota,157,Wabasha County,0,10,-10
21,Kentucky,27,Minnesota,161,Waseca County,2,0,2
21,Kentucky,27,Minnesota,169,Winona County,72,0,72
21,Kentucky,27,Minnesota,171,Wright County,0,8,-8
21,Kentucky,28,Mississippi,3,Alcorn County,1,64,-63
21,Kentucky,28,Mississippi,7,Attala County,0,6,-6
21,Kentucky,28,Mississippi,19,Choctaw County,14,0,14
21,Kentucky,28,Mississippi,21,Claiborne County,0,2,-2
21,Kentucky,28,Mississippi,25,Clay County,24,34,-10
21,Kentucky,28,Mississippi,27,Coahoma County,98,0,98
21,Kentucky,28,Mississippi,29,Copiah County,0,11,-11
21,Kentucky,28,Mississippi,33,DeSoto County,13,0,13
21,Kentucky,28,Mississippi,35,Forrest County,74,19,55
21,Kentucky,28,Mississippi,45,Hancock County,0,1,-1
21,Kentucky,28,Mississippi,47,Harrison County,152,86,66
21,Kentucky,28,Mississippi,49,Hinds County,27,5,22
21,Kentucky,28,Mississippi,51,Holmes County,4,0,4
21,Kentucky,28,Mississippi,55,Issaquena County,0,1,-1
21,Kentucky,28,Mississippi,59,Jackson County,118,11,107
21,Kentucky,28,Mississippi,67,Jones County,0,6,-6
21,Kentucky,28,Mississippi,71,Lafayette County,7,8,-1
21,Kentucky,28,Mississippi,73,Lamar County,0,53,-53
21,Kentucky,28,Mississippi,75,Lauderdale County,7,20,-13
21,Kentucky,28,Mississippi,81,Lee County,26,110,-84
21,Kentucky,28,Mississippi,83,Leflore County,0,9,-9
21,Kentucky,28,Mississippi,87,Lowndes County,14,83,-69
21,Kentucky,28,Mississippi,89,Madison County,84,11,73
21,Kentucky,28,Mississippi,91,Marion County,12,0,12
21,Kentucky,28,Mississippi,93,Marshall County,19,0,19
21,Kentucky,28,Mississippi,95,Monroe County,0,5,-5
21,Kentucky,28,Mississippi,99,Neshoba County,0,7,-7
21,Kentucky,28,Mississippi,101,Newton County,14,0,14
21,Kentucky,28,Mississippi,105,Oktibbeha County,40,52,-12
21,Kentucky,28,Mississippi,107,Panola County,7,0,7
21,Kentucky,28,Mississippi,117,Prentiss County,0,1,-1
21,Kentucky,28,Mississippi,121,Rankin County,53,146,-93
21,Kentucky,28,Mississippi,123,Scott County,17,0,17
21,Kentucky,28,Mississippi,127,Simpson County,0,14,-14
21,Kentucky,28,Mississippi,131,Stone County,0,4,-4
21,Kentucky,28,Mississippi,133,Sunflower County,0,15,-15
21,Kentucky,28,Mississippi,147,Walthall County,6,0,6
21,Kentucky,28,Mississippi,149,Warren County,36,7,29
21,Kentucky,28,Mississippi,151,Washington County,18,21,-3
21,Kentucky,28,Mississippi,159,Winston County,16,0,16
21,Kentucky,28,Mississippi,163,Yazoo County,0,20,-20
21,Kentucky,29,Missouri,7,Audrain County,0,83,-83
21,Kentucky,29,Missouri,9,Barry County,0,9,-9
21,Kentucky,29,Missouri,15,Benton County,10,0,10
21,Kentucky,29,Missouri,19,Boone County,29,47,-18
21,Kentucky,29,Missouri,21,Buchanan County,42,20,22
21,Kentucky,29,Missouri,23,Butler County,6,29,-23
21,Kentucky,29,Missouri,27,Callaway County,0,4,-4
21,Kentucky,29,Missouri,31,Cape Girardeau County,51,141,-90
21,Kentucky,29,Missouri,35,Carter County,0,21,-21
21,Kentucky,29,Missouri,37,Cass County,19,22,-3
21,Kentucky,29,Missouri,43,Christian County,0,10,-10
21,Kentucky,29,Missouri,47,Clay County,91,143,-52
21,Kentucky,29,Missouri,55,Crawford County,0,2,-2
21,Kentucky,29,Missouri,61,Daviess County,226,0,226
21,Kentucky,29,Missouri,65,Dent County,30,0,30
21,Kentucky,29,Missouri,67,Douglas County,11,0,11
21,Kentucky,29,Missouri,71,Franklin County,6,0,6
21,Kentucky,29,Missouri,77,Greene County,75,19,56
21,Kentucky,29,Missouri,81,Harrison County,10,0,10
21,Kentucky,29,Missouri,95,Jackson County,168,78,90
21,Kentucky,29,Missouri,97,Jasper County,46,89,-43
21,Kentucky,29,Missouri,99,Jefferson County,23,89,-66
21,Kentucky,29,Missouri,101,Johnson County,0,58,-58
21,Kentucky,29,Missouri,109,Lawrence County,0,18,-18
21,Kentucky,29,Missouri,119,McDonald County,0,51,-51
21,Kentucky,29,Missouri,123,Madison County,0,73,-73
21,Kentucky,29,Missouri,129,Mercer County,2,0,2
21,Kentucky,29,Missouri,141,Morgan County,38,0,38
21,Kentucky,29,Missouri,143,New Madrid County,0,5,-5
21,Kentucky,29,Missouri,145,Newton County,176,1,175
21,Kentucky,29,Missouri,157,Perry County,3,0,3
21,Kentucky,29,Missouri,161,Phelps County,0,17,-17
21,Kentucky,29,Missouri,165,Platte County,0,12,-12
21,Kentucky,29,Missouri,169,Pulaski County,243,185,58
21,Kentucky,29,Missouri,171,Putnam County,8,0,8
21,Kentucky,29,Missouri,175,Randolph County,0,3,-3
21,Kentucky,29,Missouri,183,St. Charles County,303,119,184
21,Kentucky,29,Missouri,186,Ste. Genevieve County,0,4,-4
21,Kentucky,29,Missouri,189,St. Louis County,236,253,-17
21,Kentucky,29,Missouri,201,Scott County,32,11,21
21,Kentucky,29,Missouri,207,Stoddard County,0,7,-7
21,Kentucky,29,Missouri,209,Stone County,0,7,-7
21,Kentucky,29,Missouri,213,Taney County,45,0,45
21,Kentucky,29,Missouri,225,Webster County,0,54,-54
21,Kentucky,29,Missouri,510,St. Louis city,188,182,6
21,Kentucky,30,Montana,13,Cascade County,0,4,-4
21,Kentucky,30,Montana,31,Gallatin County,12,0,12
21,Kentucky,30,Montana,35,Glacier County,0,17,-17
21,Kentucky,30,Montana,47,Lake County,0,9,-9
21,Kentucky,30,Montana,49,Lewis and Clark County,0,9,-9
21,Kentucky,30,Montana,57,Madison County,0,5,-5
21,Kentucky,30,Montana,93,Silver Bow County,25,24,1
21,Kentucky,30,Montana,97,Sweet Grass County,0,10,-10
21,Kentucky,30,Montana,107,Wheatland County,0,1,-1
21,Kentucky,30,Montana,111,Yellowstone County,0,18,-18
21,Kentucky,31,Nebraska,15,Boyd County,0,3,-3
21,Kentucky,31,Nebraska,19,Buffalo County,16,46,-30
21,Kentucky,31,Nebraska,25,Cass County,5,43,-38
21,Kentucky,31,Nebraska,29,Chase County,0,48,-48
21,Kentucky,31,Nebraska,35,Clay County,0,5,-5
21,Kentucky,31,Nebraska,39,Cuming County,28,0,28
21,Kentucky,31,Nebraska,41,Custer County,0,42,-42
21,Kentucky,31,Nebraska,45,Dawes County,9,0,9
21,Kentucky,31,Nebraska,55,Douglas County,315,115,200
21,Kentucky,31,Nebraska,79,Hall County,0,10,-10
21,Kentucky,31,Nebraska,87,Hitchcock County,0,2,-2
21,Kentucky,31,Nebraska,97,Johnson County,9,0,9
21,Kentucky,31,Nebraska,109,Lancaster County,75,34,41
21,Kentucky,31,Nebraska,111,Lincoln County,36,19,17
21,Kentucky,31,Nebraska,121,Merrick County,0,5,-5
21,Kentucky,31,Nebraska,125,Nance County,11,0,11
21,Kentucky,31,Nebraska,153,Sarpy County,0,25,-25
21,Kentucky,31,Nebraska,157,Scotts Bluff County,55,13,42
21,Kentucky,31,Nebraska,181,Webster County,0,7,-7
21,Kentucky,31,Nebraska,185,York County,10,0,10
21,Kentucky,32,Nevada,1,Churchill County,0,55,-55
21,Kentucky,32,Nevada,3,Clark County,395,510,-115
21,Kentucky,32,Nevada,7,Elko County,26,0,26
21,Kentucky,32,Nevada,11,Eureka County,8,0,8
21,Kentucky,32,Nevada,19,Lyon County,0,167,-167
21,Kentucky,32,Nevada,23,Nye County,6,23,-17
21,Kentucky,32,Nevada,31,Washoe County,32,134,-102
21,Kentucky,33,New Hampshire,1,Belknap County,14,6,8
21,Kentucky,33,New Hampshire,5,Cheshire County,3,0,3
21,Kentucky,33,New Hampshire,9,Grafton County,18,16,2
21,Kentucky,33,New Hampshire,11,Hillsborough County,140,56,84
21,Kentucky,33,New Hampshire,13,Merrimack County,127,115,12
21,Kentucky,33,New Hampshire,19,Sullivan County,30,14,16
21,Kentucky,34,New Jersey,1,Atlantic County,0,9,-9
21,Kentucky,34,New Jersey,3,Bergen County,83,0,83
21,Kentucky,34,New Jersey,5,Burlington County,30,143,-113
21,Kentucky,34,New Jersey,7,Camden County,25,0,25
21,Kentucky,34,New Jersey,11,Cumberland County,28,2,26
21,Kentucky,34,New Jersey,13,Essex County,24,20,4
21,Kentucky,34,New Jersey,15,Gloucester County,0,11,-11
21,Kentucky,34,New Jersey,17,Hudson County,26,0,26
21,Kentucky,34,New Jersey,19,Hunterdon County,11,0,11
21,Kentucky,34,New Jersey,21,Mercer County,6,12,-6
21,Kentucky,34,New Jersey,23,Middlesex County,13,48,-35
21,Kentucky,34,New Jersey,25,Monmouth County,3,38,-35
21,Kentucky,34,New Jersey,27,Morris County,110,6,104
21,Kentucky,34,New Jersey,29,Ocean County,18,7,11
21,Kentucky,34,New Jersey,31,Passaic County,81,0,81
21,Kentucky,34,New Jersey,35,Somerset County,16,16,0
21,Kentucky,34,New Jersey,37,Sussex County,34,0,34
21,Kentucky,34,New Jersey,39,Union County,0,87,-87
21,Kentucky,34,New Jersey,41,Warren County,0,11,-11
21,Kentucky,35,New Mexico,1,Bernalillo County,309,98,211
21,Kentucky,35,New Mexico,13,Doña Ana County,39,46,-7
21,Kentucky,35,New Mexico,15,Eddy County,21,0,21
21,Kentucky,35,New Mexico,17,Grant County,0,7,-7
21,Kentucky,35,New Mexico,25,Lea County,39,0,39
21,Kentucky,35,New Mexico,28,Los Alamos County,0,2,-2
21,Kentucky,35,New Mexico,31,McKinley County,0,25,-25
21,Kentucky,35,New Mexico,35,Otero County,0,32,-32
21,Kentucky,35,New Mexico,43,Sandoval County,0,1,-1
21,Kentucky,35,New Mexico,45,San Juan County,16,0,16
21,Kentucky,35,New Mexico,49,Santa Fe County,0,18,-18
21,Kentucky,35,New Mexico,61,Valencia County,190,28,162
21,Kentucky,36,New York,1,Albany County,0,60,-60
21,Kentucky,36,New York,3,Allegany County,5,0,5
21,Kentucky,36,New York,5,Bronx County,214,30,184
21,Kentucky,36,New York,7,Broome County,57,9,48
21,Kentucky,36,New York,9,Cattaraugus County,92,0,92
21,Kentucky,36,New York,11,Cayuga County,4,1,3
21,Kentucky,36,New York,13,Chautauqua County,56,46,10
21,Kentucky,36,New York,15,Chemung County,0,14,-14
21,Kentucky,36,New York,19,Clinton County,42,11,31
21,Kentucky,36,New York,23,Cortland County,0,16,-16
21,Kentucky,36,New York,27,Dutchess County,5,6,-1
21,Kentucky,36,New York,29,Erie County,29,122,-93
21,Kentucky,36,New York,37,Genesee County,13,0,13
21,Kentucky,36,New York,45,Jefferson County,402,96,306
21,Kentucky,36,New York,47,Kings County,510,75,435
21,Kentucky,36,New York,49,Lewis County,38,0,38
21,Kentucky,36,New York,51,Livingston County,7,0,7
21,Kentucky,36,New York,55,Monroe County,123,95,28
21,Kentucky,36,New York,57,Montgomery County,18,2,16
21,Kentucky,36,New York,59,Nassau County,74,8,66
21,Kentucky,36,New York,61,New York County,128,142,-14
21,Kentucky,36,New York,65,Oneida County,233,16,217
21,Kentucky,36,New York,67,Onondaga County,23,55,-32
21,Kentucky,36,New York,69,Ontario County,55,0,55
21,Kentucky,36,New York,71,Orange County,56,43,13
21,Kentucky,36,New York,73,Orleans County,30,0,30
21,Kentucky,36,New York,75,Oswego County,12,10,2
21,Kentucky,36,New York,79,Putnam County,9,0,9
21,Kentucky,36,New York,81,Queens County,174,30,144
21,Kentucky,36,New York,83,Rensselaer County,0,13,-13
21,Kentucky,36,New York,85,Richmond County,33,0,33
21,Kentucky,36,New York,87,Rockland County,6,0,6
21,Kentucky,36,New York,89,St. Lawrence County,0,15,-15
21,Kentucky,36,New York,91,Saratoga County,19,0,19
21,Kentucky,36,New York,93,Schenectady County,160,46,114
21,Kentucky,36,New York,99,Seneca County,0,3,-3
21,Kentucky,36,New York,101,Steuben County,12,0,12
21,Kentucky,36,New York,103,Suffolk County,255,31,224
21,Kentucky,36,New York,107,Tioga County,60,0,60
21,Kentucky,36,New York,109,Tompkins County,17,0,17
21,Kentucky,36,New York,111,Ulster County,10,0,10
21,Kentucky,36,New York,113,Warren County,0,5,-5
21,Kentucky,36,New York,115,Washington County,0,21,-21
21,Kentucky,36,New York,117,Wayne County,20,17,3
21,Kentucky,36,New York,119,Westchester County,36,84,-48
21,Kentucky,36,New York,123,Yates County,0,2,-2
21,Kentucky,37,North Carolina,1,Alamance County,0,28,-28
21,Kentucky,37,North Carolina,5,Alleghany County,0,11,-11
21,Kentucky,37,North Carolina,11,Avery County,27,0,27
21,Kentucky,37,North Carolina,13,Beaufort County,25,0,25
21,Kentucky,37,North Carolina,17,Bladen County,4,0,4
21,Kentucky,37,North Carolina,21,Buncombe County,96,74,22
21,Kentucky,37,North Carolina,23,Burke County,47,1,46
21,Kentucky,37,North Carolina,25,Cabarrus County,91,71,20
21,Kentucky,37,North Carolina,27,Caldwell County,17,0,17
21,Kentucky,37,North Carolina,31,Carteret County,10,4,6
21,Kentucky,37,North Carolina,33,Caswell County,0,10,-10
21,Kentucky,37,North Carolina,35,Catawba County,58,167,-109
21,Kentucky,37,North Carolina,45,Cleveland County,0,9,-9
21,Kentucky,37,North Carolina,47,Columbus County,17,0,17
21,Kentucky,37,North Carolina,49,Craven County,227,7,220
21,Kentucky,37,North Carolina,51,Cumberland County,555,331,224
21,Kentucky,37,North Carolina,53,Currituck County,0,24,-24
21,Kentucky,37,North Carolina,55,Dare County,0,84,-84
21,Kentucky,37,North Carolina,57,Davidson County,62,0,62
21,Kentucky,37,North Carolina,59,Davie County,34,0,34
21,Kentucky,37,North Carolina,61,Duplin County,11,8,3
21,Kentucky,37,North Carolina,63,Durham County,18,281,-263
21,Kentucky,37,North Carolina,67,Forsyth County,8,121,-113
21,Kentucky,37,North Carolina,69,Franklin County,27,12,15
21,Kentucky,37,North Carolina,71,Gaston County,0,45,-45
21,Kentucky,37,North Carolina,77,Granville County,7,15,-8
21,Kentucky,37,North Carolina,81,Guilford County,49,131,-82
21,Kentucky,37,North Carolina,83,Halifax County,0,7,-7
21,Kentucky,37,North Carolina,85,Harnett County,254,155,99
21,Kentucky,37,North Carolina,87,Haywood County,19,1,18
21,Kentucky,37,North Carolina,89,Henderson County,10,14,-4
21,Kentucky,37,North Carolina,91,Hertford County,0,43,-43
21,Kentucky,37,North Carolina,93,Hoke County,133,50,83
21,Kentucky,37,North Carolina,95,Hyde County,73,0,73
21,Kentucky,37,North Carolina,97,Iredell County,13,12,1
21,Kentucky,37,North Carolina,99,Jackson County,0,5,-5
21,Kentucky,37,North Carolina,101,Johnston County,10,0,10
21,Kentucky,37,North Carolina,105,Lee County,0,5,-5
21,Kentucky,37,North Carolina,107,Lenoir County,0,9,-9
21,Kentucky,37,North Carolina,109,Lincoln County,18,42,-24
21,Kentucky,37,North Carolina,111,McDowell County,48,2,46
21,Kentucky,37,North Carolina,113,Macon County,0,2,-2
21,Kentucky,37,North Carolina,119,Mecklenburg County,365,529,-164
21,Kentucky,37,North Carolina,123,Montgomery County,0,89,-89
21,Kentucky,37,North Carolina,125,Moore County,47,14,33
21,Kentucky,37,North Carolina,127,Nash County,11,29,-18
21,Kentucky,37,North Carolina,129,New Hanover County,66,21,45
21,Kentucky,37,North Carolina,133,Onslow County,152,251,-99
21,Kentucky,37,North Carolina,135,Orange County,65,27,38
21,Kentucky,37,North Carolina,137,Pamlico County,0,5,-5
21,Kentucky,37,North Carolina,139,Pasquotank County,0,64,-64
21,Kentucky,37,North Carolina,143,Perquimans County,21,0,21
21,Kentucky,37,North Carolina,147,Pitt County,32,22,10
21,Kentucky,37,North Carolina,149,Polk County,0,1,-1
21,Kentucky,37,North Carolina,151,Randolph County,11,2,9
21,Kentucky,37,North Carolina,153,Richmond County,0,16,-16
21,Kentucky,37,North Carolina,155,Robeson County,4,14,-10
21,Kentucky,37,North Carolina,161,Rutherford County,6,0,6
21,Kentucky,37,North Carolina,163,Sampson County,3,0,3
21,Kentucky,37,North Carolina,173,Swain County,26,0,26
21,Kentucky,37,North Carolina,175,Transylvania County,8,0,8
21,Kentucky,37,North Carolina,179,Union County,71,97,-26
21,Kentucky,37,North Carolina,183,Wake County,307,172,135
21,Kentucky,37,North Carolina,189,Watauga County,0,3,-3
21,Kentucky,37,North Carolina,191,Wayne County,9,32,-23
21,Kentucky,37,North Carolina,195,Wilson County,61,0,61
21,Kentucky,37,North Carolina,199,Yancey County,0,23,-23
21,Kentucky,38,North Dakota,15,Burleigh County,0,45,-45
21,Kentucky,38,North Dakota,17,Cass County,44,25,19
21,Kentucky,38,North Dakota,19,Cavalier County,0,8,-8
21,Kentucky,38,North Dakota,23,Divide County,9,0,9
21,Kentucky,38,North Dakota,35,Grand Forks County,0,23,-23
21,Kentucky,38,North Dakota,89,Stark County,0,4,-4
21,Kentucky,38,North Dakota,95,Towner County,0,4,-4
21,Kentucky,38,North Dakota,101,Ward County,3,5,-2
21,Kentucky,39,Ohio,1,Adams County,204,60,144
21,Kentucky,39,Ohio,3,Allen County,19,31,-12
21,Kentucky,39,Ohio,5,Ashland County,10,0,10
21,Kentucky,39,Ohio,7,Ashtabula County,12,20,-8
21,Kentucky,39,Ohio,9,Athens County,31,126,-95
21,Kentucky,39,Ohio,11,Auglaize County,3,26,-23
21,Kentucky,39,Ohio,13,Belmont County,15,16,-1
21,Kentucky,39,Ohio,15,Brown County,160,54,106
21,Kentucky,39,Ohio,17,Butler County,783,981,-198
21,Kentucky,39,Ohio,19,Carroll County,0,16,-16
21,Kentucky,39,Ohio,21,Champaign County,0,3,-3
21,Kentucky,39,Ohio,23,Clark County,85,71,14
21,Kentucky,39,Ohio,25,Clermont County,1204,902,302
21,Kentucky,39,Ohio,27,Clinton County,139,18,121
21,Kentucky,39,Ohio,29,Columbiana County,87,94,-7
21,Kentucky,39,Ohio,31,Coshocton County,9,0,9
21,Kentucky,39,Ohio,33,Crawford County,18,0,18
21,Kentucky,39,Ohio,35,Cuyahoga County,319,195,124
21,Kentucky,39,Ohio,37,Darke County,34,78,-44
21,Kentucky,39,Ohio,39,Defiance County,0,17,-17
21,Kentucky,39,Ohio,41,Delaware County,125,144,-19
21,Kentucky,39,Ohio,43,Erie County,74,268,-194
21,Kentucky,39,Ohio,45,Fairfield County,137,40,97
21,Kentucky,39,Ohio,47,Fayette County,8,0,8
21,Kentucky,39,Ohio,49,Franklin County,1065,944,121
21,Kentucky,39,Ohio,51,Fulton County,21,10,11
21,Kentucky,39,Ohio,53,Gallia County,0,165,-165
21,Kentucky,39,Ohio,55,Geauga County,39,6,33
21,Kentucky,39,Ohio,57,Greene County,269,160,109
21,Kentucky,39,Ohio,59,Guernsey County,10,6,4
21,Kentucky,39,Ohio,61,Hamilton County,6009,5332,677
21,Kentucky,39,Ohio,63,Hancock County,169,96,73
21,Kentucky,39,Ohio,65,Hardin County,57,11,46
21,Kentucky,39,Ohio,69,Henry County,0,21,-21
21,Kentucky,39,Ohio,71,Highland County,117,142,-25
21,Kentucky,39,Ohio,73,Hocking County,0,21,-21
21,Kentucky,39,Ohio,77,Huron County,5,22,-17
21,Kentucky,39,Ohio,79,Jackson County,24,182,-158
21,Kentucky,39,Ohio,81,Jefferson County,200,6,194
21,Kentucky,39,Ohio,83,Knox County,3,56,-53
21,Kentucky,39,Ohio,85,Lake County,8,15,-7
21,Kentucky,39,Ohio,87,Lawrence County,732,456,276
21,Kentucky,39,Ohio,89,Licking County,135,27,108
21,Kentucky,39,Ohio,91,Logan County,68,55,13
21,Kentucky,39,Ohio,93,Lorain County,107,79,28
21,Kentucky,39,Ohio,95,Lucas County,290,87,203
21,Kentucky,39,Ohio,97,Madison County,77,51,26
21,Kentucky,39,Ohio,99,Mahoning County,17,10,7
21,Kentucky,39,Ohio,101,Marion County,48,31,17
21,Kentucky,39,Ohio,103,Medina County,25,27,-2
21,Kentucky,39,Ohio,105,Meigs County,6,0,6
21,Kentucky,39,Ohio,109,Miami County,15,167,-152
21,Kentucky,39,Ohio,113,Montgomery County,522,579,-57
21,Kentucky,39,Ohio,115,Morgan County,0,8,-8
21,Kentucky,39,Ohio,119,Muskingum County,0,11,-11
21,Kentucky,39,Ohio,121,Noble County,28,16,12
21,Kentucky,39,Ohio,123,Ottawa County,14,0,14
21,Kentucky,39,Ohio,125,Paulding County,14,8,6
21,Kentucky,39,Ohio,127,Perry County,42,24,18
21,Kentucky,39,Ohio,129,Pickaway County,81,63,18
21,Kentucky,39,Ohio,131,Pike County,8,67,-59
21,Kentucky,39,Ohio,133,Portage County,33,40,-7
21,Kentucky,39,Ohio,135,Preble County,45,58,-13
21,Kentucky,39,Ohio,137,Putnam County,224,2,222
21,Kentucky,39,Ohio,139,Richland County,54,73,-19
21,Kentucky,39,Ohio,141,Ross County,65,149,-84
21,Kentucky,39,Ohio,143,Sandusky County,55,13,42
21,Kentucky,39,Ohio,145,Scioto County,459,360,99
21,Kentucky,39,Ohio,147,Seneca County,0,19,-19
21,Kentucky,39,Ohio,149,Shelby County,9,82,-73
21,Kentucky,39,Ohio,151,Stark County,39,44,-5
21,Kentucky,39,Ohio,153,Summit County,100,97,3
21,Kentucky,39,Ohio,155,Trumbull County,9,46,-37
21,Kentucky,39,Ohio,159,Union County,14,26,-12
21,Kentucky,39,Ohio,163,Vinton County,0,35,-35
21,Kentucky,39,Ohio,165,Warren County,649,855,-206
21,Kentucky,39,Ohio,167,Washington County,41,15,26
21,Kentucky,39,Ohio,169,Wayne County,138,0,138
21,Kentucky,39,Ohio,171,Williams County,0,134,-134
21,Kentucky,39,Ohio,173,Wood County,86,235,-149
21,Kentucky,39,Ohio,175,Wyandot County,0,47,-47
21,Kentucky,4,Arizona,1,Apache County,0,7,-7
21,Kentucky,4,Arizona,3,Cochise County,52,121,-69
21,Kentucky,4,Arizona,5,Coconino County,5,3,2
21,Kentucky,4,Arizona,7,Gila County,0,29,-29
21,Kentucky,4,Arizona,13,Maricopa County,597,790,-193
21,Kentucky,4,Arizona,15,Mohave County,20,0,20
21,Kentucky,4,Arizona,17,Navajo County,27,0,27
21,Kentucky,4,Arizona,19,Pima County,210,663,-453
21,Kentucky,4,Arizona,21,Pinal County,64,37,27
21,Kentucky,4,Arizona,25,Yavapai County,38,71,-33
21,Kentucky,4,Arizona,27,Yuma County,0,50,-50
21,Kentucky,40,Oklahoma,3,Alfalfa County,0,4,-4
21,Kentucky,40,Oklahoma,9,Beckham County,5,0,5
21,Kentucky,40,Oklahoma,17,Canadian County,46,28,18
21,Kentucky,40,Oklahoma,21,Cherokee County,0,8,-8
21,Kentucky,40,Oklahoma,27,Cleveland County,55,34,21
21,Kentucky,40,Oklahoma,31,Comanche County,270,377,-107
21,Kentucky,40,Oklahoma,33,Cotton County,0,18,-18
21,Kentucky,40,Oklahoma,37,Creek County,0,18,-18
21,Kentucky,40,Oklahoma,39,Custer County,0,6,-6
21,Kentucky,40,Oklahoma,41,Delaware County,0,17,-17
21,Kentucky,40,Oklahoma,47,Garfield County,20,78,-58
21,Kentucky,40,Oklahoma,63,Hughes County,40,0,40
21,Kentucky,40,Oklahoma,69,Johnston County,24,0,24
21,Kentucky,40,Oklahoma,71,Kay County,19,2,17
21,Kentucky,40,Oklahoma,79,Le Flore County,0,24,-24
21,Kentucky,40,Oklahoma,81,Lincoln County,9,52,-43
21,Kentucky,40,Oklahoma,85,Love County,14,0,14
21,Kentucky,40,Oklahoma,87,McClain County,0,2,-2
21,Kentucky,40,Oklahoma,93,Major County,0,1,-1
21,Kentucky,40,Oklahoma,101,Muskogee County,0,74,-74
21,Kentucky,40,Oklahoma,109,Oklahoma County,170,198,-28
21,Kentucky,40,Oklahoma,115,Ottawa County,0,2,-2
21,Kentucky,40,Oklahoma,119,Payne County,0,12,-12
21,Kentucky,40,Oklahoma,121,Pittsburg County,0,20,-20
21,Kentucky,40,Oklahoma,131,Rogers County,0,8,-8
21,Kentucky,40,Oklahoma,139,Texas County,0,44,-44
21,Kentucky,40,Oklahoma,143,Tulsa County,80,206,-126
21,Kentucky,40,Oklahoma,147,Washington County,48,0,48
21,Kentucky,41,Oregon,1,Baker County,0,4,-4
21,Kentucky,41,Oregon,3,Benton County,10,25,-15
21,Kentucky,41,Oregon,5,Clackamas County,69,49,20
21,Kentucky,41,Oregon,19,Douglas County,0,36,-36
21,Kentucky,41,Oregon,29,Jackson County,58,0,58
21,Kentucky,41,Oregon,33,Josephine County,23,0,23
21,Kentucky,41,Oregon,35,Klamath County,56,0,56
21,Kentucky,41,Oregon,39,Lane County,33,64,-31
21,Kentucky,41,Oregon,41,Lincoln County,0,20,-20
21,Kentucky,41,Oregon,43,Linn County,13,0,13
21,Kentucky,41,Oregon,51,Multnomah County,123,62,61
21,Kentucky,41,Oregon,67,Washington County,81,90,-9
21,Kentucky,41,Oregon,71,Yamhill County,0,13,-13
21,Kentucky,42,Pennsylvania,1,Adams County,8,13,-5
21,Kentucky,42,Pennsylvania,3,Allegheny County,277,222,55
21,Kentucky,42,Pennsylvania,5,Armstrong County,0,5,-5
21,Kentucky,42,Pennsylvania,7,Beaver County,66,57,9
21,Kentucky,42,Pennsylvania,9,Bedford County,0,10,-10
21,Kentucky,42,Pennsylvania,11,Berks County,33,105,-72
21,Kentucky,42,Pennsylvania,13,Blair County,6,10,-4
21,Kentucky,42,Pennsylvania,15,Bradford County,23,0,23
21,Kentucky,42,Pennsylvania,17,Bucks County,65,52,13
21,Kentucky,42,Pennsylvania,19,Butler County,10,28,-18
21,Kentucky,42,Pennsylvania,21,Cambria County,42,43,-1
21,Kentucky,42,Pennsylvania,27,Centre County,46,44,2
21,Kentucky,42,Pennsylvania,29,Chester County,31,21,10
21,Kentucky,42,Pennsylvania,31,Clarion County,0,43,-43
21,Kentucky,42,Pennsylvania,35,Clinton County,21,0,21
21,Kentucky,42,Pennsylvania,37,Columbia County,0,5,-5
21,Kentucky,42,Pennsylvania,39,Crawford County,0,8,-8
21,Kentucky,42,Pennsylvania,41,Cumberland County,58,28,30
21,Kentucky,42,Pennsylvania,43,Dauphin County,0,61,-61
21,Kentucky,42,Pennsylvania,45,Delaware County,44,35,9
21,Kentucky,42,Pennsylvania,49,Erie County,58,72,-14
21,Kentucky,42,Pennsylvania,51,Fayette County,0,7,-7
21,Kentucky,42,Pennsylvania,55,Franklin County,10,44,-34
21,Kentucky,42,Pennsylvania,57,Fulton County,0,3,-3
21,Kentucky,42,Pennsylvania,59,Greene County,3,3,0
21,Kentucky,42,Pennsylvania,61,Huntingdon County,0,8,-8
21,Kentucky,42,Pennsylvania,63,Indiana County,6,0,6
21,Kentucky,42,Pennsylvania,67,Juniata County,12,0,12
21,Kentucky,42,Pennsylvania,69,Lackawanna County,137,77,60
21,Kentucky,42,Pennsylvania,71,Lancaster County,36,161,-125
21,Kentucky,42,Pennsylvania,73,Lawrence County,29,0,29
21,Kentucky,42,Pennsylvania,75,Lebanon County,75,0,75
21,Kentucky,42,Pennsylvania,77,Lehigh County,57,48,9
21,Kentucky,42,Pennsylvania,79,Luzerne County,15,0,15
21,Kentucky,42,Pennsylvania,81,Lycoming County,49,57,-8
21,Kentucky,42,Pennsylvania,85,Mercer County,0,48,-48
21,Kentucky,42,Pennsylvania,89,Monroe County,22,0,22
21,Kentucky,42,Pennsylvania,91,Montgomery County,34,95,-61
21,Kentucky,42,Pennsylvania,95,Northampton County,120,0,120
21,Kentucky,42,Pennsylvania,97,Northumberland County,87,0,87
21,Kentucky,42,Pennsylvania,99,Perry County,0,11,-11
21,Kentucky,42,Pennsylvania,101,Philadelphia County,131,59,72
21,Kentucky,42,Pennsylvania,105,Potter County,3,0,3
21,Kentucky,42,Pennsylvania,107,Schuylkill County,32,9,23
21,Kentucky,42,Pennsylvania,109,Snyder County,0,2,-2
21,Kentucky,42,Pennsylvania,111,Somerset County,37,2,35
21,Kentucky,42,Pennsylvania,113,Sullivan County,28,0,28
21,Kentucky,42,Pennsylvania,115,Susquehanna County,10,0,10
21,Kentucky,42,Pennsylvania,117,Tioga County,19,11,8
21,Kentucky,42,Pennsylvania,119,Union County,0,31,-31
21,Kentucky,42,Pennsylvania,121,Venango County,0,2,-2
21,Kentucky,42,Pennsylvania,125,Washington County,6,21,-15
21,Kentucky,42,Pennsylvania,127,Wayne County,0,20,-20
21,Kentucky,42,Pennsylvania,129,Westmoreland County,155,40,115
21,Kentucky,42,Pennsylvania,131,Wyoming County,2,0,2
21,Kentucky,42,Pennsylvania,133,York County,27,46,-19
21,Kentucky,44,Rhode Island,3,Kent County,0,38,-38
21,Kentucky,44,Rhode Island,5,Newport County,70,53,17
21,Kentucky,44,Rhode Island,7,Providence County,16,8,8
21,Kentucky,45,South Carolina,3,Aiken County,103,134,-31
21,Kentucky,45,South Carolina,7,Anderson County,14,39,-25
21,Kentucky,45,South Carolina,13,Beaufort County,142,62,80
21,Kentucky,45,South Carolina,15,Berkeley County,77,312,-235
21,Kentucky,45,South Carolina,19,Charleston County,29,290,-261
21,Kentucky,45,South Carolina,21,Cherokee County,0,2,-2
21,Kentucky,45,South Carolina,23,Chester County,5,0,5
21,Kentucky,45,South Carolina,29,Colleton County,0,76,-76
21,Kentucky,45,South Carolina,31,Darlington County,0,7,-7
21,Kentucky,45,South Carolina,35,Dorchester County,10,196,-186
21,Kentucky,45,South Carolina,37,Edgefield County,0,22,-22
21,Kentucky,45,South Carolina,41,Florence County,54,70,-16
21,Kentucky,45,South Carolina,43,Georgetown County,13,0,13
21,Kentucky,45,South Carolina,45,Greenville County,131,121,10
21,Kentucky,45,South Carolina,47,Greenwood County,9,0,9
21,Kentucky,45,South Carolina,49,Hampton County,0,27,-27
21,Kentucky,45,South Carolina,51,Horry County,202,208,-6
21,Kentucky,45,South Carolina,57,Lancaster County,0,83,-83
21,Kentucky,45,South Carolina,63,Lexington County,28,80,-52
21,Kentucky,45,South Carolina,69,Marlboro County,94,0,94
21,Kentucky,45,South Carolina,73,Oconee County,0,36,-36
21,Kentucky,45,South Carolina,77,Pickens County,19,153,-134
21,Kentucky,45,South Carolina,79,Richland County,32,345,-313
21,Kentucky,45,South Carolina,83,Spartanburg County,5,66,-61
21,Kentucky,45,South Carolina,85,Sumter County,161,134,27
21,Kentucky,45,South Carolina,89,Williamsburg County,14,0,14
21,Kentucky,45,South Carolina,91,York County,123,0,123
21,Kentucky,46,South Dakota,15,Brule County,14,0,14
21,Kentucky,46,South Dakota,29,Codington County,0,4,-4
21,Kentucky,46,South Dakota,35,Davison County,63,4,59
21,Kentucky,46,South Dakota,51,Grant County,0,11,-11
21,Kentucky,46,South Dakota,81,Lawrence County,9,0,9
21,Kentucky,46,South Dakota,93,Meade County,6,0,6
21,Kentucky,46,South Dakota,99,Minnehaha County,55,7,48
21,Kentucky,46,South Dakota,103,Pennington County,12,0,12
21,Kentucky,46,South Dakota,109,Roberts County,0,12,-12
21,Kentucky,46,South Dakota,135,Yankton County,18,13,5
21,Kentucky,47,Tennessee,1,Anderson County,40,90,-50
21,Kentucky,47,Tennessee,3,Bedford County,11,0,11
21,Kentucky,47,Tennessee,9,Blount County,53,12,41
21,Kentucky,47,Tennessee,11,Bradley County,0,136,-136
21,Kentucky,47,Tennessee,13,Campbell County,118,119,-1
21,Kentucky,47,Tennessee,15,Cannon County,3,16,-13
21,Kentucky,47,Tennessee,17,Carroll County,11,26,-15
21,Kentucky,47,Tennessee,19,Carter County,50,9,41
21,Kentucky,47,Tennessee,21,Cheatham County,119,4,115
21,Kentucky,47,Tennessee,23,Chester County,0,12,-12
21,Kentucky,47,Tennessee,25,Claiborne County,111,339,-228
21,Kentucky,47,Tennessee,27,Clay County,104,29,75
21,Kentucky,47,Tennessee,29,Cocke County,23,53,-30
21,Kentucky,47,Tennessee,31,Coffee County,44,19,25
21,Kentucky,47,Tennessee,35,Cumberland County,113,122,-9
21,Kentucky,47,Tennessee,37,Davidson County,1464,1537,-73
21,Kentucky,47,Tennessee,39,Decatur County,29,19,10
21,Kentucky,47,Tennessee,41,DeKalb County,62,0,62
21,Kentucky,47,Tennessee,43,Dickson County,32,32,0
21,Kentucky,47,Tennessee,45,Dyer County,89,0,89
21,Kentucky,47,Tennessee,47,Fayette County,17,0,17
21,Kentucky,47,Tennessee,49,Fentress County,4,46,-42
21,Kentucky,47,Tennessee,51,Franklin County,8,2,6
21,Kentucky,47,Tennessee,53,Gibson County,105,0,105
21,Kentucky,47,Tennessee,55,Giles County,3,0,3
21,Kentucky,47,Tennessee,57,Grainger County,26,210,-184
21,Kentucky,47,Tennessee,59,Greene County,32,36,-4
21,Kentucky,47,Tennessee,61,Grundy County,9,0,9
21,Kentucky,47,Tennessee,63,Hamblen County,69,20,49
21,Kentucky,47,Tennessee,65,Hamilton County,350,320,30
21,Kentucky,47,Tennessee,69,Hardeman County,4,0,4
21,Kentucky,47,Tennessee,71,Hardin County,0,9,-9
21,Kentucky,47,Tennessee,73,Hawkins County,52,36,16
21,Kentucky,47,Tennessee,75,Haywood County,126,0,126
21,Kentucky,47,Tennessee,77,Henderson County,0,6,-6
21,Kentucky,47,Tennessee,79,Henry County,211,148,63
21,Kentucky,47,Tennessee,83,Houston County,13,30,-17
21,Kentucky,47,Tennessee,85,Humphreys County,46,63,-17
21,Kentucky,47,Tennessee,89,Jefferson County,20,91,-71
21,Kentucky,47,Tennessee,91,Johnson County,30,1,29
21,Kentucky,47,Tennessee,93,Knox County,610,666,-56
21,Kentucky,47,Tennessee,95,Lake County,44,13,31
21,Kentucky,47,Tennessee,99,Lawrence County,85,10,75
21,Kentucky,47,Tennessee,103,Lincoln County,0,18,-18
21,Kentucky,47,Tennessee,105,Loudon County,21,66,-45
21,Kentucky,47,Tennessee,107,McMinn County,38,1,37
21,Kentucky,47,Tennessee,111,Macon County,154,183,-29
21,Kentucky,47,Tennessee,113,Madison County,63,10,53
21,Kentucky,47,Tennessee,117,Marshall County,0,16,-16
21,Kentucky,47,Tennessee,119,Maury County,163,36,127
21,Kentucky,47,Tennessee,125,Montgomery County,1971,3858,-1887
21,Kentucky,47,Tennessee,131,Obion County,185,275,-90
21,Kentucky,47,Tennessee,133,Overton County,15,62,-47
21,Kentucky,47,Tennessee,135,Perry County,53,21,32
21,Kentucky,47,Tennessee,137,Pickett County,68,114,-46
21,Kentucky,47,Tennessee,139,Polk County,12,6,6
21,Kentucky,47,Tennessee,141,Putnam County,133,219,-86
21,Kentucky,47,Tennessee,143,Rhea County,61,0,61
21,Kentucky,47,Tennessee,145,Roane County,60,66,-6
21,Kentucky,47,Tennessee,147,Robertson County,280,62,218
21,Kentucky,47,Tennessee,149,Rutherford County,432,82,350
21,Kentucky,47,Tennessee,151,Scott County,38,74,-36
21,Kentucky,47,Tennessee,153,Sequatchie County,16,0,16
21,Kentucky,47,Tennessee,155,Sevier County,106,64,42
21,Kentucky,47,Tennessee,157,Shelby County,834,634,200
21,Kentucky,47,Tennessee,159,Smith County,0,3,-3
21,Kentucky,47,Tennessee,161,Stewart County,307,108,199
21,Kentucky,47,Tennessee,163,Sullivan County,183,166,17
21,Kentucky,47,Tennessee,165,Sumner County,746,730,16
21,Kentucky,47,Tennessee,167,Tipton County,77,202,-125
21,Kentucky,47,Tennessee,169,Trousdale County,20,0,20
21,Kentucky,47,Tennessee,171,Unicoi County,19,0,19
21,Kentucky,47,Tennessee,173,Union County,0,127,-127
21,Kentucky,47,Tennessee,177,Warren County,14,0,14
21,Kentucky,47,Tennessee,179,Washington County,93,63,30
21,Kentucky,47,Tennessee,181,Wayne County,2,0,2
21,Kentucky,47,Tennessee,183,Weakley County,53,78,-25
21,Kentucky,47,Tennessee,185,White County,5,0,5
21,Kentucky,47,Tennessee,187,Williamson County,403,156,247
21,Kentucky,47,Tennessee,189,Wilson County,227,185,42
21,Kentucky,48,Texas,1,Anderson County,11,5,6
21,Kentucky,48,Texas,5,Angelina County,10,158,-148
21,Kentucky,48,Texas,13,Atascosa County,0,72,-72
21,Kentucky,48,Texas,21,Bastrop County,4,0,4
21,Kentucky,48,Texas,27,Bell County,473,213,260
21,Kentucky,48,Texas,29,Bexar County,564,1007,-443
21,Kentucky,48,Texas,37,Bowie County,37,15,22
21,Kentucky,48,Texas,41,Brazos County,10,28,-18
21,Kentucky,48,Texas,53,Burnet County,13,0,13
21,Kentucky,48,Texas,57,Calhoun County,0,64,-64
21,Kentucky,48,Texas,61,Cameron County,0,12,-12
21,Kentucky,48,Texas,67,Cass County,50,0,50
21,Kentucky,48,Texas,71,Chambers County,0,66,-66
21,Kentucky,48,Texas,83,Coleman County,0,25,-25
21,Kentucky,48,Texas,85,Collin County,195,329,-134
21,Kentucky,48,Texas,99,Coryell County,334,151,183
21,Kentucky,48,Texas,113,Dallas County,466,118,348
21,Kentucky,48,Texas,119,Delta County,49,0,49
21,Kentucky,48,Texas,121,Denton County,146,175,-29
21,Kentucky,48,Texas,141,El Paso County,343,243,100
21,Kentucky,48,Texas,143,Erath County,0,4,-4
21,Kentucky,48,Texas,147,Fannin County,20,19,1
21,Kentucky,48,Texas,151,Fisher County,52,0,52
21,Kentucky,48,Texas,157,Fort Bend County,49,13,36
21,Kentucky,48,Texas,165,Gaines County,0,37,-37
21,Kentucky,48,Texas,167,Galveston County,3,30,-27
21,Kentucky,48,Texas,169,Garza County,0,5,-5
21,Kentucky,48,Texas,177,Gonzales County,1,0,1
21,Kentucky,48,Texas,181,Grayson County,0,54,-54
21,Kentucky,48,Texas,183,Gregg County,42,29,13
21,Kentucky,48,Texas,187,Guadalupe County,30,92,-62
21,Kentucky,48,Texas,199,Hardin County,0,1,-1
21,Kentucky,48,Texas,201,Harris County,696,371,325
21,Kentucky,48,Texas,203,Harrison County,53,0,53
21,Kentucky,48,Texas,209,Hays County,22,109,-87
21,Kentucky,48,Texas,213,Henderson County,0,52,-52
21,Kentucky,48,Texas,215,Hidalgo County,42,32,10
21,Kentucky,48,Texas,217,Hill County,0,8,-8
21,Kentucky,48,Texas,221,Hood County,127,0,127
21,Kentucky,48,Texas,223,Hopkins County,44,0,44
21,Kentucky,48,Texas,227,Howard County,0,49,-49
21,Kentucky,48,Texas,231,Hunt County,0,6,-6
21,Kentucky,48,Texas,239,Jackson County,0,26,-26
21,Kentucky,48,Texas,241,Jasper County,0,119,-119
21,Kentucky,48,Texas,245,Jefferson County,2,157,-155
21,Kentucky,48,Texas,251,Johnson County,212,49,163
21,Kentucky,48,Texas,255,Karnes County,0,4,-4
21,Kentucky,48,Texas,257,Kaufman County,0,15,-15
21,Kentucky,48,Texas,259,Kendall County,11,0,11
21,Kentucky,48,Texas,265,Kerr County,0,10,-10
21,Kentucky,48,Texas,281,Lampasas County,0,11,-11
21,Kentucky,48,Texas,287,Lee County,0,1,-1
21,Kentucky,48,Texas,291,Liberty County,0,57,-57
21,Kentucky,48,Texas,303,Lubbock County,13,65,-52
21,Kentucky,48,Texas,309,McLennan County,0,180,-180
21,Kentucky,48,Texas,323,Maverick County,9,0,9
21,Kentucky,48,Texas,329,Midland County,16,72,-56
21,Kentucky,48,Texas,339,Montgomery County,79,0,79
21,Kentucky,48,Texas,347,Nacogdoches County,0,4,-4
21,Kentucky,48,Texas,355,Nueces County,155,51,104
21,Kentucky,48,Texas,361,Orange County,0,26,-26
21,Kentucky,48,Texas,367,Parker County,4,0,4
21,Kentucky,48,Texas,375,Potter County,0,105,-105
21,Kentucky,48,Texas,379,Rains County,25,0,25
21,Kentucky,48,Texas,381,Randall County,108,30,78
21,Kentucky,48,Texas,395,Robertson County,8,0,8
21,Kentucky,48,Texas,423,Smith County,9,0,9
21,Kentucky,48,Texas,439,Tarrant County,432,499,-67
21,Kentucky,48,Texas,441,Taylor County,86,55,31
21,Kentucky,48,Texas,451,Tom Green County,0,92,-92
21,Kentucky,48,Texas,453,Travis County,263,521,-258
21,Kentucky,48,Texas,455,Trinity County,0,45,-45
21,Kentucky,48,Texas,457,Tyler County,6,19,-13
21,Kentucky,48,Texas,459,Upshur County,0,3,-3
21,Kentucky,48,Texas,467,Van Zandt County,49,2,47
21,Kentucky,48,Texas,469,Victoria County,0,46,-46
21,Kentucky,48,Texas,471,Walker County,5,0,5
21,Kentucky,48,Texas,473,Waller County,0,12,-12
21,Kentucky,48,Texas,477,Washington County,0,25,-25
21,Kentucky,48,Texas,479,Webb County,8,0,8
21,Kentucky,48,Texas,485,Wichita County,131,0,131
21,Kentucky,48,Texas,487,Wilbarger County,0,3,-3
21,Kentucky,48,Texas,491,Williamson County,243,329,-86
21,Kentucky,48,Texas,497,Wise County,29,3,26
21,Kentucky,48,Texas,499,Wood County,8,0,8
21,Kentucky,48,Texas,507,Zavala County,0,148,-148
21,Kentucky,49,Utah,11,Davis County,0,16,-16
21,Kentucky,49,Utah,35,Salt Lake County,150,259,-109
21,Kentucky,49,Utah,37,San Juan County,8,0,8
21,Kentucky,49,Utah,49,Utah County,121,249,-128
21,Kentucky,49,Utah,53,Washington County,21,0,21
21,Kentucky,49,Utah,57,Weber County,125,0,125
21,Kentucky,5,Arkansas,1,Arkansas County,0,6,-6
21,Kentucky,5,Arkansas,5,Baxter County,21,0,21
21,Kentucky,5,Arkansas,7,Benton County,119,212,-93
21,Kentucky,5,Arkansas,9,Boone County,0,68,-68
21,Kentucky,5,Arkansas,15,Carroll County,0,2,-2
21,Kentucky,5,Arkansas,17,Chicot County,0,8,-8
21,Kentucky,5,Arkansas,19,Clark County,37,0,37
21,Kentucky,5,Arkansas,31,Craighead County,58,13,45
21,Kentucky,5,Arkansas,33,Crawford County,16,0,16
21,Kentucky,5,Arkansas,35,Crittenden County,45,0,45
21,Kentucky,5,Arkansas,43,Drew County,35,0,35
21,Kentucky,5,Arkansas,45,Faulkner County,0,46,-46
21,Kentucky,5,Arkansas,47,Franklin County,0,11,-11
21,Kentucky,5,Arkansas,51,Garland County,8,52,-44
21,Kentucky,5,Arkansas,53,Grant County,0,22,-22
21,Kentucky,5,Arkansas,55,Greene County,20,0,20
21,Kentucky,5,Arkansas,63,Independence County,14,7,7
21,Kentucky,5,Arkansas,69,Jefferson County,0,26,-26
21,Kentucky,5,Arkansas,71,Johnson County,30,0,30
21,Kentucky,5,Arkansas,73,Lafayette County,0,26,-26
21,Kentucky,5,Arkansas,75,Lawrence County,0,1,-1
21,Kentucky,5,Arkansas,81,Little River County,0,4,-4
21,Kentucky,5,Arkansas,85,Lonoke County,0,274,-274
21,Kentucky,5,Arkansas,111,Poinsett County,0,35,-35
21,Kentucky,5,Arkansas,119,Pulaski County,30,79,-49
21,Kentucky,5,Arkansas,121,Randolph County,0,11,-11
21,Kentucky,5,Arkansas,123,St. Francis County,8,36,-28
21,Kentucky,5,Arkansas,125,Saline County,0,14,-14
21,Kentucky,5,Arkansas,133,Sevier County,0,3,-3
21,Kentucky,5,Arkansas,139,Union County,0,17,-17
21,Kentucky,5,Arkansas,143,Washington County,55,23,32
21,Kentucky,5,Arkansas,145,White County,0,15,-15
21,Kentucky,50,Vermont,1,Addison County,0,6,-6
21,Kentucky,50,Vermont,3,Bennington County,10,3,7
21,Kentucky,50,Vermont,5,Caledonia County,6,0,6
21,Kentucky,50,Vermont,7,Chittenden County,22,36,-14
21,Kentucky,50,Vermont,9,Essex County,16,0,16
21,Kentucky,50,Vermont,17,Orange County,10,0,10
21,Kentucky,50,Vermont,19,Orleans County,19,22,-3
21,Kentucky,50,Vermont,21,Rutland County,21,21,0
21,Kentucky,50,Vermont,27,Windsor County,11,33,-22
21,Kentucky,51,Virginia,1,Accomack County,0,18,-18
21,Kentucky,51,Virginia,3,Albemarle County,86,69,17
21,Kentucky,51,Virginia,13,Arlington County,206,19,187
21,Kentucky,51,Virginia,15,Augusta County,1,0,1
21,Kentucky,51,Virginia,27,Buchanan County,237,165,72
21,Kentucky,51,Virginia,31,Campbell County,45,0,45
21,Kentucky,51,Virginia,36,Charles City County,0,7,-7
21,Kentucky,51,Virginia,41,Chesterfield County,122,135,-13
21,Kentucky,51,Virginia,47,Culpeper County,0,24,-24
21,Kentucky,51,Virginia,51,Dickenson County,32,12,20
21,Kentucky,51,Virginia,59,Fairfax County,202,336,-134
21,Kentucky,51,Virginia,61,Fauquier County,7,22,-15
21,Kentucky,51,Virginia,67,Franklin County,0,26,-26
21,Kentucky,51,Virginia,73,Gloucester County,13,0,13
21,Kentucky,51,Virginia,75,Goochland County,0,10,-10
21,Kentucky,51,Virginia,83,Halifax County,5,0,5
21,Kentucky,51,Virginia,85,Hanover County,26,40,-14
21,Kentucky,51,Virginia,87,Henrico County,59,101,-42
21,Kentucky,51,Virginia,89,Henry County,0,9,-9
21,Kentucky,51,Virginia,95,James City County,0,93,-93
21,Kentucky,51,Virginia,105,Lee County,230,55,175
21,Kentucky,51,Virginia,107,Loudoun County,2,0,2
21,Kentucky,51,Virginia,109,Louisa County,24,21,3
21,Kentucky,51,Virginia,121,Montgomery County,66,47,19
21,Kentucky,51,Virginia,127,New Kent County,0,16,-16
21,Kentucky,51,Virginia,131,Northampton County,0,19,-19
21,Kentucky,51,Virginia,137,Orange County,128,53,75
21,Kentucky,51,Virginia,147,Prince Edward County,29,0,29
21,Kentucky,51,Virginia,149,Prince George County,40,50,-10
21,Kentucky,51,Virginia,153,Prince William County,62,130,-68
21,Kentucky,51,Virginia,155,Pulaski County,13,0,13
21,Kentucky,51,Virginia,159,Richmond County,0,15,-15
21,Kentucky,51,Virginia,161,Roanoke County,55,0,55
21,Kentucky,51,Virginia,163,Rockbridge County,19,0,19
21,Kentucky,51,Virginia,165,Rockingham County,0,42,-42
21,Kentucky,51,Virginia,167,Russell County,28,62,-34
21,Kentucky,51,Virginia,169,Scott County,10,8,2
21,Kentucky,51,Virginia,171,Shenandoah County,0,14,-14
21,Kentucky,51,Virginia,177,Spotsylvania County,52,25,27
21,Kentucky,51,Virginia,179,Stafford County,57,130,-73
21,Kentucky,51,Virginia,183,Sussex County,0,21,-21
21,Kentucky,51,Virginia,185,Tazewell County,0,64,-64
21,Kentucky,51,Virginia,187,Warren County,3,0,3
21,Kentucky,51,Virginia,191,Washington County,32,29,3
21,Kentucky,51,Virginia,193,Westmoreland County,10,0,10
21,Kentucky,51,Virginia,195,Wise County,61,162,-101
21,Kentucky,51,Virginia,197,Wythe County,12,1,11
21,Kentucky,51,Virginia,199,York County,44,12,32
21,Kentucky,51,Virginia,510,Alexandria city,59,41,18
21,Kentucky,51,Virginia,520,Bristol city,28,99,-71
21,Kentucky,51,Virginia,530,Buena Vista city,0,10,-10
21,Kentucky,51,Virginia,540,Charlottesville city,0,20,-20
21,Kentucky,51,Virginia,550,Chesapeake city,17,78,-61
21,Kentucky,51,Virginia,600,Fairfax city,24,12,12
21,Kentucky,51,Virginia,630,Fredericksburg city,8,4,4
21,Kentucky,51,Virginia,650,Hampton city,32,102,-70
21,Kentucky,51,Virginia,660,Harrisonburg city,54,24,30
21,Kentucky,51,Virginia,670,Hopewell city,68,46,22
21,Kentucky,51,Virginia,680,Lynchburg city,19,15,4
21,Kentucky,51,Virginia,683,Manassas city,35,0,35
21,Kentucky,51,Virginia,685,Manassas Park city,35,0,35
21,Kentucky,51,Virginia,700,Newport News city,67,77,-10
21,Kentucky,51,Virginia,710,Norfolk city,10,181,-171
21,Kentucky,51,Virginia,720,Norton city,0,21,-21
21,Kentucky,51,Virginia,730,Petersburg city,5,15,-10
21,Kentucky,51,Virginia,740,Portsmouth city,50,4,46
21,Kentucky,51,Virginia,750,Radford city,28,0,28
21,Kentucky,51,Virginia,760,Richmond city,59,87,-28
21,Kentucky,51,Virginia,770,Roanoke city,0,89,-89
21,Kentucky,51,Virginia,775,Salem city,17,41,-24
21,Kentucky,51,Virginia,800,Suffolk city,0,5,-5
21,Kentucky,51,Virginia,810,Virginia Beach city,79,167,-88
21,Kentucky,51,Virginia,820,Waynesboro city,0,37,-37
21,Kentucky,51,Virginia,830,Williamsburg city,7,20,-13
21,Kentucky,51,Virginia,840,Winchester city,0,106,-106
21,Kentucky,53,Washington,5,Benton County,14,83,-69
21,Kentucky,53,Washington,9,Clallam County,0,14,-14
21,Kentucky,53,Washington,11,Clark County,72,76,-4
21,Kentucky,53,Washington,15,Cowlitz County,58,0,58
21,Kentucky,53,Washington,21,Franklin County,10,0,10
21,Kentucky,53,Washington,25,Grant County,150,0,150
21,Kentucky,53,Washington,29,Island County,0,17,-17
21,Kentucky,53,Washington,33,King County,328,261,67
21,Kentucky,53,Washington,35,Kitsap County,38,51,-13
21,Kentucky,53,Washington,39,Klickitat County,10,0,10
21,Kentucky,53,Washington,41,Lewis County,19,2,17
21,Kentucky,53,Washington,45,Mason County,12,0,12
21,Kentucky,53,Washington,47,Okanogan County,11,0,11
21,Kentucky,53,Washington,53,Pierce County,382,576,-194
21,Kentucky,53,Washington,57,Skagit County,3,21,-18
21,Kentucky,53,Washington,61,Snohomish County,121,84,37
21,Kentucky,53,Washington,63,Spokane County,51,41,10
21,Kentucky,53,Washington,65,Stevens County,0,37,-37
21,Kentucky,53,Washington,67,Thurston County,128,100,28
21,Kentucky,53,Washington,71,Walla Walla County,0,14,-14
21,Kentucky,53,Washington,73,Whatcom County,20,0,20
21,Kentucky,53,Washington,75,Whitman County,0,17,-17
21,Kentucky,54,West Virginia,1,Barbour County,0,23,-23
21,Kentucky,54,West Virginia,3,Berkeley County,39,0,39
21,Kentucky,54,West Virginia,5,Boone County,0,7,-7
21,Kentucky,54,West Virginia,7,Braxton County,0,29,-29
21,Kentucky,54,West Virginia,11,Cabell County,280,320,-40
21,Kentucky,54,West Virginia,15,Clay County,36,0,36
21,Kentucky,54,West Virginia,17,Doddridge County,0,62,-62
21,Kentucky,54,West Virginia,19,Fayette County,5,17,-12
21,Kentucky,54,West Virginia,21,Gilmer County,0,15,-15
21,Kentucky,54,West Virginia,23,Grant County,152,0,152
21,Kentucky,54,West Virginia,25,Greenbrier County,73,0,73
21,Kentucky,54,West Virginia,29,Hancock County,0,21,-21
21,Kentucky,54,West Virginia,33,Harrison County,10,0,10
21,Kentucky,54,West Virginia,39,Kanawha County,276,171,105
21,Kentucky,54,West Virginia,41,Lewis County,26,4,22
21,Kentucky,54,West Virginia,43,Lincoln County,9,0,9
21,Kentucky,54,West Virginia,45,Logan County,193,30,163
21,Kentucky,54,West Virginia,47,McDowell County,54,8,46
21,Kentucky,54,West Virginia,49,Marion County,6,20,-14
21,Kentucky,54,West Virginia,51,Marshall County,0,16,-16
21,Kentucky,54,West Virginia,53,Mason County,44,0,44
21,Kentucky,54,West Virginia,55,Mercer County,30,17,13
21,Kentucky,54,West Virginia,59,Mingo County,355,129,226
21,Kentucky,54,West Virginia,61,Monongalia County,38,103,-65
21,Kentucky,54,West Virginia,63,Monroe County,24,0,24
21,Kentucky,54,West Virginia,69,Ohio County,33,0,33
21,Kentucky,54,West Virginia,77,Preston County,9,18,-9
21,Kentucky,54,West Virginia,79,Putnam County,194,39,155
21,Kentucky,54,West Virginia,81,Raleigh County,144,80,64
21,Kentucky,54,West Virginia,83,Randolph County,40,8,32
21,Kentucky,54,West Virginia,87,Roane County,18,0,18
21,Kentucky,54,West Virginia,89,Summers County,7,11,-4
21,Kentucky,54,West Virginia,91,Taylor County,0,19,-19
21,Kentucky,54,West Virginia,95,Tyler County,4,0,4
21,Kentucky,54,West Virginia,99,Wayne County,332,298,34
21,Kentucky,54,West Virginia,107,Wood County,34,131,-97
21,Kentucky,55,Wisconsin,9,Brown County,27,21,6
21,Kentucky,55,Wisconsin,11,Buffalo County,0,3,-3
21,Kentucky,55,Wisconsin,15,Calumet County,23,16,7
21,Kentucky,55,Wisconsin,23,Crawford County,0,1,-1
21,Kentucky,55,Wisconsin,25,Dane County,196,80,116
21,Kentucky,55,Wisconsin,31,Douglas County,0,1,-1
21,Kentucky,55,Wisconsin,33,Dunn County,20,0,20
21,Kentucky,55,Wisconsin,35,Eau Claire County,20,49,-29
21,Kentucky,55,Wisconsin,43,Grant County,0,13,-13
21,Kentucky,55,Wisconsin,45,Green County,13,0,13
21,Kentucky,55,Wisconsin,49,Iowa County,0,5,-5
21,Kentucky,55,Wisconsin,53,Jackson County,0,5,-5
21,Kentucky,55,Wisconsin,55,Jefferson County,0,4,-4
21,Kentucky,55,Wisconsin,57,Juneau County,0,39,-39
21,Kentucky,55,Wisconsin,59,Kenosha County,65,32,33
21,Kentucky,55,Wisconsin,63,La Crosse County,67,0,67
21,Kentucky,55,Wisconsin,65,Lafayette County,48,0,48
21,Kentucky,55,Wisconsin,71,Manitowoc County,15,34,-19
21,Kentucky,55,Wisconsin,73,Marathon County,3,62,-59
21,Kentucky,55,Wisconsin,77,Marquette County,5,0,5
21,Kentucky,55,Wisconsin,79,Milwaukee County,129,92,37
21,Kentucky,55,Wisconsin,81,Monroe County,21,29,-8
21,Kentucky,55,Wisconsin,83,Oconto County,0,29,-29
21,Kentucky,55,Wisconsin,87,Outagamie County,14,51,-37
21,Kentucky,55,Wisconsin,89,Ozaukee County,30,29,1
21,Kentucky,55,Wisconsin,93,Pierce County,0,73,-73
21,Kentucky,55,Wisconsin,101,Racine County,0,110,-110
21,Kentucky,55,Wisconsin,105,Rock County,31,0,31
21,Kentucky,55,Wisconsin,111,Sauk County,0,6,-6
21,Kentucky,55,Wisconsin,113,Sawyer County,0,1,-1
21,Kentucky,55,Wisconsin,117,Sheboygan County,16,0,16
21,Kentucky,55,Wisconsin,119,Taylor County,0,2,-2
21,Kentucky,55,Wisconsin,123,Vernon County,0,3,-3
21,Kentucky,55,Wisconsin,125,Vilas County,7,0,7
21,Kentucky,55,Wisconsin,127,Walworth County,91,0,91
21,Kentucky,55,Wisconsin,131,Washington County,25,3,22
21,Kentucky,55,Wisconsin,133,Waukesha County,94,29,65
21,Kentucky,55,Wisconsin,135,Waupaca County,0,3,-3
21,Kentucky,55,Wisconsin,139,Winnebago County,79,24,55
21,Kentucky,55,Wisconsin,141,Wood County,0,33,-33
21,Kentucky,56,Wyoming,5,Campbell County,17,0,17
21,Kentucky,56,Wyoming,21,Laramie County,81,0,81
21,Kentucky,56,Wyoming,25,Natrona County,0,86,-86
21,Kentucky,56,Wyoming,29,Park County,81,52,29
21,Kentucky,56,Wyoming,39,Teton County,68,6,62
21,Kentucky,56,Wyoming,45,Weston County,19,0,19
21,Kentucky,6,California,1,Alameda County,153,237,-84
21,Kentucky,6,California,5,Amador County,27,0,27
21,Kentucky,6,California,7,Butte County,54,0,54
21,Kentucky,6,California,9,Calaveras County,0,29,-29
21,Kentucky,6,California,13,Contra Costa County,74,251,-177
21,Kentucky,6,California,19,Fresno County,17,45,-28
21,Kentucky,6,California,23,Humboldt County,19,19,0
21,Kentucky,6,California,25,Imperial County,0,3,-3
21,Kentucky,6,California,29,Kern County,100,79,21
21,Kentucky,6,California,31,Kings County,31,0,31
21,Kentucky,6,California,35,Lassen County,0,9,-9
21,Kentucky,6,California,37,Los Angeles County,571,669,-98
21,Kentucky,6,California,41,Marin County,25,0,25
21,Kentucky,6,California,45,Mendocino County,0,102,-102
21,Kentucky,6,California,47,Merced County,183,18,165
21,Kentucky,6,California,51,Mono County,0,6,-6
21,Kentucky,6,California,53,Monterey County,14,52,-38
21,Kentucky,6,California,55,Napa County,0,30,-30
21,Kentucky,6,California,59,Orange County,364,217,147
21,Kentucky,6,California,61,Placer County,51,55,-4
21,Kentucky,6,California,65,Riverside County,152,62,90
21,Kentucky,6,California,67,Sacramento County,262,209,53
21,Kentucky,6,California,71,San Bernardino County,233,202,31
21,Kentucky,6,California,73,San Diego County,782,354,428
21,Kentucky,6,California,75,San Francisco County,249,65,184
21,Kentucky,6,California,77,San Joaquin County,71,61,10
21,Kentucky,6,California,79,San Luis Obispo County,232,124,108
21,Kentucky,6,California,81,San Mateo County,30,82,-52
21,Kentucky,6,California,83,Santa Barbara County,30,106,-76
21,Kentucky,6,California,85,Santa Clara County,78,123,-45
21,Kentucky,6,California,87,Santa Cruz County,38,9,29
21,Kentucky,6,California,89,Shasta County,16,73,-57
21,Kentucky,6,California,95,Solano County,72,43,29
21,Kentucky,6,California,97,Sonoma County,98,11,87
21,Kentucky,6,California,99,Stanislaus County,34,0,34
21,Kentucky,6,California,101,Sutter County,34,0,34
21,Kentucky,6,California,105,Trinity County,35,0,35
21,Kentucky,6,California,107,Tulare County,27,0,27
21,Kentucky,6,California,111,Ventura County,121,112,9
21,Kentucky,6,California,115,Yuba County,0,132,-132
21,Kentucky,72,Puerto Rico,1,Adjuntas Municipio,80,0,80
21,Kentucky,72,Puerto Rico,3,Aguada Municipio,73,0,73
21,Kentucky,72,Puerto Rico,21,Bayamón Municipio,93,13,80
21,Kentucky,72,Puerto Rico,25,Caguas Municipio,160,0,160
21,Kentucky,72,Puerto Rico,31,Carolina Municipio,0,11,-11
21,Kentucky,72,Puerto Rico,53,Fajardo Municipio,144,0,144
21,Kentucky,72,Puerto Rico,61,Guaynabo Municipio,24,0,24
21,Kentucky,72,Puerto Rico,73,Jayuya Municipio,98,0,98
21,Kentucky,72,Puerto Rico,91,Manatí Municipio,0,50,-50
21,Kentucky,72,Puerto Rico,103,Naguabo Municipio,75,0,75
21,Kentucky,72,Puerto Rico,113,Ponce Municipio,41,0,41
21,Kentucky,72,Puerto Rico,121,Sabana Grande Municipio,0,8,-8
21,Kentucky,72,Puerto Rico,127,San Juan Municipio,51,0,51
21,Kentucky,72,Puerto Rico,135,Toa Alta Municipio,26,4,22
21,Kentucky,72,Puerto Rico,141,Utuado Municipio,91,0,91
21,Kentucky,8,Colorado,1,Adams County,0,98,-98
21,Kentucky,8,Colorado,5,Arapahoe County,190,130,60
21,Kentucky,8,Colorado,13,Boulder County,45,196,-151
21,Kentucky,8,Colorado,14,Broomfield County,5,22,-17
21,Kentucky,8,Colorado,19,Clear Creek County,0,136,-136
21,Kentucky,8,Colorado,29,Delta County,0,20,-20
21,Kentucky,8,Colorado,31,Denver County,191,227,-36
21,Kentucky,8,Colorado,35,Douglas County,43,121,-78
21,Kentucky,8,Colorado,37,Eagle County,49,0,49
21,Kentucky,8,Colorado,39,Elbert County,0,31,-31
21,Kentucky,8,Colorado,41,El Paso County,335,359,-24
21,Kentucky,8,Colorado,43,Fremont County,166,0,166
21,Kentucky,8,Colorado,45,Garfield County,0,23,-23
21,Kentucky,8,Colorado,49,Grand County,2,0,2
21,Kentucky,8,Colorado,57,Jackson County,0,1,-1
21,Kentucky,8,Colorado,59,Jefferson County,82,100,-18
21,Kentucky,8,Colorado,61,Kiowa County,0,9,-9
21,Kentucky,8,Colorado,65,Lake County,22,0,22
21,Kentucky,8,Colorado,69,Larimer County,221,209,12
21,Kentucky,8,Colorado,77,Mesa County,0,18,-18
21,Kentucky,8,Colorado,83,Montezuma County,101,0,101
21,Kentucky,8,Colorado,87,Morgan County,0,8,-8
21,Kentucky,8,Colorado,97,Pitkin County,92,0,92
21,Kentucky,8,Colorado,101,Pueblo County,31,26,5
21,Kentucky,8,Colorado,107,Routt County,0,7,-7
21,Kentucky,8,Colorado,117,Summit County,10,0,10
21,Kentucky,8,Colorado,123,Weld County,29,17,12
21,Kentucky,9,Connecticut,1,Fairfield County,89,158,-69
21,Kentucky,9,Connecticut,3,Hartford County,89,8,81
21,Kentucky,9,Connecticut,5,Litchfield County,0,31,-31
21,Kentucky,9,Connecticut,7,Middlesex County,44,0,44
21,Kentucky,9,Connecticut,9,New Haven County,104,41,63
21,Kentucky,9,Connecticut,11,New London County,47,16,31
21,Kentucky,AFR,Africa,,-,1366,0,0
21,Kentucky,ASI,Asia,,-,8217,0,0
21,Kentucky,CAM,Central America,,-,2233,0,0
21,Kentucky,CAR,Caribbean,,-,866,0,0
21,Kentucky,EUR,Europe,,-,2095,0,0
21,Kentucky,NAM,Northern America,,-,597,0,0
21,Kentucky,OCE,Oceania and At Sea,,-,250,0,0
21,Kentucky,SAM,South America,,-,705,0,0
22,Louisiana,1,Alabama,1,Autauga County,57,0,57
22,Louisiana,1,Alabama,3,Baldwin County,448,111,337
22,Louisiana,1,Alabama,5,Barbour County,0,12,-12
22,Louisiana,1,Alabama,7,Bibb County,12,0,12
22,Louisiana,1,Alabama,9,Blount County,54,0,54
22,Louisiana,1,Alabama,15,Calhoun County,150,12,138
22,Louisiana,1,Alabama,23,Choctaw County,0,5,-5
22,Louisiana,1,Alabama,25,Clarke County,24,0,24
22,Louisiana,1,Alabama,31,Coffee County,71,36,35
22,Louisiana,1,Alabama,37,Coosa County,4,0,4
22,Louisiana,1,Alabama,39,Covington County,0,3,-3
22,Louisiana,1,Alabama,43,Cullman County,38,0,38
22,Louisiana,1,Alabama,45,Dale County,43,139,-96
22,Louisiana,1,Alabama,47,Dallas County,89,4,85
22,Louisiana,1,Alabama,49,DeKalb County,9,1,8
22,Louisiana,1,Alabama,51,Elmore County,112,20,92
22,Louisiana,1,Alabama,53,Escambia County,15,0,15
22,Louisiana,1,Alabama,55,Etowah County,6,6,0
22,Louisiana,1,Alabama,61,Geneva County,12,0,12
22,Louisiana,1,Alabama,65,Hale County,17,0,17
22,Louisiana,1,Alabama,67,Henry County,0,3,-3
22,Louisiana,1,Alabama,69,Houston County,35,31,4
22,Louisiana,1,Alabama,71,Jackson County,0,1,-1
22,Louisiana,1,Alabama,73,Jefferson County,270,327,-57
22,Louisiana,1,Alabama,77,Lauderdale County,49,0,49
22,Louisiana,1,Alabama,79,Lawrence County,0,12,-12
22,Louisiana,1,Alabama,81,Lee County,147,12,135
22,Louisiana,1,Alabama,83,Limestone County,44,0,44
22,Louisiana,1,Alabama,87,Macon County,0,5,-5
22,Louisiana,1,Alabama,89,Madison County,119,94,25
22,Louisiana,1,Alabama,95,Marshall County,58,43,15
22,Louisiana,1,Alabama,97,Mobile County,972,400,572
22,Louisiana,1,Alabama,101,Montgomery County,97,151,-54
22,Louisiana,1,Alabama,103,Morgan County,6,10,-4
22,Louisiana,1,Alabama,107,Pickens County,20,28,-8
22,Louisiana,1,Alabama,113,Russell County,89,0,89
22,Louisiana,1,Alabama,115,St. Clair County,31,0,31
22,Louisiana,1,Alabama,117,Shelby County,556,147,409
22,Louisiana,1,Alabama,121,Talladega County,96,8,88
22,Louisiana,1,Alabama,125,Tuscaloosa County,55,96,-41
22,Louisiana,1,Alabama,127,Walker County,0,21,-21
22,Louisiana,1,Alabama,131,Wilcox County,0,7,-7
22,Louisiana,10,Delaware,1,Kent County,12,17,-5
22,Louisiana,10,Delaware,3,New Castle County,89,21,68
22,Louisiana,10,Delaware,5,Sussex County,0,20,-20
22,Louisiana,11,District of Columbia,1,District of Columbia,214,529,-315
22,Louisiana,12,Florida,1,Alachua County,157,32,125
22,Louisiana,12,Florida,3,Baker County,0,10,-10
22,Louisiana,12,Florida,5,Bay County,145,145,0
22,Louisiana,12,Florida,9,Brevard County,110,116,-6
22,Louisiana,12,Florida,11,Broward County,419,484,-65
22,Louisiana,12,Florida,15,Charlotte County,0,13,-13
22,Louisiana,12,Florida,17,Citrus County,16,20,-4
22,Louisiana,12,Florida,19,Clay County,32,0,32
22,Louisiana,12,Florida,21,Collier County,233,0,233
22,Louisiana,12,Florida,23,Columbia County,23,31,-8
22,Louisiana,12,Florida,29,Dixie County,0,2,-2
22,Louisiana,12,Florida,31,Duval County,93,450,-357
22,Louisiana,12,Florida,33,Escambia County,554,635,-81
22,Louisiana,12,Florida,35,Flagler County,0,39,-39
22,Louisiana,12,Florida,39,Gadsden County,29,7,22
22,Louisiana,12,Florida,45,Gulf County,0,32,-32
22,Louisiana,12,Florida,51,Hendry County,0,46,-46
22,Louisiana,12,Florida,55,Highlands County,56,11,45
22,Louisiana,12,Florida,57,Hillsborough County,665,661,4
22,Louisiana,12,Florida,63,Jackson County,22,15,7
22,Louisiana,12,Florida,69,Lake County,61,0,61
22,Louisiana,12,Florida,71,Lee County,145,125,20
22,Louisiana,12,Florida,73,Leon County,91,91,0
22,Louisiana,12,Florida,75,Levy County,4,0,4
22,Louisiana,12,Florida,79,Madison County,5,0,5
22,Louisiana,12,Florida,81,Manatee County,73,325,-252
22,Louisiana,12,Florida,83,Marion County,249,0,249
22,Louisiana,12,Florida,85,Martin County,58,0,58
22,Louisiana,12,Florida,86,Miami-Dade County,592,134,458
22,Louisiana,12,Florida,87,Monroe County,124,0,124
22,Louisiana,12,Florida,89,Nassau County,32,20,12
22,Louisiana,12,Florida,91,Okaloosa County,233,90,143
22,Louisiana,12,Florida,95,Orange County,411,338,73
22,Louisiana,12,Florida,97,Osceola County,0,83,-83
22,Louisiana,12,Florida,99,Palm Beach County,172,282,-110
22,Louisiana,12,Florida,101,Pasco County,49,110,-61
22,Louisiana,12,Florida,103,Pinellas County,43,259,-216
22,Louisiana,12,Florida,105,Polk County,11,237,-226
22,Louisiana,12,Florida,107,Putnam County,0,69,-69
22,Louisiana,12,Florida,109,St. Johns County,80,19,61
22,Louisiana,12,Florida,111,St. Lucie County,9,137,-128
22,Louisiana,12,Florida,113,Santa Rosa County,186,349,-163
22,Louisiana,12,Florida,115,Sarasota County,77,107,-30
22,Louisiana,12,Florida,117,Seminole County,190,117,73
22,Louisiana,12,Florida,119,Sumter County,0,12,-12
22,Louisiana,12,Florida,121,Suwannee County,19,0,19
22,Louisiana,12,Florida,127,Volusia County,119,119,0
22,Louisiana,12,Florida,129,Wakulla County,7,0,7
22,Louisiana,12,Florida,131,Walton County,36,0,36
22,Louisiana,13,Georgia,3,Atkinson County,142,0,142
22,Louisiana,13,Georgia,13,Barrow County,11,0,11
22,Louisiana,13,Georgia,15,Bartow County,0,8,-8
22,Louisiana,13,Georgia,17,Ben Hill County,70,0,70
22,Louisiana,13,Georgia,21,Bibb County,0,7,-7
22,Louisiana,13,Georgia,27,Brooks County,12,0,12
22,Louisiana,13,Georgia,29,Bryan County,28,0,28
22,Louisiana,13,Georgia,31,Bulloch County,16,0,16
22,Louisiana,13,Georgia,33,Burke County,7,0,7
22,Louisiana,13,Georgia,37,Calhoun County,35,0,35
22,Louisiana,13,Georgia,39,Camden County,0,84,-84
22,Louisiana,13,Georgia,45,Carroll County,9,2,7
22,Louisiana,13,Georgia,47,Catoosa County,0,24,-24
22,Louisiana,13,Georgia,51,Chatham County,259,105,154
22,Louisiana,13,Georgia,53,Chattahoochee County,67,36,31
22,Louisiana,13,Georgia,57,Cherokee County,11,55,-44
22,Louisiana,13,Georgia,59,Clarke County,71,100,-29
22,Louisiana,13,Georgia,63,Clayton County,207,88,119
22,Louisiana,13,Georgia,67,Cobb County,406,572,-166
22,Louisiana,13,Georgia,69,Coffee County,64,7,57
22,Louisiana,13,Georgia,71,Colquitt County,25,0,25
22,Louisiana,13,Georgia,73,Columbia County,50,216,-166
22,Louisiana,13,Georgia,77,Coweta County,11,21,-10
22,Louisiana,13,Georgia,81,Crisp County,13,0,13
22,Louisiana,13,Georgia,83,Dade County,9,0,9
22,Louisiana,13,Georgia,85,Dawson County,0,10,-10
22,Louisiana,13,Georgia,89,DeKalb County,314,395,-81
22,Louisiana,13,Georgia,91,Dodge County,7,0,7
22,Louisiana,13,Georgia,95,Dougherty County,17,19,-2
22,Louisiana,13,Georgia,97,Douglas County,61,2,59
22,Louisiana,13,Georgia,103,Effingham County,133,0,133
22,Louisiana,13,Georgia,107,Emanuel County,0,28,-28
22,Louisiana,13,Georgia,113,Fayette County,30,0,30
22,Louisiana,13,Georgia,115,Floyd County,18,15,3
22,Louisiana,13,Georgia,117,Forsyth County,0,178,-178
22,Louisiana,13,Georgia,119,Franklin County,0,69,-69
22,Louisiana,13,Georgia,121,Fulton County,1061,713,348
22,Louisiana,13,Georgia,127,Glynn County,27,0,27
22,Louisiana,13,Georgia,129,Gordon County,0,1,-1
22,Louisiana,13,Georgia,135,Gwinnett County,355,345,10
22,Louisiana,13,Georgia,137,Habersham County,6,0,6
22,Louisiana,13,Georgia,139,Hall County,163,67,96
22,Louisiana,13,Georgia,145,Harris County,31,0,31
22,Louisiana,13,Georgia,151,Henry County,0,31,-31
22,Louisiana,13,Georgia,153,Houston County,105,0,105
22,Louisiana,13,Georgia,157,Jackson County,19,4,15
22,Louisiana,13,Georgia,159,Jasper County,42,0,42
22,Louisiana,13,Georgia,175,Laurens County,10,0,10
22,Louisiana,13,Georgia,177,Lee County,83,0,83
22,Louisiana,13,Georgia,179,Liberty County,30,249,-219
22,Louisiana,13,Georgia,185,Lowndes County,6,293,-287
22,Louisiana,13,Georgia,187,Lumpkin County,0,11,-11
22,Louisiana,13,Georgia,195,Madison County,0,2,-2
22,Louisiana,13,Georgia,197,Marion County,22,51,-29
22,Louisiana,13,Georgia,199,Meriwether County,19,4,15
22,Louisiana,13,Georgia,213,Murray County,0,6,-6
22,Louisiana,13,Georgia,215,Muscogee County,126,219,-93
22,Louisiana,13,Georgia,217,Newton County,22,124,-102
22,Louisiana,13,Georgia,219,Oconee County,0,16,-16
22,Louisiana,13,Georgia,221,Oglethorpe County,0,2,-2
22,Louisiana,13,Georgia,227,Pickens County,0,50,-50
22,Louisiana,13,Georgia,229,Pierce County,0,84,-84
22,Louisiana,13,Georgia,231,Pike County,20,0,20
22,Louisiana,13,Georgia,237,Putnam County,0,26,-26
22,Louisiana,13,Georgia,245,Richmond County,74,88,-14
22,Louisiana,13,Georgia,247,Rockdale County,0,20,-20
22,Louisiana,13,Georgia,253,Seminole County,0,6,-6
22,Louisiana,13,Georgia,255,Spalding County,7,0,7
22,Louisiana,13,Georgia,259,Stewart County,0,10,-10
22,Louisiana,13,Georgia,267,Tattnall County,0,11,-11
22,Louisiana,13,Georgia,275,Thomas County,0,193,-193
22,Louisiana,13,Georgia,279,Toombs County,0,183,-183
22,Louisiana,13,Georgia,285,Troup County,0,131,-131
22,Louisiana,13,Georgia,291,Union County,23,0,23
22,Louisiana,13,Georgia,295,Walker County,89,0,89
22,Louisiana,13,Georgia,305,Wayne County,0,18,-18
22,Louisiana,13,Georgia,311,White County,4,0,4
22,Louisiana,13,Georgia,321,Worth County,0,36,-36
22,Louisiana,15,Hawaii,1,Hawaii County,18,55,-37
22,Louisiana,15,Hawaii,3,Honolulu County,583,481,102
22,Louisiana,15,Hawaii,9,Maui County,46,0,46
22,Louisiana,16,Idaho,1,Ada County,74,28,46
22,Louisiana,16,Idaho,5,Bannock County,14,0,14
22,Louisiana,16,Idaho,7,Bear Lake County,0,11,-11
22,Louisiana,16,Idaho,19,Bonneville County,0,48,-48
22,Louisiana,16,Idaho,27,Canyon County,25,48,-23
22,Louisiana,16,Idaho,35,Clearwater County,0,20,-20
22,Louisiana,16,Idaho,51,Jefferson County,0,35,-35
22,Louisiana,16,Idaho,57,Latah County,0,16,-16
22,Louisiana,16,Idaho,73,Owyhee County,0,4,-4
22,Louisiana,16,Idaho,83,Twin Falls County,0,20,-20
22,Louisiana,17,Illinois,1,Adams County,42,10,32
22,Louisiana,17,Illinois,5,Bond County,0,5,-5
22,Louisiana,17,Illinois,11,Bureau County,0,8,-8
22,Louisiana,17,Illinois,15,Carroll County,0,62,-62
22,Louisiana,17,Illinois,19,Champaign County,32,65,-33
22,Louisiana,17,Illinois,27,Clinton County,0,3,-3
22,Louisiana,17,Illinois,31,Cook County,1223,568,655
22,Louisiana,17,Illinois,37,DeKalb County,4,59,-55
22,Louisiana,17,Illinois,43,DuPage County,93,73,20
22,Louisiana,17,Illinois,55,Franklin County,17,0,17
22,Louisiana,17,Illinois,57,Fulton County,0,2,-2
22,Louisiana,17,Illinois,73,Henry County,0,2,-2
22,Louisiana,17,Illinois,77,Jackson County,63,38,25
22,Louisiana,17,Illinois,79,Jasper County,74,0,74
22,Louisiana,17,Illinois,83,Jersey County,38,0,38
22,Louisiana,17,Illinois,89,Kane County,169,0,169
22,Louisiana,17,Illinois,93,Kendall County,0,55,-55
22,Louisiana,17,Illinois,97,Lake County,120,110,10
22,Louisiana,17,Illinois,109,McDonough County,15,0,15
22,Louisiana,17,Illinois,111,McHenry County,164,72,92
22,Louisiana,17,Illinois,113,McLean County,5,0,5
22,Louisiana,17,Illinois,115,Macon County,0,17,-17
22,Louisiana,17,Illinois,119,Madison County,0,36,-36
22,Louisiana,17,Illinois,121,Marion County,29,52,-23
22,Louisiana,17,Illinois,127,Massac County,0,30,-30
22,Louisiana,17,Illinois,137,Morgan County,0,24,-24
22,Louisiana,17,Illinois,143,Peoria County,58,14,44
22,Louisiana,17,Illinois,151,Pope County,0,8,-8
22,Louisiana,17,Illinois,161,Rock Island County,93,49,44
22,Louisiana,17,Illinois,163,St. Clair County,103,102,1
22,Louisiana,17,Illinois,165,Saline County,98,0,98
22,Louisiana,17,Illinois,167,Sangamon County,11,6,5
22,Louisiana,17,Illinois,179,Tazewell County,24,0,24
22,Louisiana,17,Illinois,187,Warren County,0,9,-9
22,Louisiana,17,Illinois,197,Will County,5,45,-40
22,Louisiana,17,Illinois,199,Williamson County,0,39,-39
22,Louisiana,17,Illinois,201,Winnebago County,91,51,40
22,Louisiana,18,Indiana,3,Allen County,1,0,1
22,Louisiana,18,Indiana,5,Bartholomew County,25,29,-4
22,Louisiana,18,Indiana,11,Boone County,9,0,9
22,Louisiana,18,Indiana,13,Brown County,0,9,-9
22,Louisiana,18,Indiana,19,Clark County,0,53,-53
22,Louisiana,18,Indiana,23,Clinton County,0,8,-8
22,Louisiana,18,Indiana,35,Delaware County,60,0,60
22,Louisiana,18,Indiana,43,Floyd County,18,15,3
22,Louisiana,18,Indiana,53,Grant County,5,0,5
22,Louisiana,18,Indiana,57,Hamilton County,29,15,14
22,Louisiana,18,Indiana,83,Knox County,0,29,-29
22,Louisiana,18,Indiana,85,Kosciusko County,0,32,-32
22,Louisiana,18,Indiana,89,Lake County,9,17,-8
22,Louisiana,18,Indiana,91,LaPorte County,16,18,-2
22,Louisiana,18,Indiana,95,Madison County,9,0,9
22,Louisiana,18,Indiana,97,Marion County,186,221,-35
22,Louisiana,18,Indiana,105,Monroe County,18,0,18
22,Louisiana,18,Indiana,121,Parke County,0,7,-7
22,Louisiana,18,Indiana,127,Porter County,0,30,-30
22,Louisiana,18,Indiana,129,Posey County,0,6,-6
22,Louisiana,18,Indiana,141,St. Joseph County,3,79,-76
22,Louisiana,18,Indiana,145,Shelby County,4,0,4
22,Louisiana,18,Indiana,151,Steuben County,0,22,-22
22,Louisiana,18,Indiana,157,Tippecanoe County,17,75,-58
22,Louisiana,18,Indiana,163,Vanderburgh County,14,26,-12
22,Louisiana,18,Indiana,167,Vigo County,37,35,2
22,Louisiana,18,Indiana,171,Warren County,0,1,-1
22,Louisiana,18,Indiana,173,Warrick County,0,49,-49
22,Louisiana,18,Indiana,177,Wayne County,0,55,-55
22,Louisiana,19,Iowa,13,Black Hawk County,0,16,-16
22,Louisiana,19,Iowa,17,Bremer County,0,11,-11
22,Louisiana,19,Iowa,33,Cerro Gordo County,0,7,-7
22,Louisiana,19,Iowa,41,Clay County,0,1,-1
22,Louisiana,19,Iowa,49,Dallas County,0,2,-2
22,Louisiana,19,Iowa,63,Emmet County,0,11,-11
22,Louisiana,19,Iowa,73,Greene County,0,34,-34
22,Louisiana,19,Iowa,83,Hardin County,0,2,-2
22,Louisiana,19,Iowa,87,Henry County,0,8,-8
22,Louisiana,19,Iowa,97,Jackson County,0,5,-5
22,Louisiana,19,Iowa,101,Jefferson County,0,5,-5
22,Louisiana,19,Iowa,103,Johnson County,225,21,204
22,Louisiana,19,Iowa,111,Lee County,0,15,-15
22,Louisiana,19,Iowa,113,Linn County,0,41,-41
22,Louisiana,19,Iowa,119,Lyon County,10,0,10
22,Louisiana,19,Iowa,123,Mahaska County,0,15,-15
22,Louisiana,19,Iowa,149,Plymouth County,0,6,-6
22,Louisiana,19,Iowa,153,Polk County,131,73,58
22,Louisiana,19,Iowa,155,Pottawattamie County,14,8,6
22,Louisiana,19,Iowa,157,Poweshiek County,0,22,-22
22,Louisiana,19,Iowa,163,Scott County,6,0,6
22,Louisiana,19,Iowa,169,Story County,59,31,28
22,Louisiana,19,Iowa,175,Union County,0,16,-16
22,Louisiana,19,Iowa,183,Washington County,0,9,-9
22,Louisiana,19,Iowa,187,Webster County,79,2,77
22,Louisiana,19,Iowa,193,Woodbury County,76,19,57
22,Louisiana,2,Alaska,16,Aleutians West Census Area,0,1,-1
22,Louisiana,2,Alaska,20,Anchorage Municipality,249,129,120
22,Louisiana,2,Alaska,90,Fairbanks North Star Borough,197,183,14
22,Louisiana,2,Alaska,105,Hoonah-Angoon Census Area,0,1,-1
22,Louisiana,2,Alaska,110,Juneau City and Borough,126,0,126
22,Louisiana,2,Alaska,122,Kenai Peninsula Borough,0,41,-41
22,Louisiana,2,Alaska,170,Matanuska-Susitna Borough,43,32,11
22,Louisiana,2,Alaska,180,Nome Census Area,0,8,-8
22,Louisiana,2,Alaska,185,North Slope Borough,18,4,14
22,Louisiana,2,Alaska,195,Petersburg Borough,0,2,-2
22,Louisiana,2,Alaska,198,Prince of Wales-Hyder Census Area,0,7,-7
22,Louisiana,2,Alaska,220,Sitka City and Borough,0,6,-6
22,Louisiana,2,Alaska,261,Valdez-Cordova Census Area,0,7,-7
22,Louisiana,20,Kansas,11,Bourbon County,0,4,-4
22,Louisiana,20,Kansas,15,Butler County,6,2,4
22,Louisiana,20,Kansas,19,Chautauqua County,0,9,-9
22,Louisiana,20,Kansas,27,Clay County,0,123,-123
22,Louisiana,20,Kansas,31,Coffey County,0,39,-39
22,Louisiana,20,Kansas,35,Cowley County,0,21,-21
22,Louisiana,20,Kansas,41,Dickinson County,17,0,17
22,Louisiana,20,Kansas,43,Doniphan County,0,15,-15
22,Louisiana,20,Kansas,45,Douglas County,11,0,11
22,Louisiana,20,Kansas,51,Ellis County,21,0,21
22,Louisiana,20,Kansas,55,Finney County,0,4,-4
22,Louisiana,20,Kansas,61,Geary County,170,58,112
22,Louisiana,20,Kansas,79,Harvey County,24,0,24
22,Louisiana,20,Kansas,85,Jackson County,0,4,-4
22,Louisiana,20,Kansas,91,Johnson County,186,68,118
22,Louisiana,20,Kansas,95,Kingman County,0,1,-1
22,Louisiana,20,Kansas,99,Labette County,0,1,-1
22,Louisiana,20,Kansas,103,Leavenworth County,27,135,-108
22,Louisiana,20,Kansas,105,Lincoln County,0,5,-5
22,Louisiana,20,Kansas,113,McPherson County,0,37,-37
22,Louisiana,20,Kansas,125,Montgomery County,0,75,-75
22,Louisiana,20,Kansas,155,Reno County,0,20,-20
22,Louisiana,20,Kansas,161,Riley County,66,30,36
22,Louisiana,20,Kansas,167,Russell County,0,1,-1
22,Louisiana,20,Kansas,169,Saline County,40,11,29
22,Louisiana,20,Kansas,173,Sedgwick County,73,70,3
22,Louisiana,20,Kansas,175,Seward County,0,41,-41
22,Louisiana,20,Kansas,177,Shawnee County,52,0,52
22,Louisiana,20,Kansas,191,Sumner County,8,0,8
22,Louisiana,20,Kansas,205,Wilson County,0,18,-18
22,Louisiana,20,Kansas,209,Wyandotte County,26,19,7
22,Louisiana,21,Kentucky,7,Ballard County,4,0,4
22,Louisiana,21,Kentucky,15,Boone County,0,22,-22
22,Louisiana,21,Kentucky,25,Breathitt County,58,0,58
22,Louisiana,21,Kentucky,29,Bullitt County,17,0,17
22,Louisiana,21,Kentucky,47,Christian County,22,164,-142
22,Louisiana,21,Kentucky,51,Clay County,0,12,-12
22,Louisiana,21,Kentucky,59,Daviess County,0,12,-12
22,Louisiana,21,Kentucky,67,Fayette County,40,33,7
22,Louisiana,21,Kentucky,71,Floyd County,31,0,31
22,Louisiana,21,Kentucky,73,Franklin County,0,21,-21
22,Louisiana,21,Kentucky,83,Graves County,29,0,29
22,Louisiana,21,Kentucky,93,Hardin County,0,57,-57
22,Louisiana,21,Kentucky,105,Hickman County,0,7,-7
22,Louisiana,21,Kentucky,111,Jefferson County,208,299,-91
22,Louisiana,21,Kentucky,117,Kenton County,219,0,219
22,Louisiana,21,Kentucky,123,Larue County,0,44,-44
22,Louisiana,21,Kentucky,133,Letcher County,5,0,5
22,Louisiana,21,Kentucky,145,McCracken County,3,0,3
22,Louisiana,21,Kentucky,151,Madison County,6,6,0
22,Louisiana,21,Kentucky,159,Martin County,21,0,21
22,Louisiana,21,Kentucky,163,Meade County,39,139,-100
22,Louisiana,21,Kentucky,179,Nelson County,129,0,129
22,Louisiana,21,Kentucky,183,Ohio County,15,0,15
22,Louisiana,21,Kentucky,185,Oldham County,28,0,28
22,Louisiana,21,Kentucky,197,Powell County,0,64,-64
22,Louisiana,21,Kentucky,199,Pulaski County,7,0,7
22,Louisiana,21,Kentucky,205,Rowan County,0,6,-6
22,Louisiana,21,Kentucky,209,Scott County,7,51,-44
22,Louisiana,21,Kentucky,221,Trigg County,19,0,19
22,Louisiana,21,Kentucky,227,Warren County,14,69,-55
22,Louisiana,22,Louisiana,1,Acadia Parish,3097,2047,1050
22,Louisiana,22,Louisiana,3,Allen Parish,1211,1223,-12
22,Louisiana,22,Louisiana,5,Ascension Parish,3938,3090,848
22,Louisiana,22,Louisiana,7,Assumption Parish,997,676,321
22,Louisiana,22,Louisiana,9,Avoyelles Parish,1168,1375,-207
22,Louisiana,22,Louisiana,11,Beauregard Parish,1591,1884,-293
22,Louisiana,22,Louisiana,13,Bienville Parish,620,528,92
22,Louisiana,22,Louisiana,15,Bossier Parish,4688,5371,-683
22,Louisiana,22,Louisiana,17,Caddo Parish,7139,5657,1482
22,Louisiana,22,Louisiana,19,Calcasieu Parish,4210,4177,33
22,Louisiana,22,Louisiana,21,Caldwell Parish,173,583,-410
22,Louisiana,22,Louisiana,23,Cameron Parish,661,74,587
22,Louisiana,22,Louisiana,25,Catahoula Parish,397,769,-372
22,Louisiana,22,Louisiana,27,Claiborne Parish,486,656,-170
22,Louisiana,22,Louisiana,29,Concordia Parish,878,982,-104
22,Louisiana,22,Louisiana,31,De Soto Parish,483,933,-450
22,Louisiana,22,Louisiana,33,East Baton Rouge Parish,12549,16307,-3758
22,Louisiana,22,Louisiana,35,East Carroll Parish,642,1351,-709
22,Louisiana,22,Louisiana,37,East Feliciana Parish,1112,1490,-378
22,Louisiana,22,Louisiana,39,Evangeline Parish,876,952,-76
22,Louisiana,22,Louisiana,41,Franklin Parish,633,911,-278
22,Louisiana,22,Louisiana,43,Grant Parish,1292,653,639
22,Louisiana,22,Louisiana,45,Iberia Parish,3105,2593,512
22,Louisiana,22,Louisiana,47,Iberville Parish,1548,2173,-625
22,Louisiana,22,Louisiana,49,Jackson Parish,753,1099,-346
22,Louisiana,22,Louisiana,51,Jefferson Parish,14235,11888,2347
22,Louisiana,22,Louisiana,53,Jefferson Davis Parish,1375,1691,-316
22,Louisiana,22,Louisiana,55,Lafayette Parish,7074,9508,-2434
22,Louisiana,22,Louisiana,57,Lafourche Parish,4024,3727,297
22,Louisiana,22,Louisiana,59,LaSalle Parish,741,558,183
22,Louisiana,22,Louisiana,61,Lincoln Parish,1757,2387,-630
22,Louisiana,22,Louisiana,63,Livingston Parish,4897,4350,547
22,Louisiana,22,Louisiana,65,Madison Parish,432,683,-251
22,Louisiana,22,Louisiana,67,Morehouse Parish,492,410,82
22,Louisiana,22,Louisiana,69,Natchitoches Parish,809,1596,-787
22,Louisiana,22,Louisiana,71,Orleans Parish,15155,10334,4821
22,Louisiana,22,Louisiana,73,Ouachita Parish,3385,4664,-1279
22,Louisiana,22,Louisiana,75,Plaquemines Parish,1403,334,1069
22,Louisiana,22,Louisiana,77,Pointe Coupee Parish,495,687,-192
22,Louisiana,22,Louisiana,79,Rapides Parish,3362,3354,8
22,Louisiana,22,Louisiana,81,Red River Parish,181,334,-153
22,Louisiana,22,Louisiana,83,Richland Parish,1439,833,606
22,Louisiana,22,Louisiana,85,Sabine Parish,412,454,-42
22,Louisiana,22,Louisiana,87,St. Bernard Parish,1284,2358,-1074
22,Louisiana,22,Louisiana,89,St. Charles Parish,2670,1663,1007
22,Louisiana,22,Louisiana,91,St. Helena Parish,420,385,35
22,Louisiana,22,Louisiana,93,St. James Parish,558,428,130
22,Louisiana,22,Louisiana,95,St. John the Baptist Parish,1858,1452,406
22,Louisiana,22,Louisiana,97,St. Landry Parish,3168,1928,1240
22,Louisiana,22,Louisiana,99,St. Martin Parish,2365,1291,1074
22,Louisiana,22,Louisiana,101,St. Mary Parish,1614,1517,97
22,Louisiana,22,Louisiana,103,St. Tammany Parish,6167,7523,-1356
22,Louisiana,22,Louisiana,105,Tangipahoa Parish,3851,6537,-2686
22,Louisiana,22,Louisiana,107,Tensas Parish,192,39,153
22,Louisiana,22,Louisiana,109,Terrebonne Parish,3926,3521,405
22,Louisiana,22,Louisiana,111,Union Parish,560,446,114
22,Louisiana,22,Louisiana,113,Vermilion Parish,1699,2604,-905
22,Louisiana,22,Louisiana,115,Vernon Parish,1617,1217,400
22,Louisiana,22,Louisiana,117,Washington Parish,1228,1295,-67
22,Louisiana,22,Louisiana,119,Webster Parish,1367,1251,116
22,Louisiana,22,Louisiana,121,West Baton Rouge Parish,1296,1470,-174
22,Louisiana,22,Louisiana,123,West Carroll Parish,191,223,-32
22,Louisiana,22,Louisiana,125,West Feliciana Parish,1016,580,436
22,Louisiana,22,Louisiana,127,Winn Parish,817,705,112
22,Louisiana,23,Maine,1,Androscoggin County,0,22,-22
22,Louisiana,23,Maine,3,Aroostook County,0,237,-237
22,Louisiana,23,Maine,5,Cumberland County,26,51,-25
22,Louisiana,23,Maine,9,Hancock County,10,6,4
22,Louisiana,23,Maine,11,Kennebec County,0,5,-5
22,Louisiana,23,Maine,13,Knox County,0,4,-4
22,Louisiana,23,Maine,15,Lincoln County,0,2,-2
22,Louisiana,23,Maine,17,Oxford County,0,4,-4
22,Louisiana,23,Maine,19,Penobscot County,0,57,-57
22,Louisiana,23,Maine,21,Piscataquis County,0,2,-2
22,Louisiana,23,Maine,23,Sagadahoc County,0,8,-8
22,Louisiana,23,Maine,25,Somerset County,0,2,-2
22,Louisiana,23,Maine,27,Waldo County,0,3,-3
22,Louisiana,23,Maine,29,Washington County,0,35,-35
22,Louisiana,23,Maine,31,York County,0,84,-84
22,Louisiana,24,Maryland,3,Anne Arundel County,71,43,28
22,Louisiana,24,Maryland,5,Baltimore County,129,26,103
22,Louisiana,24,Maryland,13,Carroll County,14,0,14
22,Louisiana,24,Maryland,17,Charles County,51,133,-82
22,Louisiana,24,Maryland,21,Frederick County,10,0,10
22,Louisiana,24,Maryland,25,Harford County,9,16,-7
22,Louisiana,24,Maryland,27,Howard County,0,22,-22
22,Louisiana,24,Maryland,31,Montgomery County,185,105,80
22,Louisiana,24,Maryland,33,Prince George's County,183,158,25
22,Louisiana,24,Maryland,35,Queen Anne's County,12,0,12
22,Louisiana,24,Maryland,37,St. Mary's County,0,3,-3
22,Louisiana,24,Maryland,45,Wicomico County,0,104,-104
22,Louisiana,24,Maryland,510,Baltimore city,187,6,181
22,Louisiana,25,Massachusetts,1,Barnstable County,5,0,5
22,Louisiana,25,Massachusetts,3,Berkshire County,39,0,39
22,Louisiana,25,Massachusetts,5,Bristol County,16,0,16
22,Louisiana,25,Massachusetts,9,Essex County,123,26,97
22,Louisiana,25,Massachusetts,11,Franklin County,0,34,-34
22,Louisiana,25,Massachusetts,13,Hampden County,74,0,74
22,Louisiana,25,Massachusetts,15,Hampshire County,27,0,27
22,Louisiana,25,Massachusetts,17,Middlesex County,163,127,36
22,Louisiana,25,Massachusetts,21,Norfolk County,44,28,16
22,Louisiana,25,Massachusetts,23,Plymouth County,23,7,16
22,Louisiana,25,Massachusetts,25,Suffolk County,97,319,-222
22,Louisiana,25,Massachusetts,27,Worcester County,87,18,69
22,Louisiana,26,Michigan,9,Antrim County,5,4,1
22,Louisiana,26,Michigan,11,Arenac County,0,4,-4
22,Louisiana,26,Michigan,17,Bay County,26,79,-53
22,Louisiana,26,Michigan,19,Benzie County,9,0,9
22,Louisiana,26,Michigan,21,Berrien County,214,8,206
22,Louisiana,26,Michigan,25,Calhoun County,0,13,-13
22,Louisiana,26,Michigan,29,Charlevoix County,0,10,-10
22,Louisiana,26,Michigan,33,Chippewa County,0,6,-6
22,Louisiana,26,Michigan,37,Clinton County,4,0,4
22,Louisiana,26,Michigan,49,Genesee County,329,174,155
22,Louisiana,26,Michigan,51,Gladwin County,99,0,99
22,Louisiana,26,Michigan,57,Gratiot County,0,2,-2
22,Louisiana,26,Michigan,59,Hillsdale County,16,0,16
22,Louisiana,26,Michigan,65,Ingham County,73,130,-57
22,Louisiana,26,Michigan,71,Iron County,0,3,-3
22,Louisiana,26,Michigan,73,Isabella County,0,19,-19
22,Louisiana,26,Michigan,75,Jackson County,22,50,-28
22,Louisiana,26,Michigan,77,Kalamazoo County,20,126,-106
22,Louisiana,26,Michigan,81,Kent County,41,125,-84
22,Louisiana,26,Michigan,91,Lenawee County,0,14,-14
22,Louisiana,26,Michigan,93,Livingston County,6,62,-56
22,Louisiana,26,Michigan,95,Luce County,0,2,-2
22,Louisiana,26,Michigan,99,Macomb County,58,60,-2
22,Louisiana,26,Michigan,101,Manistee County,0,28,-28
22,Louisiana,26,Michigan,103,Marquette County,8,4,4
22,Louisiana,26,Michigan,111,Midland County,55,16,39
22,Louisiana,26,Michigan,115,Monroe County,0,3,-3
22,Louisiana,26,Michigan,123,Newaygo County,0,2,-2
22,Louisiana,26,Michigan,125,Oakland County,115,36,79
22,Louisiana,26,Michigan,127,Oceana County,0,7,-7
22,Louisiana,26,Michigan,143,Roscommon County,0,3,-3
22,Louisiana,26,Michigan,145,Saginaw County,26,2,24
22,Louisiana,26,Michigan,151,Sanilac County,0,1,-1
22,Louisiana,26,Michigan,155,Shiawassee County,28,0,28
22,Louisiana,26,Michigan,159,Van Buren County,25,0,25
22,Louisiana,26,Michigan,161,Washtenaw County,97,25,72
22,Louisiana,26,Michigan,163,Wayne County,486,118,368
22,Louisiana,27,Minnesota,1,Aitkin County,0,6,-6
22,Louisiana,27,Minnesota,3,Anoka County,42,10,32
22,Louisiana,27,Minnesota,21,Cass County,0,1,-1
22,Louisiana,27,Minnesota,27,Clay County,17,10,7
22,Louisiana,27,Minnesota,35,Crow Wing County,8,45,-37
22,Louisiana,27,Minnesota,37,Dakota County,0,21,-21
22,Louisiana,27,Minnesota,39,Dodge County,0,10,-10
22,Louisiana,27,Minnesota,45,Fillmore County,0,2,-2
22,Louisiana,27,Minnesota,53,Hennepin County,323,172,151
22,Louisiana,27,Minnesota,57,Hubbard County,3,11,-8
22,Louisiana,27,Minnesota,71,Koochiching County,0,4,-4
22,Louisiana,27,Minnesota,91,Martin County,35,0,35
22,Louisiana,27,Minnesota,109,Olmsted County,0,18,-18
22,Louisiana,27,Minnesota,111,Otter Tail County,0,5,-5
22,Louisiana,27,Minnesota,115,Pine County,0,15,-15
22,Louisiana,27,Minnesota,117,Pipestone County,0,22,-22
22,Louisiana,27,Minnesota,123,Ramsey County,47,49,-2
22,Louisiana,27,Minnesota,127,Redwood County,0,9,-9
22,Louisiana,27,Minnesota,131,Rice County,0,4,-4
22,Louisiana,27,Minnesota,141,Sherburne County,0,1,-1
22,Louisiana,27,Minnesota,145,Stearns County,0,6,-6
22,Louisiana,27,Minnesota,151,Swift County,0,5,-5
22,Louisiana,27,Minnesota,153,Todd County,0,3,-3
22,Louisiana,27,Minnesota,163,Washington County,122,0,122
22,Louisiana,27,Minnesota,171,Wright County,7,0,7
22,Louisiana,27,Minnesota,173,Yellow Medicine County,3,0,3
22,Louisiana,28,Mississippi,1,Adams County,463,97,366
22,Louisiana,28,Mississippi,3,Alcorn County,6,1,5
22,Louisiana,28,Mississippi,5,Amite County,369,43,326
22,Louisiana,28,Mississippi,7,Attala County,56,0,56
22,Louisiana,28,Mississippi,11,Bolivar County,11,13,-2
22,Louisiana,28,Mississippi,13,Calhoun County,0,16,-16
22,Louisiana,28,Mississippi,15,Carroll County,29,0,29
22,Louisiana,28,Mississippi,17,Chickasaw County,0,5,-5
22,Louisiana,28,Mississippi,21,Claiborne County,0,48,-48
22,Louisiana,28,Mississippi,25,Clay County,0,116,-116
22,Louisiana,28,Mississippi,27,Coahoma County,0,13,-13
22,Louisiana,28,Mississippi,29,Copiah County,58,13,45
22,Louisiana,28,Mississippi,31,Covington County,62,0,62
22,Louisiana,28,Mississippi,33,DeSoto County,393,0,393
22,Louisiana,28,Mississippi,35,Forrest County,559,281,278
22,Louisiana,28,Mississippi,37,Franklin County,113,30,83
22,Louisiana,28,Mississippi,39,George County,167,11,156
22,Louisiana,28,Mississippi,41,Greene County,8,12,-4
22,Louisiana,28,Mississippi,43,Grenada County,17,6,11
22,Louisiana,28,Mississippi,45,Hancock County,243,792,-549
22,Louisiana,28,Mississippi,47,Harrison County,1290,933,357
22,Louisiana,28,Mississippi,49,Hinds County,643,697,-54
22,Louisiana,28,Mississippi,57,Itawamba County,3,4,-1
22,Louisiana,28,Mississippi,59,Jackson County,198,454,-256
22,Louisiana,28,Mississippi,61,Jasper County,68,0,68
22,Louisiana,28,Mississippi,63,Jefferson County,0,10,-10
22,Louisiana,28,Mississippi,65,Jefferson Davis County,7,0,7
22,Louisiana,28,Mississippi,67,Jones County,245,7,238
22,Louisiana,28,Mississippi,69,Kemper County,3,54,-51
22,Louisiana,28,Mississippi,71,Lafayette County,180,118,62
22,Louisiana,28,Mississippi,73,Lamar County,120,267,-147
22,Louisiana,28,Mississippi,75,Lauderdale County,207,101,106
22,Louisiana,28,Mississippi,77,Lawrence County,80,29,51
22,Louisiana,28,Mississippi,79,Leake County,0,11,-11
22,Louisiana,28,Mississippi,81,Lee County,2,0,2
22,Louisiana,28,Mississippi,83,Leflore County,2,5,-3
22,Louisiana,28,Mississippi,85,Lincoln County,299,103,196
22,Louisiana,28,Mississippi,87,Lowndes County,62,166,-104
22,Louisiana,28,Mississippi,89,Madison County,134,211,-77
22,Louisiana,28,Mississippi,91,Marion County,142,207,-65
22,Louisiana,28,Mississippi,93,Marshall County,10,6,4
22,Louisiana,28,Mississippi,95,Monroe County,31,54,-23
22,Louisiana,28,Mississippi,99,Neshoba County,10,8,2
22,Louisiana,28,Mississippi,101,Newton County,0,13,-13
22,Louisiana,28,Mississippi,105,Oktibbeha County,57,58,-1
22,Louisiana,28,Mississippi,107,Panola County,5,5,0
22,Louisiana,28,Mississippi,109,Pearl River County,951,1196,-245
22,Louisiana,28,Mississippi,111,Perry County,0,69,-69
22,Louisiana,28,Mississippi,113,Pike County,294,523,-229
22,Louisiana,28,Mississippi,115,Pontotoc County,1,0,1
22,Louisiana,28,Mississippi,117,Prentiss County,0,5,-5
22,Louisiana,28,Mississippi,121,Rankin County,249,335,-86
22,Louisiana,28,Mississippi,123,Scott County,0,24,-24
22,Louisiana,28,Mississippi,127,Simpson County,3,82,-79
22,Louisiana,28,Mississippi,129,Smith County,6,0,6
22,Louisiana,28,Mississippi,131,Stone County,0,117,-117
22,Louisiana,28,Mississippi,133,Sunflower County,0,7,-7
22,Louisiana,28,Mississippi,139,Tippah County,0,9,-9
22,Louisiana,28,Mississippi,141,Tishomingo County,13,0,13
22,Louisiana,28,Mississippi,143,Tunica County,47,0,47
22,Louisiana,28,Mississippi,147,Walthall County,81,193,-112
22,Louisiana,28,Mississippi,149,Warren County,95,170,-75
22,Louisiana,28,Mississippi,151,Washington County,194,31,163
22,Louisiana,28,Mississippi,153,Wayne County,24,0,24
22,Louisiana,28,Mississippi,157,Wilkinson County,109,51,58
22,Louisiana,28,Mississippi,159,Winston County,0,1,-1
22,Louisiana,28,Mississippi,161,Yalobusha County,20,0,20
22,Louisiana,28,Mississippi,163,Yazoo County,32,22,10
22,Louisiana,29,Missouri,9,Barry County,52,33,19
22,Louisiana,29,Missouri,15,Benton County,0,15,-15
22,Louisiana,29,Missouri,19,Boone County,42,17,25
22,Louisiana,29,Missouri,25,Caldwell County,16,0,16
22,Louisiana,29,Missouri,27,Callaway County,8,9,-1
22,Louisiana,29,Missouri,31,Cape Girardeau County,8,0,8
22,Louisiana,29,Missouri,39,Cedar County,0,25,-25
22,Louisiana,29,Missouri,47,Clay County,22,211,-189
22,Louisiana,29,Missouri,51,Cole County,17,6,11
22,Louisiana,29,Missouri,59,Dallas County,0,11,-11
22,Louisiana,29,Missouri,71,Franklin County,0,33,-33
22,Louisiana,29,Missouri,77,Greene County,45,56,-11
22,Louisiana,29,Missouri,91,Howell County,0,5,-5
22,Louisiana,29,Missouri,95,Jackson County,113,149,-36
22,Louisiana,29,Missouri,97,Jasper County,17,36,-19
22,Louisiana,29,Missouri,101,Johnson County,233,38,195
22,Louisiana,29,Missouri,109,Lawrence County,1,0,1
22,Louisiana,29,Missouri,117,Livingston County,0,10,-10
22,Louisiana,29,Missouri,119,McDonald County,25,10,15
22,Louisiana,29,Missouri,123,Madison County,79,17,62
22,Louisiana,29,Missouri,125,Maries County,15,0,15
22,Louisiana,29,Missouri,127,Marion County,0,80,-80
22,Louisiana,29,Missouri,129,Mercer County,0,3,-3
22,Louisiana,29,Missouri,141,Morgan County,0,28,-28
22,Louisiana,29,Missouri,145,Newton County,0,17,-17
22,Louisiana,29,Missouri,153,Ozark County,0,3,-3
22,Louisiana,29,Missouri,161,Phelps County,40,69,-29
22,Louisiana,29,Missouri,163,Pike County,0,17,-17
22,Louisiana,29,Missouri,165,Platte County,0,115,-115
22,Louisiana,29,Missouri,167,Polk County,63,0,63
22,Louisiana,29,Missouri,169,Pulaski County,159,288,-129
22,Louisiana,29,Missouri,175,Randolph County,18,4,14
22,Louisiana,29,Missouri,183,St. Charles County,50,0,50
22,Louisiana,29,Missouri,189,St. Louis County,117,216,-99
22,Louisiana,29,Missouri,207,Stoddard County,0,7,-7
22,Louisiana,29,Missouri,209,Stone County,0,20,-20
22,Louisiana,29,Missouri,213,Taney County,13,0,13
22,Louisiana,29,Missouri,215,Texas County,5,14,-9
22,Louisiana,29,Missouri,219,Warren County,9,0,9
22,Louisiana,29,Missouri,221,Washington County,0,11,-11
22,Louisiana,29,Missouri,225,Webster County,0,11,-11
22,Louisiana,29,Missouri,229,Wright County,29,0,29
22,Louisiana,29,Missouri,510,St. Louis city,128,113,15
22,Louisiana,30,Montana,9,Carbon County,0,10,-10
22,Louisiana,30,Montana,13,Cascade County,52,0,52
22,Louisiana,30,Montana,29,Flathead County,33,18,15
22,Louisiana,30,Montana,31,Gallatin County,0,12,-12
22,Louisiana,30,Montana,49,Lewis and Clark County,23,0,23
22,Louisiana,30,Montana,57,Madison County,14,0,14
22,Louisiana,30,Montana,63,Missoula County,58,97,-39
22,Louisiana,30,Montana,77,Powell County,60,0,60
22,Louisiana,30,Montana,81,Ravalli County,6,0,6
22,Louisiana,30,Montana,93,Silver Bow County,46,0,46
22,Louisiana,30,Montana,111,Yellowstone County,9,59,-50
22,Louisiana,31,Nebraska,23,Butler County,7,0,7
22,Louisiana,31,Nebraska,25,Cass County,20,0,20
22,Louisiana,31,Nebraska,55,Douglas County,58,7,51
22,Louisiana,31,Nebraska,79,Hall County,12,140,-128
22,Louisiana,31,Nebraska,81,Hamilton County,25,0,25
22,Louisiana,31,Nebraska,95,Jefferson County,0,3,-3
22,Louisiana,31,Nebraska,109,Lancaster County,4,93,-89
22,Louisiana,31,Nebraska,119,Madison County,11,0,11
22,Louisiana,31,Nebraska,129,Nuckolls County,0,5,-5
22,Louisiana,31,Nebraska,139,Pierce County,14,0,14
22,Louisiana,31,Nebraska,153,Sarpy County,57,18,39
22,Louisiana,31,Nebraska,155,Saunders County,0,26,-26
22,Louisiana,31,Nebraska,185,York County,0,8,-8
22,Louisiana,32,Nevada,3,Clark County,223,256,-33
22,Louisiana,32,Nevada,19,Lyon County,42,0,42
22,Louisiana,32,Nevada,21,Mineral County,0,15,-15
22,Louisiana,32,Nevada,31,Washoe County,227,87,140
22,Louisiana,33,New Hampshire,5,Cheshire County,0,5,-5
22,Louisiana,33,New Hampshire,7,Coos County,30,12,18
22,Louisiana,33,New Hampshire,9,Grafton County,12,17,-5
22,Louisiana,33,New Hampshire,11,Hillsborough County,52,127,-75
22,Louisiana,33,New Hampshire,13,Merrimack County,14,0,14
22,Louisiana,33,New Hampshire,17,Strafford County,8,48,-40
22,Louisiana,33,New Hampshire,19,Sullivan County,77,0,77
22,Louisiana,34,New Jersey,1,Atlantic County,0,157,-157
22,Louisiana,34,New Jersey,3,Bergen County,107,194,-87
22,Louisiana,34,New Jersey,5,Burlington County,131,107,24
22,Louisiana,34,New Jersey,7,Camden County,29,39,-10
22,Louisiana,34,New Jersey,9,Cape May County,0,7,-7
22,Louisiana,34,New Jersey,11,Cumberland County,19,19,0
22,Louisiana,34,New Jersey,13,Essex County,114,15,99
22,Louisiana,34,New Jersey,17,Hudson County,55,65,-10
22,Louisiana,34,New Jersey,21,Mercer County,36,11,25
22,Louisiana,34,New Jersey,23,Middlesex County,47,87,-40
22,Louisiana,34,New Jersey,25,Monmouth County,22,46,-24
22,Louisiana,34,New Jersey,27,Morris County,106,20,86
22,Louisiana,34,New Jersey,29,Ocean County,0,11,-11
22,Louisiana,34,New Jersey,31,Passaic County,7,15,-8
22,Louisiana,34,New Jersey,33,Salem County,27,0,27
22,Louisiana,34,New Jersey,35,Somerset County,0,8,-8
22,Louisiana,34,New Jersey,37,Sussex County,0,9,-9
22,Louisiana,34,New Jersey,39,Union County,9,21,-12
22,Louisiana,34,New Jersey,41,Warren County,0,70,-70
22,Louisiana,35,New Mexico,1,Bernalillo County,89,117,-28
22,Louisiana,35,New Mexico,5,Chaves County,0,13,-13
22,Louisiana,35,New Mexico,9,Curry County,45,36,9
22,Louisiana,35,New Mexico,13,Doña Ana County,35,3,32
22,Louisiana,35,New Mexico,15,Eddy County,24,0,24
22,Louisiana,35,New Mexico,28,Los Alamos County,8,0,8
22,Louisiana,35,New Mexico,29,Luna County,0,52,-52
22,Louisiana,35,New Mexico,31,McKinley County,0,114,-114
22,Louisiana,35,New Mexico,35,Otero County,75,54,21
22,Louisiana,35,New Mexico,37,Quay County,11,0,11
22,Louisiana,35,New Mexico,43,Sandoval County,0,60,-60
22,Louisiana,35,New Mexico,45,San Juan County,0,141,-141
22,Louisiana,35,New Mexico,49,Santa Fe County,38,26,12
22,Louisiana,35,New Mexico,53,Socorro County,0,3,-3
22,Louisiana,35,New Mexico,57,Torrance County,8,0,8
22,Louisiana,35,New Mexico,61,Valencia County,7,0,7
22,Louisiana,36,New York,1,Albany County,29,13,16
22,Louisiana,36,New York,5,Bronx County,73,43,30
22,Louisiana,36,New York,7,Broome County,6,8,-2
22,Louisiana,36,New York,9,Cattaraugus County,6,0,6
22,Louisiana,36,New York,27,Dutchess County,16,5,11
22,Louisiana,36,New York,29,Erie County,41,27,14
22,Louisiana,36,New York,31,Essex County,0,7,-7
22,Louisiana,36,New York,37,Genesee County,9,0,9
22,Louisiana,36,New York,45,Jefferson County,34,86,-52
22,Louisiana,36,New York,47,Kings County,339,273,66
22,Louisiana,36,New York,53,Madison County,14,2,12
22,Louisiana,36,New York,55,Monroe County,55,101,-46
22,Louisiana,36,New York,57,Montgomery County,16,0,16
22,Louisiana,36,New York,59,Nassau County,125,10,115
22,Louisiana,36,New York,61,New York County,618,203,415
22,Louisiana,36,New York,63,Niagara County,144,42,102
22,Louisiana,36,New York,65,Oneida County,0,57,-57
22,Louisiana,36,New York,67,Onondaga County,46,78,-32
22,Louisiana,36,New York,71,Orange County,29,31,-2
22,Louisiana,36,New York,75,Oswego County,0,8,-8
22,Louisiana,36,New York,77,Otsego County,65,0,65
22,Louisiana,36,New York,79,Putnam County,12,0,12
22,Louisiana,36,New York,81,Queens County,247,36,211
22,Louisiana,36,New York,83,Rensselaer County,9,24,-15
22,Louisiana,36,New York,85,Richmond County,8,0,8
22,Louisiana,36,New York,87,Rockland County,142,0,142
22,Louisiana,36,New York,89,St. Lawrence County,23,0,23
22,Louisiana,36,New York,93,Schenectady County,8,0,8
22,Louisiana,36,New York,101,Steuben County,0,5,-5
22,Louisiana,36,New York,103,Suffolk County,83,296,-213
22,Louisiana,36,New York,109,Tompkins County,70,43,27
22,Louisiana,36,New York,111,Ulster County,32,54,-22
22,Louisiana,36,New York,119,Westchester County,99,46,53
22,Louisiana,37,North Carolina,1,Alamance County,11,0,11
22,Louisiana,37,North Carolina,19,Brunswick County,35,0,35
22,Louisiana,37,North Carolina,21,Buncombe County,26,120,-94
22,Louisiana,37,North Carolina,23,Burke County,0,7,-7
22,Louisiana,37,North Carolina,25,Cabarrus County,57,9,48
22,Louisiana,37,North Carolina,35,Catawba County,0,3,-3
22,Louisiana,37,North Carolina,49,Craven County,125,206,-81
22,Louisiana,37,North Carolina,51,Cumberland County,406,169,237
22,Louisiana,37,North Carolina,53,Currituck County,0,11,-11
22,Louisiana,37,North Carolina,55,Dare County,83,17,66
22,Louisiana,37,North Carolina,63,Durham County,144,6,138
22,Louisiana,37,North Carolina,65,Edgecombe County,5,0,5
22,Louisiana,37,North Carolina,67,Forsyth County,28,146,-118
22,Louisiana,37,North Carolina,71,Gaston County,13,151,-138
22,Louisiana,37,North Carolina,77,Granville County,9,0,9
22,Louisiana,37,North Carolina,81,Guilford County,248,35,213
22,Louisiana,37,North Carolina,85,Harnett County,6,117,-111
22,Louisiana,37,North Carolina,89,Henderson County,15,8,7
22,Louisiana,37,North Carolina,93,Hoke County,20,0,20
22,Louisiana,37,North Carolina,97,Iredell County,26,0,26
22,Louisiana,37,North Carolina,101,Johnston County,25,92,-67
22,Louisiana,37,North Carolina,105,Lee County,36,0,36
22,Louisiana,37,North Carolina,111,McDowell County,6,0,6
22,Louisiana,37,North Carolina,115,Madison County,0,26,-26
22,Louisiana,37,North Carolina,119,Mecklenburg County,207,232,-25
22,Louisiana,37,North Carolina,125,Moore County,42,32,10
22,Louisiana,37,North Carolina,127,Nash County,0,31,-31
22,Louisiana,37,North Carolina,129,New Hanover County,27,0,27
22,Louisiana,37,North Carolina,133,Onslow County,466,250,216
22,Louisiana,37,North Carolina,135,Orange County,125,13,112
22,Louisiana,37,North Carolina,139,Pasquotank County,54,0,54
22,Louisiana,37,North Carolina,143,Perquimans County,0,20,-20
22,Louisiana,37,North Carolina,147,Pitt County,8,17,-9
22,Louisiana,37,North Carolina,151,Randolph County,79,16,63
22,Louisiana,37,North Carolina,153,Richmond County,0,2,-2
22,Louisiana,37,North Carolina,155,Robeson County,125,9,116
22,Louisiana,37,North Carolina,157,Rockingham County,67,0,67
22,Louisiana,37,North Carolina,159,Rowan County,0,7,-7
22,Louisiana,37,North Carolina,179,Union County,44,91,-47
22,Louisiana,37,North Carolina,183,Wake County,111,224,-113
22,Louisiana,37,North Carolina,191,Wayne County,0,30,-30
22,Louisiana,37,North Carolina,199,Yancey County,0,6,-6
22,Louisiana,38,North Dakota,17,Cass County,6,0,6
22,Louisiana,38,North Dakota,27,Eddy County,0,1,-1
22,Louisiana,38,North Dakota,35,Grand Forks County,58,0,58
22,Louisiana,38,North Dakota,59,Morton County,0,2,-2
22,Louisiana,38,North Dakota,89,Stark County,0,21,-21
22,Louisiana,38,North Dakota,93,Stutsman County,0,14,-14
22,Louisiana,38,North Dakota,97,Traill County,13,0,13
22,Louisiana,38,North Dakota,99,Walsh County,0,28,-28
22,Louisiana,38,North Dakota,101,Ward County,70,127,-57
22,Louisiana,38,North Dakota,105,Williams County,65,25,40
22,Louisiana,39,Ohio,1,Adams County,4,0,4
22,Louisiana,39,Ohio,5,Ashland County,18,0,18
22,Louisiana,39,Ohio,7,Ashtabula County,10,0,10
22,Louisiana,39,Ohio,9,Athens County,0,9,-9
22,Louisiana,39,Ohio,11,Auglaize County,15,0,15
22,Louisiana,39,Ohio,13,Belmont County,64,0,64
22,Louisiana,39,Ohio,17,Butler County,11,0,11
22,Louisiana,39,Ohio,21,Champaign County,0,41,-41
22,Louisiana,39,Ohio,25,Clermont County,0,46,-46
22,Louisiana,39,Ohio,29,Columbiana County,0,42,-42
22,Louisiana,39,Ohio,35,Cuyahoga County,157,56,101
22,Louisiana,39,Ohio,37,Darke County,0,2,-2
22,Louisiana,39,Ohio,49,Franklin County,228,259,-31
22,Louisiana,39,Ohio,55,Geauga County,13,0,13
22,Louisiana,39,Ohio,57,Greene County,141,6,135
22,Louisiana,39,Ohio,59,Guernsey County,0,12,-12
22,Louisiana,39,Ohio,61,Hamilton County,15,107,-92
22,Louisiana,39,Ohio,65,Hardin County,0,6,-6
22,Louisiana,39,Ohio,69,Henry County,0,2,-2
22,Louisiana,39,Ohio,73,Hocking County,11,6,5
22,Louisiana,39,Ohio,81,Jefferson County,0,29,-29
22,Louisiana,39,Ohio,85,Lake County,38,48,-10
22,Louisiana,39,Ohio,89,Licking County,269,0,269
22,Louisiana,39,Ohio,91,Logan County,0,234,-234
22,Louisiana,39,Ohio,93,Lorain County,12,0,12
22,Louisiana,39,Ohio,95,Lucas County,36,27,9
22,Louisiana,39,Ohio,99,Mahoning County,53,5,48
22,Louisiana,39,Ohio,103,Medina County,0,50,-50
22,Louisiana,39,Ohio,107,Mercer County,6,0,6
22,Louisiana,39,Ohio,113,Montgomery County,44,43,1
22,Louisiana,39,Ohio,123,Ottawa County,0,8,-8
22,Louisiana,39,Ohio,127,Perry County,0,9,-9
22,Louisiana,39,Ohio,133,Portage County,0,98,-98
22,Louisiana,39,Ohio,135,Preble County,0,6,-6
22,Louisiana,39,Ohio,139,Richland County,0,10,-10
22,Louisiana,39,Ohio,141,Ross County,0,2,-2
22,Louisiana,39,Ohio,143,Sandusky County,0,100,-100
22,Louisiana,39,Ohio,151,Stark County,7,5,2
22,Louisiana,39,Ohio,153,Summit County,388,30,358
22,Louisiana,39,Ohio,155,Trumbull County,21,8,13
22,Louisiana,39,Ohio,157,Tuscarawas County,0,14,-14
22,Louisiana,39,Ohio,165,Warren County,5,2,3
22,Louisiana,39,Ohio,167,Washington County,0,9,-9
22,Louisiana,4,Arizona,3,Cochise County,6,55,-49
22,Louisiana,4,Arizona,5,Coconino County,18,18,0
22,Louisiana,4,Arizona,7,Gila County,15,0,15
22,Louisiana,4,Arizona,13,Maricopa County,396,986,-590
22,Louisiana,4,Arizona,15,Mohave County,9,92,-83
22,Louisiana,4,Arizona,17,Navajo County,0,33,-33
22,Louisiana,4,Arizona,19,Pima County,108,209,-101
22,Louisiana,4,Arizona,21,Pinal County,19,35,-16
22,Louisiana,4,Arizona,27,Yuma County,0,13,-13
22,Louisiana,40,Oklahoma,5,Atoka County,0,1,-1
22,Louisiana,40,Oklahoma,9,Beckham County,103,16,87
22,Louisiana,40,Oklahoma,11,Blaine County,0,24,-24
22,Louisiana,40,Oklahoma,13,Bryan County,132,40,92
22,Louisiana,40,Oklahoma,15,Caddo County,0,18,-18
22,Louisiana,40,Oklahoma,17,Canadian County,163,110,53
22,Louisiana,40,Oklahoma,21,Cherokee County,0,9,-9
22,Louisiana,40,Oklahoma,23,Choctaw County,0,99,-99
22,Louisiana,40,Oklahoma,27,Cleveland County,121,188,-67
22,Louisiana,40,Oklahoma,31,Comanche County,177,234,-57
22,Louisiana,40,Oklahoma,37,Creek County,0,16,-16
22,Louisiana,40,Oklahoma,41,Delaware County,0,4,-4
22,Louisiana,40,Oklahoma,43,Dewey County,0,16,-16
22,Louisiana,40,Oklahoma,47,Garfield County,0,148,-148
22,Louisiana,40,Oklahoma,51,Grady County,0,11,-11
22,Louisiana,40,Oklahoma,63,Hughes County,0,6,-6
22,Louisiana,40,Oklahoma,65,Jackson County,0,1,-1
22,Louisiana,40,Oklahoma,67,Jefferson County,0,33,-33
22,Louisiana,40,Oklahoma,71,Kay County,0,65,-65
22,Louisiana,40,Oklahoma,81,Lincoln County,24,0,24
22,Louisiana,40,Oklahoma,83,Logan County,186,16,170
22,Louisiana,40,Oklahoma,85,Love County,0,14,-14
22,Louisiana,40,Oklahoma,87,McClain County,12,0,12
22,Louisiana,40,Oklahoma,89,McCurtain County,0,16,-16
22,Louisiana,40,Oklahoma,91,McIntosh County,15,0,15
22,Louisiana,40,Oklahoma,93,Major County,21,0,21
22,Louisiana,40,Oklahoma,97,Mayes County,0,9,-9
22,Louisiana,40,Oklahoma,101,Muskogee County,0,72,-72
22,Louisiana,40,Oklahoma,103,Noble County,6,18,-12
22,Louisiana,40,Oklahoma,105,Nowata County,0,9,-9
22,Louisiana,40,Oklahoma,109,Oklahoma County,271,168,103
22,Louisiana,40,Oklahoma,111,Okmulgee County,16,0,16
22,Louisiana,40,Oklahoma,115,Ottawa County,0,24,-24
22,Louisiana,40,Oklahoma,117,Pawnee County,48,0,48
22,Louisiana,40,Oklahoma,119,Payne County,22,13,9
22,Louisiana,40,Oklahoma,121,Pittsburg County,179,9,170
22,Louisiana,40,Oklahoma,123,Pontotoc County,3,10,-7
22,Louisiana,40,Oklahoma,127,Pushmataha County,0,3,-3
22,Louisiana,40,Oklahoma,131,Rogers County,0,41,-41
22,Louisiana,40,Oklahoma,135,Sequoyah County,0,33,-33
22,Louisiana,40,Oklahoma,137,Stephens County,0,38,-38
22,Louisiana,40,Oklahoma,139,Texas County,0,4,-4
22,Louisiana,40,Oklahoma,143,Tulsa County,349,411,-62
22,Louisiana,40,Oklahoma,145,Wagoner County,13,0,13
22,Louisiana,40,Oklahoma,147,Washington County,0,73,-73
22,Louisiana,40,Oklahoma,149,Washita County,0,7,-7
22,Louisiana,41,Oregon,3,Benton County,27,0,27
22,Louisiana,41,Oregon,5,Clackamas County,0,66,-66
22,Louisiana,41,Oregon,11,Coos County,0,20,-20
22,Louisiana,41,Oregon,17,Deschutes County,0,27,-27
22,Louisiana,41,Oregon,19,Douglas County,0,74,-74
22,Louisiana,41,Oregon,29,Jackson County,44,23,21
22,Louisiana,41,Oregon,33,Josephine County,0,102,-102
22,Louisiana,41,Oregon,35,Klamath County,0,5,-5
22,Louisiana,41,Oregon,39,Lane County,7,163,-156
22,Louisiana,41,Oregon,43,Linn County,0,40,-40
22,Louisiana,41,Oregon,47,Marion County,12,73,-61
22,Louisiana,41,Oregon,51,Multnomah County,168,336,-168
22,Louisiana,41,Oregon,53,Polk County,0,30,-30
22,Louisiana,41,Oregon,57,Tillamook County,0,31,-31
22,Louisiana,41,Oregon,67,Washington County,67,178,-111
22,Louisiana,41,Oregon,71,Yamhill County,538,0,538
22,Louisiana,42,Pennsylvania,3,Allegheny County,62,152,-90
22,Louisiana,42,Pennsylvania,7,Beaver County,18,0,18
22,Louisiana,42,Pennsylvania,11,Berks County,33,6,27
22,Louisiana,42,Pennsylvania,13,Blair County,19,0,19
22,Louisiana,42,Pennsylvania,15,Bradford County,0,23,-23
22,Louisiana,42,Pennsylvania,17,Bucks County,35,0,35
22,Louisiana,42,Pennsylvania,19,Butler County,38,41,-3
22,Louisiana,42,Pennsylvania,27,Centre County,103,2,101
22,Louisiana,42,Pennsylvania,29,Chester County,25,0,25
22,Louisiana,42,Pennsylvania,31,Clarion County,0,3,-3
22,Louisiana,42,Pennsylvania,41,Cumberland County,26,38,-12
22,Louisiana,42,Pennsylvania,43,Dauphin County,0,61,-61
22,Louisiana,42,Pennsylvania,45,Delaware County,20,36,-16
22,Louisiana,42,Pennsylvania,47,Elk County,0,14,-14
22,Louisiana,42,Pennsylvania,49,Erie County,11,0,11
22,Louisiana,42,Pennsylvania,53,Forest County,0,1,-1
22,Louisiana,42,Pennsylvania,63,Indiana County,5,37,-32
22,Louisiana,42,Pennsylvania,71,Lancaster County,12,0,12
22,Louisiana,42,Pennsylvania,79,Luzerne County,58,24,34
22,Louisiana,42,Pennsylvania,81,Lycoming County,0,25,-25
22,Louisiana,42,Pennsylvania,85,Mercer County,0,10,-10
22,Louisiana,42,Pennsylvania,87,Mifflin County,15,0,15
22,Louisiana,42,Pennsylvania,89,Monroe County,13,0,13
22,Louisiana,42,Pennsylvania,91,Montgomery County,30,102,-72
22,Louisiana,42,Pennsylvania,95,Northampton County,31,0,31
22,Louisiana,42,Pennsylvania,101,Philadelphia County,210,271,-61
22,Louisiana,42,Pennsylvania,111,Somerset County,28,0,28
22,Louisiana,42,Pennsylvania,115,Susquehanna County,0,15,-15
22,Louisiana,42,Pennsylvania,119,Union County,18,7,11
22,Louisiana,42,Pennsylvania,121,Venango County,2,0,2
22,Louisiana,42,Pennsylvania,125,Washington County,64,68,-4
22,Louisiana,42,Pennsylvania,129,Westmoreland County,25,5,20
22,Louisiana,44,Rhode Island,1,Bristol County,5,0,5
22,Louisiana,44,Rhode Island,3,Kent County,26,74,-48
22,Louisiana,44,Rhode Island,5,Newport County,9,14,-5
22,Louisiana,44,Rhode Island,7,Providence County,84,224,-140
22,Louisiana,45,South Carolina,3,Aiken County,56,0,56
22,Louisiana,45,South Carolina,5,Allendale County,0,48,-48
22,Louisiana,45,South Carolina,7,Anderson County,17,72,-55
22,Louisiana,45,South Carolina,9,Bamberg County,26,0,26
22,Louisiana,45,South Carolina,13,Beaufort County,41,234,-193
22,Louisiana,45,South Carolina,15,Berkeley County,0,61,-61
22,Louisiana,45,South Carolina,19,Charleston County,114,209,-95
22,Louisiana,45,South Carolina,25,Chesterfield County,2,0,2
22,Louisiana,45,South Carolina,35,Dorchester County,133,10,123
22,Louisiana,45,South Carolina,45,Greenville County,185,138,47
22,Louisiana,45,South Carolina,47,Greenwood County,0,84,-84
22,Louisiana,45,South Carolina,51,Horry County,41,19,22
22,Louisiana,45,South Carolina,55,Kershaw County,9,64,-55
22,Louisiana,45,South Carolina,57,Lancaster County,43,0,43
22,Louisiana,45,South Carolina,63,Lexington County,45,103,-58
22,Louisiana,45,South Carolina,73,Oconee County,1,53,-52
22,Louisiana,45,South Carolina,75,Orangeburg County,0,35,-35
22,Louisiana,45,South Carolina,77,Pickens County,35,50,-15
22,Louisiana,45,South Carolina,79,Richland County,151,328,-177
22,Louisiana,45,South Carolina,83,Spartanburg County,41,0,41
22,Louisiana,45,South Carolina,85,Sumter County,20,42,-22
22,Louisiana,45,South Carolina,87,Union County,40,0,40
22,Louisiana,45,South Carolina,89,Williamsburg County,10,0,10
22,Louisiana,45,South Carolina,91,York County,66,24,42
22,Louisiana,46,South Dakota,9,Bon Homme County,0,1,-1
22,Louisiana,46,South Dakota,13,Brown County,0,25,-25
22,Louisiana,46,South Dakota,23,Charles Mix County,0,4,-4
22,Louisiana,46,South Dakota,39,Deuel County,30,0,30
22,Louisiana,46,South Dakota,61,Hanson County,0,13,-13
22,Louisiana,46,South Dakota,65,Hughes County,3,0,3
22,Louisiana,46,South Dakota,79,Lake County,0,3,-3
22,Louisiana,46,South Dakota,81,Lawrence County,73,0,73
22,Louisiana,46,South Dakota,83,Lincoln County,0,76,-76
22,Louisiana,46,South Dakota,85,Lyman County,21,0,21
22,Louisiana,46,South Dakota,93,Meade County,0,53,-53
22,Louisiana,46,South Dakota,99,Minnehaha County,42,94,-52
22,Louisiana,46,South Dakota,103,Pennington County,2,21,-19
22,Louisiana,46,South Dakota,127,Union County,0,16,-16
22,Louisiana,47,Tennessee,1,Anderson County,11,8,3
22,Louisiana,47,Tennessee,3,Bedford County,0,204,-204
22,Louisiana,47,Tennessee,5,Benton County,19,0,19
22,Louisiana,47,Tennessee,9,Blount County,0,10,-10
22,Louisiana,47,Tennessee,11,Bradley County,10,0,10
22,Louisiana,47,Tennessee,15,Cannon County,0,17,-17
22,Louisiana,47,Tennessee,19,Carter County,0,42,-42
22,Louisiana,47,Tennessee,25,Claiborne County,22,0,22
22,Louisiana,47,Tennessee,29,Cocke County,25,0,25
22,Louisiana,47,Tennessee,35,Cumberland County,0,4,-4
22,Louisiana,47,Tennessee,37,Davidson County,454,434,20
22,Louisiana,47,Tennessee,43,Dickson County,2,0,2
22,Louisiana,47,Tennessee,45,Dyer County,40,0,40
22,Louisiana,47,Tennessee,55,Giles County,68,11,57
22,Louisiana,47,Tennessee,57,Grainger County,0,39,-39
22,Louisiana,47,Tennessee,59,Greene County,1,0,1
22,Louisiana,47,Tennessee,63,Hamblen County,0,50,-50
22,Louisiana,47,Tennessee,65,Hamilton County,149,250,-101
22,Louisiana,47,Tennessee,69,Hardeman County,0,3,-3
22,Louisiana,47,Tennessee,79,Henry County,20,0,20
22,Louisiana,47,Tennessee,81,Hickman County,20,0,20
22,Louisiana,47,Tennessee,93,Knox County,55,52,3
22,Louisiana,47,Tennessee,97,Lauderdale County,0,4,-4
22,Louisiana,47,Tennessee,99,Lawrence County,33,0,33
22,Louisiana,47,Tennessee,109,McNairy County,61,0,61
22,Louisiana,47,Tennessee,113,Madison County,99,283,-184
22,Louisiana,47,Tennessee,115,Marion County,13,0,13
22,Louisiana,47,Tennessee,119,Maury County,41,0,41
22,Louisiana,47,Tennessee,125,Montgomery County,259,121,138
22,Louisiana,47,Tennessee,131,Obion County,0,8,-8
22,Louisiana,47,Tennessee,133,Overton County,3,9,-6
22,Louisiana,47,Tennessee,137,Pickett County,0,15,-15
22,Louisiana,47,Tennessee,141,Putnam County,0,17,-17
22,Louisiana,47,Tennessee,143,Rhea County,7,0,7
22,Louisiana,47,Tennessee,147,Robertson County,75,237,-162
22,Louisiana,47,Tennessee,149,Rutherford County,103,119,-16
22,Louisiana,47,Tennessee,155,Sevier County,0,117,-117
22,Louisiana,47,Tennessee,157,Shelby County,612,635,-23
22,Louisiana,47,Tennessee,159,Smith County,12,0,12
22,Louisiana,47,Tennessee,163,Sullivan County,0,7,-7
22,Louisiana,47,Tennessee,165,Sumner County,140,27,113
22,Louisiana,47,Tennessee,171,Unicoi County,0,102,-102
22,Louisiana,47,Tennessee,173,Union County,25,0,25
22,Louisiana,47,Tennessee,179,Washington County,34,20,14
22,Louisiana,47,Tennessee,183,Weakley County,0,27,-27
22,Louisiana,47,Tennessee,187,Williamson County,5,135,-130
22,Louisiana,47,Tennessee,189,Wilson County,8,151,-143
22,Louisiana,48,Texas,1,Anderson County,31,0,31
22,Louisiana,48,Texas,5,Angelina County,92,332,-240
22,Louisiana,48,Texas,15,Austin County,40,94,-54
22,Louisiana,48,Texas,19,Bandera County,0,2,-2
22,Louisiana,48,Texas,21,Bastrop County,28,43,-15
22,Louisiana,48,Texas,25,Bee County,0,63,-63
22,Louisiana,48,Texas,27,Bell County,255,466,-211
22,Louisiana,48,Texas,29,Bexar County,582,780,-198
22,Louisiana,48,Texas,35,Bosque County,15,15,0
22,Louisiana,48,Texas,37,Bowie County,190,369,-179
22,Louisiana,48,Texas,39,Brazoria County,291,728,-437
22,Louisiana,48,Texas,41,Brazos County,67,227,-160
22,Louisiana,48,Texas,49,Brown County,1,26,-25
22,Louisiana,48,Texas,53,Burnet County,28,0,28
22,Louisiana,48,Texas,57,Calhoun County,31,0,31
22,Louisiana,48,Texas,59,Callahan County,0,39,-39
22,Louisiana,48,Texas,61,Cameron County,225,42,183
22,Louisiana,48,Texas,67,Cass County,166,0,166
22,Louisiana,48,Texas,71,Chambers County,46,135,-89
22,Louisiana,48,Texas,73,Cherokee County,34,115,-81
22,Louisiana,48,Texas,75,Childress County,110,0,110
22,Louisiana,48,Texas,77,Clay County,21,0,21
22,Louisiana,48,Texas,81,Coke County,0,5,-5
22,Louisiana,48,Texas,85,Collin County,358,595,-237
22,Louisiana,48,Texas,89,Colorado County,85,0,85
22,Louisiana,48,Texas,91,Comal County,30,70,-40
22,Louisiana,48,Texas,97,Cooke County,0,16,-16
22,Louisiana,48,Texas,99,Coryell County,41,89,-48
22,Louisiana,48,Texas,109,Culberson County,0,4,-4
22,Louisiana,48,Texas,113,Dallas County,1756,2362,-606
22,Louisiana,48,Texas,121,Denton County,481,1393,-912
22,Louisiana,48,Texas,127,Dimmit County,0,3,-3
22,Louisiana,48,Texas,129,Donley County,0,2,-2
22,Louisiana,48,Texas,135,Ector County,0,123,-123
22,Louisiana,48,Texas,139,Ellis County,26,62,-36
22,Louisiana,48,Texas,141,El Paso County,913,218,695
22,Louisiana,48,Texas,147,Fannin County,7,39,-32
22,Louisiana,48,Texas,157,Fort Bend County,377,955,-578
22,Louisiana,48,Texas,161,Freestone County,0,4,-4
22,Louisiana,48,Texas,167,Galveston County,443,877,-434
22,Louisiana,48,Texas,169,Garza County,15,0,15
22,Louisiana,48,Texas,171,Gillespie County,0,12,-12
22,Louisiana,48,Texas,175,Goliad County,0,65,-65
22,Louisiana,48,Texas,177,Gonzales County,0,5,-5
22,Louisiana,48,Texas,181,Grayson County,86,50,36
22,Louisiana,48,Texas,183,Gregg County,131,250,-119
22,Louisiana,48,Texas,187,Guadalupe County,103,69,34
22,Louisiana,48,Texas,189,Hale County,0,17,-17
22,Louisiana,48,Texas,191,Hall County,24,0,24
22,Louisiana,48,Texas,197,Hardeman County,0,2,-2
22,Louisiana,48,Texas,199,Hardin County,165,0,165
22,Louisiana,48,Texas,201,Harris County,5366,6748,-1382
22,Louisiana,48,Texas,203,Harrison County,243,290,-47
22,Louisiana,48,Texas,209,Hays County,54,65,-11
22,Louisiana,48,Texas,213,Henderson County,54,9,45
22,Louisiana,48,Texas,215,Hidalgo County,366,255,111
22,Louisiana,48,Texas,217,Hill County,8,4,4
22,Louisiana,48,Texas,221,Hood County,15,104,-89
22,Louisiana,48,Texas,223,Hopkins County,158,0,158
22,Louisiana,48,Texas,225,Houston County,16,0,16
22,Louisiana,48,Texas,227,Howard County,37,43,-6
22,Louisiana,48,Texas,229,Hudspeth County,0,6,-6
22,Louisiana,48,Texas,231,Hunt County,0,10,-10
22,Louisiana,48,Texas,233,Hutchinson County,0,11,-11
22,Louisiana,48,Texas,237,Jack County,0,5,-5
22,Louisiana,48,Texas,241,Jasper County,129,40,89
22,Louisiana,48,Texas,245,Jefferson County,431,964,-533
22,Louisiana,48,Texas,249,Jim Wells County,26,15,11
22,Louisiana,48,Texas,251,Johnson County,33,68,-35
22,Louisiana,48,Texas,253,Jones County,0,8,-8
22,Louisiana,48,Texas,257,Kaufman County,95,2,93
22,Louisiana,48,Texas,259,Kendall County,74,0,74
22,Louisiana,48,Texas,265,Kerr County,0,48,-48
22,Louisiana,48,Texas,267,Kimble County,0,21,-21
22,Louisiana,48,Texas,277,Lamar County,165,68,97
22,Louisiana,48,Texas,279,Lamb County,0,123,-123
22,Louisiana,48,Texas,281,Lampasas County,9,2,7
22,Louisiana,48,Texas,287,Lee County,8,0,8
22,Louisiana,48,Texas,289,Leon County,0,1,-1
22,Louisiana,48,Texas,291,Liberty County,155,179,-24
22,Louisiana,48,Texas,297,Live Oak County,0,3,-3
22,Louisiana,48,Texas,299,Llano County,3,16,-13
22,Louisiana,48,Texas,303,Lubbock County,79,110,-31
22,Louisiana,48,Texas,307,McCulloch County,0,10,-10
22,Louisiana,48,Texas,309,McLennan County,76,65,11
22,Louisiana,48,Texas,313,Madison County,0,40,-40
22,Louisiana,48,Texas,315,Marion County,0,58,-58
22,Louisiana,48,Texas,321,Matagorda County,23,30,-7
22,Louisiana,48,Texas,323,Maverick County,50,15,35
22,Louisiana,48,Texas,329,Midland County,95,235,-140
22,Louisiana,48,Texas,331,Milam County,9,21,-12
22,Louisiana,48,Texas,335,Mitchell County,0,3,-3
22,Louisiana,48,Texas,339,Montgomery County,406,1213,-807
22,Louisiana,48,Texas,347,Nacogdoches County,7,124,-117
22,Louisiana,48,Texas,349,Navarro County,23,11,12
22,Louisiana,48,Texas,351,Newton County,15,19,-4
22,Louisiana,48,Texas,355,Nueces County,287,194,93
22,Louisiana,48,Texas,361,Orange County,186,486,-300
22,Louisiana,48,Texas,365,Panola County,0,39,-39
22,Louisiana,48,Texas,367,Parker County,57,130,-73
22,Louisiana,48,Texas,373,Polk County,7,38,-31
22,Louisiana,48,Texas,375,Potter County,0,9,-9
22,Louisiana,48,Texas,381,Randall County,26,174,-148
22,Louisiana,48,Texas,389,Reeves County,0,7,-7
22,Louisiana,48,Texas,395,Robertson County,16,0,16
22,Louisiana,48,Texas,397,Rockwall County,188,79,109
22,Louisiana,48,Texas,401,Rusk County,74,111,-37
22,Louisiana,48,Texas,403,Sabine County,34,0,34
22,Louisiana,48,Texas,405,San Augustine County,101,12,89
22,Louisiana,48,Texas,407,San Jacinto County,0,20,-20
22,Louisiana,48,Texas,409,San Patricio County,85,95,-10
22,Louisiana,48,Texas,411,San Saba County,0,10,-10
22,Louisiana,48,Texas,415,Scurry County,0,16,-16
22,Louisiana,48,Texas,417,Shackelford County,0,1,-1
22,Louisiana,48,Texas,419,Shelby County,348,129,219
22,Louisiana,48,Texas,423,Smith County,155,775,-620
22,Louisiana,48,Texas,427,Starr County,0,6,-6
22,Louisiana,48,Texas,435,Sutton County,0,77,-77
22,Louisiana,48,Texas,439,Tarrant County,1230,2434,-1204
22,Louisiana,48,Texas,441,Taylor County,63,97,-34
22,Louisiana,48,Texas,449,Titus County,29,29,0
22,Louisiana,48,Texas,451,Tom Green County,72,15,57
22,Louisiana,48,Texas,453,Travis County,893,884,9
22,Louisiana,48,Texas,455,Trinity County,0,18,-18
22,Louisiana,48,Texas,457,Tyler County,50,39,11
22,Louisiana,48,Texas,459,Upshur County,42,28,14
22,Louisiana,48,Texas,461,Upton County,10,0,10
22,Louisiana,48,Texas,463,Uvalde County,7,0,7
22,Louisiana,48,Texas,465,Val Verde County,6,0,6
22,Louisiana,48,Texas,467,Van Zandt County,20,4,16
22,Louisiana,48,Texas,469,Victoria County,0,24,-24
22,Louisiana,48,Texas,471,Walker County,4,5,-1
22,Louisiana,48,Texas,473,Waller County,54,25,29
22,Louisiana,48,Texas,475,Ward County,0,19,-19
22,Louisiana,48,Texas,479,Webb County,0,17,-17
22,Louisiana,48,Texas,481,Wharton County,0,25,-25
22,Louisiana,48,Texas,483,Wheeler County,0,21,-21
22,Louisiana,48,Texas,485,Wichita County,786,111,675
22,Louisiana,48,Texas,489,Willacy County,15,0,15
22,Louisiana,48,Texas,491,Williamson County,247,223,24
22,Louisiana,48,Texas,493,Wilson County,0,26,-26
22,Louisiana,48,Texas,499,Wood County,24,8,16
22,Louisiana,48,Texas,503,Young County,0,3,-3
22,Louisiana,49,Utah,5,Cache County,7,0,7
22,Louisiana,49,Utah,11,Davis County,59,66,-7
22,Louisiana,49,Utah,13,Duchesne County,0,31,-31
22,Louisiana,49,Utah,21,Iron County,0,16,-16
22,Louisiana,49,Utah,29,Morgan County,0,26,-26
22,Louisiana,49,Utah,35,Salt Lake County,235,103,132
22,Louisiana,49,Utah,45,Tooele County,114,0,114
22,Louisiana,49,Utah,47,Uintah County,9,0,9
22,Louisiana,49,Utah,49,Utah County,29,101,-72
22,Louisiana,49,Utah,57,Weber County,0,86,-86
22,Louisiana,5,Arkansas,3,Ashley County,189,38,151
22,Louisiana,5,Arkansas,5,Baxter County,5,9,-4
22,Louisiana,5,Arkansas,7,Benton County,104,47,57
22,Louisiana,5,Arkansas,9,Boone County,2,341,-339
22,Louisiana,5,Arkansas,11,Bradley County,16,17,-1
22,Louisiana,5,Arkansas,15,Carroll County,0,6,-6
22,Louisiana,5,Arkansas,17,Chicot County,4,26,-22
22,Louisiana,5,Arkansas,19,Clark County,0,15,-15
22,Louisiana,5,Arkansas,23,Cleburne County,13,3,10
22,Louisiana,5,Arkansas,25,Cleveland County,0,12,-12
22,Louisiana,5,Arkansas,27,Columbia County,48,127,-79
22,Louisiana,5,Arkansas,29,Conway County,0,47,-47
22,Louisiana,5,Arkansas,31,Craighead County,29,163,-134
22,Louisiana,5,Arkansas,33,Crawford County,15,0,15
22,Louisiana,5,Arkansas,35,Crittenden County,91,1,90
22,Louisiana,5,Arkansas,39,Dallas County,0,27,-27
22,Louisiana,5,Arkansas,41,Desha County,32,3,29
22,Louisiana,5,Arkansas,43,Drew County,9,1,8
22,Louisiana,5,Arkansas,45,Faulkner County,38,40,-2
22,Louisiana,5,Arkansas,47,Franklin County,0,24,-24
22,Louisiana,5,Arkansas,51,Garland County,147,62,85
22,Louisiana,5,Arkansas,55,Greene County,12,72,-60
22,Louisiana,5,Arkansas,57,Hempstead County,0,7,-7
22,Louisiana,5,Arkansas,59,Hot Spring County,3,61,-58
22,Louisiana,5,Arkansas,61,Howard County,0,17,-17
22,Louisiana,5,Arkansas,63,Independence County,19,0,19
22,Louisiana,5,Arkansas,65,Izard County,0,10,-10
22,Louisiana,5,Arkansas,67,Jackson County,5,7,-2
22,Louisiana,5,Arkansas,69,Jefferson County,56,6,50
22,Louisiana,5,Arkansas,71,Johnson County,0,5,-5
22,Louisiana,5,Arkansas,73,Lafayette County,0,50,-50
22,Louisiana,5,Arkansas,81,Little River County,0,49,-49
22,Louisiana,5,Arkansas,85,Lonoke County,39,1,38
22,Louisiana,5,Arkansas,91,Miller County,47,102,-55
22,Louisiana,5,Arkansas,93,Mississippi County,34,19,15
22,Louisiana,5,Arkansas,97,Montgomery County,0,46,-46
22,Louisiana,5,Arkansas,99,Nevada County,0,15,-15
22,Louisiana,5,Arkansas,103,Ouachita County,43,129,-86
22,Louisiana,5,Arkansas,105,Perry County,0,24,-24
22,Louisiana,5,Arkansas,109,Pike County,15,1,14
22,Louisiana,5,Arkansas,111,Poinsett County,0,34,-34
22,Louisiana,5,Arkansas,113,Polk County,0,49,-49
22,Louisiana,5,Arkansas,115,Pope County,26,54,-28
22,Louisiana,5,Arkansas,117,Prairie County,21,0,21
22,Louisiana,5,Arkansas,119,Pulaski County,527,402,125
22,Louisiana,5,Arkansas,121,Randolph County,0,13,-13
22,Louisiana,5,Arkansas,123,St. Francis County,48,34,14
22,Louisiana,5,Arkansas,125,Saline County,77,239,-162
22,Louisiana,5,Arkansas,127,Scott County,0,12,-12
22,Louisiana,5,Arkansas,129,Searcy County,0,28,-28
22,Louisiana,5,Arkansas,131,Sebastian County,31,12,19
22,Louisiana,5,Arkansas,133,Sevier County,0,5,-5
22,Louisiana,5,Arkansas,137,Stone County,44,168,-124
22,Louisiana,5,Arkansas,139,Union County,135,187,-52
22,Louisiana,5,Arkansas,141,Van Buren County,36,38,-2
22,Louisiana,5,Arkansas,143,Washington County,231,149,82
22,Louisiana,5,Arkansas,145,White County,66,48,18
22,Louisiana,5,Arkansas,149,Yell County,0,158,-158
22,Louisiana,50,Vermont,1,Addison County,15,0,15
22,Louisiana,50,Vermont,7,Chittenden County,17,19,-2
22,Louisiana,50,Vermont,25,Windham County,0,14,-14
22,Louisiana,51,Virginia,3,Albemarle County,16,41,-25
22,Louisiana,51,Virginia,5,Alleghany County,0,39,-39
22,Louisiana,51,Virginia,9,Amherst County,0,10,-10
22,Louisiana,51,Virginia,13,Arlington County,103,156,-53
22,Louisiana,51,Virginia,19,Bedford County,0,1,-1
22,Louisiana,51,Virginia,25,Brunswick County,0,1,-1
22,Louisiana,51,Virginia,31,Campbell County,62,0,62
22,Louisiana,51,Virginia,33,Caroline County,0,1,-1
22,Louisiana,51,Virginia,35,Carroll County,0,28,-28
22,Louisiana,51,Virginia,41,Chesterfield County,188,72,116
22,Louisiana,51,Virginia,47,Culpeper County,0,45,-45
22,Louisiana,51,Virginia,59,Fairfax County,362,469,-107
22,Louisiana,51,Virginia,61,Fauquier County,0,14,-14
22,Louisiana,51,Virginia,73,Gloucester County,41,0,41
22,Louisiana,51,Virginia,83,Halifax County,0,1,-1
22,Louisiana,51,Virginia,85,Hanover County,3,0,3
22,Louisiana,51,Virginia,87,Henrico County,35,8,27
22,Louisiana,51,Virginia,93,Isle of Wight County,0,22,-22
22,Louisiana,51,Virginia,95,James City County,66,0,66
22,Louisiana,51,Virginia,99,King George County,0,15,-15
22,Louisiana,51,Virginia,103,Lancaster County,0,27,-27
22,Louisiana,51,Virginia,105,Lee County,18,0,18
22,Louisiana,51,Virginia,107,Loudoun County,21,67,-46
22,Louisiana,51,Virginia,109,Louisa County,81,22,59
22,Louisiana,51,Virginia,117,Mecklenburg County,0,5,-5
22,Louisiana,51,Virginia,119,Middlesex County,0,5,-5
22,Louisiana,51,Virginia,121,Montgomery County,11,17,-6
22,Louisiana,51,Virginia,125,Nelson County,5,0,5
22,Louisiana,51,Virginia,127,New Kent County,15,0,15
22,Louisiana,51,Virginia,131,Northampton County,0,21,-21
22,Louisiana,51,Virginia,135,Nottoway County,0,2,-2
22,Louisiana,51,Virginia,139,Page County,0,18,-18
22,Louisiana,51,Virginia,143,Pittsylvania County,0,25,-25
22,Louisiana,51,Virginia,145,Powhatan County,2,6,-4
22,Louisiana,51,Virginia,147,Prince Edward County,0,2,-2
22,Louisiana,51,Virginia,149,Prince George County,125,0,125
22,Louisiana,51,Virginia,153,Prince William County,245,148,97
22,Louisiana,51,Virginia,167,Russell County,2,0,2
22,Louisiana,51,Virginia,177,Spotsylvania County,0,18,-18
22,Louisiana,51,Virginia,179,Stafford County,45,66,-21
22,Louisiana,51,Virginia,187,Warren County,41,0,41
22,Louisiana,51,Virginia,191,Washington County,0,29,-29
22,Louisiana,51,Virginia,193,Westmoreland County,0,74,-74
22,Louisiana,51,Virginia,199,York County,203,0,203
22,Louisiana,51,Virginia,510,Alexandria city,93,93,0
22,Louisiana,51,Virginia,540,Charlottesville city,22,61,-39
22,Louisiana,51,Virginia,550,Chesapeake city,67,169,-102
22,Louisiana,51,Virginia,570,Colonial Heights city,0,22,-22
22,Louisiana,51,Virginia,600,Fairfax city,12,0,12
22,Louisiana,51,Virginia,650,Hampton city,0,28,-28
22,Louisiana,51,Virginia,660,Harrisonburg city,9,0,9
22,Louisiana,51,Virginia,670,Hopewell city,25,0,25
22,Louisiana,51,Virginia,678,Lexington city,11,0,11
22,Louisiana,51,Virginia,690,Martinsville city,8,0,8
22,Louisiana,51,Virginia,700,Newport News city,35,20,15
22,Louisiana,51,Virginia,710,Norfolk city,38,114,-76
22,Louisiana,51,Virginia,730,Petersburg city,22,21,1
22,Louisiana,51,Virginia,735,Poquoson city,52,0,52
22,Louisiana,51,Virginia,740,Portsmouth city,0,12,-12
22,Louisiana,51,Virginia,760,Richmond city,21,60,-39
22,Louisiana,51,Virginia,770,Roanoke city,0,6,-6
22,Louisiana,51,Virginia,790,Staunton city,3,0,3
22,Louisiana,51,Virginia,810,Virginia Beach city,401,269,132
22,Louisiana,51,Virginia,820,Waynesboro city,0,73,-73
22,Louisiana,51,Virginia,830,Williamsburg city,5,0,5
22,Louisiana,53,Washington,5,Benton County,28,0,28
22,Louisiana,53,Washington,11,Clark County,5,21,-16
22,Louisiana,53,Washington,15,Cowlitz County,59,21,38
22,Louisiana,53,Washington,25,Grant County,24,10,14
22,Louisiana,53,Washington,29,Island County,68,70,-2
22,Louisiana,53,Washington,33,King County,528,225,303
22,Louisiana,53,Washington,35,Kitsap County,14,178,-164
22,Louisiana,53,Washington,37,Kittitas County,13,0,13
22,Louisiana,53,Washington,41,Lewis County,0,18,-18
22,Louisiana,53,Washington,53,Pierce County,302,371,-69
22,Louisiana,53,Washington,55,San Juan County,0,4,-4
22,Louisiana,53,Washington,57,Skagit County,148,13,135
22,Louisiana,53,Washington,59,Skamania County,0,5,-5
22,Louisiana,53,Washington,61,Snohomish County,21,89,-68
22,Louisiana,53,Washington,63,Spokane County,42,10,32
22,Louisiana,53,Washington,67,Thurston County,40,23,17
22,Louisiana,53,Washington,73,Whatcom County,111,0,111
22,Louisiana,53,Washington,77,Yakima County,165,11,154
22,Louisiana,54,West Virginia,19,Fayette County,87,0,87
22,Louisiana,54,West Virginia,35,Jackson County,6,0,6
22,Louisiana,54,West Virginia,37,Jefferson County,17,0,17
22,Louisiana,54,West Virginia,39,Kanawha County,165,32,133
22,Louisiana,54,West Virginia,55,Mercer County,8,0,8
22,Louisiana,54,West Virginia,65,Morgan County,0,4,-4
22,Louisiana,54,West Virginia,69,Ohio County,65,0,65
22,Louisiana,54,West Virginia,81,Raleigh County,0,50,-50
22,Louisiana,54,West Virginia,107,Wood County,0,29,-29
22,Louisiana,55,Wisconsin,5,Barron County,31,0,31
22,Louisiana,55,Wisconsin,9,Brown County,28,0,28
22,Louisiana,55,Wisconsin,11,Buffalo County,0,5,-5
22,Louisiana,55,Wisconsin,17,Chippewa County,0,87,-87
22,Louisiana,55,Wisconsin,25,Dane County,63,3,60
22,Louisiana,55,Wisconsin,27,Dodge County,0,1,-1
22,Louisiana,55,Wisconsin,29,Door County,0,9,-9
22,Louisiana,55,Wisconsin,39,Fond du Lac County,0,9,-9
22,Louisiana,55,Wisconsin,49,Iowa County,0,7,-7
22,Louisiana,55,Wisconsin,53,Jackson County,24,0,24
22,Louisiana,55,Wisconsin,55,Jefferson County,0,15,-15
22,Louisiana,55,Wisconsin,59,Kenosha County,42,98,-56
22,Louisiana,55,Wisconsin,61,Kewaunee County,0,5,-5
22,Louisiana,55,Wisconsin,63,La Crosse County,1,65,-64
22,Louisiana,55,Wisconsin,71,Manitowoc County,56,6,50
22,Louisiana,55,Wisconsin,73,Marathon County,0,30,-30
22,Louisiana,55,Wisconsin,75,Marinette County,2,0,2
22,Louisiana,55,Wisconsin,77,Marquette County,17,0,17
22,Louisiana,55,Wisconsin,79,Milwaukee County,116,84,32
22,Louisiana,55,Wisconsin,87,Outagamie County,55,0,55
22,Louisiana,55,Wisconsin,95,Polk County,0,9,-9
22,Louisiana,55,Wisconsin,97,Portage County,16,2,14
22,Louisiana,55,Wisconsin,101,Racine County,0,28,-28
22,Louisiana,55,Wisconsin,105,Rock County,74,0,74
22,Louisiana,55,Wisconsin,113,Sawyer County,0,3,-3
22,Louisiana,55,Wisconsin,123,Vernon County,1,0,1
22,Louisiana,55,Wisconsin,127,Walworth County,8,5,3
22,Louisiana,55,Wisconsin,131,Washington County,0,6,-6
22,Louisiana,55,Wisconsin,133,Waukesha County,0,59,-59
22,Louisiana,55,Wisconsin,135,Waupaca County,0,7,-7
22,Louisiana,55,Wisconsin,139,Winnebago County,0,10,-10
22,Louisiana,56,Wyoming,1,Albany County,0,71,-71
22,Louisiana,56,Wyoming,5,Campbell County,0,65,-65
22,Louisiana,56,Wyoming,7,Carbon County,0,3,-3
22,Louisiana,56,Wyoming,17,Hot Springs County,0,18,-18
22,Louisiana,56,Wyoming,19,Johnson County,0,1,-1
22,Louisiana,56,Wyoming,21,Laramie County,59,84,-25
22,Louisiana,56,Wyoming,25,Natrona County,3,5,-2
22,Louisiana,56,Wyoming,31,Platte County,10,5,5
22,Louisiana,56,Wyoming,33,Sheridan County,0,7,-7
22,Louisiana,56,Wyoming,35,Sublette County,4,0,4
22,Louisiana,56,Wyoming,41,Uinta County,42,0,42
22,Louisiana,56,Wyoming,45,Weston County,2,0,2
22,Louisiana,6,California,1,Alameda County,128,138,-10
22,Louisiana,6,California,7,Butte County,50,30,20
22,Louisiana,6,California,13,Contra Costa County,125,151,-26
22,Louisiana,6,California,17,El Dorado County,0,30,-30
22,Louisiana,6,California,19,Fresno County,134,96,38
22,Louisiana,6,California,23,Humboldt County,22,53,-31
22,Louisiana,6,California,25,Imperial County,16,0,16
22,Louisiana,6,California,29,Kern County,93,94,-1
22,Louisiana,6,California,31,Kings County,43,0,43
22,Louisiana,6,California,33,Lake County,38,0,38
22,Louisiana,6,California,35,Lassen County,21,0,21
22,Louisiana,6,California,37,Los Angeles County,1289,890,399
22,Louisiana,6,California,39,Madera County,15,0,15
22,Louisiana,6,California,41,Marin County,104,18,86
22,Louisiana,6,California,47,Merced County,68,0,68
22,Louisiana,6,California,53,Monterey County,177,168,9
22,Louisiana,6,California,55,Napa County,3,9,-6
22,Louisiana,6,California,57,Nevada County,51,0,51
22,Louisiana,6,California,59,Orange County,393,390,3
22,Louisiana,6,California,61,Placer County,0,15,-15
22,Louisiana,6,California,65,Riverside County,164,243,-79
22,Louisiana,6,California,67,Sacramento County,157,541,-384
22,Louisiana,6,California,71,San Bernardino County,298,212,86
22,Louisiana,6,California,73,San Diego County,793,549,244
22,Louisiana,6,California,75,San Francisco County,257,165,92
22,Louisiana,6,California,77,San Joaquin County,32,115,-83
22,Louisiana,6,California,79,San Luis Obispo County,49,19,30
22,Louisiana,6,California,81,San Mateo County,5,18,-13
22,Louisiana,6,California,83,Santa Barbara County,47,122,-75
22,Louisiana,6,California,85,Santa Clara County,121,296,-175
22,Louisiana,6,California,87,Santa Cruz County,0,72,-72
22,Louisiana,6,California,89,Shasta County,46,126,-80
22,Louisiana,6,California,93,Siskiyou County,4,0,4
22,Louisiana,6,California,95,Solano County,27,95,-68
22,Louisiana,6,California,97,Sonoma County,13,67,-54
22,Louisiana,6,California,99,Stanislaus County,19,133,-114
22,Louisiana,6,California,101,Sutter County,0,10,-10
22,Louisiana,6,California,103,Tehama County,32,0,32
22,Louisiana,6,California,107,Tulare County,13,8,5
22,Louisiana,6,California,111,Ventura County,112,66,46
22,Louisiana,6,California,113,Yolo County,0,31,-31
22,Louisiana,72,Puerto Rico,5,Aguadilla Municipio,0,27,-27
22,Louisiana,72,Puerto Rico,11,Añasco Municipio,11,0,11
22,Louisiana,72,Puerto Rico,21,Bayamón Municipio,30,0,30
22,Louisiana,72,Puerto Rico,27,Camuy Municipio,93,0,93
22,Louisiana,72,Puerto Rico,29,Canóvanas Municipio,68,0,68
22,Louisiana,72,Puerto Rico,31,Carolina Municipio,56,0,56
22,Louisiana,72,Puerto Rico,51,Dorado Municipio,31,0,31
22,Louisiana,72,Puerto Rico,59,Guayanilla Municipio,13,0,13
22,Louisiana,72,Puerto Rico,61,Guaynabo Municipio,12,41,-29
22,Louisiana,72,Puerto Rico,97,Mayagüez Municipio,15,0,15
22,Louisiana,72,Puerto Rico,127,San Juan Municipio,99,0,99
22,Louisiana,72,Puerto Rico,137,Toa Baja Municipio,38,0,38
22,Louisiana,8,Colorado,1,Adams County,88,565,-477
22,Louisiana,8,Colorado,5,Arapahoe County,145,301,-156
22,Louisiana,8,Colorado,7,Archuleta County,0,26,-26
22,Louisiana,8,Colorado,13,Boulder County,73,181,-108
22,Louisiana,8,Colorado,14,Broomfield County,34,0,34
22,Louisiana,8,Colorado,21,Conejos County,0,2,-2
22,Louisiana,8,Colorado,29,Delta County,1,4,-3
22,Louisiana,8,Colorado,31,Denver County,133,471,-338
22,Louisiana,8,Colorado,35,Douglas County,169,129,40
22,Louisiana,8,Colorado,37,Eagle County,7,0,7
22,Louisiana,8,Colorado,41,El Paso County,618,444,174
22,Louisiana,8,Colorado,43,Fremont County,40,0,40
22,Louisiana,8,Colorado,45,Garfield County,16,0,16
22,Louisiana,8,Colorado,47,Gilpin County,0,9,-9
22,Louisiana,8,Colorado,49,Grand County,0,27,-27
22,Louisiana,8,Colorado,59,Jefferson County,172,186,-14
22,Louisiana,8,Colorado,63,Kit Carson County,13,0,13
22,Louisiana,8,Colorado,67,La Plata County,45,43,2
22,Louisiana,8,Colorado,69,Larimer County,46,169,-123
22,Louisiana,8,Colorado,75,Logan County,8,0,8
22,Louisiana,8,Colorado,77,Mesa County,123,110,13
22,Louisiana,8,Colorado,79,Mineral County,45,0,45
22,Louisiana,8,Colorado,83,Montezuma County,0,22,-22
22,Louisiana,8,Colorado,87,Morgan County,0,34,-34
22,Louisiana,8,Colorado,101,Pueblo County,33,41,-8
22,Louisiana,8,Colorado,113,San Miguel County,0,11,-11
22,Louisiana,8,Colorado,119,Teller County,38,0,38
22,Louisiana,8,Colorado,123,Weld County,28,83,-55
22,Louisiana,9,Connecticut,1,Fairfield County,92,48,44
22,Louisiana,9,Connecticut,3,Hartford County,34,76,-42
22,Louisiana,9,Connecticut,5,Litchfield County,0,34,-34
22,Louisiana,9,Connecticut,7,Middlesex County,24,34,-10
22,Louisiana,9,Connecticut,9,New Haven County,56,56,0
22,Louisiana,9,Connecticut,11,New London County,65,20,45
22,Louisiana,9,Connecticut,13,Tolland County,22,0,22
22,Louisiana,9,Connecticut,15,Windham County,0,2,-2
22,Louisiana,AFR,Africa,,-,513,0,0
22,Louisiana,ASI,Asia,,-,4868,0,0
22,Louisiana,CAM,Central America,,-,3266,0,0
22,Louisiana,CAR,Caribbean,,-,1069,0,0
22,Louisiana,EUR,Europe,,-,3280,0,0
22,Louisiana,ISL,U.S. Island Areas,,-,122,0,0
22,Louisiana,NAM,Northern America,,-,370,0,0
22,Louisiana,OCE,Oceania and At Sea,,-,227,0,0
22,Louisiana,SAM,South America,,-,733,0,0
23,Maine,1,Alabama,33,Colbert County,20,0,20
23,Maine,1,Alabama,43,Cullman County,30,0,30
23,Maine,1,Alabama,45,Dale County,12,0,12
23,Maine,1,Alabama,73,Jefferson County,0,19,-19
23,Maine,1,Alabama,95,Marshall County,0,11,-11
23,Maine,1,Alabama,101,Montgomery County,3,8,-5
23,Maine,1,Alabama,117,Shelby County,65,30,35
23,Maine,1,Alabama,127,Walker County,3,0,3
23,Maine,10,Delaware,1,Kent County,11,18,-7
23,Maine,10,Delaware,3,New Castle County,34,142,-108
23,Maine,10,Delaware,5,Sussex County,44,5,39
23,Maine,11,District of Columbia,1,District of Columbia,114,145,-31
23,Maine,12,Florida,1,Alachua County,67,0,67
23,Maine,12,Florida,5,Bay County,1,14,-13
23,Maine,12,Florida,7,Bradford County,6,0,6
23,Maine,12,Florida,9,Brevard County,150,156,-6
23,Maine,12,Florida,11,Broward County,67,146,-79
23,Maine,12,Florida,15,Charlotte County,32,498,-466
23,Maine,12,Florida,17,Citrus County,116,27,89
23,Maine,12,Florida,19,Clay County,6,0,6
23,Maine,12,Florida,21,Collier County,217,114,103
23,Maine,12,Florida,23,Columbia County,0,31,-31
23,Maine,12,Florida,27,DeSoto County,0,16,-16
23,Maine,12,Florida,31,Duval County,93,156,-63
23,Maine,12,Florida,33,Escambia County,8,9,-1
23,Maine,12,Florida,35,Flagler County,58,79,-21
23,Maine,12,Florida,43,Glades County,12,0,12
23,Maine,12,Florida,53,Hernando County,0,35,-35
23,Maine,12,Florida,55,Highlands County,54,0,54
23,Maine,12,Florida,57,Hillsborough County,61,206,-145
23,Maine,12,Florida,61,Indian River County,30,77,-47
23,Maine,12,Florida,69,Lake County,38,110,-72
23,Maine,12,Florida,71,Lee County,241,120,121
23,Maine,12,Florida,73,Leon County,7,51,-44
23,Maine,12,Florida,75,Levy County,16,20,-4
23,Maine,12,Florida,81,Manatee County,10,14,-4
23,Maine,12,Florida,83,Marion County,80,159,-79
23,Maine,12,Florida,85,Martin County,7,110,-103
23,Maine,12,Florida,86,Miami-Dade County,69,2,67
23,Maine,12,Florida,87,Monroe County,99,35,64
23,Maine,12,Florida,89,Nassau County,0,12,-12
23,Maine,12,Florida,91,Okaloosa County,65,9,56
23,Maine,12,Florida,95,Orange County,9,45,-36
23,Maine,12,Florida,97,Osceola County,10,66,-56
23,Maine,12,Florida,99,Palm Beach County,135,183,-48
23,Maine,12,Florida,101,Pasco County,179,315,-136
23,Maine,12,Florida,103,Pinellas County,236,220,16
23,Maine,12,Florida,105,Polk County,94,138,-44
23,Maine,12,Florida,107,Putnam County,0,9,-9
23,Maine,12,Florida,109,St. Johns County,42,11,31
23,Maine,12,Florida,111,St. Lucie County,4,42,-38
23,Maine,12,Florida,115,Sarasota County,193,145,48
23,Maine,12,Florida,117,Seminole County,28,72,-44
23,Maine,12,Florida,119,Sumter County,4,6,-2
23,Maine,12,Florida,127,Volusia County,96,155,-59
23,Maine,13,Georgia,13,Barrow County,0,23,-23
23,Maine,13,Georgia,25,Brantley County,0,63,-63
23,Maine,13,Georgia,33,Burke County,15,1,14
23,Maine,13,Georgia,39,Camden County,0,10,-10
23,Maine,13,Georgia,45,Carroll County,18,0,18
23,Maine,13,Georgia,51,Chatham County,19,102,-83
23,Maine,13,Georgia,59,Clarke County,0,8,-8
23,Maine,13,Georgia,67,Cobb County,0,56,-56
23,Maine,13,Georgia,73,Columbia County,1,0,1
23,Maine,13,Georgia,77,Coweta County,0,13,-13
23,Maine,13,Georgia,89,DeKalb County,2,42,-40
23,Maine,13,Georgia,95,Dougherty County,40,0,40
23,Maine,13,Georgia,113,Fayette County,12,0,12
23,Maine,13,Georgia,115,Floyd County,93,0,93
23,Maine,13,Georgia,117,Forsyth County,0,53,-53
23,Maine,13,Georgia,119,Franklin County,0,21,-21
23,Maine,13,Georgia,121,Fulton County,34,44,-10
23,Maine,13,Georgia,127,Glynn County,24,27,-3
23,Maine,13,Georgia,135,Gwinnett County,30,0,30
23,Maine,13,Georgia,139,Hall County,0,9,-9
23,Maine,13,Georgia,141,Hancock County,4,0,4
23,Maine,13,Georgia,153,Houston County,7,0,7
23,Maine,13,Georgia,175,Laurens County,15,17,-2
23,Maine,13,Georgia,179,Liberty County,33,0,33
23,Maine,13,Georgia,183,Long County,21,0,21
23,Maine,13,Georgia,199,Meriwether County,38,0,38
23,Maine,13,Georgia,215,Muscogee County,0,5,-5
23,Maine,13,Georgia,245,Richmond County,0,73,-73
23,Maine,13,Georgia,247,Rockdale County,6,0,6
23,Maine,13,Georgia,257,Stephens County,3,0,3
23,Maine,13,Georgia,261,Sumter County,11,0,11
23,Maine,13,Georgia,267,Tattnall County,3,0,3
23,Maine,13,Georgia,303,Washington County,6,0,6
23,Maine,15,Hawaii,1,Hawaii County,0,46,-46
23,Maine,15,Hawaii,3,Honolulu County,188,295,-107
23,Maine,15,Hawaii,7,Kauai County,16,0,16
23,Maine,15,Hawaii,9,Maui County,22,6,16
23,Maine,16,Idaho,1,Ada County,23,101,-78
23,Maine,16,Idaho,5,Bannock County,0,5,-5
23,Maine,16,Idaho,9,Benewah County,0,3,-3
23,Maine,16,Idaho,13,Blaine County,7,0,7
23,Maine,16,Idaho,27,Canyon County,13,0,13
23,Maine,16,Idaho,31,Cassia County,18,0,18
23,Maine,16,Idaho,39,Elmore County,28,30,-2
23,Maine,16,Idaho,55,Kootenai County,0,16,-16
23,Maine,16,Idaho,65,Madison County,0,5,-5
23,Maine,16,Idaho,83,Twin Falls County,4,0,4
23,Maine,17,Illinois,19,Champaign County,0,12,-12
23,Maine,17,Illinois,31,Cook County,210,100,110
23,Maine,17,Illinois,37,DeKalb County,3,0,3
23,Maine,17,Illinois,43,DuPage County,6,0,6
23,Maine,17,Illinois,55,Franklin County,0,93,-93
23,Maine,17,Illinois,59,Gallatin County,0,9,-9
23,Maine,17,Illinois,73,Henry County,6,0,6
23,Maine,17,Illinois,83,Jersey County,0,4,-4
23,Maine,17,Illinois,93,Kendall County,5,0,5
23,Maine,17,Illinois,97,Lake County,19,237,-218
23,Maine,17,Illinois,109,McDonough County,7,0,7
23,Maine,17,Illinois,111,McHenry County,0,16,-16
23,Maine,17,Illinois,113,McLean County,6,0,6
23,Maine,17,Illinois,121,Marion County,24,0,24
23,Maine,17,Illinois,157,Randolph County,0,3,-3
23,Maine,17,Illinois,163,St. Clair County,9,40,-31
23,Maine,17,Illinois,177,Stephenson County,44,0,44
23,Maine,17,Illinois,179,Tazewell County,0,3,-3
23,Maine,17,Illinois,201,Winnebago County,2,0,2
23,Maine,18,Indiana,3,Allen County,5,0,5
23,Maine,18,Indiana,19,Clark County,26,0,26
23,Maine,18,Indiana,43,Floyd County,0,50,-50
23,Maine,18,Indiana,55,Greene County,9,0,9
23,Maine,18,Indiana,57,Hamilton County,27,0,27
23,Maine,18,Indiana,67,Howard County,0,12,-12
23,Maine,18,Indiana,81,Johnson County,9,0,9
23,Maine,18,Indiana,89,Lake County,0,7,-7
23,Maine,18,Indiana,91,LaPorte County,3,0,3
23,Maine,18,Indiana,95,Madison County,0,50,-50
23,Maine,18,Indiana,97,Marion County,10,73,-63
23,Maine,18,Indiana,105,Monroe County,0,82,-82
23,Maine,18,Indiana,113,Noble County,2,0,2
23,Maine,18,Indiana,127,Porter County,0,2,-2
23,Maine,18,Indiana,157,Tippecanoe County,19,0,19
23,Maine,18,Indiana,163,Vanderburgh County,0,35,-35
23,Maine,18,Indiana,177,Wayne County,0,49,-49
23,Maine,19,Iowa,11,Benton County,0,4,-4
23,Maine,19,Iowa,13,Black Hawk County,44,5,39
23,Maine,19,Iowa,31,Cedar County,36,0,36
23,Maine,19,Iowa,85,Harrison County,0,2,-2
23,Maine,19,Iowa,97,Jackson County,0,14,-14
23,Maine,19,Iowa,127,Marshall County,0,20,-20
23,Maine,19,Iowa,139,Muscatine County,3,2,1
23,Maine,19,Iowa,153,Polk County,143,37,106
23,Maine,19,Iowa,157,Poweshiek County,0,17,-17
23,Maine,19,Iowa,167,Sioux County,0,2,-2
23,Maine,19,Iowa,169,Story County,29,26,3
23,Maine,2,Alaska,20,Anchorage Municipality,84,19,65
23,Maine,2,Alaska,70,Dillingham Census Area,0,4,-4
23,Maine,2,Alaska,90,Fairbanks North Star Borough,16,7,9
23,Maine,2,Alaska,110,Juneau City and Borough,34,5,29
23,Maine,2,Alaska,122,Kenai Peninsula Borough,61,4,57
23,Maine,2,Alaska,130,Ketchikan Gateway Borough,0,5,-5
23,Maine,2,Alaska,150,Kodiak Island Borough,0,29,-29
23,Maine,2,Alaska,170,Matanuska-Susitna Borough,10,9,1
23,Maine,2,Alaska,180,Nome Census Area,0,5,-5
23,Maine,2,Alaska,185,North Slope Borough,3,0,3
23,Maine,2,Alaska,195,Petersburg Borough,0,1,-1
23,Maine,2,Alaska,220,Sitka City and Borough,16,0,16
23,Maine,2,Alaska,230,Skagway Municipality,0,1,-1
23,Maine,2,Alaska,261,Valdez-Cordova Census Area,0,3,-3
23,Maine,20,Kansas,29,Cloud County,0,3,-3
23,Maine,20,Kansas,45,Douglas County,18,16,2
23,Maine,20,Kansas,61,Geary County,52,0,52
23,Maine,20,Kansas,91,Johnson County,145,23,122
23,Maine,20,Kansas,99,Labette County,0,9,-9
23,Maine,20,Kansas,103,Leavenworth County,37,0,37
23,Maine,20,Kansas,111,Lyon County,10,0,10
23,Maine,20,Kansas,113,McPherson County,0,3,-3
23,Maine,20,Kansas,117,Marshall County,0,3,-3
23,Maine,20,Kansas,125,Montgomery County,22,0,22
23,Maine,20,Kansas,161,Riley County,11,0,11
23,Maine,20,Kansas,175,Seward County,0,67,-67
23,Maine,20,Kansas,197,Wabaunsee County,0,2,-2
23,Maine,21,Kentucky,13,Bell County,0,5,-5
23,Maine,21,Kentucky,21,Boyle County,0,5,-5
23,Maine,21,Kentucky,47,Christian County,10,57,-47
23,Maine,21,Kentucky,49,Clark County,0,40,-40
23,Maine,21,Kentucky,67,Fayette County,0,79,-79
23,Maine,21,Kentucky,77,Gallatin County,12,0,12
23,Maine,21,Kentucky,93,Hardin County,186,0,186
23,Maine,21,Kentucky,111,Jefferson County,32,6,26
23,Maine,21,Kentucky,113,Jessamine County,43,18,25
23,Maine,21,Kentucky,117,Kenton County,0,21,-21
23,Maine,21,Kentucky,173,Montgomery County,13,0,13
23,Maine,21,Kentucky,185,Oldham County,0,25,-25
23,Maine,21,Kentucky,205,Rowan County,3,0,3
23,Maine,21,Kentucky,227,Warren County,0,34,-34
23,Maine,22,Louisiana,9,Avoyelles Parish,90,0,90
23,Maine,22,Louisiana,17,Caddo Parish,117,0,117
23,Maine,22,Louisiana,33,East Baton Rouge Parish,130,9,121
23,Maine,22,Louisiana,39,Evangeline Parish,16,0,16
23,Maine,22,Louisiana,53,Jefferson Davis Parish,15,0,15
23,Maine,22,Louisiana,55,Lafayette Parish,33,0,33
23,Maine,22,Louisiana,71,Orleans Parish,14,27,-13
23,Maine,22,Louisiana,79,Rapides Parish,16,0,16
23,Maine,22,Louisiana,89,St. Charles Parish,6,0,6
23,Maine,22,Louisiana,103,St. Tammany Parish,19,0,19
23,Maine,22,Louisiana,115,Vernon Parish,50,0,50
23,Maine,22,Louisiana,121,West Baton Rouge Parish,16,0,16
23,Maine,23,Maine,1,Androscoggin County,3899,3518,381
23,Maine,23,Maine,3,Aroostook County,1141,874,267
23,Maine,23,Maine,5,Cumberland County,7791,6875,916
23,Maine,23,Maine,7,Franklin County,1265,1390,-125
23,Maine,23,Maine,9,Hancock County,1353,1414,-61
23,Maine,23,Maine,11,Kennebec County,4625,4492,133
23,Maine,23,Maine,13,Knox County,1480,1072,408
23,Maine,23,Maine,15,Lincoln County,1520,1040,480
23,Maine,23,Maine,17,Oxford County,1600,1638,-38
23,Maine,23,Maine,19,Penobscot County,2925,5388,-2463
23,Maine,23,Maine,21,Piscataquis County,690,486,204
23,Maine,23,Maine,23,Sagadahoc County,1803,1817,-14
23,Maine,23,Maine,25,Somerset County,2800,1973,827
23,Maine,23,Maine,27,Waldo County,1507,1300,207
23,Maine,23,Maine,29,Washington County,713,708,5
23,Maine,23,Maine,31,York County,3553,4680,-1127
23,Maine,24,Maryland,3,Anne Arundel County,8,24,-16
23,Maine,24,Maryland,5,Baltimore County,54,97,-43
23,Maine,24,Maryland,9,Calvert County,6,0,6
23,Maine,24,Maryland,13,Carroll County,26,0,26
23,Maine,24,Maryland,15,Cecil County,0,11,-11
23,Maine,24,Maryland,17,Charles County,12,0,12
23,Maine,24,Maryland,21,Frederick County,4,0,4
23,Maine,24,Maryland,25,Harford County,6,27,-21
23,Maine,24,Maryland,27,Howard County,40,0,40
23,Maine,24,Maryland,31,Montgomery County,124,23,101
23,Maine,24,Maryland,33,Prince George's County,0,22,-22
23,Maine,24,Maryland,37,St. Mary's County,36,0,36
23,Maine,24,Maryland,41,Talbot County,0,9,-9
23,Maine,24,Maryland,43,Washington County,7,0,7
23,Maine,24,Maryland,47,Worcester County,9,0,9
23,Maine,24,Maryland,510,Baltimore city,9,57,-48
23,Maine,25,Massachusetts,1,Barnstable County,284,156,128
23,Maine,25,Massachusetts,3,Berkshire County,73,38,35
23,Maine,25,Massachusetts,5,Bristol County,242,178,64
23,Maine,25,Massachusetts,7,Dukes County,0,13,-13
23,Maine,25,Massachusetts,9,Essex County,920,373,547
23,Maine,25,Massachusetts,11,Franklin County,120,12,108
23,Maine,25,Massachusetts,13,Hampden County,163,226,-63
23,Maine,25,Massachusetts,15,Hampshire County,253,282,-29
23,Maine,25,Massachusetts,17,Middlesex County,1699,910,789
23,Maine,25,Massachusetts,19,Nantucket County,54,0,54
23,Maine,25,Massachusetts,21,Norfolk County,642,410,232
23,Maine,25,Massachusetts,23,Plymouth County,369,227,142
23,Maine,25,Massachusetts,25,Suffolk County,583,616,-33
23,Maine,25,Massachusetts,27,Worcester County,535,446,89
23,Maine,26,Michigan,5,Allegan County,0,17,-17
23,Maine,26,Michigan,29,Charlevoix County,0,25,-25
23,Maine,26,Michigan,31,Cheboygan County,0,6,-6
23,Maine,26,Michigan,33,Chippewa County,20,0,20
23,Maine,26,Michigan,35,Clare County,3,0,3
23,Maine,26,Michigan,45,Eaton County,7,0,7
23,Maine,26,Michigan,49,Genesee County,0,13,-13
23,Maine,26,Michigan,55,Grand Traverse County,0,78,-78
23,Maine,26,Michigan,61,Houghton County,11,0,11
23,Maine,26,Michigan,65,Ingham County,0,32,-32
23,Maine,26,Michigan,69,Iosco County,0,4,-4
23,Maine,26,Michigan,77,Kalamazoo County,0,27,-27
23,Maine,26,Michigan,81,Kent County,9,0,9
23,Maine,26,Michigan,91,Lenawee County,0,22,-22
23,Maine,26,Michigan,93,Livingston County,0,6,-6
23,Maine,26,Michigan,117,Montcalm County,35,3,32
23,Maine,26,Michigan,125,Oakland County,21,27,-6
23,Maine,26,Michigan,139,Ottawa County,46,88,-42
23,Maine,26,Michigan,145,Saginaw County,0,17,-17
23,Maine,26,Michigan,147,St. Clair County,0,9,-9
23,Maine,26,Michigan,157,Tuscola County,0,2,-2
23,Maine,26,Michigan,161,Washtenaw County,42,0,42
23,Maine,26,Michigan,163,Wayne County,16,0,16
23,Maine,27,Minnesota,9,Benton County,0,5,-5
23,Maine,27,Minnesota,13,Blue Earth County,1,2,-1
23,Maine,27,Minnesota,37,Dakota County,2,12,-10
23,Maine,27,Minnesota,53,Hennepin County,60,32,28
23,Maine,27,Minnesota,95,Mille Lacs County,0,6,-6
23,Maine,27,Minnesota,109,Olmsted County,7,0,7
23,Maine,27,Minnesota,123,Ramsey County,80,30,50
23,Maine,27,Minnesota,137,St. Louis County,26,0,26
23,Maine,27,Minnesota,141,Sherburne County,0,32,-32
23,Maine,27,Minnesota,145,Stearns County,0,12,-12
23,Maine,28,Mississippi,33,DeSoto County,0,36,-36
23,Maine,28,Mississippi,47,Harrison County,4,31,-27
23,Maine,28,Mississippi,105,Oktibbeha County,6,0,6
23,Maine,29,Missouri,19,Boone County,0,12,-12
23,Maine,29,Missouri,21,Buchanan County,184,0,184
23,Maine,29,Missouri,31,Cape Girardeau County,0,2,-2
23,Maine,29,Missouri,43,Christian County,0,22,-22
23,Maine,29,Missouri,47,Clay County,0,32,-32
23,Maine,29,Missouri,77,Greene County,74,0,74
23,Maine,29,Missouri,95,Jackson County,22,0,22
23,Maine,29,Missouri,105,Laclede County,0,34,-34
23,Maine,29,Missouri,131,Miller County,51,0,51
23,Maine,29,Missouri,169,Pulaski County,0,190,-190
23,Maine,29,Missouri,189,St. Louis County,3,30,-27
23,Maine,29,Missouri,510,St. Louis city,30,51,-21
23,Maine,30,Montana,1,Beaverhead County,17,0,17
23,Maine,30,Montana,9,Carbon County,0,1,-1
23,Maine,30,Montana,13,Cascade County,30,0,30
23,Maine,30,Montana,27,Fergus County,2,0,2
23,Maine,30,Montana,29,Flathead County,0,19,-19
23,Maine,30,Montana,31,Gallatin County,20,63,-43
23,Maine,30,Montana,53,Lincoln County,2,0,2
23,Maine,30,Montana,57,Madison County,0,2,-2
23,Maine,30,Montana,63,Missoula County,0,12,-12
23,Maine,30,Montana,95,Stillwater County,20,0,20
23,Maine,30,Montana,111,Yellowstone County,7,0,7
23,Maine,31,Nebraska,51,Dixon County,23,0,23
23,Maine,31,Nebraska,55,Douglas County,0,49,-49
23,Maine,31,Nebraska,57,Dundy County,26,0,26
23,Maine,31,Nebraska,75,Grant County,0,2,-2
23,Maine,31,Nebraska,95,Jefferson County,0,92,-92
23,Maine,31,Nebraska,109,Lancaster County,0,9,-9
23,Maine,31,Nebraska,119,Madison County,36,0,36
23,Maine,31,Nebraska,141,Platte County,0,1,-1
23,Maine,31,Nebraska,157,Scotts Bluff County,14,0,14
23,Maine,32,Nevada,3,Clark County,97,88,9
23,Maine,32,Nevada,5,Douglas County,34,0,34
23,Maine,32,Nevada,510,Carson City,0,52,-52
23,Maine,33,New Hampshire,1,Belknap County,96,37,59
23,Maine,33,New Hampshire,3,Carroll County,396,330,66
23,Maine,33,New Hampshire,5,Cheshire County,214,181,33
23,Maine,33,New Hampshire,7,Coos County,107,51,56
23,Maine,33,New Hampshire,9,Grafton County,209,223,-14
23,Maine,33,New Hampshire,11,Hillsborough County,1022,675,347
23,Maine,33,New Hampshire,13,Merrimack County,153,428,-275
23,Maine,33,New Hampshire,15,Rockingham County,1038,866,172
23,Maine,33,New Hampshire,17,Strafford County,1130,1023,107
23,Maine,33,New Hampshire,19,Sullivan County,64,7,57
23,Maine,34,New Jersey,1,Atlantic County,22,0,22
23,Maine,34,New Jersey,3,Bergen County,117,10,107
23,Maine,34,New Jersey,5,Burlington County,49,13,36
23,Maine,34,New Jersey,7,Camden County,23,0,23
23,Maine,34,New Jersey,11,Cumberland County,13,0,13
23,Maine,34,New Jersey,13,Essex County,56,0,56
23,Maine,34,New Jersey,15,Gloucester County,88,0,88
23,Maine,34,New Jersey,17,Hudson County,165,34,131
23,Maine,34,New Jersey,19,Hunterdon County,73,0,73
23,Maine,34,New Jersey,21,Mercer County,22,0,22
23,Maine,34,New Jersey,23,Middlesex County,76,111,-35
23,Maine,34,New Jersey,25,Monmouth County,55,18,37
23,Maine,34,New Jersey,27,Morris County,42,56,-14
23,Maine,34,New Jersey,29,Ocean County,63,33,30
23,Maine,34,New Jersey,31,Passaic County,25,60,-35
23,Maine,34,New Jersey,33,Salem County,26,6,20
23,Maine,34,New Jersey,35,Somerset County,27,19,8
23,Maine,34,New Jersey,37,Sussex County,36,15,21
23,Maine,34,New Jersey,39,Union County,47,0,47
23,Maine,35,New Mexico,1,Bernalillo County,75,154,-79
23,Maine,35,New Mexico,5,Chaves County,19,9,10
23,Maine,35,New Mexico,9,Curry County,36,0,36
23,Maine,35,New Mexico,13,Doña Ana County,41,70,-29
23,Maine,35,New Mexico,15,Eddy County,0,18,-18
23,Maine,35,New Mexico,27,Lincoln County,0,8,-8
23,Maine,35,New Mexico,28,Los Alamos County,15,0,15
23,Maine,35,New Mexico,39,Rio Arriba County,0,2,-2
23,Maine,35,New Mexico,43,Sandoval County,37,0,37
23,Maine,35,New Mexico,49,Santa Fe County,5,0,5
23,Maine,35,New Mexico,55,Taos County,0,35,-35
23,Maine,36,New York,1,Albany County,55,2,53
23,Maine,36,New York,3,Allegany County,0,4,-4
23,Maine,36,New York,5,Bronx County,119,6,113
23,Maine,36,New York,7,Broome County,0,20,-20
23,Maine,36,New York,13,Chautauqua County,8,0,8
23,Maine,36,New York,17,Chenango County,6,0,6
23,Maine,36,New York,19,Clinton County,13,18,-5
23,Maine,36,New York,21,Columbia County,36,0,36
23,Maine,36,New York,25,Delaware County,0,16,-16
23,Maine,36,New York,27,Dutchess County,75,44,31
23,Maine,36,New York,29,Erie County,65,114,-49
23,Maine,36,New York,31,Essex County,6,11,-5
23,Maine,36,New York,33,Franklin County,33,36,-3
23,Maine,36,New York,39,Greene County,3,0,3
23,Maine,36,New York,43,Herkimer County,6,0,6
23,Maine,36,New York,45,Jefferson County,32,14,18
23,Maine,36,New York,47,Kings County,576,192,384
23,Maine,36,New York,49,Lewis County,74,0,74
23,Maine,36,New York,51,Livingston County,7,5,2
23,Maine,36,New York,53,Madison County,11,12,-1
23,Maine,36,New York,55,Monroe County,60,85,-25
23,Maine,36,New York,57,Montgomery County,0,12,-12
23,Maine,36,New York,59,Nassau County,36,24,12
23,Maine,36,New York,61,New York County,290,164,126
23,Maine,36,New York,63,Niagara County,0,20,-20
23,Maine,36,New York,65,Oneida County,2,8,-6
23,Maine,36,New York,67,Onondaga County,26,89,-63
23,Maine,36,New York,69,Ontario County,9,55,-46
23,Maine,36,New York,71,Orange County,52,28,24
23,Maine,36,New York,73,Orleans County,0,5,-5
23,Maine,36,New York,75,Oswego County,0,9,-9
23,Maine,36,New York,77,Otsego County,29,10,19
23,Maine,36,New York,81,Queens County,147,35,112
23,Maine,36,New York,83,Rensselaer County,92,66,26
23,Maine,36,New York,85,Richmond County,8,0,8
23,Maine,36,New York,87,Rockland County,0,57,-57
23,Maine,36,New York,89,St. Lawrence County,56,26,30
23,Maine,36,New York,91,Saratoga County,139,88,51
23,Maine,36,New York,93,Schenectady County,18,17,1
23,Maine,36,New York,97,Schuyler County,39,0,39
23,Maine,36,New York,101,Steuben County,1,0,1
23,Maine,36,New York,103,Suffolk County,108,26,82
23,Maine,36,New York,105,Sullivan County,3,0,3
23,Maine,36,New York,109,Tompkins County,32,53,-21
23,Maine,36,New York,111,Ulster County,16,20,-4
23,Maine,36,New York,113,Warren County,30,0,30
23,Maine,36,New York,115,Washington County,24,0,24
23,Maine,36,New York,119,Westchester County,191,37,154
23,Maine,37,North Carolina,1,Alamance County,0,132,-132
23,Maine,37,North Carolina,13,Beaufort County,0,51,-51
23,Maine,37,North Carolina,19,Brunswick County,0,13,-13
23,Maine,37,North Carolina,21,Buncombe County,48,97,-49
23,Maine,37,North Carolina,23,Burke County,23,0,23
23,Maine,37,North Carolina,31,Carteret County,6,0,6
23,Maine,37,North Carolina,41,Chowan County,19,0,19
23,Maine,37,North Carolina,49,Craven County,0,32,-32
23,Maine,37,North Carolina,51,Cumberland County,36,184,-148
23,Maine,37,North Carolina,53,Currituck County,28,0,28
23,Maine,37,North Carolina,57,Davidson County,12,0,12
23,Maine,37,North Carolina,63,Durham County,66,0,66
23,Maine,37,North Carolina,65,Edgecombe County,0,11,-11
23,Maine,37,North Carolina,67,Forsyth County,8,73,-65
23,Maine,37,North Carolina,71,Gaston County,11,26,-15
23,Maine,37,North Carolina,81,Guilford County,0,94,-94
23,Maine,37,North Carolina,85,Harnett County,0,18,-18
23,Maine,37,North Carolina,87,Haywood County,0,32,-32
23,Maine,37,North Carolina,89,Henderson County,39,0,39
23,Maine,37,North Carolina,93,Hoke County,0,83,-83
23,Maine,37,North Carolina,97,Iredell County,29,17,12
23,Maine,37,North Carolina,105,Lee County,0,3,-3
23,Maine,37,North Carolina,109,Lincoln County,15,0,15
23,Maine,37,North Carolina,113,Macon County,45,0,45
23,Maine,37,North Carolina,119,Mecklenburg County,83,114,-31
23,Maine,37,North Carolina,125,Moore County,0,23,-23
23,Maine,37,North Carolina,129,New Hanover County,0,18,-18
23,Maine,37,North Carolina,133,Onslow County,38,103,-65
23,Maine,37,North Carolina,135,Orange County,19,79,-60
23,Maine,37,North Carolina,147,Pitt County,6,0,6
23,Maine,37,North Carolina,151,Randolph County,0,18,-18
23,Maine,37,North Carolina,157,Rockingham County,25,0,25
23,Maine,37,North Carolina,159,Rowan County,144,19,125
23,Maine,37,North Carolina,161,Rutherford County,0,3,-3
23,Maine,37,North Carolina,175,Transylvania County,0,19,-19
23,Maine,37,North Carolina,179,Union County,20,16,4
23,Maine,37,North Carolina,183,Wake County,44,35,9
23,Maine,37,North Carolina,191,Wayne County,14,11,3
23,Maine,37,North Carolina,197,Yadkin County,20,0,20
23,Maine,38,North Dakota,59,Morton County,11,0,11
23,Maine,38,North Dakota,101,Ward County,41,0,41
23,Maine,39,Ohio,7,Ashtabula County,24,0,24
23,Maine,39,Ohio,9,Athens County,29,0,29
23,Maine,39,Ohio,13,Belmont County,16,0,16
23,Maine,39,Ohio,17,Butler County,34,0,34
23,Maine,39,Ohio,23,Clark County,26,0,26
23,Maine,39,Ohio,25,Clermont County,37,11,26
23,Maine,39,Ohio,33,Crawford County,5,0,5
23,Maine,39,Ohio,35,Cuyahoga County,33,78,-45
23,Maine,39,Ohio,41,Delaware County,25,0,25
23,Maine,39,Ohio,45,Fairfield County,0,13,-13
23,Maine,39,Ohio,49,Franklin County,119,43,76
23,Maine,39,Ohio,57,Greene County,0,13,-13
23,Maine,39,Ohio,61,Hamilton County,24,11,13
23,Maine,39,Ohio,81,Jefferson County,0,15,-15
23,Maine,39,Ohio,83,Knox County,13,0,13
23,Maine,39,Ohio,89,Licking County,0,1,-1
23,Maine,39,Ohio,93,Lorain County,13,18,-5
23,Maine,39,Ohio,95,Lucas County,26,0,26
23,Maine,39,Ohio,103,Medina County,14,71,-57
23,Maine,39,Ohio,113,Montgomery County,15,6,9
23,Maine,39,Ohio,123,Ottawa County,10,0,10
23,Maine,39,Ohio,133,Portage County,53,0,53
23,Maine,39,Ohio,151,Stark County,5,12,-7
23,Maine,39,Ohio,153,Summit County,0,39,-39
23,Maine,39,Ohio,157,Tuscarawas County,2,0,2
23,Maine,39,Ohio,159,Union County,0,21,-21
23,Maine,39,Ohio,161,Van Wert County,6,0,6
23,Maine,39,Ohio,169,Wayne County,0,35,-35
23,Maine,4,Arizona,3,Cochise County,7,21,-14
23,Maine,4,Arizona,5,Coconino County,2,3,-1
23,Maine,4,Arizona,13,Maricopa County,181,230,-49
23,Maine,4,Arizona,15,Mohave County,0,105,-105
23,Maine,4,Arizona,19,Pima County,138,72,66
23,Maine,4,Arizona,21,Pinal County,26,99,-73
23,Maine,4,Arizona,25,Yavapai County,16,0,16
23,Maine,4,Arizona,27,Yuma County,0,49,-49
23,Maine,40,Oklahoma,27,Cleveland County,28,0,28
23,Maine,40,Oklahoma,31,Comanche County,3,83,-80
23,Maine,40,Oklahoma,47,Garfield County,0,10,-10
23,Maine,40,Oklahoma,57,Harmon County,0,1,-1
23,Maine,40,Oklahoma,83,Logan County,0,13,-13
23,Maine,40,Oklahoma,97,Mayes County,2,0,2
23,Maine,40,Oklahoma,109,Oklahoma County,33,0,33
23,Maine,40,Oklahoma,119,Payne County,0,12,-12
23,Maine,40,Oklahoma,135,Sequoyah County,4,0,4
23,Maine,40,Oklahoma,137,Stephens County,6,0,6
23,Maine,40,Oklahoma,143,Tulsa County,47,7,40
23,Maine,40,Oklahoma,145,Wagoner County,0,14,-14
23,Maine,41,Oregon,5,Clackamas County,13,0,13
23,Maine,41,Oregon,7,Clatsop County,0,9,-9
23,Maine,41,Oregon,17,Deschutes County,4,0,4
23,Maine,41,Oregon,19,Douglas County,13,0,13
23,Maine,41,Oregon,27,Hood River County,0,22,-22
23,Maine,41,Oregon,29,Jackson County,43,0,43
23,Maine,41,Oregon,33,Josephine County,3,0,3
23,Maine,41,Oregon,39,Lane County,0,56,-56
23,Maine,41,Oregon,47,Marion County,44,14,30
23,Maine,41,Oregon,51,Multnomah County,76,62,14
23,Maine,41,Oregon,67,Washington County,0,67,-67
23,Maine,41,Oregon,71,Yamhill County,15,0,15
23,Maine,42,Pennsylvania,1,Adams County,14,0,14
23,Maine,42,Pennsylvania,3,Allegheny County,70,135,-65
23,Maine,42,Pennsylvania,7,Beaver County,22,0,22
23,Maine,42,Pennsylvania,9,Bedford County,1,0,1
23,Maine,42,Pennsylvania,11,Berks County,25,26,-1
23,Maine,42,Pennsylvania,13,Blair County,1,0,1
23,Maine,42,Pennsylvania,15,Bradford County,12,0,12
23,Maine,42,Pennsylvania,17,Bucks County,25,29,-4
23,Maine,42,Pennsylvania,19,Butler County,6,14,-8
23,Maine,42,Pennsylvania,23,Cameron County,0,7,-7
23,Maine,42,Pennsylvania,25,Carbon County,3,22,-19
23,Maine,42,Pennsylvania,27,Centre County,22,4,18
23,Maine,42,Pennsylvania,29,Chester County,142,60,82
23,Maine,42,Pennsylvania,37,Columbia County,2,0,2
23,Maine,42,Pennsylvania,39,Crawford County,0,2,-2
23,Maine,42,Pennsylvania,41,Cumberland County,8,7,1
23,Maine,42,Pennsylvania,43,Dauphin County,77,0,77
23,Maine,42,Pennsylvania,45,Delaware County,12,44,-32
23,Maine,42,Pennsylvania,49,Erie County,238,10,228
23,Maine,42,Pennsylvania,51,Fayette County,16,0,16
23,Maine,42,Pennsylvania,55,Franklin County,119,0,119
23,Maine,42,Pennsylvania,63,Indiana County,9,0,9
23,Maine,42,Pennsylvania,65,Jefferson County,16,0,16
23,Maine,42,Pennsylvania,69,Lackawanna County,44,26,18
23,Maine,42,Pennsylvania,71,Lancaster County,96,41,55
23,Maine,42,Pennsylvania,75,Lebanon County,0,31,-31
23,Maine,42,Pennsylvania,77,Lehigh County,7,17,-10
23,Maine,42,Pennsylvania,79,Luzerne County,44,61,-17
23,Maine,42,Pennsylvania,83,McKean County,34,0,34
23,Maine,42,Pennsylvania,85,Mercer County,0,14,-14
23,Maine,42,Pennsylvania,89,Monroe County,5,0,5
23,Maine,42,Pennsylvania,91,Montgomery County,49,106,-57
23,Maine,42,Pennsylvania,95,Northampton County,124,12,112
23,Maine,42,Pennsylvania,97,Northumberland County,11,0,11
23,Maine,42,Pennsylvania,99,Perry County,0,6,-6
23,Maine,42,Pennsylvania,101,Philadelphia County,429,298,131
23,Maine,42,Pennsylvania,103,Pike County,0,14,-14
23,Maine,42,Pennsylvania,107,Schuylkill County,12,52,-40
23,Maine,42,Pennsylvania,109,Snyder County,0,29,-29
23,Maine,42,Pennsylvania,115,Susquehanna County,0,3,-3
23,Maine,42,Pennsylvania,117,Tioga County,0,8,-8
23,Maine,42,Pennsylvania,119,Union County,43,5,38
23,Maine,42,Pennsylvania,125,Washington County,0,12,-12
23,Maine,42,Pennsylvania,127,Wayne County,23,0,23
23,Maine,42,Pennsylvania,129,Westmoreland County,0,65,-65
23,Maine,42,Pennsylvania,133,York County,13,14,-1
23,Maine,44,Rhode Island,1,Bristol County,45,18,27
23,Maine,44,Rhode Island,3,Kent County,101,23,78
23,Maine,44,Rhode Island,5,Newport County,27,38,-11
23,Maine,44,Rhode Island,7,Providence County,385,161,224
23,Maine,44,Rhode Island,9,Washington County,111,154,-43
23,Maine,45,South Carolina,7,Anderson County,6,123,-117
23,Maine,45,South Carolina,13,Beaufort County,59,354,-295
23,Maine,45,South Carolina,15,Berkeley County,11,67,-56
23,Maine,45,South Carolina,19,Charleston County,34,80,-46
23,Maine,45,South Carolina,29,Colleton County,0,9,-9
23,Maine,45,South Carolina,35,Dorchester County,0,10,-10
23,Maine,45,South Carolina,41,Florence County,0,61,-61
23,Maine,45,South Carolina,43,Georgetown County,77,0,77
23,Maine,45,South Carolina,45,Greenville County,43,127,-84
23,Maine,45,South Carolina,51,Horry County,32,113,-81
23,Maine,45,South Carolina,53,Jasper County,0,7,-7
23,Maine,45,South Carolina,63,Lexington County,11,14,-3
23,Maine,45,South Carolina,79,Richland County,43,206,-163
23,Maine,45,South Carolina,83,Spartanburg County,0,18,-18
23,Maine,45,South Carolina,91,York County,23,2,21
23,Maine,46,South Dakota,47,Fall River County,0,8,-8
23,Maine,46,South Dakota,71,Jackson County,7,0,7
23,Maine,46,South Dakota,135,Yankton County,4,0,4
23,Maine,47,Tennessee,1,Anderson County,0,118,-118
23,Maine,47,Tennessee,11,Bradley County,0,14,-14
23,Maine,47,Tennessee,21,Cheatham County,20,0,20
23,Maine,47,Tennessee,37,Davidson County,46,121,-75
23,Maine,47,Tennessee,43,Dickson County,0,2,-2
23,Maine,47,Tennessee,51,Franklin County,4,0,4
23,Maine,47,Tennessee,59,Greene County,0,15,-15
23,Maine,47,Tennessee,63,Hamblen County,0,48,-48
23,Maine,47,Tennessee,65,Hamilton County,46,127,-81
23,Maine,47,Tennessee,109,McNairy County,14,0,14
23,Maine,47,Tennessee,119,Maury County,0,22,-22
23,Maine,47,Tennessee,123,Monroe County,7,0,7
23,Maine,47,Tennessee,125,Montgomery County,14,406,-392
23,Maine,47,Tennessee,157,Shelby County,38,0,38
23,Maine,47,Tennessee,163,Sullivan County,8,9,-1
23,Maine,47,Tennessee,173,Union County,0,11,-11
23,Maine,47,Tennessee,179,Washington County,11,27,-16
23,Maine,47,Tennessee,187,Williamson County,0,8,-8
23,Maine,48,Texas,3,Andrews County,16,0,16
23,Maine,48,Texas,21,Bastrop County,9,17,-8
23,Maine,48,Texas,27,Bell County,30,0,30
23,Maine,48,Texas,29,Bexar County,51,396,-345
23,Maine,48,Texas,39,Brazoria County,0,19,-19
23,Maine,48,Texas,55,Caldwell County,0,23,-23
23,Maine,48,Texas,61,Cameron County,45,0,45
23,Maine,48,Texas,91,Comal County,3,0,3
23,Maine,48,Texas,99,Coryell County,61,0,61
23,Maine,48,Texas,113,Dallas County,112,121,-9
23,Maine,48,Texas,121,Denton County,22,50,-28
23,Maine,48,Texas,139,Ellis County,0,10,-10
23,Maine,48,Texas,141,El Paso County,13,0,13
23,Maine,48,Texas,167,Galveston County,32,24,8
23,Maine,48,Texas,201,Harris County,19,55,-36
23,Maine,48,Texas,223,Hopkins County,53,0,53
23,Maine,48,Texas,227,Howard County,3,0,3
23,Maine,48,Texas,233,Hutchinson County,0,5,-5
23,Maine,48,Texas,245,Jefferson County,6,0,6
23,Maine,48,Texas,257,Kaufman County,4,0,4
23,Maine,48,Texas,265,Kerr County,37,0,37
23,Maine,48,Texas,291,Liberty County,15,0,15
23,Maine,48,Texas,309,McLennan County,23,0,23
23,Maine,48,Texas,323,Maverick County,44,0,44
23,Maine,48,Texas,339,Montgomery County,0,64,-64
23,Maine,48,Texas,355,Nueces County,22,5,17
23,Maine,48,Texas,373,Polk County,0,2,-2
23,Maine,48,Texas,375,Potter County,0,30,-30
23,Maine,48,Texas,377,Presidio County,0,83,-83
23,Maine,48,Texas,423,Smith County,5,0,5
23,Maine,48,Texas,439,Tarrant County,159,39,120
23,Maine,48,Texas,441,Taylor County,7,24,-17
23,Maine,48,Texas,453,Travis County,95,73,22
23,Maine,48,Texas,457,Tyler County,4,0,4
23,Maine,48,Texas,491,Williamson County,25,26,-1
23,Maine,49,Utah,5,Cache County,0,25,-25
23,Maine,49,Utah,11,Davis County,27,0,27
23,Maine,49,Utah,23,Juab County,0,5,-5
23,Maine,49,Utah,35,Salt Lake County,161,58,103
23,Maine,49,Utah,39,Sanpete County,0,18,-18
23,Maine,49,Utah,43,Summit County,7,0,7
23,Maine,49,Utah,49,Utah County,52,22,30
23,Maine,49,Utah,51,Wasatch County,28,0,28
23,Maine,49,Utah,53,Washington County,0,14,-14
23,Maine,49,Utah,57,Weber County,0,4,-4
23,Maine,5,Arkansas,119,Pulaski County,0,14,-14
23,Maine,5,Arkansas,149,Yell County,2,0,2
23,Maine,50,Vermont,1,Addison County,74,53,21
23,Maine,50,Vermont,3,Bennington County,10,0,10
23,Maine,50,Vermont,5,Caledonia County,48,25,23
23,Maine,50,Vermont,7,Chittenden County,36,235,-199
23,Maine,50,Vermont,11,Franklin County,212,24,188
23,Maine,50,Vermont,13,Grand Isle County,0,3,-3
23,Maine,50,Vermont,15,Lamoille County,61,56,5
23,Maine,50,Vermont,17,Orange County,54,24,30
23,Maine,50,Vermont,19,Orleans County,153,17,136
23,Maine,50,Vermont,21,Rutland County,58,87,-29
23,Maine,50,Vermont,23,Washington County,70,80,-10
23,Maine,50,Vermont,25,Windham County,2,85,-83
23,Maine,50,Vermont,27,Windsor County,78,24,54
23,Maine,51,Virginia,3,Albemarle County,0,17,-17
23,Maine,51,Virginia,9,Amherst County,0,7,-7
23,Maine,51,Virginia,13,Arlington County,32,19,13
23,Maine,51,Virginia,31,Campbell County,0,30,-30
23,Maine,51,Virginia,41,Chesterfield County,31,49,-18
23,Maine,51,Virginia,45,Craig County,0,53,-53
23,Maine,51,Virginia,59,Fairfax County,102,81,21
23,Maine,51,Virginia,61,Fauquier County,3,0,3
23,Maine,51,Virginia,85,Hanover County,0,41,-41
23,Maine,51,Virginia,87,Henrico County,32,61,-29
23,Maine,51,Virginia,93,Isle of Wight County,0,17,-17
23,Maine,51,Virginia,95,James City County,57,0,57
23,Maine,51,Virginia,107,Loudoun County,43,73,-30
23,Maine,51,Virginia,115,Mathews County,2,0,2
23,Maine,51,Virginia,121,Montgomery County,0,22,-22
23,Maine,51,Virginia,137,Orange County,11,0,11
23,Maine,51,Virginia,149,Prince George County,1,10,-9
23,Maine,51,Virginia,153,Prince William County,47,33,14
23,Maine,51,Virginia,177,Spotsylvania County,0,73,-73
23,Maine,51,Virginia,187,Warren County,0,7,-7
23,Maine,51,Virginia,199,York County,10,39,-29
23,Maine,51,Virginia,510,Alexandria city,50,43,7
23,Maine,51,Virginia,540,Charlottesville city,32,0,32
23,Maine,51,Virginia,550,Chesapeake city,17,33,-16
23,Maine,51,Virginia,600,Fairfax city,37,0,37
23,Maine,51,Virginia,630,Fredericksburg city,0,8,-8
23,Maine,51,Virginia,660,Harrisonburg city,26,45,-19
23,Maine,51,Virginia,680,Lynchburg city,7,23,-16
23,Maine,51,Virginia,700,Newport News city,49,34,15
23,Maine,51,Virginia,710,Norfolk city,36,119,-83
23,Maine,51,Virginia,730,Petersburg city,1,0,1
23,Maine,51,Virginia,740,Portsmouth city,3,18,-15
23,Maine,51,Virginia,760,Richmond city,0,37,-37
23,Maine,51,Virginia,770,Roanoke city,0,6,-6
23,Maine,51,Virginia,775,Salem city,0,9,-9
23,Maine,51,Virginia,800,Suffolk city,31,4,27
23,Maine,51,Virginia,810,Virginia Beach city,22,10,12
23,Maine,51,Virginia,840,Winchester city,0,39,-39
23,Maine,53,Washington,7,Chelan County,0,1,-1
23,Maine,53,Washington,11,Clark County,85,0,85
23,Maine,53,Washington,17,Douglas County,12,0,12
23,Maine,53,Washington,25,Grant County,0,124,-124
23,Maine,53,Washington,31,Jefferson County,27,0,27
23,Maine,53,Washington,33,King County,123,122,1
23,Maine,53,Washington,35,Kitsap County,0,78,-78
23,Maine,53,Washington,45,Mason County,0,15,-15
23,Maine,53,Washington,53,Pierce County,168,59,109
23,Maine,53,Washington,57,Skagit County,0,2,-2
23,Maine,53,Washington,61,Snohomish County,27,44,-17
23,Maine,53,Washington,63,Spokane County,78,0,78
23,Maine,53,Washington,67,Thurston County,20,12,8
23,Maine,53,Washington,73,Whatcom County,133,10,123
23,Maine,53,Washington,75,Whitman County,0,9,-9
23,Maine,53,Washington,77,Yakima County,0,95,-95
23,Maine,54,West Virginia,3,Berkeley County,25,59,-34
23,Maine,54,West Virginia,23,Grant County,3,0,3
23,Maine,54,West Virginia,37,Jefferson County,0,22,-22
23,Maine,54,West Virginia,39,Kanawha County,34,14,20
23,Maine,54,West Virginia,49,Marion County,0,13,-13
23,Maine,54,West Virginia,61,Monongalia County,0,14,-14
23,Maine,54,West Virginia,69,Ohio County,0,8,-8
23,Maine,54,West Virginia,77,Preston County,12,0,12
23,Maine,54,West Virginia,91,Taylor County,1,0,1
23,Maine,54,West Virginia,107,Wood County,0,5,-5
23,Maine,55,Wisconsin,25,Dane County,90,165,-75
23,Maine,55,Wisconsin,27,Dodge County,0,16,-16
23,Maine,55,Wisconsin,29,Door County,0,12,-12
23,Maine,55,Wisconsin,59,Kenosha County,31,0,31
23,Maine,55,Wisconsin,63,La Crosse County,38,0,38
23,Maine,55,Wisconsin,71,Manitowoc County,4,0,4
23,Maine,55,Wisconsin,75,Marinette County,16,0,16
23,Maine,55,Wisconsin,79,Milwaukee County,44,53,-9
23,Maine,55,Wisconsin,87,Outagamie County,3,0,3
23,Maine,55,Wisconsin,89,Ozaukee County,0,35,-35
23,Maine,55,Wisconsin,103,Richland County,0,4,-4
23,Maine,55,Wisconsin,105,Rock County,0,101,-101
23,Maine,55,Wisconsin,111,Sauk County,0,5,-5
23,Maine,55,Wisconsin,115,Shawano County,1,0,1
23,Maine,55,Wisconsin,125,Vilas County,0,10,-10
23,Maine,55,Wisconsin,133,Waukesha County,9,15,-6
23,Maine,55,Wisconsin,139,Winnebago County,0,17,-17
23,Maine,56,Wyoming,9,Converse County,0,33,-33
23,Maine,56,Wyoming,21,Laramie County,89,14,75
23,Maine,56,Wyoming,23,Lincoln County,0,94,-94
23,Maine,56,Wyoming,33,Sheridan County,0,15,-15
23,Maine,56,Wyoming,39,Teton County,0,13,-13
23,Maine,6,California,1,Alameda County,98,138,-40
23,Maine,6,California,7,Butte County,0,12,-12
23,Maine,6,California,13,Contra Costa County,3,0,3
23,Maine,6,California,17,El Dorado County,12,10,2
23,Maine,6,California,19,Fresno County,6,36,-30
23,Maine,6,California,21,Glenn County,0,49,-49
23,Maine,6,California,23,Humboldt County,0,16,-16
23,Maine,6,California,31,Kings County,22,0,22
23,Maine,6,California,37,Los Angeles County,621,119,502
23,Maine,6,California,41,Marin County,8,15,-7
23,Maine,6,California,45,Mendocino County,5,0,5
23,Maine,6,California,53,Monterey County,0,18,-18
23,Maine,6,California,55,Napa County,0,16,-16
23,Maine,6,California,59,Orange County,82,62,20
23,Maine,6,California,65,Riverside County,25,35,-10
23,Maine,6,California,67,Sacramento County,3,0,3
23,Maine,6,California,71,San Bernardino County,16,395,-379
23,Maine,6,California,73,San Diego County,274,567,-293
23,Maine,6,California,75,San Francisco County,103,56,47
23,Maine,6,California,79,San Luis Obispo County,28,0,28
23,Maine,6,California,81,San Mateo County,0,99,-99
23,Maine,6,California,83,Santa Barbara County,35,17,18
23,Maine,6,California,85,Santa Clara County,277,23,254
23,Maine,6,California,87,Santa Cruz County,32,12,20
23,Maine,6,California,95,Solano County,0,44,-44
23,Maine,6,California,97,Sonoma County,14,9,5
23,Maine,6,California,101,Sutter County,9,0,9
23,Maine,6,California,103,Tehama County,10,0,10
23,Maine,6,California,105,Trinity County,5,0,5
23,Maine,6,California,107,Tulare County,3,3,0
23,Maine,6,California,111,Ventura County,71,38,33
23,Maine,6,California,113,Yolo County,0,19,-19
23,Maine,72,Puerto Rico,127,San Juan Municipio,30,0,30
23,Maine,8,Colorado,1,Adams County,6,0,6
23,Maine,8,Colorado,5,Arapahoe County,39,1,38
23,Maine,8,Colorado,13,Boulder County,40,22,18
23,Maine,8,Colorado,14,Broomfield County,4,0,4
23,Maine,8,Colorado,31,Denver County,34,107,-73
23,Maine,8,Colorado,35,Douglas County,76,0,76
23,Maine,8,Colorado,37,Eagle County,42,3,39
23,Maine,8,Colorado,41,El Paso County,1,115,-114
23,Maine,8,Colorado,43,Fremont County,2,0,2
23,Maine,8,Colorado,45,Garfield County,0,22,-22
23,Maine,8,Colorado,51,Gunnison County,8,32,-24
23,Maine,8,Colorado,55,Huerfano County,0,3,-3
23,Maine,8,Colorado,59,Jefferson County,81,7,74
23,Maine,8,Colorado,67,La Plata County,0,2,-2
23,Maine,8,Colorado,69,Larimer County,40,3,37
23,Maine,8,Colorado,77,Mesa County,1,0,1
23,Maine,8,Colorado,87,Morgan County,0,12,-12
23,Maine,8,Colorado,89,Otero County,4,0,4
23,Maine,8,Colorado,93,Park County,47,0,47
23,Maine,8,Colorado,97,Pitkin County,60,0,60
23,Maine,8,Colorado,101,Pueblo County,25,0,25
23,Maine,8,Colorado,103,Rio Blanco County,0,2,-2
23,Maine,8,Colorado,107,Routt County,7,25,-18
23,Maine,8,Colorado,123,Weld County,4,8,-4
23,Maine,9,Connecticut,1,Fairfield County,327,221,106
23,Maine,9,Connecticut,3,Hartford County,599,230,369
23,Maine,9,Connecticut,5,Litchfield County,65,0,65
23,Maine,9,Connecticut,7,Middlesex County,45,0,45
23,Maine,9,Connecticut,9,New Haven County,463,163,300
23,Maine,9,Connecticut,11,New London County,49,181,-132
23,Maine,9,Connecticut,13,Tolland County,68,59,9
23,Maine,9,Connecticut,15,Windham County,195,16,179
23,Maine,AFR,Africa,,-,912,0,0
23,Maine,ASI,Asia,,-,1333,0,0
23,Maine,CAM,Central America,,-,299,0,0
23,Maine,CAR,Caribbean,,-,114,0,0
23,Maine,EUR,Europe,,-,1024,0,0
23,Maine,ISL,U.S. Island Areas,,-,18,0,0
23,Maine,NAM,Northern America,,-,553,0,0
23,Maine,OCE,Oceania and At Sea,,-,49,0,0
23,Maine,SAM,South America,,-,84,0,0
24,Maryland,1,Alabama,1,Autauga County,132,142,-10
24,Maryland,1,Alabama,3,Baldwin County,18,54,-36
24,Maryland,1,Alabama,5,Barbour County,66,0,66
24,Maryland,1,Alabama,9,Blount County,0,6,-6
24,Maryland,1,Alabama,15,Calhoun County,0,8,-8
24,Maryland,1,Alabama,19,Cherokee County,0,34,-34
24,Maryland,1,Alabama,23,Choctaw County,0,38,-38
24,Maryland,1,Alabama,31,Coffee County,0,11,-11
24,Maryland,1,Alabama,33,Colbert County,16,31,-15
24,Maryland,1,Alabama,43,Cullman County,0,31,-31
24,Maryland,1,Alabama,45,Dale County,6,29,-23
24,Maryland,1,Alabama,47,Dallas County,0,4,-4
24,Maryland,1,Alabama,53,Escambia County,2,6,-4
24,Maryland,1,Alabama,55,Etowah County,0,23,-23
24,Maryland,1,Alabama,63,Greene County,0,32,-32
24,Maryland,1,Alabama,69,Houston County,26,14,12
24,Maryland,1,Alabama,71,Jackson County,0,1,-1
24,Maryland,1,Alabama,73,Jefferson County,94,56,38
24,Maryland,1,Alabama,81,Lee County,62,47,15
24,Maryland,1,Alabama,83,Limestone County,16,0,16
24,Maryland,1,Alabama,87,Macon County,23,20,3
24,Maryland,1,Alabama,89,Madison County,174,193,-19
24,Maryland,1,Alabama,95,Marshall County,51,34,17
24,Maryland,1,Alabama,97,Mobile County,56,34,22
24,Maryland,1,Alabama,101,Montgomery County,96,112,-16
24,Maryland,1,Alabama,105,Perry County,0,10,-10
24,Maryland,1,Alabama,113,Russell County,86,0,86
24,Maryland,1,Alabama,117,Shelby County,181,60,121
24,Maryland,1,Alabama,121,Talladega County,15,0,15
24,Maryland,1,Alabama,125,Tuscaloosa County,0,211,-211
24,Maryland,1,Alabama,127,Walker County,27,16,11
24,Maryland,1,Alabama,129,Washington County,0,1,-1
24,Maryland,1,Alabama,131,Wilcox County,23,0,23
24,Maryland,10,Delaware,1,Kent County,532,1351,-819
24,Maryland,10,Delaware,3,New Castle County,2660,2540,120
24,Maryland,10,Delaware,5,Sussex County,2076,3709,-1633
24,Maryland,11,District of Columbia,1,District of Columbia,19984,12287,7697
24,Maryland,12,Florida,1,Alachua County,138,160,-22
24,Maryland,12,Florida,5,Bay County,184,50,134
24,Maryland,12,Florida,9,Brevard County,270,602,-332
24,Maryland,12,Florida,11,Broward County,867,1207,-340
24,Maryland,12,Florida,15,Charlotte County,26,240,-214
24,Maryland,12,Florida,17,Citrus County,86,58,28
24,Maryland,12,Florida,19,Clay County,68,359,-291
24,Maryland,12,Florida,21,Collier County,236,339,-103
24,Maryland,12,Florida,27,DeSoto County,0,20,-20
24,Maryland,12,Florida,29,Dixie County,1,0,1
24,Maryland,12,Florida,31,Duval County,763,757,6
24,Maryland,12,Florida,33,Escambia County,502,746,-244
24,Maryland,12,Florida,35,Flagler County,75,78,-3
24,Maryland,12,Florida,37,Franklin County,16,0,16
24,Maryland,12,Florida,39,Gadsden County,0,14,-14
24,Maryland,12,Florida,41,Gilchrist County,0,33,-33
24,Maryland,12,Florida,51,Hendry County,29,0,29
24,Maryland,12,Florida,53,Hernando County,107,0,107
24,Maryland,12,Florida,55,Highlands County,8,163,-155
24,Maryland,12,Florida,57,Hillsborough County,578,1529,-951
24,Maryland,12,Florida,61,Indian River County,74,234,-160
24,Maryland,12,Florida,63,Jackson County,15,0,15
24,Maryland,12,Florida,69,Lake County,0,181,-181
24,Maryland,12,Florida,71,Lee County,285,922,-637
24,Maryland,12,Florida,73,Leon County,113,231,-118
24,Maryland,12,Florida,75,Levy County,0,26,-26
24,Maryland,12,Florida,81,Manatee County,8,377,-369
24,Maryland,12,Florida,83,Marion County,71,226,-155
24,Maryland,12,Florida,85,Martin County,88,166,-78
24,Maryland,12,Florida,86,Miami-Dade County,1168,733,435
24,Maryland,12,Florida,87,Monroe County,264,107,157
24,Maryland,12,Florida,89,Nassau County,2,11,-9
24,Maryland,12,Florida,91,Okaloosa County,606,248,358
24,Maryland,12,Florida,95,Orange County,458,1035,-577
24,Maryland,12,Florida,97,Osceola County,97,261,-164
24,Maryland,12,Florida,99,Palm Beach County,466,1161,-695
24,Maryland,12,Florida,101,Pasco County,180,98,82
24,Maryland,12,Florida,103,Pinellas County,115,716,-601
24,Maryland,12,Florida,105,Polk County,51,966,-915
24,Maryland,12,Florida,107,Putnam County,0,7,-7
24,Maryland,12,Florida,109,St. Johns County,141,532,-391
24,Maryland,12,Florida,111,St. Lucie County,54,118,-64
24,Maryland,12,Florida,113,Santa Rosa County,114,357,-243
24,Maryland,12,Florida,115,Sarasota County,199,341,-142
24,Maryland,12,Florida,117,Seminole County,60,250,-190
24,Maryland,12,Florida,119,Sumter County,27,117,-90
24,Maryland,12,Florida,121,Suwannee County,131,30,101
24,Maryland,12,Florida,127,Volusia County,551,453,98
24,Maryland,12,Florida,129,Wakulla County,2,0,2
24,Maryland,12,Florida,131,Walton County,122,27,95
24,Maryland,13,Georgia,15,Bartow County,73,0,73
24,Maryland,13,Georgia,17,Ben Hill County,106,0,106
24,Maryland,13,Georgia,19,Berrien County,7,0,7
24,Maryland,13,Georgia,21,Bibb County,9,47,-38
24,Maryland,13,Georgia,25,Brantley County,0,22,-22
24,Maryland,13,Georgia,29,Bryan County,26,0,26
24,Maryland,13,Georgia,31,Bulloch County,0,30,-30
24,Maryland,13,Georgia,35,Butts County,0,29,-29
24,Maryland,13,Georgia,39,Camden County,31,114,-83
24,Maryland,13,Georgia,45,Carroll County,9,0,9
24,Maryland,13,Georgia,51,Chatham County,658,277,381
24,Maryland,13,Georgia,53,Chattahoochee County,0,33,-33
24,Maryland,13,Georgia,57,Cherokee County,48,11,37
24,Maryland,13,Georgia,59,Clarke County,28,63,-35
24,Maryland,13,Georgia,63,Clayton County,39,169,-130
24,Maryland,13,Georgia,67,Cobb County,515,611,-96
24,Maryland,13,Georgia,69,Coffee County,9,0,9
24,Maryland,13,Georgia,71,Colquitt County,1,15,-14
24,Maryland,13,Georgia,73,Columbia County,263,328,-65
24,Maryland,13,Georgia,77,Coweta County,52,51,1
24,Maryland,13,Georgia,81,Crisp County,0,55,-55
24,Maryland,13,Georgia,83,Dade County,0,15,-15
24,Maryland,13,Georgia,89,DeKalb County,787,237,550
24,Maryland,13,Georgia,93,Dooly County,0,14,-14
24,Maryland,13,Georgia,97,Douglas County,48,14,34
24,Maryland,13,Georgia,103,Effingham County,0,14,-14
24,Maryland,13,Georgia,109,Evans County,8,0,8
24,Maryland,13,Georgia,113,Fayette County,56,84,-28
24,Maryland,13,Georgia,115,Floyd County,1,28,-27
24,Maryland,13,Georgia,117,Forsyth County,49,53,-4
24,Maryland,13,Georgia,121,Fulton County,1071,765,306
24,Maryland,13,Georgia,123,Gilmer County,0,22,-22
24,Maryland,13,Georgia,127,Glynn County,13,12,1
24,Maryland,13,Georgia,129,Gordon County,44,24,20
24,Maryland,13,Georgia,131,Grady County,0,8,-8
24,Maryland,13,Georgia,133,Greene County,37,0,37
24,Maryland,13,Georgia,135,Gwinnett County,561,357,204
24,Maryland,13,Georgia,139,Hall County,60,50,10
24,Maryland,13,Georgia,143,Haralson County,55,0,55
24,Maryland,13,Georgia,151,Henry County,49,16,33
24,Maryland,13,Georgia,153,Houston County,38,35,3
24,Maryland,13,Georgia,157,Jackson County,9,1,8
24,Maryland,13,Georgia,163,Jefferson County,2,0,2
24,Maryland,13,Georgia,175,Laurens County,30,155,-125
24,Maryland,13,Georgia,177,Lee County,0,52,-52
24,Maryland,13,Georgia,179,Liberty County,132,27,105
24,Maryland,13,Georgia,181,Lincoln County,0,2,-2
24,Maryland,13,Georgia,183,Long County,0,22,-22
24,Maryland,13,Georgia,185,Lowndes County,80,7,73
24,Maryland,13,Georgia,187,Lumpkin County,20,0,20
24,Maryland,13,Georgia,195,Madison County,12,0,12
24,Maryland,13,Georgia,199,Meriwether County,3,0,3
24,Maryland,13,Georgia,215,Muscogee County,110,297,-187
24,Maryland,13,Georgia,217,Newton County,0,137,-137
24,Maryland,13,Georgia,223,Paulding County,130,41,89
24,Maryland,13,Georgia,225,Peach County,12,0,12
24,Maryland,13,Georgia,233,Polk County,38,0,38
24,Maryland,13,Georgia,245,Richmond County,376,346,30
24,Maryland,13,Georgia,247,Rockdale County,6,0,6
24,Maryland,13,Georgia,275,Thomas County,37,0,37
24,Maryland,13,Georgia,291,Union County,66,0,66
24,Maryland,13,Georgia,295,Walker County,0,11,-11
24,Maryland,13,Georgia,297,Walton County,15,1,14
24,Maryland,13,Georgia,299,Ware County,99,0,99
24,Maryland,13,Georgia,303,Washington County,0,2,-2
24,Maryland,13,Georgia,305,Wayne County,0,43,-43
24,Maryland,13,Georgia,313,Whitfield County,6,0,6
24,Maryland,13,Georgia,317,Wilkes County,0,141,-141
24,Maryland,13,Georgia,321,Worth County,0,3,-3
24,Maryland,15,Hawaii,1,Hawaii County,21,0,21
24,Maryland,15,Hawaii,3,Honolulu County,1783,804,979
24,Maryland,15,Hawaii,7,Kauai County,0,32,-32
24,Maryland,15,Hawaii,9,Maui County,103,16,87
24,Maryland,16,Idaho,1,Ada County,97,5,92
24,Maryland,16,Idaho,27,Canyon County,67,13,54
24,Maryland,16,Idaho,31,Cassia County,0,10,-10
24,Maryland,16,Idaho,39,Elmore County,0,27,-27
24,Maryland,16,Idaho,41,Franklin County,9,0,9
24,Maryland,16,Idaho,43,Fremont County,0,8,-8
24,Maryland,16,Idaho,55,Kootenai County,0,23,-23
24,Maryland,16,Idaho,57,Latah County,0,22,-22
24,Maryland,16,Idaho,65,Madison County,0,11,-11
24,Maryland,16,Idaho,81,Teton County,0,37,-37
24,Maryland,16,Idaho,83,Twin Falls County,0,12,-12
24,Maryland,16,Idaho,85,Valley County,0,36,-36
24,Maryland,17,Illinois,1,Adams County,0,2,-2
24,Maryland,17,Illinois,7,Boone County,0,38,-38
24,Maryland,17,Illinois,19,Champaign County,98,146,-48
24,Maryland,17,Illinois,21,Christian County,0,8,-8
24,Maryland,17,Illinois,25,Clay County,0,32,-32
24,Maryland,17,Illinois,29,Coles County,0,38,-38
24,Maryland,17,Illinois,31,Cook County,1029,1291,-262
24,Maryland,17,Illinois,37,DeKalb County,26,10,16
24,Maryland,17,Illinois,41,Douglas County,0,30,-30
24,Maryland,17,Illinois,43,DuPage County,178,235,-57
24,Maryland,17,Illinois,45,Edgar County,0,2,-2
24,Maryland,17,Illinois,75,Iroquois County,10,0,10
24,Maryland,17,Illinois,79,Jasper County,109,0,109
24,Maryland,17,Illinois,87,Johnson County,0,10,-10
24,Maryland,17,Illinois,89,Kane County,76,83,-7
24,Maryland,17,Illinois,91,Kankakee County,0,46,-46
24,Maryland,17,Illinois,95,Knox County,9,0,9
24,Maryland,17,Illinois,97,Lake County,205,224,-19
24,Maryland,17,Illinois,99,LaSalle County,14,0,14
24,Maryland,17,Illinois,103,Lee County,36,0,36
24,Maryland,17,Illinois,107,Logan County,15,0,15
24,Maryland,17,Illinois,109,McDonough County,31,0,31
24,Maryland,17,Illinois,111,McHenry County,93,0,93
24,Maryland,17,Illinois,113,McLean County,0,81,-81
24,Maryland,17,Illinois,115,Macon County,24,0,24
24,Maryland,17,Illinois,119,Madison County,0,56,-56
24,Maryland,17,Illinois,121,Marion County,0,14,-14
24,Maryland,17,Illinois,141,Ogle County,28,0,28
24,Maryland,17,Illinois,143,Peoria County,0,5,-5
24,Maryland,17,Illinois,161,Rock Island County,0,25,-25
24,Maryland,17,Illinois,163,St. Clair County,128,86,42
24,Maryland,17,Illinois,167,Sangamon County,19,4,15
24,Maryland,17,Illinois,177,Stephenson County,0,10,-10
24,Maryland,17,Illinois,179,Tazewell County,2,0,2
24,Maryland,17,Illinois,197,Will County,21,120,-99
24,Maryland,17,Illinois,199,Williamson County,10,12,-2
24,Maryland,18,Indiana,3,Allen County,22,112,-90
24,Maryland,18,Indiana,19,Clark County,0,86,-86
24,Maryland,18,Indiana,35,Delaware County,27,22,5
24,Maryland,18,Indiana,39,Elkhart County,28,5,23
24,Maryland,18,Indiana,43,Floyd County,79,0,79
24,Maryland,18,Indiana,53,Grant County,16,0,16
24,Maryland,18,Indiana,57,Hamilton County,184,306,-122
24,Maryland,18,Indiana,59,Hancock County,0,36,-36
24,Maryland,18,Indiana,63,Hendricks County,7,0,7
24,Maryland,18,Indiana,67,Howard County,40,0,40
24,Maryland,18,Indiana,69,Huntington County,0,27,-27
24,Maryland,18,Indiana,71,Jackson County,15,0,15
24,Maryland,18,Indiana,73,Jasper County,0,39,-39
24,Maryland,18,Indiana,81,Johnson County,60,38,22
24,Maryland,18,Indiana,85,Kosciusko County,0,20,-20
24,Maryland,18,Indiana,89,Lake County,90,23,67
24,Maryland,18,Indiana,91,LaPorte County,0,6,-6
24,Maryland,18,Indiana,95,Madison County,32,28,4
24,Maryland,18,Indiana,97,Marion County,362,90,272
24,Maryland,18,Indiana,101,Martin County,32,0,32
24,Maryland,18,Indiana,105,Monroe County,20,80,-60
24,Maryland,18,Indiana,109,Morgan County,0,7,-7
24,Maryland,18,Indiana,111,Newton County,0,3,-3
24,Maryland,18,Indiana,127,Porter County,67,11,56
24,Maryland,18,Indiana,137,Ripley County,82,0,82
24,Maryland,18,Indiana,141,St. Joseph County,48,92,-44
24,Maryland,18,Indiana,157,Tippecanoe County,78,75,3
24,Maryland,18,Indiana,159,Tipton County,23,0,23
24,Maryland,18,Indiana,167,Vigo County,37,38,-1
24,Maryland,18,Indiana,169,Wabash County,1,17,-16
24,Maryland,18,Indiana,177,Wayne County,87,27,60
24,Maryland,19,Iowa,5,Allamakee County,21,53,-32
24,Maryland,19,Iowa,11,Benton County,3,0,3
24,Maryland,19,Iowa,15,Boone County,7,7,0
24,Maryland,19,Iowa,19,Buchanan County,0,15,-15
24,Maryland,19,Iowa,27,Carroll County,57,0,57
24,Maryland,19,Iowa,31,Cedar County,0,2,-2
24,Maryland,19,Iowa,53,Decatur County,0,7,-7
24,Maryland,19,Iowa,61,Dubuque County,0,10,-10
24,Maryland,19,Iowa,63,Emmet County,0,7,-7
24,Maryland,19,Iowa,87,Henry County,0,8,-8
24,Maryland,19,Iowa,89,Howard County,25,0,25
24,Maryland,19,Iowa,97,Jackson County,0,7,-7
24,Maryland,19,Iowa,101,Jefferson County,0,2,-2
24,Maryland,19,Iowa,103,Johnson County,168,62,106
24,Maryland,19,Iowa,113,Linn County,0,11,-11
24,Maryland,19,Iowa,117,Lucas County,0,1,-1
24,Maryland,19,Iowa,121,Madison County,0,7,-7
24,Maryland,19,Iowa,125,Marion County,8,0,8
24,Maryland,19,Iowa,147,Palo Alto County,0,14,-14
24,Maryland,19,Iowa,153,Polk County,68,248,-180
24,Maryland,19,Iowa,155,Pottawattamie County,40,13,27
24,Maryland,19,Iowa,157,Poweshiek County,29,43,-14
24,Maryland,19,Iowa,163,Scott County,40,0,40
24,Maryland,19,Iowa,169,Story County,43,0,43
24,Maryland,19,Iowa,181,Warren County,20,0,20
24,Maryland,19,Iowa,187,Webster County,0,4,-4
24,Maryland,19,Iowa,189,Winnebago County,0,1,-1
24,Maryland,2,Alaska,16,Aleutians West Census Area,0,12,-12
24,Maryland,2,Alaska,20,Anchorage Municipality,398,78,320
24,Maryland,2,Alaska,60,Bristol Bay Borough,0,1,-1
24,Maryland,2,Alaska,68,Denali Borough,0,6,-6
24,Maryland,2,Alaska,90,Fairbanks North Star Borough,132,179,-47
24,Maryland,2,Alaska,110,Juneau City and Borough,13,0,13
24,Maryland,2,Alaska,122,Kenai Peninsula Borough,0,6,-6
24,Maryland,2,Alaska,130,Ketchikan Gateway Borough,0,5,-5
24,Maryland,2,Alaska,150,Kodiak Island Borough,0,12,-12
24,Maryland,2,Alaska,185,North Slope Borough,0,5,-5
24,Maryland,2,Alaska,230,Skagway Municipality,0,7,-7
24,Maryland,2,Alaska,240,Southeast Fairbanks Census Area,273,0,273
24,Maryland,20,Kansas,15,Butler County,0,24,-24
24,Maryland,20,Kansas,45,Douglas County,86,174,-88
24,Maryland,20,Kansas,53,Ellsworth County,0,3,-3
24,Maryland,20,Kansas,61,Geary County,100,68,32
24,Maryland,20,Kansas,79,Harvey County,38,0,38
24,Maryland,20,Kansas,91,Johnson County,95,89,6
24,Maryland,20,Kansas,103,Leavenworth County,44,99,-55
24,Maryland,20,Kansas,113,McPherson County,22,0,22
24,Maryland,20,Kansas,125,Montgomery County,22,0,22
24,Maryland,20,Kansas,127,Morris County,0,15,-15
24,Maryland,20,Kansas,141,Osborne County,0,2,-2
24,Maryland,20,Kansas,147,Phillips County,11,0,11
24,Maryland,20,Kansas,155,Reno County,33,0,33
24,Maryland,20,Kansas,161,Riley County,161,110,51
24,Maryland,20,Kansas,173,Sedgwick County,108,52,56
24,Maryland,20,Kansas,177,Shawnee County,8,69,-61
24,Maryland,20,Kansas,209,Wyandotte County,0,14,-14
24,Maryland,21,Kentucky,1,Adair County,0,11,-11
24,Maryland,21,Kentucky,13,Bell County,0,10,-10
24,Maryland,21,Kentucky,19,Boyd County,13,3,10
24,Maryland,21,Kentucky,21,Boyle County,71,0,71
24,Maryland,21,Kentucky,37,Campbell County,0,24,-24
24,Maryland,21,Kentucky,47,Christian County,87,106,-19
24,Maryland,21,Kentucky,49,Clark County,0,8,-8
24,Maryland,21,Kentucky,53,Clinton County,0,5,-5
24,Maryland,21,Kentucky,59,Daviess County,13,0,13
24,Maryland,21,Kentucky,61,Edmonson County,0,28,-28
24,Maryland,21,Kentucky,67,Fayette County,166,660,-494
24,Maryland,21,Kentucky,73,Franklin County,17,9,8
24,Maryland,21,Kentucky,85,Grayson County,0,22,-22
24,Maryland,21,Kentucky,89,Greenup County,12,6,6
24,Maryland,21,Kentucky,93,Hardin County,234,95,139
24,Maryland,21,Kentucky,99,Hart County,11,0,11
24,Maryland,21,Kentucky,111,Jefferson County,73,280,-207
24,Maryland,21,Kentucky,113,Jessamine County,0,59,-59
24,Maryland,21,Kentucky,117,Kenton County,6,75,-69
24,Maryland,21,Kentucky,127,Lawrence County,0,1,-1
24,Maryland,21,Kentucky,129,Lee County,0,4,-4
24,Maryland,21,Kentucky,145,McCracken County,10,0,10
24,Maryland,21,Kentucky,151,Madison County,40,70,-30
24,Maryland,21,Kentucky,159,Martin County,3,0,3
24,Maryland,21,Kentucky,161,Mason County,0,21,-21
24,Maryland,21,Kentucky,163,Meade County,0,78,-78
24,Maryland,21,Kentucky,183,Ohio County,0,75,-75
24,Maryland,21,Kentucky,185,Oldham County,0,4,-4
24,Maryland,21,Kentucky,199,Pulaski County,10,0,10
24,Maryland,21,Kentucky,201,Robertson County,0,6,-6
24,Maryland,21,Kentucky,209,Scott County,0,8,-8
24,Maryland,21,Kentucky,225,Union County,0,8,-8
24,Maryland,21,Kentucky,227,Warren County,39,0,39
24,Maryland,21,Kentucky,239,Woodford County,0,4,-4
24,Maryland,22,Louisiana,5,Ascension Parish,0,30,-30
24,Maryland,22,Louisiana,9,Avoyelles Parish,22,0,22
24,Maryland,22,Louisiana,15,Bossier Parish,8,0,8
24,Maryland,22,Louisiana,17,Caddo Parish,20,3,17
24,Maryland,22,Louisiana,33,East Baton Rouge Parish,55,49,6
24,Maryland,22,Louisiana,51,Jefferson Parish,36,54,-18
24,Maryland,22,Louisiana,55,Lafayette Parish,0,54,-54
24,Maryland,22,Louisiana,63,Livingston Parish,0,66,-66
24,Maryland,22,Louisiana,71,Orleans Parish,194,361,-167
24,Maryland,22,Louisiana,75,Plaquemines Parish,104,0,104
24,Maryland,22,Louisiana,79,Rapides Parish,0,15,-15
24,Maryland,22,Louisiana,101,St. Mary Parish,0,56,-56
24,Maryland,22,Louisiana,103,St. Tammany Parish,133,86,47
24,Maryland,22,Louisiana,105,Tangipahoa Parish,1,0,1
24,Maryland,22,Louisiana,113,Vermilion Parish,0,2,-2
24,Maryland,22,Louisiana,115,Vernon Parish,43,63,-20
24,Maryland,22,Louisiana,117,Washington Parish,0,12,-12
24,Maryland,23,Maine,1,Androscoggin County,0,65,-65
24,Maryland,23,Maine,5,Cumberland County,84,105,-21
24,Maryland,23,Maine,7,Franklin County,32,11,21
24,Maryland,23,Maine,9,Hancock County,0,5,-5
24,Maryland,23,Maine,11,Kennebec County,0,16,-16
24,Maryland,23,Maine,13,Knox County,0,5,-5
24,Maryland,23,Maine,15,Lincoln County,26,19,7
24,Maryland,23,Maine,17,Oxford County,3,14,-11
24,Maryland,23,Maine,19,Penobscot County,87,43,44
24,Maryland,23,Maine,25,Somerset County,0,27,-27
24,Maryland,23,Maine,27,Waldo County,23,0,23
24,Maryland,23,Maine,29,Washington County,0,18,-18
24,Maryland,23,Maine,31,York County,15,13,2
24,Maryland,24,Maryland,1,Allegany County,2135,2472,-337
24,Maryland,24,Maryland,3,Anne Arundel County,15546,14868,678
24,Maryland,24,Maryland,5,Baltimore County,24695,26356,-1661
24,Maryland,24,Maryland,9,Calvert County,3249,3438,-189
24,Maryland,24,Maryland,11,Caroline County,960,1438,-478
24,Maryland,24,Maryland,13,Carroll County,3792,4564,-772
24,Maryland,24,Maryland,15,Cecil County,1907,1842,65
24,Maryland,24,Maryland,17,Charles County,5076,4757,319
24,Maryland,24,Maryland,19,Dorchester County,1214,1017,197
24,Maryland,24,Maryland,21,Frederick County,6618,6974,-356
24,Maryland,24,Maryland,23,Garrett County,333,473,-140
24,Maryland,24,Maryland,25,Harford County,7043,6523,520
24,Maryland,24,Maryland,27,Howard County,12677,12280,397
24,Maryland,24,Maryland,29,Kent County,1145,625,520
24,Maryland,24,Maryland,31,Montgomery County,20168,16638,3530
24,Maryland,24,Maryland,33,Prince George's County,22670,19194,3476
24,Maryland,24,Maryland,35,Queen Anne's County,1919,2596,-677
24,Maryland,24,Maryland,37,St. Mary's County,2445,3775,-1330
24,Maryland,24,Maryland,39,Somerset County,1202,2406,-1204
24,Maryland,24,Maryland,41,Talbot County,1479,1365,114
24,Maryland,24,Maryland,43,Washington County,2827,4623,-1796
24,Maryland,24,Maryland,45,Wicomico County,3023,4680,-1657
24,Maryland,24,Maryland,47,Worcester County,1459,1940,-481
24,Maryland,24,Maryland,510,Baltimore city,22930,21668,1262
24,Maryland,25,Massachusetts,1,Barnstable County,108,116,-8
24,Maryland,25,Massachusetts,3,Berkshire County,24,59,-35
24,Maryland,25,Massachusetts,5,Bristol County,294,155,139
24,Maryland,25,Massachusetts,9,Essex County,389,300,89
24,Maryland,25,Massachusetts,11,Franklin County,30,1,29
24,Maryland,25,Massachusetts,13,Hampden County,83,59,24
24,Maryland,25,Massachusetts,15,Hampshire County,126,64,62
24,Maryland,25,Massachusetts,17,Middlesex County,722,1257,-535
24,Maryland,25,Massachusetts,21,Norfolk County,411,390,21
24,Maryland,25,Massachusetts,23,Plymouth County,154,143,11
24,Maryland,25,Massachusetts,25,Suffolk County,492,587,-95
24,Maryland,25,Massachusetts,27,Worcester County,176,158,18
24,Maryland,26,Michigan,3,Alger County,10,0,10
24,Maryland,26,Michigan,13,Baraga County,0,10,-10
24,Maryland,26,Michigan,19,Benzie County,0,3,-3
24,Maryland,26,Michigan,21,Berrien County,21,20,1
24,Maryland,26,Michigan,23,Branch County,0,17,-17
24,Maryland,26,Michigan,25,Calhoun County,19,18,1
24,Maryland,26,Michigan,33,Chippewa County,0,9,-9
24,Maryland,26,Michigan,37,Clinton County,37,16,21
24,Maryland,26,Michigan,45,Eaton County,0,8,-8
24,Maryland,26,Michigan,47,Emmet County,0,6,-6
24,Maryland,26,Michigan,49,Genesee County,84,5,79
24,Maryland,26,Michigan,55,Grand Traverse County,8,0,8
24,Maryland,26,Michigan,57,Gratiot County,14,41,-27
24,Maryland,26,Michigan,61,Houghton County,0,26,-26
24,Maryland,26,Michigan,65,Ingham County,175,138,37
24,Maryland,26,Michigan,67,Ionia County,16,8,8
24,Maryland,26,Michigan,75,Jackson County,28,0,28
24,Maryland,26,Michigan,77,Kalamazoo County,27,0,27
24,Maryland,26,Michigan,81,Kent County,57,201,-144
24,Maryland,26,Michigan,89,Leelanau County,72,0,72
24,Maryland,26,Michigan,91,Lenawee County,0,15,-15
24,Maryland,26,Michigan,93,Livingston County,0,27,-27
24,Maryland,26,Michigan,99,Macomb County,120,50,70
24,Maryland,26,Michigan,103,Marquette County,13,0,13
24,Maryland,26,Michigan,107,Mecosta County,5,0,5
24,Maryland,26,Michigan,111,Midland County,20,7,13
24,Maryland,26,Michigan,117,Montcalm County,0,5,-5
24,Maryland,26,Michigan,121,Muskegon County,6,10,-4
24,Maryland,26,Michigan,125,Oakland County,277,84,193
24,Maryland,26,Michigan,139,Ottawa County,0,81,-81
24,Maryland,26,Michigan,143,Roscommon County,0,5,-5
24,Maryland,26,Michigan,145,Saginaw County,34,0,34
24,Maryland,26,Michigan,147,St. Clair County,0,25,-25
24,Maryland,26,Michigan,157,Tuscola County,4,3,1
24,Maryland,26,Michigan,161,Washtenaw County,297,416,-119
24,Maryland,26,Michigan,163,Wayne County,322,237,85
24,Maryland,27,Minnesota,3,Anoka County,38,29,9
24,Maryland,27,Minnesota,5,Becker County,0,3,-3
24,Maryland,27,Minnesota,7,Beltrami County,20,0,20
24,Maryland,27,Minnesota,13,Blue Earth County,0,6,-6
24,Maryland,27,Minnesota,17,Carlton County,0,5,-5
24,Maryland,27,Minnesota,19,Carver County,0,2,-2
24,Maryland,27,Minnesota,21,Cass County,0,1,-1
24,Maryland,27,Minnesota,27,Clay County,14,0,14
24,Maryland,27,Minnesota,37,Dakota County,84,15,69
24,Maryland,27,Minnesota,45,Fillmore County,0,12,-12
24,Maryland,27,Minnesota,53,Hennepin County,339,440,-101
24,Maryland,27,Minnesota,55,Houston County,0,3,-3
24,Maryland,27,Minnesota,103,Nicollet County,0,13,-13
24,Maryland,27,Minnesota,109,Olmsted County,0,83,-83
24,Maryland,27,Minnesota,123,Ramsey County,177,143,34
24,Maryland,27,Minnesota,127,Redwood County,0,2,-2
24,Maryland,27,Minnesota,131,Rice County,0,10,-10
24,Maryland,27,Minnesota,137,St. Louis County,19,0,19
24,Maryland,27,Minnesota,145,Stearns County,0,86,-86
24,Maryland,27,Minnesota,153,Todd County,0,7,-7
24,Maryland,27,Minnesota,163,Washington County,20,6,14
24,Maryland,27,Minnesota,169,Winona County,0,5,-5
24,Maryland,27,Minnesota,171,Wright County,0,3,-3
24,Maryland,28,Mississippi,13,Calhoun County,0,1,-1
24,Maryland,28,Mississippi,25,Clay County,21,0,21
24,Maryland,28,Mississippi,33,DeSoto County,56,0,56
24,Maryland,28,Mississippi,35,Forrest County,14,0,14
24,Maryland,28,Mississippi,41,Greene County,0,16,-16
24,Maryland,28,Mississippi,47,Harrison County,276,231,45
24,Maryland,28,Mississippi,49,Hinds County,30,20,10
24,Maryland,28,Mississippi,59,Jackson County,21,43,-22
24,Maryland,28,Mississippi,71,Lafayette County,0,48,-48
24,Maryland,28,Mississippi,75,Lauderdale County,94,9,85
24,Maryland,28,Mississippi,85,Lincoln County,74,0,74
24,Maryland,28,Mississippi,87,Lowndes County,0,50,-50
24,Maryland,28,Mississippi,89,Madison County,0,72,-72
24,Maryland,28,Mississippi,93,Marshall County,0,8,-8
24,Maryland,28,Mississippi,105,Oktibbeha County,14,0,14
24,Maryland,28,Mississippi,109,Pearl River County,176,0,176
24,Maryland,28,Mississippi,115,Pontotoc County,0,11,-11
24,Maryland,28,Mississippi,117,Prentiss County,12,0,12
24,Maryland,28,Mississippi,133,Sunflower County,0,9,-9
24,Maryland,28,Mississippi,149,Warren County,0,8,-8
24,Maryland,28,Mississippi,161,Yalobusha County,0,13,-13
24,Maryland,29,Missouri,19,Boone County,153,26,127
24,Maryland,29,Missouri,27,Callaway County,0,18,-18
24,Maryland,29,Missouri,29,Camden County,0,10,-10
24,Maryland,29,Missouri,31,Cape Girardeau County,83,0,83
24,Maryland,29,Missouri,37,Cass County,36,0,36
24,Maryland,29,Missouri,47,Clay County,0,3,-3
24,Maryland,29,Missouri,51,Cole County,36,0,36
24,Maryland,29,Missouri,69,Dunklin County,0,105,-105
24,Maryland,29,Missouri,77,Greene County,0,23,-23
24,Maryland,29,Missouri,95,Jackson County,107,158,-51
24,Maryland,29,Missouri,97,Jasper County,0,9,-9
24,Maryland,29,Missouri,99,Jefferson County,0,24,-24
24,Maryland,29,Missouri,113,Lincoln County,14,0,14
24,Maryland,29,Missouri,145,Newton County,0,22,-22
24,Maryland,29,Missouri,147,Nodaway County,9,0,9
24,Maryland,29,Missouri,159,Pettis County,35,0,35
24,Maryland,29,Missouri,161,Phelps County,0,36,-36
24,Maryland,29,Missouri,165,Platte County,39,10,29
24,Maryland,29,Missouri,169,Pulaski County,38,472,-434
24,Maryland,29,Missouri,175,Randolph County,0,8,-8
24,Maryland,29,Missouri,179,Reynolds County,0,6,-6
24,Maryland,29,Missouri,183,St. Charles County,41,35,6
24,Maryland,29,Missouri,189,St. Louis County,90,557,-467
24,Maryland,29,Missouri,207,Stoddard County,0,20,-20
24,Maryland,29,Missouri,209,Stone County,0,3,-3
24,Maryland,29,Missouri,219,Warren County,53,0,53
24,Maryland,29,Missouri,510,St. Louis city,37,161,-124
24,Maryland,30,Montana,1,Beaverhead County,0,14,-14
24,Maryland,30,Montana,13,Cascade County,0,63,-63
24,Maryland,30,Montana,29,Flathead County,0,12,-12
24,Maryland,30,Montana,31,Gallatin County,0,72,-72
24,Maryland,30,Montana,45,Judith Basin County,0,7,-7
24,Maryland,30,Montana,47,Lake County,0,25,-25
24,Maryland,30,Montana,53,Lincoln County,12,0,12
24,Maryland,30,Montana,63,Missoula County,0,10,-10
24,Maryland,30,Montana,81,Ravalli County,26,0,26
24,Maryland,30,Montana,93,Silver Bow County,10,0,10
24,Maryland,30,Montana,95,Stillwater County,0,2,-2
24,Maryland,30,Montana,111,Yellowstone County,21,0,21
24,Maryland,31,Nebraska,3,Antelope County,0,4,-4
24,Maryland,31,Nebraska,13,Box Butte County,9,0,9
24,Maryland,31,Nebraska,45,Dawes County,0,5,-5
24,Maryland,31,Nebraska,49,Deuel County,0,8,-8
24,Maryland,31,Nebraska,51,Dixon County,34,4,30
24,Maryland,31,Nebraska,53,Dodge County,0,3,-3
24,Maryland,31,Nebraska,55,Douglas County,86,125,-39
24,Maryland,31,Nebraska,109,Lancaster County,116,177,-61
24,Maryland,31,Nebraska,141,Platte County,0,4,-4
24,Maryland,31,Nebraska,151,Saline County,0,46,-46
24,Maryland,31,Nebraska,153,Sarpy County,29,145,-116
24,Maryland,32,Nevada,1,Churchill County,0,4,-4
24,Maryland,32,Nevada,3,Clark County,442,792,-350
24,Maryland,32,Nevada,5,Douglas County,0,34,-34
24,Maryland,32,Nevada,19,Lyon County,0,8,-8
24,Maryland,32,Nevada,31,Washoe County,329,64,265
24,Maryland,32,Nevada,33,White Pine County,14,0,14
24,Maryland,32,Nevada,510,Carson City,0,23,-23
24,Maryland,33,New Hampshire,1,Belknap County,0,25,-25
24,Maryland,33,New Hampshire,3,Carroll County,5,6,-1
24,Maryland,33,New Hampshire,5,Cheshire County,17,30,-13
24,Maryland,33,New Hampshire,7,Coos County,0,4,-4
24,Maryland,33,New Hampshire,9,Grafton County,48,251,-203
24,Maryland,33,New Hampshire,11,Hillsborough County,63,140,-77
24,Maryland,33,New Hampshire,13,Merrimack County,55,79,-24
24,Maryland,33,New Hampshire,15,Rockingham County,86,140,-54
24,Maryland,33,New Hampshire,17,Strafford County,0,26,-26
24,Maryland,33,New Hampshire,19,Sullivan County,8,0,8
24,Maryland,34,New Jersey,1,Atlantic County,308,38,270
24,Maryland,34,New Jersey,3,Bergen County,381,265,116
24,Maryland,34,New Jersey,5,Burlington County,1114,232,882
24,Maryland,34,New Jersey,7,Camden County,691,514,177
24,Maryland,34,New Jersey,9,Cape May County,10,79,-69
24,Maryland,34,New Jersey,11,Cumberland County,98,6,92
24,Maryland,34,New Jersey,13,Essex County,623,244,379
24,Maryland,34,New Jersey,15,Gloucester County,126,106,20
24,Maryland,34,New Jersey,17,Hudson County,387,539,-152
24,Maryland,34,New Jersey,19,Hunterdon County,135,41,94
24,Maryland,34,New Jersey,21,Mercer County,402,96,306
24,Maryland,34,New Jersey,23,Middlesex County,682,391,291
24,Maryland,34,New Jersey,25,Monmouth County,743,369,374
24,Maryland,34,New Jersey,27,Morris County,401,107,294
24,Maryland,34,New Jersey,29,Ocean County,310,343,-33
24,Maryland,34,New Jersey,31,Passaic County,106,181,-75
24,Maryland,34,New Jersey,33,Salem County,8,57,-49
24,Maryland,34,New Jersey,35,Somerset County,395,83,312
24,Maryland,34,New Jersey,37,Sussex County,47,0,47
24,Maryland,34,New Jersey,39,Union County,335,104,231
24,Maryland,34,New Jersey,41,Warren County,18,0,18
24,Maryland,35,New Mexico,1,Bernalillo County,108,224,-116
24,Maryland,35,New Mexico,5,Chaves County,0,22,-22
24,Maryland,35,New Mexico,6,Cibola County,0,11,-11
24,Maryland,35,New Mexico,9,Curry County,282,186,96
24,Maryland,35,New Mexico,13,Doña Ana County,138,19,119
24,Maryland,35,New Mexico,17,Grant County,49,12,37
24,Maryland,35,New Mexico,25,Lea County,14,11,3
24,Maryland,35,New Mexico,28,Los Alamos County,6,17,-11
24,Maryland,35,New Mexico,35,Otero County,0,133,-133
24,Maryland,35,New Mexico,39,Rio Arriba County,78,0,78
24,Maryland,35,New Mexico,43,Sandoval County,20,3,17
24,Maryland,35,New Mexico,45,San Juan County,0,17,-17
24,Maryland,35,New Mexico,49,Santa Fe County,67,216,-149
24,Maryland,35,New Mexico,55,Taos County,0,119,-119
24,Maryland,35,New Mexico,57,Torrance County,0,9,-9
24,Maryland,35,New Mexico,61,Valencia County,0,1,-1
24,Maryland,36,New York,1,Albany County,427,100,327
24,Maryland,36,New York,3,Allegany County,0,39,-39
24,Maryland,36,New York,5,Bronx County,1294,222,1072
24,Maryland,36,New York,7,Broome County,93,152,-59
24,Maryland,36,New York,9,Cattaraugus County,34,29,5
24,Maryland,36,New York,11,Cayuga County,13,10,3
24,Maryland,36,New York,13,Chautauqua County,10,17,-7
24,Maryland,36,New York,15,Chemung County,12,4,8
24,Maryland,36,New York,17,Chenango County,14,16,-2
24,Maryland,36,New York,21,Columbia County,0,18,-18
24,Maryland,36,New York,23,Cortland County,0,4,-4
24,Maryland,36,New York,25,Delaware County,24,29,-5
24,Maryland,36,New York,27,Dutchess County,261,56,205
24,Maryland,36,New York,29,Erie County,637,250,387
24,Maryland,36,New York,31,Essex County,28,0,28
24,Maryland,36,New York,33,Franklin County,0,10,-10
24,Maryland,36,New York,35,Fulton County,30,0,30
24,Maryland,36,New York,37,Genesee County,8,10,-2
24,Maryland,36,New York,39,Greene County,9,0,9
24,Maryland,36,New York,43,Herkimer County,0,9,-9
24,Maryland,36,New York,45,Jefferson County,250,125,125
24,Maryland,36,New York,47,Kings County,2281,865,1416
24,Maryland,36,New York,49,Lewis County,54,5,49
24,Maryland,36,New York,51,Livingston County,0,73,-73
24,Maryland,36,New York,53,Madison County,95,0,95
24,Maryland,36,New York,55,Monroe County,551,370,181
24,Maryland,36,New York,59,Nassau County,861,323,538
24,Maryland,36,New York,61,New York County,1032,1637,-605
24,Maryland,36,New York,63,Niagara County,160,57,103
24,Maryland,36,New York,65,Oneida County,106,244,-138
24,Maryland,36,New York,67,Onondaga County,292,581,-289
24,Maryland,36,New York,69,Ontario County,46,50,-4
24,Maryland,36,New York,71,Orange County,195,127,68
24,Maryland,36,New York,73,Orleans County,14,0,14
24,Maryland,36,New York,75,Oswego County,0,9,-9
24,Maryland,36,New York,77,Otsego County,92,9,83
24,Maryland,36,New York,79,Putnam County,44,52,-8
24,Maryland,36,New York,81,Queens County,1627,717,910
24,Maryland,36,New York,83,Rensselaer County,49,90,-41
24,Maryland,36,New York,85,Richmond County,170,59,111
24,Maryland,36,New York,87,Rockland County,163,49,114
24,Maryland,36,New York,89,St. Lawrence County,0,11,-11
24,Maryland,36,New York,91,Saratoga County,52,116,-64
24,Maryland,36,New York,93,Schenectady County,71,24,47
24,Maryland,36,New York,95,Schoharie County,0,14,-14
24,Maryland,36,New York,97,Schuyler County,0,8,-8
24,Maryland,36,New York,101,Steuben County,36,15,21
24,Maryland,36,New York,103,Suffolk County,821,165,656
24,Maryland,36,New York,105,Sullivan County,6,0,6
24,Maryland,36,New York,109,Tompkins County,175,299,-124
24,Maryland,36,New York,111,Ulster County,11,61,-50
24,Maryland,36,New York,115,Washington County,1,29,-28
24,Maryland,36,New York,117,Wayne County,0,8,-8
24,Maryland,36,New York,119,Westchester County,912,304,608
24,Maryland,37,North Carolina,1,Alamance County,44,175,-131
24,Maryland,37,North Carolina,3,Alexander County,9,5,4
24,Maryland,37,North Carolina,11,Avery County,0,6,-6
24,Maryland,37,North Carolina,13,Beaufort County,0,29,-29
24,Maryland,37,North Carolina,15,Bertie County,2,22,-20
24,Maryland,37,North Carolina,17,Bladen County,1,0,1
24,Maryland,37,North Carolina,19,Brunswick County,159,247,-88
24,Maryland,37,North Carolina,21,Buncombe County,157,214,-57
24,Maryland,37,North Carolina,23,Burke County,82,28,54
24,Maryland,37,North Carolina,25,Cabarrus County,85,128,-43
24,Maryland,37,North Carolina,27,Caldwell County,0,9,-9
24,Maryland,37,North Carolina,31,Carteret County,46,85,-39
24,Maryland,37,North Carolina,33,Caswell County,23,0,23
24,Maryland,37,North Carolina,35,Catawba County,0,74,-74
24,Maryland,37,North Carolina,37,Chatham County,10,35,-25
24,Maryland,37,North Carolina,39,Cherokee County,0,3,-3
24,Maryland,37,North Carolina,41,Chowan County,0,68,-68
24,Maryland,37,North Carolina,45,Cleveland County,68,6,62
24,Maryland,37,North Carolina,47,Columbus County,0,10,-10
24,Maryland,37,North Carolina,49,Craven County,69,79,-10
24,Maryland,37,North Carolina,51,Cumberland County,591,398,193
24,Maryland,37,North Carolina,53,Currituck County,57,70,-13
24,Maryland,37,North Carolina,55,Dare County,0,29,-29
24,Maryland,37,North Carolina,57,Davidson County,63,10,53
24,Maryland,37,North Carolina,61,Duplin County,0,127,-127
24,Maryland,37,North Carolina,63,Durham County,778,603,175
24,Maryland,37,North Carolina,65,Edgecombe County,29,33,-4
24,Maryland,37,North Carolina,67,Forsyth County,122,174,-52
24,Maryland,37,North Carolina,69,Franklin County,15,30,-15
24,Maryland,37,North Carolina,71,Gaston County,57,198,-141
24,Maryland,37,North Carolina,73,Gates County,74,0,74
24,Maryland,37,North Carolina,77,Granville County,58,47,11
24,Maryland,37,North Carolina,79,Greene County,0,14,-14
24,Maryland,37,North Carolina,81,Guilford County,639,658,-19
24,Maryland,37,North Carolina,83,Halifax County,0,66,-66
24,Maryland,37,North Carolina,85,Harnett County,282,100,182
24,Maryland,37,North Carolina,89,Henderson County,0,80,-80
24,Maryland,37,North Carolina,91,Hertford County,108,162,-54
24,Maryland,37,North Carolina,93,Hoke County,32,68,-36
24,Maryland,37,North Carolina,97,Iredell County,49,154,-105
24,Maryland,37,North Carolina,99,Jackson County,35,39,-4
24,Maryland,37,North Carolina,101,Johnston County,114,46,68
24,Maryland,37,North Carolina,107,Lenoir County,0,44,-44
24,Maryland,37,North Carolina,109,Lincoln County,0,85,-85
24,Maryland,37,North Carolina,115,Madison County,20,57,-37
24,Maryland,37,North Carolina,117,Martin County,7,0,7
24,Maryland,37,North Carolina,119,Mecklenburg County,975,1172,-197
24,Maryland,37,North Carolina,123,Montgomery County,0,11,-11
24,Maryland,37,North Carolina,125,Moore County,50,191,-141
24,Maryland,37,North Carolina,127,Nash County,59,98,-39
24,Maryland,37,North Carolina,129,New Hanover County,124,343,-219
24,Maryland,37,North Carolina,131,Northampton County,0,22,-22
24,Maryland,37,North Carolina,133,Onslow County,717,730,-13
24,Maryland,37,North Carolina,135,Orange County,107,306,-199
24,Maryland,37,North Carolina,139,Pasquotank County,88,4,84
24,Maryland,37,North Carolina,141,Pender County,39,77,-38
24,Maryland,37,North Carolina,143,Perquimans County,0,81,-81
24,Maryland,37,North Carolina,145,Person County,29,2,27
24,Maryland,37,North Carolina,147,Pitt County,97,492,-395
24,Maryland,37,North Carolina,151,Randolph County,96,80,16
24,Maryland,37,North Carolina,153,Richmond County,16,2,14
24,Maryland,37,North Carolina,155,Robeson County,109,51,58
24,Maryland,37,North Carolina,157,Rockingham County,0,59,-59
24,Maryland,37,North Carolina,159,Rowan County,0,103,-103
24,Maryland,37,North Carolina,161,Rutherford County,0,2,-2
24,Maryland,37,North Carolina,163,Sampson County,22,0,22
24,Maryland,37,North Carolina,165,Scotland County,25,11,14
24,Maryland,37,North Carolina,167,Stanly County,0,14,-14
24,Maryland,37,North Carolina,171,Surry County,64,0,64
24,Maryland,37,North Carolina,175,Transylvania County,0,56,-56
24,Maryland,37,North Carolina,179,Union County,35,107,-72
24,Maryland,37,North Carolina,181,Vance County,176,64,112
24,Maryland,37,North Carolina,183,Wake County,814,1346,-532
24,Maryland,37,North Carolina,185,Warren County,106,4,102
24,Maryland,37,North Carolina,189,Watauga County,51,27,24
24,Maryland,37,North Carolina,191,Wayne County,25,366,-341
24,Maryland,37,North Carolina,193,Wilkes County,18,2,16
24,Maryland,37,North Carolina,195,Wilson County,27,41,-14
24,Maryland,38,North Dakota,15,Burleigh County,28,0,28
24,Maryland,38,North Dakota,17,Cass County,48,14,34
24,Maryland,38,North Dakota,33,Golden Valley County,0,11,-11
24,Maryland,38,North Dakota,35,Grand Forks County,8,41,-33
24,Maryland,38,North Dakota,89,Stark County,12,7,5
24,Maryland,38,North Dakota,93,Stutsman County,0,4,-4
24,Maryland,38,North Dakota,101,Ward County,66,18,48
24,Maryland,39,Ohio,1,Adams County,0,10,-10
24,Maryland,39,Ohio,3,Allen County,84,0,84
24,Maryland,39,Ohio,7,Ashtabula County,0,14,-14
24,Maryland,39,Ohio,9,Athens County,85,72,13
24,Maryland,39,Ohio,17,Butler County,108,231,-123
24,Maryland,39,Ohio,19,Carroll County,34,0,34
24,Maryland,39,Ohio,21,Champaign County,0,41,-41
24,Maryland,39,Ohio,23,Clark County,0,33,-33
24,Maryland,39,Ohio,25,Clermont County,82,6,76
24,Maryland,39,Ohio,27,Clinton County,0,26,-26
24,Maryland,39,Ohio,29,Columbiana County,107,58,49
24,Maryland,39,Ohio,31,Coshocton County,18,0,18
24,Maryland,39,Ohio,33,Crawford County,0,8,-8
24,Maryland,39,Ohio,35,Cuyahoga County,538,307,231
24,Maryland,39,Ohio,37,Darke County,0,6,-6
24,Maryland,39,Ohio,41,Delaware County,0,242,-242
24,Maryland,39,Ohio,49,Franklin County,627,663,-36
24,Maryland,39,Ohio,53,Gallia County,0,10,-10
24,Maryland,39,Ohio,55,Geauga County,27,0,27
24,Maryland,39,Ohio,57,Greene County,189,149,40
24,Maryland,39,Ohio,61,Hamilton County,409,332,77
24,Maryland,39,Ohio,63,Hancock County,0,28,-28
24,Maryland,39,Ohio,67,Harrison County,0,1,-1
24,Maryland,39,Ohio,69,Henry County,0,13,-13
24,Maryland,39,Ohio,77,Huron County,0,50,-50
24,Maryland,39,Ohio,81,Jefferson County,71,71,0
24,Maryland,39,Ohio,83,Knox County,0,17,-17
24,Maryland,39,Ohio,85,Lake County,194,22,172
24,Maryland,39,Ohio,89,Licking County,0,118,-118
24,Maryland,39,Ohio,93,Lorain County,50,89,-39
24,Maryland,39,Ohio,95,Lucas County,13,0,13
24,Maryland,39,Ohio,99,Mahoning County,28,12,16
24,Maryland,39,Ohio,101,Marion County,18,0,18
24,Maryland,39,Ohio,103,Medina County,41,21,20
24,Maryland,39,Ohio,113,Montgomery County,185,201,-16
24,Maryland,39,Ohio,117,Morrow County,54,2,52
24,Maryland,39,Ohio,123,Ottawa County,0,21,-21
24,Maryland,39,Ohio,129,Pickaway County,0,8,-8
24,Maryland,39,Ohio,133,Portage County,12,114,-102
24,Maryland,39,Ohio,143,Sandusky County,0,6,-6
24,Maryland,39,Ohio,145,Scioto County,26,10,16
24,Maryland,39,Ohio,149,Shelby County,0,26,-26
24,Maryland,39,Ohio,151,Stark County,25,148,-123
24,Maryland,39,Ohio,153,Summit County,71,175,-104
24,Maryland,39,Ohio,155,Trumbull County,0,20,-20
24,Maryland,39,Ohio,157,Tuscarawas County,31,0,31
24,Maryland,39,Ohio,161,Van Wert County,0,19,-19
24,Maryland,39,Ohio,165,Warren County,53,0,53
24,Maryland,39,Ohio,167,Washington County,17,50,-33
24,Maryland,39,Ohio,169,Wayne County,6,10,-4
24,Maryland,39,Ohio,173,Wood County,0,35,-35
24,Maryland,39,Ohio,175,Wyandot County,14,0,14
24,Maryland,4,Arizona,3,Cochise County,136,38,98
24,Maryland,4,Arizona,5,Coconino County,0,6,-6
24,Maryland,4,Arizona,9,Graham County,13,0,13
24,Maryland,4,Arizona,12,La Paz County,0,19,-19
24,Maryland,4,Arizona,13,Maricopa County,822,1358,-536
24,Maryland,4,Arizona,15,Mohave County,7,0,7
24,Maryland,4,Arizona,17,Navajo County,21,8,13
24,Maryland,4,Arizona,19,Pima County,194,272,-78
24,Maryland,4,Arizona,21,Pinal County,27,18,9
24,Maryland,4,Arizona,25,Yavapai County,319,0,319
24,Maryland,4,Arizona,27,Yuma County,210,0,210
24,Maryland,40,Oklahoma,1,Adair County,0,27,-27
24,Maryland,40,Oklahoma,13,Bryan County,0,3,-3
24,Maryland,40,Oklahoma,17,Canadian County,0,46,-46
24,Maryland,40,Oklahoma,19,Carter County,9,0,9
24,Maryland,40,Oklahoma,27,Cleveland County,87,73,14
24,Maryland,40,Oklahoma,31,Comanche County,133,111,22
24,Maryland,40,Oklahoma,47,Garfield County,0,55,-55
24,Maryland,40,Oklahoma,51,Grady County,0,5,-5
24,Maryland,40,Oklahoma,65,Jackson County,74,12,62
24,Maryland,40,Oklahoma,101,Muskogee County,18,0,18
24,Maryland,40,Oklahoma,109,Oklahoma County,140,293,-153
24,Maryland,40,Oklahoma,113,Osage County,0,6,-6
24,Maryland,40,Oklahoma,119,Payne County,0,16,-16
24,Maryland,40,Oklahoma,131,Rogers County,0,6,-6
24,Maryland,40,Oklahoma,137,Stephens County,4,0,4
24,Maryland,40,Oklahoma,143,Tulsa County,92,279,-187
24,Maryland,41,Oregon,3,Benton County,102,57,45
24,Maryland,41,Oregon,5,Clackamas County,45,90,-45
24,Maryland,41,Oregon,9,Columbia County,0,9,-9
24,Maryland,41,Oregon,17,Deschutes County,4,0,4
24,Maryland,41,Oregon,19,Douglas County,0,26,-26
24,Maryland,41,Oregon,29,Jackson County,0,71,-71
24,Maryland,41,Oregon,31,Jefferson County,0,6,-6
24,Maryland,41,Oregon,39,Lane County,16,124,-108
24,Maryland,41,Oregon,43,Linn County,0,15,-15
24,Maryland,41,Oregon,47,Marion County,97,37,60
24,Maryland,41,Oregon,51,Multnomah County,147,329,-182
24,Maryland,41,Oregon,65,Wasco County,0,4,-4
24,Maryland,41,Oregon,67,Washington County,28,68,-40
24,Maryland,41,Oregon,69,Wheeler County,0,7,-7
24,Maryland,41,Oregon,71,Yamhill County,0,129,-129
24,Maryland,42,Pennsylvania,1,Adams County,284,898,-614
24,Maryland,42,Pennsylvania,3,Allegheny County,1426,1323,103
24,Maryland,42,Pennsylvania,5,Armstrong County,8,58,-50
24,Maryland,42,Pennsylvania,7,Beaver County,55,98,-43
24,Maryland,42,Pennsylvania,9,Bedford County,67,176,-109
24,Maryland,42,Pennsylvania,11,Berks County,306,426,-120
24,Maryland,42,Pennsylvania,13,Blair County,89,127,-38
24,Maryland,42,Pennsylvania,15,Bradford County,22,29,-7
24,Maryland,42,Pennsylvania,17,Bucks County,549,314,235
24,Maryland,42,Pennsylvania,19,Butler County,23,14,9
24,Maryland,42,Pennsylvania,21,Cambria County,39,158,-119
24,Maryland,42,Pennsylvania,23,Cameron County,0,10,-10
24,Maryland,42,Pennsylvania,25,Carbon County,21,36,-15
24,Maryland,42,Pennsylvania,27,Centre County,297,662,-365
24,Maryland,42,Pennsylvania,29,Chester County,748,1198,-450
24,Maryland,42,Pennsylvania,31,Clarion County,19,0,19
24,Maryland,42,Pennsylvania,33,Clearfield County,8,3,5
24,Maryland,42,Pennsylvania,35,Clinton County,4,32,-28
24,Maryland,42,Pennsylvania,37,Columbia County,17,165,-148
24,Maryland,42,Pennsylvania,39,Crawford County,9,84,-75
24,Maryland,42,Pennsylvania,41,Cumberland County,412,552,-140
24,Maryland,42,Pennsylvania,43,Dauphin County,503,644,-141
24,Maryland,42,Pennsylvania,45,Delaware County,523,568,-45
24,Maryland,42,Pennsylvania,49,Erie County,229,184,45
24,Maryland,42,Pennsylvania,51,Fayette County,4,94,-90
24,Maryland,42,Pennsylvania,55,Franklin County,741,1020,-279
24,Maryland,42,Pennsylvania,57,Fulton County,99,103,-4
24,Maryland,42,Pennsylvania,59,Greene County,30,45,-15
24,Maryland,42,Pennsylvania,61,Huntingdon County,2,109,-107
24,Maryland,42,Pennsylvania,63,Indiana County,29,264,-235
24,Maryland,42,Pennsylvania,65,Jefferson County,38,22,16
24,Maryland,42,Pennsylvania,67,Juniata County,0,11,-11
24,Maryland,42,Pennsylvania,69,Lackawanna County,128,126,2
24,Maryland,42,Pennsylvania,71,Lancaster County,433,694,-261
24,Maryland,42,Pennsylvania,73,Lawrence County,35,37,-2
24,Maryland,42,Pennsylvania,75,Lebanon County,22,146,-124
24,Maryland,42,Pennsylvania,77,Lehigh County,228,246,-18
24,Maryland,42,Pennsylvania,79,Luzerne County,192,124,68
24,Maryland,42,Pennsylvania,81,Lycoming County,191,124,67
24,Maryland,42,Pennsylvania,83,McKean County,65,0,65
24,Maryland,42,Pennsylvania,85,Mercer County,36,54,-18
24,Maryland,42,Pennsylvania,87,Mifflin County,0,11,-11
24,Maryland,42,Pennsylvania,89,Monroe County,90,2,88
24,Maryland,42,Pennsylvania,91,Montgomery County,403,864,-461
24,Maryland,42,Pennsylvania,93,Montour County,11,22,-11
24,Maryland,42,Pennsylvania,95,Northampton County,213,256,-43
24,Maryland,42,Pennsylvania,97,Northumberland County,97,97,0
24,Maryland,42,Pennsylvania,99,Perry County,13,64,-51
24,Maryland,42,Pennsylvania,101,Philadelphia County,1735,1885,-150
24,Maryland,42,Pennsylvania,103,Pike County,84,42,42
24,Maryland,42,Pennsylvania,105,Potter County,0,9,-9
24,Maryland,42,Pennsylvania,107,Schuylkill County,108,8,100
24,Maryland,42,Pennsylvania,109,Snyder County,10,26,-16
24,Maryland,42,Pennsylvania,111,Somerset County,138,78,60
24,Maryland,42,Pennsylvania,113,Sullivan County,0,4,-4
24,Maryland,42,Pennsylvania,115,Susquehanna County,0,3,-3
24,Maryland,42,Pennsylvania,117,Tioga County,0,7,-7
24,Maryland,42,Pennsylvania,119,Union County,42,262,-220
24,Maryland,42,Pennsylvania,121,Venango County,0,34,-34
24,Maryland,42,Pennsylvania,123,Warren County,0,13,-13
24,Maryland,42,Pennsylvania,125,Washington County,139,113,26
24,Maryland,42,Pennsylvania,127,Wayne County,21,0,21
24,Maryland,42,Pennsylvania,129,Westmoreland County,69,297,-228
24,Maryland,42,Pennsylvania,131,Wyoming County,8,19,-11
24,Maryland,42,Pennsylvania,133,York County,2280,3787,-1507
24,Maryland,44,Rhode Island,1,Bristol County,60,10,50
24,Maryland,44,Rhode Island,3,Kent County,51,41,10
24,Maryland,44,Rhode Island,5,Newport County,280,328,-48
24,Maryland,44,Rhode Island,7,Providence County,253,307,-54
24,Maryland,44,Rhode Island,9,Washington County,31,3,28
24,Maryland,45,South Carolina,1,Abbeville County,0,7,-7
24,Maryland,45,South Carolina,3,Aiken County,24,83,-59
24,Maryland,45,South Carolina,7,Anderson County,47,35,12
24,Maryland,45,South Carolina,9,Bamberg County,0,5,-5
24,Maryland,45,South Carolina,13,Beaufort County,108,182,-74
24,Maryland,45,South Carolina,15,Berkeley County,76,240,-164
24,Maryland,45,South Carolina,19,Charleston County,240,736,-496
24,Maryland,45,South Carolina,21,Cherokee County,48,2,46
24,Maryland,45,South Carolina,25,Chesterfield County,14,21,-7
24,Maryland,45,South Carolina,27,Clarendon County,18,6,12
24,Maryland,45,South Carolina,29,Colleton County,0,28,-28
24,Maryland,45,South Carolina,31,Darlington County,16,66,-50
24,Maryland,45,South Carolina,33,Dillon County,6,0,6
24,Maryland,45,South Carolina,35,Dorchester County,77,68,9
24,Maryland,45,South Carolina,37,Edgefield County,0,12,-12
24,Maryland,45,South Carolina,41,Florence County,65,12,53
24,Maryland,45,South Carolina,43,Georgetown County,0,91,-91
24,Maryland,45,South Carolina,45,Greenville County,113,266,-153
24,Maryland,45,South Carolina,47,Greenwood County,0,257,-257
24,Maryland,45,South Carolina,51,Horry County,195,725,-530
24,Maryland,45,South Carolina,55,Kershaw County,0,37,-37
24,Maryland,45,South Carolina,57,Lancaster County,0,42,-42
24,Maryland,45,South Carolina,59,Laurens County,0,17,-17
24,Maryland,45,South Carolina,63,Lexington County,35,290,-255
24,Maryland,45,South Carolina,67,Marion County,28,0,28
24,Maryland,45,South Carolina,69,Marlboro County,11,11,0
24,Maryland,45,South Carolina,71,Newberry County,17,0,17
24,Maryland,45,South Carolina,73,Oconee County,2,147,-145
24,Maryland,45,South Carolina,75,Orangeburg County,40,0,40
24,Maryland,45,South Carolina,77,Pickens County,94,72,22
24,Maryland,45,South Carolina,79,Richland County,337,797,-460
24,Maryland,45,South Carolina,81,Saluda County,0,5,-5
24,Maryland,45,South Carolina,83,Spartanburg County,26,82,-56
24,Maryland,45,South Carolina,85,Sumter County,84,50,34
24,Maryland,45,South Carolina,91,York County,275,63,212
24,Maryland,46,South Dakota,13,Brown County,7,10,-3
24,Maryland,46,South Dakota,23,Charles Mix County,0,16,-16
24,Maryland,46,South Dakota,27,Clay County,0,4,-4
24,Maryland,46,South Dakota,93,Meade County,0,8,-8
24,Maryland,46,South Dakota,99,Minnehaha County,74,87,-13
24,Maryland,46,South Dakota,103,Pennington County,50,31,19
24,Maryland,46,South Dakota,121,Todd County,0,6,-6
24,Maryland,46,South Dakota,127,Union County,6,0,6
24,Maryland,47,Tennessee,1,Anderson County,0,13,-13
24,Maryland,47,Tennessee,9,Blount County,153,73,80
24,Maryland,47,Tennessee,11,Bradley County,0,16,-16
24,Maryland,47,Tennessee,17,Carroll County,0,7,-7
24,Maryland,47,Tennessee,19,Carter County,45,0,45
24,Maryland,47,Tennessee,21,Cheatham County,45,0,45
24,Maryland,47,Tennessee,25,Claiborne County,0,39,-39
24,Maryland,47,Tennessee,29,Cocke County,0,89,-89
24,Maryland,47,Tennessee,31,Coffee County,0,26,-26
24,Maryland,47,Tennessee,37,Davidson County,189,352,-163
24,Maryland,47,Tennessee,43,Dickson County,0,104,-104
24,Maryland,47,Tennessee,49,Fentress County,0,7,-7
24,Maryland,47,Tennessee,51,Franklin County,0,19,-19
24,Maryland,47,Tennessee,55,Giles County,0,19,-19
24,Maryland,47,Tennessee,59,Greene County,8,0,8
24,Maryland,47,Tennessee,63,Hamblen County,11,0,11
24,Maryland,47,Tennessee,65,Hamilton County,47,85,-38
24,Maryland,47,Tennessee,73,Hawkins County,12,0,12
24,Maryland,47,Tennessee,77,Henderson County,10,27,-17
24,Maryland,47,Tennessee,79,Henry County,0,1,-1
24,Maryland,47,Tennessee,89,Jefferson County,0,7,-7
24,Maryland,47,Tennessee,93,Knox County,100,285,-185
24,Maryland,47,Tennessee,105,Loudon County,8,0,8
24,Maryland,47,Tennessee,107,McMinn County,32,0,32
24,Maryland,47,Tennessee,119,Maury County,21,0,21
24,Maryland,47,Tennessee,125,Montgomery County,43,128,-85
24,Maryland,47,Tennessee,133,Overton County,0,18,-18
24,Maryland,47,Tennessee,141,Putnam County,84,11,73
24,Maryland,47,Tennessee,143,Rhea County,131,0,131
24,Maryland,47,Tennessee,149,Rutherford County,50,66,-16
24,Maryland,47,Tennessee,155,Sevier County,0,49,-49
24,Maryland,47,Tennessee,157,Shelby County,282,250,32
24,Maryland,47,Tennessee,161,Stewart County,0,6,-6
24,Maryland,47,Tennessee,163,Sullivan County,11,0,11
24,Maryland,47,Tennessee,167,Tipton County,41,0,41
24,Maryland,47,Tennessee,171,Unicoi County,0,8,-8
24,Maryland,47,Tennessee,175,Van Buren County,0,5,-5
24,Maryland,47,Tennessee,177,Warren County,10,0,10
24,Maryland,47,Tennessee,179,Washington County,9,17,-8
24,Maryland,47,Tennessee,187,Williamson County,96,99,-3
24,Maryland,48,Texas,27,Bell County,237,213,24
24,Maryland,48,Texas,29,Bexar County,735,1449,-714
24,Maryland,48,Texas,37,Bowie County,0,25,-25
24,Maryland,48,Texas,39,Brazoria County,7,44,-37
24,Maryland,48,Texas,41,Brazos County,142,59,83
24,Maryland,48,Texas,43,Brewster County,0,17,-17
24,Maryland,48,Texas,51,Burleson County,0,6,-6
24,Maryland,48,Texas,53,Burnet County,0,1,-1
24,Maryland,48,Texas,55,Caldwell County,24,0,24
24,Maryland,48,Texas,59,Callahan County,40,0,40
24,Maryland,48,Texas,73,Cherokee County,10,0,10
24,Maryland,48,Texas,85,Collin County,318,452,-134
24,Maryland,48,Texas,89,Colorado County,5,0,5
24,Maryland,48,Texas,91,Comal County,0,17,-17
24,Maryland,48,Texas,95,Concho County,0,4,-4
24,Maryland,48,Texas,99,Coryell County,20,211,-191
24,Maryland,48,Texas,113,Dallas County,428,794,-366
24,Maryland,48,Texas,121,Denton County,78,159,-81
24,Maryland,48,Texas,139,Ellis County,36,13,23
24,Maryland,48,Texas,141,El Paso County,596,313,283
24,Maryland,48,Texas,157,Fort Bend County,53,419,-366
24,Maryland,48,Texas,167,Galveston County,77,29,48
24,Maryland,48,Texas,177,Gonzales County,135,1,134
24,Maryland,48,Texas,181,Grayson County,16,0,16
24,Maryland,48,Texas,183,Gregg County,14,32,-18
24,Maryland,48,Texas,187,Guadalupe County,0,158,-158
24,Maryland,48,Texas,201,Harris County,1019,2537,-1518
24,Maryland,48,Texas,209,Hays County,0,51,-51
24,Maryland,48,Texas,215,Hidalgo County,9,103,-94
24,Maryland,48,Texas,217,Hill County,33,36,-3
24,Maryland,48,Texas,223,Hopkins County,0,11,-11
24,Maryland,48,Texas,227,Howard County,11,0,11
24,Maryland,48,Texas,231,Hunt County,0,39,-39
24,Maryland,48,Texas,245,Jefferson County,50,35,15
24,Maryland,48,Texas,251,Johnson County,11,15,-4
24,Maryland,48,Texas,257,Kaufman County,0,39,-39
24,Maryland,48,Texas,259,Kendall County,0,53,-53
24,Maryland,48,Texas,265,Kerr County,0,1,-1
24,Maryland,48,Texas,281,Lampasas County,0,17,-17
24,Maryland,48,Texas,299,Llano County,0,29,-29
24,Maryland,48,Texas,303,Lubbock County,0,143,-143
24,Maryland,48,Texas,309,McLennan County,19,70,-51
24,Maryland,48,Texas,323,Maverick County,0,6,-6
24,Maryland,48,Texas,329,Midland County,0,35,-35
24,Maryland,48,Texas,339,Montgomery County,36,41,-5
24,Maryland,48,Texas,355,Nueces County,72,41,31
24,Maryland,48,Texas,361,Orange County,8,0,8
24,Maryland,48,Texas,367,Parker County,35,13,22
24,Maryland,48,Texas,373,Polk County,7,4,3
24,Maryland,48,Texas,375,Potter County,22,0,22
24,Maryland,48,Texas,381,Randall County,0,2,-2
24,Maryland,48,Texas,395,Robertson County,11,0,11
24,Maryland,48,Texas,397,Rockwall County,0,63,-63
24,Maryland,48,Texas,409,San Patricio County,0,4,-4
24,Maryland,48,Texas,419,Shelby County,16,0,16
24,Maryland,48,Texas,423,Smith County,0,25,-25
24,Maryland,48,Texas,427,Starr County,0,9,-9
24,Maryland,48,Texas,439,Tarrant County,209,875,-666
24,Maryland,48,Texas,441,Taylor County,0,25,-25
24,Maryland,48,Texas,445,Terry County,0,57,-57
24,Maryland,48,Texas,451,Tom Green County,95,4,91
24,Maryland,48,Texas,453,Travis County,747,565,182
24,Maryland,48,Texas,471,Walker County,40,93,-53
24,Maryland,48,Texas,479,Webb County,0,29,-29
24,Maryland,48,Texas,481,Wharton County,27,0,27
24,Maryland,48,Texas,485,Wichita County,0,86,-86
24,Maryland,48,Texas,491,Williamson County,33,208,-175
24,Maryland,48,Texas,499,Wood County,0,12,-12
24,Maryland,49,Utah,5,Cache County,23,16,7
24,Maryland,49,Utah,7,Carbon County,0,19,-19
24,Maryland,49,Utah,11,Davis County,104,104,0
24,Maryland,49,Utah,19,Grand County,50,0,50
24,Maryland,49,Utah,21,Iron County,11,0,11
24,Maryland,49,Utah,27,Millard County,0,4,-4
24,Maryland,49,Utah,29,Morgan County,0,19,-19
24,Maryland,49,Utah,35,Salt Lake County,131,215,-84
24,Maryland,49,Utah,43,Summit County,70,37,33
24,Maryland,49,Utah,45,Tooele County,49,0,49
24,Maryland,49,Utah,49,Utah County,299,193,106
24,Maryland,49,Utah,53,Washington County,12,23,-11
24,Maryland,5,Arkansas,5,Baxter County,22,0,22
24,Maryland,5,Arkansas,7,Benton County,6,0,6
24,Maryland,5,Arkansas,11,Bradley County,0,4,-4
24,Maryland,5,Arkansas,45,Faulkner County,0,5,-5
24,Maryland,5,Arkansas,47,Franklin County,14,0,14
24,Maryland,5,Arkansas,49,Fulton County,0,3,-3
24,Maryland,5,Arkansas,51,Garland County,24,0,24
24,Maryland,5,Arkansas,55,Greene County,0,1,-1
24,Maryland,5,Arkansas,59,Hot Spring County,0,1,-1
24,Maryland,5,Arkansas,69,Jefferson County,0,14,-14
24,Maryland,5,Arkansas,81,Little River County,0,3,-3
24,Maryland,5,Arkansas,83,Logan County,0,6,-6
24,Maryland,5,Arkansas,89,Marion County,0,3,-3
24,Maryland,5,Arkansas,107,Phillips County,9,0,9
24,Maryland,5,Arkansas,115,Pope County,5,0,5
24,Maryland,5,Arkansas,119,Pulaski County,164,264,-100
24,Maryland,5,Arkansas,139,Union County,0,10,-10
24,Maryland,5,Arkansas,143,Washington County,24,179,-155
24,Maryland,5,Arkansas,145,White County,13,7,6
24,Maryland,50,Vermont,1,Addison County,11,55,-44
24,Maryland,50,Vermont,3,Bennington County,14,3,11
24,Maryland,50,Vermont,7,Chittenden County,0,339,-339
24,Maryland,50,Vermont,11,Franklin County,34,0,34
24,Maryland,50,Vermont,15,Lamoille County,22,12,10
24,Maryland,50,Vermont,17,Orange County,66,2,64
24,Maryland,50,Vermont,19,Orleans County,0,24,-24
24,Maryland,50,Vermont,21,Rutland County,0,13,-13
24,Maryland,50,Vermont,23,Washington County,61,40,21
24,Maryland,50,Vermont,25,Windham County,55,1,54
24,Maryland,50,Vermont,27,Windsor County,39,0,39
24,Maryland,51,Virginia,1,Accomack County,362,167,195
24,Maryland,51,Virginia,3,Albemarle County,244,388,-144
24,Maryland,51,Virginia,5,Alleghany County,0,9,-9
24,Maryland,51,Virginia,9,Amherst County,0,94,-94
24,Maryland,51,Virginia,11,Appomattox County,0,10,-10
24,Maryland,51,Virginia,13,Arlington County,2859,2283,576
24,Maryland,51,Virginia,15,Augusta County,22,83,-61
24,Maryland,51,Virginia,19,Bedford County,90,220,-130
24,Maryland,51,Virginia,23,Botetourt County,28,37,-9
24,Maryland,51,Virginia,25,Brunswick County,6,0,6
24,Maryland,51,Virginia,27,Buchanan County,0,48,-48
24,Maryland,51,Virginia,29,Buckingham County,0,24,-24
24,Maryland,51,Virginia,31,Campbell County,0,101,-101
24,Maryland,51,Virginia,33,Caroline County,69,68,1
24,Maryland,51,Virginia,41,Chesterfield County,311,408,-97
24,Maryland,51,Virginia,43,Clarke County,28,53,-25
24,Maryland,51,Virginia,47,Culpeper County,0,130,-130
24,Maryland,51,Virginia,57,Essex County,24,11,13
24,Maryland,51,Virginia,59,Fairfax County,5492,6784,-1292
24,Maryland,51,Virginia,61,Fauquier County,37,164,-127
24,Maryland,51,Virginia,65,Fluvanna County,0,81,-81
24,Maryland,51,Virginia,67,Franklin County,0,78,-78
24,Maryland,51,Virginia,69,Frederick County,190,136,54
24,Maryland,51,Virginia,71,Giles County,42,0,42
24,Maryland,51,Virginia,75,Goochland County,0,8,-8
24,Maryland,51,Virginia,77,Grayson County,0,1,-1
24,Maryland,51,Virginia,79,Greene County,8,0,8
24,Maryland,51,Virginia,81,Greensville County,1,0,1
24,Maryland,51,Virginia,83,Halifax County,8,0,8
24,Maryland,51,Virginia,85,Hanover County,70,207,-137
24,Maryland,51,Virginia,87,Henrico County,262,484,-222
24,Maryland,51,Virginia,89,Henry County,0,83,-83
24,Maryland,51,Virginia,93,Isle of Wight County,23,2,21
24,Maryland,51,Virginia,95,James City County,48,62,-14
24,Maryland,51,Virginia,99,King George County,331,554,-223
24,Maryland,51,Virginia,101,King William County,65,0,65
24,Maryland,51,Virginia,103,Lancaster County,33,0,33
24,Maryland,51,Virginia,107,Loudoun County,1357,1524,-167
24,Maryland,51,Virginia,109,Louisa County,0,40,-40
24,Maryland,51,Virginia,113,Madison County,0,41,-41
24,Maryland,51,Virginia,117,Mecklenburg County,115,57,58
24,Maryland,51,Virginia,119,Middlesex County,0,30,-30
24,Maryland,51,Virginia,121,Montgomery County,287,486,-199
24,Maryland,51,Virginia,125,Nelson County,13,18,-5
24,Maryland,51,Virginia,127,New Kent County,0,22,-22
24,Maryland,51,Virginia,131,Northampton County,25,9,16
24,Maryland,51,Virginia,133,Northumberland County,5,49,-44
24,Maryland,51,Virginia,137,Orange County,9,104,-95
24,Maryland,51,Virginia,139,Page County,25,8,17
24,Maryland,51,Virginia,143,Pittsylvania County,0,52,-52
24,Maryland,51,Virginia,145,Powhatan County,0,123,-123
24,Maryland,51,Virginia,147,Prince Edward County,5,39,-34
24,Maryland,51,Virginia,149,Prince George County,196,43,153
24,Maryland,51,Virginia,153,Prince William County,1875,2364,-489
24,Maryland,51,Virginia,155,Pulaski County,1,15,-14
24,Maryland,51,Virginia,157,Rappahannock County,0,9,-9
24,Maryland,51,Virginia,159,Richmond County,9,8,1
24,Maryland,51,Virginia,161,Roanoke County,71,66,5
24,Maryland,51,Virginia,163,Rockbridge County,14,2,12
24,Maryland,51,Virginia,165,Rockingham County,23,71,-48
24,Maryland,51,Virginia,171,Shenandoah County,9,96,-87
24,Maryland,51,Virginia,173,Smyth County,0,61,-61
24,Maryland,51,Virginia,175,Southampton County,0,2,-2
24,Maryland,51,Virginia,177,Spotsylvania County,201,211,-10
24,Maryland,51,Virginia,179,Stafford County,513,488,25
24,Maryland,51,Virginia,183,Sussex County,0,1,-1
24,Maryland,51,Virginia,185,Tazewell County,8,0,8
24,Maryland,51,Virginia,187,Warren County,26,75,-49
24,Maryland,51,Virginia,191,Washington County,0,25,-25
24,Maryland,51,Virginia,193,Westmoreland County,13,69,-56
24,Maryland,51,Virginia,195,Wise County,54,0,54
24,Maryland,51,Virginia,197,Wythe County,0,59,-59
24,Maryland,51,Virginia,199,York County,55,132,-77
24,Maryland,51,Virginia,510,Alexandria city,2569,1823,746
24,Maryland,51,Virginia,520,Bristol city,0,5,-5
24,Maryland,51,Virginia,530,Buena Vista city,9,0,9
24,Maryland,51,Virginia,540,Charlottesville city,107,605,-498
24,Maryland,51,Virginia,550,Chesapeake city,244,616,-372
24,Maryland,51,Virginia,570,Colonial Heights city,40,67,-27
24,Maryland,51,Virginia,590,Danville city,44,27,17
24,Maryland,51,Virginia,600,Fairfax city,243,89,154
24,Maryland,51,Virginia,610,Falls Church city,58,98,-40
24,Maryland,51,Virginia,620,Franklin city,15,0,15
24,Maryland,51,Virginia,630,Fredericksburg city,341,171,170
24,Maryland,51,Virginia,640,Galax city,0,9,-9
24,Maryland,51,Virginia,650,Hampton city,400,317,83
24,Maryland,51,Virginia,660,Harrisonburg city,143,471,-328
24,Maryland,51,Virginia,670,Hopewell city,0,15,-15
24,Maryland,51,Virginia,678,Lexington city,0,7,-7
24,Maryland,51,Virginia,680,Lynchburg city,28,237,-209
24,Maryland,51,Virginia,683,Manassas city,187,103,84
24,Maryland,51,Virginia,685,Manassas Park city,62,134,-72
24,Maryland,51,Virginia,690,Martinsville city,45,0,45
24,Maryland,51,Virginia,700,Newport News city,272,213,59
24,Maryland,51,Virginia,710,Norfolk city,453,786,-333
24,Maryland,51,Virginia,730,Petersburg city,33,65,-32
24,Maryland,51,Virginia,735,Poquoson city,0,8,-8
24,Maryland,51,Virginia,740,Portsmouth city,239,172,67
24,Maryland,51,Virginia,750,Radford city,75,56,19
24,Maryland,51,Virginia,760,Richmond city,470,720,-250
24,Maryland,51,Virginia,770,Roanoke city,210,161,49
24,Maryland,51,Virginia,775,Salem city,25,47,-22
24,Maryland,51,Virginia,790,Staunton city,21,34,-13
24,Maryland,51,Virginia,800,Suffolk city,47,110,-63
24,Maryland,51,Virginia,810,Virginia Beach city,1135,897,238
24,Maryland,51,Virginia,820,Waynesboro city,46,0,46
24,Maryland,51,Virginia,830,Williamsburg city,12,156,-144
24,Maryland,51,Virginia,840,Winchester city,78,157,-79
24,Maryland,53,Washington,5,Benton County,66,0,66
24,Maryland,53,Washington,7,Chelan County,0,38,-38
24,Maryland,53,Washington,9,Clallam County,0,8,-8
24,Maryland,53,Washington,11,Clark County,56,42,14
24,Maryland,53,Washington,21,Franklin County,19,0,19
24,Maryland,53,Washington,25,Grant County,10,0,10
24,Maryland,53,Washington,27,Grays Harbor County,0,18,-18
24,Maryland,53,Washington,29,Island County,119,211,-92
24,Maryland,53,Washington,33,King County,742,1108,-366
24,Maryland,53,Washington,35,Kitsap County,238,165,73
24,Maryland,53,Washington,41,Lewis County,0,37,-37
24,Maryland,53,Washington,43,Lincoln County,2,0,2
24,Maryland,53,Washington,53,Pierce County,427,477,-50
24,Maryland,53,Washington,55,San Juan County,0,6,-6
24,Maryland,53,Washington,57,Skagit County,0,23,-23
24,Maryland,53,Washington,61,Snohomish County,139,195,-56
24,Maryland,53,Washington,63,Spokane County,32,147,-115
24,Maryland,53,Washington,67,Thurston County,0,16,-16
24,Maryland,53,Washington,71,Walla Walla County,11,0,11
24,Maryland,53,Washington,73,Whatcom County,56,300,-244
24,Maryland,53,Washington,75,Whitman County,4,35,-31
24,Maryland,53,Washington,77,Yakima County,15,0,15
24,Maryland,54,West Virginia,1,Barbour County,35,27,8
24,Maryland,54,West Virginia,3,Berkeley County,823,2357,-1534
24,Maryland,54,West Virginia,5,Boone County,0,11,-11
24,Maryland,54,West Virginia,7,Braxton County,0,1,-1
24,Maryland,54,West Virginia,9,Brooke County,0,43,-43
24,Maryland,54,West Virginia,11,Cabell County,41,111,-70
24,Maryland,54,West Virginia,19,Fayette County,0,6,-6
24,Maryland,54,West Virginia,21,Gilmer County,0,64,-64
24,Maryland,54,West Virginia,23,Grant County,48,4,44
24,Maryland,54,West Virginia,25,Greenbrier County,25,46,-21
24,Maryland,54,West Virginia,27,Hampshire County,322,33,289
24,Maryland,54,West Virginia,29,Hancock County,19,19,0
24,Maryland,54,West Virginia,31,Hardy County,102,202,-100
24,Maryland,54,West Virginia,33,Harrison County,43,44,-1
24,Maryland,54,West Virginia,35,Jackson County,0,23,-23
24,Maryland,54,West Virginia,37,Jefferson County,449,739,-290
24,Maryland,54,West Virginia,39,Kanawha County,53,186,-133
24,Maryland,54,West Virginia,41,Lewis County,16,0,16
24,Maryland,54,West Virginia,47,McDowell County,74,16,58
24,Maryland,54,West Virginia,49,Marion County,21,113,-92
24,Maryland,54,West Virginia,51,Marshall County,21,0,21
24,Maryland,54,West Virginia,53,Mason County,0,4,-4
24,Maryland,54,West Virginia,55,Mercer County,28,46,-18
24,Maryland,54,West Virginia,57,Mineral County,394,294,100
24,Maryland,54,West Virginia,61,Monongalia County,270,845,-575
24,Maryland,54,West Virginia,63,Monroe County,17,0,17
24,Maryland,54,West Virginia,65,Morgan County,221,598,-377
24,Maryland,54,West Virginia,67,Nicholas County,17,29,-12
24,Maryland,54,West Virginia,69,Ohio County,53,46,7
24,Maryland,54,West Virginia,75,Pocahontas County,35,4,31
24,Maryland,54,West Virginia,77,Preston County,144,81,63
24,Maryland,54,West Virginia,79,Putnam County,27,25,2
24,Maryland,54,West Virginia,81,Raleigh County,40,23,17
24,Maryland,54,West Virginia,83,Randolph County,81,7,74
24,Maryland,54,West Virginia,87,Roane County,1,0,1
24,Maryland,54,West Virginia,91,Taylor County,0,36,-36
24,Maryland,54,West Virginia,93,Tucker County,47,7,40
24,Maryland,54,West Virginia,97,Upshur County,0,68,-68
24,Maryland,54,West Virginia,99,Wayne County,1,13,-12
24,Maryland,54,West Virginia,107,Wood County,28,31,-3
24,Maryland,54,West Virginia,109,Wyoming County,31,0,31
24,Maryland,55,Wisconsin,7,Bayfield County,0,3,-3
24,Maryland,55,Wisconsin,9,Brown County,50,25,25
24,Maryland,55,Wisconsin,11,Buffalo County,0,1,-1
24,Maryland,55,Wisconsin,21,Columbia County,21,0,21
24,Maryland,55,Wisconsin,25,Dane County,502,142,360
24,Maryland,55,Wisconsin,29,Door County,0,2,-2
24,Maryland,55,Wisconsin,31,Douglas County,0,2,-2
24,Maryland,55,Wisconsin,35,Eau Claire County,0,12,-12
24,Maryland,55,Wisconsin,39,Fond du Lac County,23,45,-22
24,Maryland,55,Wisconsin,43,Grant County,21,0,21
24,Maryland,55,Wisconsin,45,Green County,38,0,38
24,Maryland,55,Wisconsin,55,Jefferson County,8,0,8
24,Maryland,55,Wisconsin,57,Juneau County,0,42,-42
24,Maryland,55,Wisconsin,59,Kenosha County,0,28,-28
24,Maryland,55,Wisconsin,63,La Crosse County,184,0,184
24,Maryland,55,Wisconsin,71,Manitowoc County,0,12,-12
24,Maryland,55,Wisconsin,73,Marathon County,0,3,-3
24,Maryland,55,Wisconsin,75,Marinette County,8,23,-15
24,Maryland,55,Wisconsin,79,Milwaukee County,135,84,51
24,Maryland,55,Wisconsin,81,Monroe County,6,0,6
24,Maryland,55,Wisconsin,87,Outagamie County,9,0,9
24,Maryland,55,Wisconsin,93,Pierce County,29,7,22
24,Maryland,55,Wisconsin,97,Portage County,0,13,-13
24,Maryland,55,Wisconsin,101,Racine County,0,7,-7
24,Maryland,55,Wisconsin,105,Rock County,16,26,-10
24,Maryland,55,Wisconsin,109,St. Croix County,0,23,-23
24,Maryland,55,Wisconsin,125,Vilas County,0,1,-1
24,Maryland,55,Wisconsin,133,Waukesha County,30,0,30
24,Maryland,55,Wisconsin,139,Winnebago County,41,55,-14
24,Maryland,56,Wyoming,1,Albany County,0,2,-2
24,Maryland,56,Wyoming,9,Converse County,17,0,17
24,Maryland,56,Wyoming,13,Fremont County,0,30,-30
24,Maryland,56,Wyoming,21,Laramie County,93,1,92
24,Maryland,56,Wyoming,23,Lincoln County,0,19,-19
24,Maryland,56,Wyoming,33,Sheridan County,20,0,20
24,Maryland,56,Wyoming,39,Teton County,0,2,-2
24,Maryland,6,California,1,Alameda County,555,835,-280
24,Maryland,6,California,7,Butte County,0,28,-28
24,Maryland,6,California,13,Contra Costa County,345,185,160
24,Maryland,6,California,15,Del Norte County,0,7,-7
24,Maryland,6,California,17,El Dorado County,20,0,20
24,Maryland,6,California,19,Fresno County,131,33,98
24,Maryland,6,California,25,Imperial County,0,25,-25
24,Maryland,6,California,29,Kern County,104,242,-138
24,Maryland,6,California,31,Kings County,129,99,30
24,Maryland,6,California,37,Los Angeles County,1269,2207,-938
24,Maryland,6,California,39,Madera County,49,0,49
24,Maryland,6,California,41,Marin County,12,19,-7
24,Maryland,6,California,45,Mendocino County,0,29,-29
24,Maryland,6,California,47,Merced County,0,6,-6
24,Maryland,6,California,51,Mono County,13,0,13
24,Maryland,6,California,53,Monterey County,635,335,300
24,Maryland,6,California,55,Napa County,0,32,-32
24,Maryland,6,California,57,Nevada County,0,55,-55
24,Maryland,6,California,59,Orange County,353,650,-297
24,Maryland,6,California,61,Placer County,36,62,-26
24,Maryland,6,California,65,Riverside County,401,299,102
24,Maryland,6,California,67,Sacramento County,202,530,-328
24,Maryland,6,California,71,San Bernardino County,313,236,77
24,Maryland,6,California,73,San Diego County,1813,1915,-102
24,Maryland,6,California,75,San Francisco County,491,364,127
24,Maryland,6,California,77,San Joaquin County,126,40,86
24,Maryland,6,California,79,San Luis Obispo County,7,5,2
24,Maryland,6,California,81,San Mateo County,161,248,-87
24,Maryland,6,California,83,Santa Barbara County,85,53,32
24,Maryland,6,California,85,Santa Clara County,103,802,-699
24,Maryland,6,California,87,Santa Cruz County,121,33,88
24,Maryland,6,California,89,Shasta County,33,80,-47
24,Maryland,6,California,93,Siskiyou County,42,0,42
24,Maryland,6,California,95,Solano County,3,26,-23
24,Maryland,6,California,97,Sonoma County,112,98,14
24,Maryland,6,California,99,Stanislaus County,21,25,-4
24,Maryland,6,California,103,Tehama County,0,6,-6
24,Maryland,6,California,107,Tulare County,86,0,86
24,Maryland,6,California,109,Tuolumne County,58,0,58
24,Maryland,6,California,111,Ventura County,111,194,-83
24,Maryland,6,California,113,Yolo County,0,20,-20
24,Maryland,6,California,115,Yuba County,0,75,-75
24,Maryland,72,Puerto Rico,5,Aguadilla Municipio,0,14,-14
24,Maryland,72,Puerto Rico,11,Añasco Municipio,0,7,-7
24,Maryland,72,Puerto Rico,13,Arecibo Municipio,10,0,10
24,Maryland,72,Puerto Rico,17,Barceloneta Municipio,106,0,106
24,Maryland,72,Puerto Rico,23,Cabo Rojo Municipio,79,0,79
24,Maryland,72,Puerto Rico,25,Caguas Municipio,19,0,19
24,Maryland,72,Puerto Rico,31,Carolina Municipio,9,0,9
24,Maryland,72,Puerto Rico,35,Cayey Municipio,88,0,88
24,Maryland,72,Puerto Rico,61,Guaynabo Municipio,131,0,131
24,Maryland,72,Puerto Rico,63,Gurabo Municipio,25,11,14
24,Maryland,72,Puerto Rico,69,Humacao Municipio,18,0,18
24,Maryland,72,Puerto Rico,81,Lares Municipio,85,0,85
24,Maryland,72,Puerto Rico,83,Las Marías Municipio,19,0,19
24,Maryland,72,Puerto Rico,97,Mayagüez Municipio,433,0,433
24,Maryland,72,Puerto Rico,99,Moca Municipio,0,24,-24
24,Maryland,72,Puerto Rico,107,Orocovis Municipio,46,0,46
24,Maryland,72,Puerto Rico,109,Patillas Municipio,88,0,88
24,Maryland,72,Puerto Rico,111,Peñuelas Municipio,0,16,-16
24,Maryland,72,Puerto Rico,113,Ponce Municipio,217,0,217
24,Maryland,72,Puerto Rico,121,Sabana Grande Municipio,0,6,-6
24,Maryland,72,Puerto Rico,125,San Germán Municipio,34,0,34
24,Maryland,72,Puerto Rico,127,San Juan Municipio,107,33,74
24,Maryland,72,Puerto Rico,139,Trujillo Alto Municipio,62,10,52
24,Maryland,72,Puerto Rico,151,Yabucoa Municipio,0,35,-35
24,Maryland,72,Puerto Rico,153,Yauco Municipio,16,0,16
24,Maryland,8,Colorado,1,Adams County,70,120,-50
24,Maryland,8,Colorado,3,Alamosa County,0,15,-15
24,Maryland,8,Colorado,5,Arapahoe County,279,216,63
24,Maryland,8,Colorado,7,Archuleta County,5,0,5
24,Maryland,8,Colorado,13,Boulder County,268,291,-23
24,Maryland,8,Colorado,14,Broomfield County,54,79,-25
24,Maryland,8,Colorado,15,Chaffee County,0,5,-5
24,Maryland,8,Colorado,31,Denver County,501,584,-83
24,Maryland,8,Colorado,35,Douglas County,82,304,-222
24,Maryland,8,Colorado,37,Eagle County,86,5,81
24,Maryland,8,Colorado,41,El Paso County,369,643,-274
24,Maryland,8,Colorado,51,Gunnison County,8,26,-18
24,Maryland,8,Colorado,53,Hinsdale County,0,6,-6
24,Maryland,8,Colorado,59,Jefferson County,196,94,102
24,Maryland,8,Colorado,63,Kit Carson County,0,1,-1
24,Maryland,8,Colorado,65,Lake County,0,1,-1
24,Maryland,8,Colorado,67,La Plata County,26,12,14
24,Maryland,8,Colorado,69,Larimer County,37,216,-179
24,Maryland,8,Colorado,77,Mesa County,25,7,18
24,Maryland,8,Colorado,83,Montezuma County,83,0,83
24,Maryland,8,Colorado,85,Montrose County,0,22,-22
24,Maryland,8,Colorado,93,Park County,9,0,9
24,Maryland,8,Colorado,101,Pueblo County,0,29,-29
24,Maryland,8,Colorado,105,Rio Grande County,40,0,40
24,Maryland,8,Colorado,107,Routt County,0,20,-20
24,Maryland,8,Colorado,113,San Miguel County,20,0,20
24,Maryland,8,Colorado,117,Summit County,28,0,28
24,Maryland,8,Colorado,121,Washington County,0,7,-7
24,Maryland,8,Colorado,123,Weld County,17,161,-144
24,Maryland,9,Connecticut,1,Fairfield County,226,240,-14
24,Maryland,9,Connecticut,3,Hartford County,331,278,53
24,Maryland,9,Connecticut,5,Litchfield County,25,56,-31
24,Maryland,9,Connecticut,7,Middlesex County,67,15,52
24,Maryland,9,Connecticut,9,New Haven County,623,507,116
24,Maryland,9,Connecticut,11,New London County,36,265,-229
24,Maryland,9,Connecticut,13,Tolland County,48,56,-8
24,Maryland,9,Connecticut,15,Windham County,40,0,40
24,Maryland,AFR,Africa,,-,8985,0,0
24,Maryland,ASI,Asia,,-,17029,0,0
24,Maryland,CAM,Central America,,-,4129,0,0
24,Maryland,CAR,Caribbean,,-,1537,0,0
24,Maryland,EUR,Europe,,-,8269,0,0
24,Maryland,ISL,U.S. Island Areas,,-,529,0,0
24,Maryland,NAM,Northern America,,-,781,0,0
24,Maryland,OCE,Oceania and At Sea,,-,622,0,0
24,Maryland,SAM,South America,,-,3902,0,0
25,Massachusetts,1,Alabama,1,Autauga County,5,108,-103
25,Massachusetts,1,Alabama,3,Baldwin County,0,67,-67
25,Massachusetts,1,Alabama,27,Clay County,15,0,15
25,Massachusetts,1,Alabama,31,Coffee County,5,16,-11
25,Massachusetts,1,Alabama,45,Dale County,0,3,-3
25,Massachusetts,1,Alabama,47,Dallas County,10,0,10
25,Massachusetts,1,Alabama,55,Etowah County,0,22,-22
25,Massachusetts,1,Alabama,69,Houston County,0,8,-8
25,Massachusetts,1,Alabama,73,Jefferson County,51,121,-70
25,Massachusetts,1,Alabama,81,Lee County,7,6,1
25,Massachusetts,1,Alabama,83,Limestone County,17,0,17
25,Massachusetts,1,Alabama,89,Madison County,27,211,-184
25,Massachusetts,1,Alabama,93,Marion County,0,13,-13
25,Massachusetts,1,Alabama,95,Marshall County,0,13,-13
25,Massachusetts,1,Alabama,97,Mobile County,56,41,15
25,Massachusetts,1,Alabama,101,Montgomery County,86,0,86
25,Massachusetts,1,Alabama,117,Shelby County,56,48,8
25,Massachusetts,1,Alabama,119,Sumter County,27,0,27
25,Massachusetts,1,Alabama,125,Tuscaloosa County,34,56,-22
25,Massachusetts,10,Delaware,1,Kent County,49,43,6
25,Massachusetts,10,Delaware,3,New Castle County,375,472,-97
25,Massachusetts,10,Delaware,5,Sussex County,84,53,31
25,Massachusetts,11,District of Columbia,1,District of Columbia,1351,2051,-700
25,Massachusetts,12,Florida,1,Alachua County,82,75,7
25,Massachusetts,12,Florida,3,Baker County,28,0,28
25,Massachusetts,12,Florida,5,Bay County,38,39,-1
25,Massachusetts,12,Florida,9,Brevard County,134,279,-145
25,Massachusetts,12,Florida,11,Broward County,1254,1713,-459
25,Massachusetts,12,Florida,15,Charlotte County,256,308,-52
25,Massachusetts,12,Florida,17,Citrus County,113,114,-1
25,Massachusetts,12,Florida,19,Clay County,32,162,-130
25,Massachusetts,12,Florida,21,Collier County,185,1086,-901
25,Massachusetts,12,Florida,23,Columbia County,0,29,-29
25,Massachusetts,12,Florida,27,DeSoto County,19,21,-2
25,Massachusetts,12,Florida,31,Duval County,296,596,-300
25,Massachusetts,12,Florida,33,Escambia County,45,104,-59
25,Massachusetts,12,Florida,35,Flagler County,0,151,-151
25,Massachusetts,12,Florida,43,Glades County,0,5,-5
25,Massachusetts,12,Florida,51,Hendry County,0,31,-31
25,Massachusetts,12,Florida,53,Hernando County,239,89,150
25,Massachusetts,12,Florida,55,Highlands County,8,14,-6
25,Massachusetts,12,Florida,57,Hillsborough County,386,1304,-918
25,Massachusetts,12,Florida,59,Holmes County,0,4,-4
25,Massachusetts,12,Florida,61,Indian River County,73,342,-269
25,Massachusetts,12,Florida,63,Jackson County,7,0,7
25,Massachusetts,12,Florida,69,Lake County,257,187,70
25,Massachusetts,12,Florida,71,Lee County,347,905,-558
25,Massachusetts,12,Florida,73,Leon County,193,124,69
25,Massachusetts,12,Florida,75,Levy County,0,3,-3
25,Massachusetts,12,Florida,81,Manatee County,189,730,-541
25,Massachusetts,12,Florida,83,Marion County,75,427,-352
25,Massachusetts,12,Florida,85,Martin County,59,257,-198
25,Massachusetts,12,Florida,86,Miami-Dade County,1360,1612,-252
25,Massachusetts,12,Florida,87,Monroe County,86,141,-55
25,Massachusetts,12,Florida,89,Nassau County,69,0,69
25,Massachusetts,12,Florida,91,Okaloosa County,111,41,70
25,Massachusetts,12,Florida,95,Orange County,1088,1057,31
25,Massachusetts,12,Florida,97,Osceola County,545,138,407
25,Massachusetts,12,Florida,99,Palm Beach County,917,1998,-1081
25,Massachusetts,12,Florida,101,Pasco County,135,209,-74
25,Massachusetts,12,Florida,103,Pinellas County,275,902,-627
25,Massachusetts,12,Florida,105,Polk County,233,573,-340
25,Massachusetts,12,Florida,109,St. Johns County,139,50,89
25,Massachusetts,12,Florida,111,St. Lucie County,155,148,7
25,Massachusetts,12,Florida,113,Santa Rosa County,24,109,-85
25,Massachusetts,12,Florida,115,Sarasota County,570,674,-104
25,Massachusetts,12,Florida,117,Seminole County,75,181,-106
25,Massachusetts,12,Florida,119,Sumter County,155,297,-142
25,Massachusetts,12,Florida,121,Suwannee County,0,39,-39
25,Massachusetts,12,Florida,127,Volusia County,445,568,-123
25,Massachusetts,12,Florida,131,Walton County,0,10,-10
25,Massachusetts,13,Georgia,9,Baldwin County,0,4,-4
25,Massachusetts,13,Georgia,13,Barrow County,34,0,34
25,Massachusetts,13,Georgia,15,Bartow County,0,35,-35
25,Massachusetts,13,Georgia,19,Berrien County,0,14,-14
25,Massachusetts,13,Georgia,21,Bibb County,50,0,50
25,Massachusetts,13,Georgia,33,Burke County,9,0,9
25,Massachusetts,13,Georgia,39,Camden County,25,0,25
25,Massachusetts,13,Georgia,43,Candler County,0,13,-13
25,Massachusetts,13,Georgia,45,Carroll County,35,0,35
25,Massachusetts,13,Georgia,51,Chatham County,88,160,-72
25,Massachusetts,13,Georgia,53,Chattahoochee County,15,30,-15
25,Massachusetts,13,Georgia,57,Cherokee County,184,0,184
25,Massachusetts,13,Georgia,59,Clarke County,0,45,-45
25,Massachusetts,13,Georgia,63,Clayton County,7,16,-9
25,Massachusetts,13,Georgia,67,Cobb County,355,174,181
25,Massachusetts,13,Georgia,73,Columbia County,101,66,35
25,Massachusetts,13,Georgia,81,Crisp County,0,36,-36
25,Massachusetts,13,Georgia,89,DeKalb County,470,496,-26
25,Massachusetts,13,Georgia,91,Dodge County,0,5,-5
25,Massachusetts,13,Georgia,95,Dougherty County,24,0,24
25,Massachusetts,13,Georgia,97,Douglas County,12,0,12
25,Massachusetts,13,Georgia,113,Fayette County,59,11,48
25,Massachusetts,13,Georgia,115,Floyd County,0,9,-9
25,Massachusetts,13,Georgia,117,Forsyth County,75,253,-178
25,Massachusetts,13,Georgia,119,Franklin County,0,2,-2
25,Massachusetts,13,Georgia,121,Fulton County,854,950,-96
25,Massachusetts,13,Georgia,127,Glynn County,47,23,24
25,Massachusetts,13,Georgia,135,Gwinnett County,52,486,-434
25,Massachusetts,13,Georgia,139,Hall County,0,142,-142
25,Massachusetts,13,Georgia,151,Henry County,275,207,68
25,Massachusetts,13,Georgia,153,Houston County,6,45,-39
25,Massachusetts,13,Georgia,157,Jackson County,2,0,2
25,Massachusetts,13,Georgia,173,Lanier County,14,0,14
25,Massachusetts,13,Georgia,185,Lowndes County,13,6,7
25,Massachusetts,13,Georgia,195,Madison County,0,10,-10
25,Massachusetts,13,Georgia,207,Monroe County,25,0,25
25,Massachusetts,13,Georgia,215,Muscogee County,32,90,-58
25,Massachusetts,13,Georgia,219,Oconee County,15,0,15
25,Massachusetts,13,Georgia,223,Paulding County,0,13,-13
25,Massachusetts,13,Georgia,245,Richmond County,145,156,-11
25,Massachusetts,13,Georgia,257,Stephens County,20,0,20
25,Massachusetts,13,Georgia,261,Sumter County,0,7,-7
25,Massachusetts,13,Georgia,279,Toombs County,26,0,26
25,Massachusetts,13,Georgia,297,Walton County,19,0,19
25,Massachusetts,13,Georgia,305,Wayne County,0,17,-17
25,Massachusetts,15,Hawaii,1,Hawaii County,7,109,-102
25,Massachusetts,15,Hawaii,3,Honolulu County,422,335,87
25,Massachusetts,15,Hawaii,9,Maui County,65,20,45
25,Massachusetts,16,Idaho,1,Ada County,175,90,85
25,Massachusetts,16,Idaho,5,Bannock County,41,23,18
25,Massachusetts,16,Idaho,7,Bear Lake County,25,0,25
25,Massachusetts,16,Idaho,13,Blaine County,10,0,10
25,Massachusetts,16,Idaho,49,Idaho County,0,3,-3
25,Massachusetts,16,Idaho,55,Kootenai County,116,53,63
25,Massachusetts,16,Idaho,57,Latah County,42,0,42
25,Massachusetts,16,Idaho,59,Lemhi County,0,1,-1
25,Massachusetts,16,Idaho,73,Owyhee County,13,0,13
25,Massachusetts,16,Idaho,81,Teton County,0,5,-5
25,Massachusetts,16,Idaho,83,Twin Falls County,0,45,-45
25,Massachusetts,16,Idaho,85,Valley County,8,0,8
25,Massachusetts,17,Illinois,19,Champaign County,130,307,-177
25,Massachusetts,17,Illinois,31,Cook County,2541,2248,293
25,Massachusetts,17,Illinois,43,DuPage County,225,250,-25
25,Massachusetts,17,Illinois,49,Effingham County,0,3,-3
25,Massachusetts,17,Illinois,57,Fulton County,0,38,-38
25,Massachusetts,17,Illinois,89,Kane County,40,116,-76
25,Massachusetts,17,Illinois,97,Lake County,341,257,84
25,Massachusetts,17,Illinois,99,LaSalle County,0,28,-28
25,Massachusetts,17,Illinois,103,Lee County,0,14,-14
25,Massachusetts,17,Illinois,111,McHenry County,88,164,-76
25,Massachusetts,17,Illinois,113,McLean County,0,25,-25
25,Massachusetts,17,Illinois,123,Marshall County,0,2,-2
25,Massachusetts,17,Illinois,141,Ogle County,166,0,166
25,Massachusetts,17,Illinois,143,Peoria County,13,39,-26
25,Massachusetts,17,Illinois,159,Richland County,11,0,11
25,Massachusetts,17,Illinois,161,Rock Island County,0,7,-7
25,Massachusetts,17,Illinois,163,St. Clair County,41,8,33
25,Massachusetts,17,Illinois,183,Vermilion County,0,8,-8
25,Massachusetts,17,Illinois,189,Washington County,0,43,-43
25,Massachusetts,17,Illinois,197,Will County,16,40,-24
25,Massachusetts,17,Illinois,201,Winnebago County,0,38,-38
25,Massachusetts,18,Indiana,3,Allen County,8,47,-39
25,Massachusetts,18,Indiana,5,Bartholomew County,52,70,-18
25,Massachusetts,18,Indiana,13,Brown County,6,0,6
25,Massachusetts,18,Indiana,17,Cass County,0,2,-2
25,Massachusetts,18,Indiana,29,Dearborn County,0,67,-67
25,Massachusetts,18,Indiana,33,DeKalb County,30,0,30
25,Massachusetts,18,Indiana,35,Delaware County,59,0,59
25,Massachusetts,18,Indiana,39,Elkhart County,0,5,-5
25,Massachusetts,18,Indiana,49,Fulton County,0,43,-43
25,Massachusetts,18,Indiana,55,Greene County,0,12,-12
25,Massachusetts,18,Indiana,57,Hamilton County,109,94,15
25,Massachusetts,18,Indiana,61,Harrison County,9,0,9
25,Massachusetts,18,Indiana,63,Hendricks County,105,0,105
25,Massachusetts,18,Indiana,85,Kosciusko County,43,0,43
25,Massachusetts,18,Indiana,89,Lake County,16,0,16
25,Massachusetts,18,Indiana,91,LaPorte County,0,6,-6
25,Massachusetts,18,Indiana,97,Marion County,222,190,32
25,Massachusetts,18,Indiana,105,Monroe County,72,158,-86
25,Massachusetts,18,Indiana,127,Porter County,4,1,3
25,Massachusetts,18,Indiana,141,St. Joseph County,61,126,-65
25,Massachusetts,18,Indiana,157,Tippecanoe County,103,65,38
25,Massachusetts,18,Indiana,159,Tipton County,63,0,63
25,Massachusetts,18,Indiana,163,Vanderburgh County,0,19,-19
25,Massachusetts,18,Indiana,167,Vigo County,20,0,20
25,Massachusetts,18,Indiana,169,Wabash County,0,7,-7
25,Massachusetts,18,Indiana,173,Warrick County,0,36,-36
25,Massachusetts,18,Indiana,177,Wayne County,0,33,-33
25,Massachusetts,19,Iowa,13,Black Hawk County,39,0,39
25,Massachusetts,19,Iowa,23,Butler County,0,2,-2
25,Massachusetts,19,Iowa,61,Dubuque County,0,61,-61
25,Massachusetts,19,Iowa,83,Hardin County,78,0,78
25,Massachusetts,19,Iowa,101,Jefferson County,46,12,34
25,Massachusetts,19,Iowa,103,Johnson County,21,29,-8
25,Massachusetts,19,Iowa,113,Linn County,0,80,-80
25,Massachusetts,19,Iowa,125,Marion County,0,14,-14
25,Massachusetts,19,Iowa,133,Monona County,45,0,45
25,Massachusetts,19,Iowa,153,Polk County,47,99,-52
25,Massachusetts,19,Iowa,155,Pottawattamie County,7,8,-1
25,Massachusetts,19,Iowa,163,Scott County,0,9,-9
25,Massachusetts,19,Iowa,165,Shelby County,0,8,-8
25,Massachusetts,19,Iowa,169,Story County,85,20,65
25,Massachusetts,19,Iowa,191,Winneshiek County,19,0,19
25,Massachusetts,19,Iowa,193,Woodbury County,0,5,-5
25,Massachusetts,2,Alaska,16,Aleutians West Census Area,0,1,-1
25,Massachusetts,2,Alaska,20,Anchorage Municipality,224,83,141
25,Massachusetts,2,Alaska,90,Fairbanks North Star Borough,88,9,79
25,Massachusetts,2,Alaska,110,Juneau City and Borough,0,20,-20
25,Massachusetts,2,Alaska,122,Kenai Peninsula Borough,35,14,21
25,Massachusetts,2,Alaska,150,Kodiak Island Borough,276,27,249
25,Massachusetts,2,Alaska,170,Matanuska-Susitna Borough,0,32,-32
25,Massachusetts,2,Alaska,180,Nome Census Area,226,0,226
25,Massachusetts,2,Alaska,195,Petersburg Borough,0,4,-4
25,Massachusetts,2,Alaska,198,Prince of Wales-Hyder Census Area,0,2,-2
25,Massachusetts,2,Alaska,240,Southeast Fairbanks Census Area,0,26,-26
25,Massachusetts,2,Alaska,261,Valdez-Cordova Census Area,54,0,54
25,Massachusetts,20,Kansas,15,Butler County,0,18,-18
25,Massachusetts,20,Kansas,45,Douglas County,171,130,41
25,Massachusetts,20,Kansas,51,Ellis County,1,0,1
25,Massachusetts,20,Kansas,55,Finney County,0,34,-34
25,Massachusetts,20,Kansas,61,Geary County,13,0,13
25,Massachusetts,20,Kansas,91,Johnson County,110,197,-87
25,Massachusetts,20,Kansas,103,Leavenworth County,0,75,-75
25,Massachusetts,20,Kansas,111,Lyon County,0,15,-15
25,Massachusetts,20,Kansas,161,Riley County,63,30,33
25,Massachusetts,20,Kansas,173,Sedgwick County,72,52,20
25,Massachusetts,20,Kansas,209,Wyandotte County,88,62,26
25,Massachusetts,21,Kentucky,1,Adair County,0,16,-16
25,Massachusetts,21,Kentucky,5,Anderson County,20,0,20
25,Massachusetts,21,Kentucky,15,Boone County,0,16,-16
25,Massachusetts,21,Kentucky,21,Boyle County,0,61,-61
25,Massachusetts,21,Kentucky,35,Calloway County,0,18,-18
25,Massachusetts,21,Kentucky,37,Campbell County,84,0,84
25,Massachusetts,21,Kentucky,47,Christian County,0,15,-15
25,Massachusetts,21,Kentucky,59,Daviess County,0,5,-5
25,Massachusetts,21,Kentucky,65,Estill County,15,9,6
25,Massachusetts,21,Kentucky,67,Fayette County,89,230,-141
25,Massachusetts,21,Kentucky,69,Fleming County,12,0,12
25,Massachusetts,21,Kentucky,73,Franklin County,17,8,9
25,Massachusetts,21,Kentucky,89,Greenup County,13,0,13
25,Massachusetts,21,Kentucky,93,Hardin County,43,142,-99
25,Massachusetts,21,Kentucky,95,Harlan County,2,0,2
25,Massachusetts,21,Kentucky,111,Jefferson County,258,35,223
25,Massachusetts,21,Kentucky,117,Kenton County,18,14,4
25,Massachusetts,21,Kentucky,125,Laurel County,23,0,23
25,Massachusetts,21,Kentucky,145,McCracken County,0,8,-8
25,Massachusetts,21,Kentucky,151,Madison County,54,21,33
25,Massachusetts,21,Kentucky,163,Meade County,0,5,-5
25,Massachusetts,21,Kentucky,185,Oldham County,0,15,-15
25,Massachusetts,21,Kentucky,211,Shelby County,6,0,6
25,Massachusetts,21,Kentucky,217,Taylor County,0,76,-76
25,Massachusetts,21,Kentucky,227,Warren County,21,0,21
25,Massachusetts,22,Louisiana,11,Beauregard Parish,0,2,-2
25,Massachusetts,22,Louisiana,15,Bossier Parish,0,34,-34
25,Massachusetts,22,Louisiana,17,Caddo Parish,0,41,-41
25,Massachusetts,22,Louisiana,19,Calcasieu Parish,27,85,-58
25,Massachusetts,22,Louisiana,33,East Baton Rouge Parish,41,34,7
25,Massachusetts,22,Louisiana,39,Evangeline Parish,0,4,-4
25,Massachusetts,22,Louisiana,45,Iberia Parish,0,66,-66
25,Massachusetts,22,Louisiana,47,Iberville Parish,0,4,-4
25,Massachusetts,22,Louisiana,51,Jefferson Parish,48,10,38
25,Massachusetts,22,Louisiana,55,Lafayette Parish,0,43,-43
25,Massachusetts,22,Louisiana,71,Orleans Parish,363,277,86
25,Massachusetts,22,Louisiana,73,Ouachita Parish,0,4,-4
25,Massachusetts,22,Louisiana,79,Rapides Parish,7,0,7
25,Massachusetts,22,Louisiana,97,St. Landry Parish,0,16,-16
25,Massachusetts,22,Louisiana,99,St. Martin Parish,0,39,-39
25,Massachusetts,22,Louisiana,103,St. Tammany Parish,0,38,-38
25,Massachusetts,22,Louisiana,115,Vernon Parish,73,1,72
25,Massachusetts,23,Maine,1,Androscoggin County,122,331,-209
25,Massachusetts,23,Maine,3,Aroostook County,113,100,13
25,Massachusetts,23,Maine,5,Cumberland County,1085,1612,-527
25,Massachusetts,23,Maine,7,Franklin County,116,205,-89
25,Massachusetts,23,Maine,9,Hancock County,171,173,-2
25,Massachusetts,23,Maine,11,Kennebec County,293,266,27
25,Massachusetts,23,Maine,13,Knox County,251,126,125
25,Massachusetts,23,Maine,15,Lincoln County,78,25,53
25,Massachusetts,23,Maine,17,Oxford County,56,129,-73
25,Massachusetts,23,Maine,19,Penobscot County,329,811,-482
25,Massachusetts,23,Maine,21,Piscataquis County,146,13,133
25,Massachusetts,23,Maine,23,Sagadahoc County,154,21,133
25,Massachusetts,23,Maine,25,Somerset County,5,265,-260
25,Massachusetts,23,Maine,27,Waldo County,81,283,-202
25,Massachusetts,23,Maine,29,Washington County,31,83,-52
25,Massachusetts,23,Maine,31,York County,856,1494,-638
25,Massachusetts,24,Maryland,1,Allegany County,14,10,4
25,Massachusetts,24,Maryland,3,Anne Arundel County,95,317,-222
25,Massachusetts,24,Maryland,5,Baltimore County,345,314,31
25,Massachusetts,24,Maryland,13,Carroll County,56,88,-32
25,Massachusetts,24,Maryland,15,Cecil County,0,2,-2
25,Massachusetts,24,Maryland,17,Charles County,50,9,41
25,Massachusetts,24,Maryland,21,Frederick County,181,96,85
25,Massachusetts,24,Maryland,25,Harford County,17,144,-127
25,Massachusetts,24,Maryland,27,Howard County,311,202,109
25,Massachusetts,24,Maryland,29,Kent County,0,43,-43
25,Massachusetts,24,Maryland,31,Montgomery County,1172,809,363
25,Massachusetts,24,Maryland,33,Prince George's County,192,351,-159
25,Massachusetts,24,Maryland,37,St. Mary's County,0,47,-47
25,Massachusetts,24,Maryland,41,Talbot County,46,7,39
25,Massachusetts,24,Maryland,43,Washington County,8,86,-78
25,Massachusetts,24,Maryland,45,Wicomico County,141,27,114
25,Massachusetts,24,Maryland,47,Worcester County,47,7,40
25,Massachusetts,24,Maryland,510,Baltimore city,614,450,164
25,Massachusetts,25,Massachusetts,1,Barnstable County,5475,4165,1310
25,Massachusetts,25,Massachusetts,3,Berkshire County,1718,1816,-98
25,Massachusetts,25,Massachusetts,5,Bristol County,9836,13600,-3764
25,Massachusetts,25,Massachusetts,7,Dukes County,301,145,156
25,Massachusetts,25,Massachusetts,9,Essex County,13643,16002,-2359
25,Massachusetts,25,Massachusetts,11,Franklin County,2296,2438,-142
25,Massachusetts,25,Massachusetts,13,Hampden County,6757,8923,-2166
25,Massachusetts,25,Massachusetts,15,Hampshire County,6827,10339,-3512
25,Massachusetts,25,Massachusetts,17,Middlesex County,45215,39995,5220
25,Massachusetts,25,Massachusetts,19,Nantucket County,160,370,-210
25,Massachusetts,25,Massachusetts,21,Norfolk County,27530,27396,134
25,Massachusetts,25,Massachusetts,23,Plymouth County,15299,14041,1258
25,Massachusetts,25,Massachusetts,25,Suffolk County,37264,31990,5274
25,Massachusetts,25,Massachusetts,27,Worcester County,14717,15818,-1101
25,Massachusetts,26,Michigan,7,Alpena County,0,17,-17
25,Massachusetts,26,Michigan,15,Barry County,0,7,-7
25,Massachusetts,26,Michigan,17,Bay County,23,6,17
25,Massachusetts,26,Michigan,21,Berrien County,0,69,-69
25,Massachusetts,26,Michigan,25,Calhoun County,7,3,4
25,Massachusetts,26,Michigan,29,Charlevoix County,0,3,-3
25,Massachusetts,26,Michigan,33,Chippewa County,50,0,50
25,Massachusetts,26,Michigan,37,Clinton County,17,7,10
25,Massachusetts,26,Michigan,41,Delta County,0,1,-1
25,Massachusetts,26,Michigan,43,Dickinson County,0,17,-17
25,Massachusetts,26,Michigan,45,Eaton County,5,0,5
25,Massachusetts,26,Michigan,47,Emmet County,0,15,-15
25,Massachusetts,26,Michigan,49,Genesee County,101,10,91
25,Massachusetts,26,Michigan,55,Grand Traverse County,13,48,-35
25,Massachusetts,26,Michigan,57,Gratiot County,16,0,16
25,Massachusetts,26,Michigan,59,Hillsdale County,0,4,-4
25,Massachusetts,26,Michigan,61,Houghton County,43,4,39
25,Massachusetts,26,Michigan,65,Ingham County,70,186,-116
25,Massachusetts,26,Michigan,69,Iosco County,1,10,-9
25,Massachusetts,26,Michigan,71,Iron County,0,2,-2
25,Massachusetts,26,Michigan,73,Isabella County,16,11,5
25,Massachusetts,26,Michigan,77,Kalamazoo County,36,20,16
25,Massachusetts,26,Michigan,81,Kent County,90,121,-31
25,Massachusetts,26,Michigan,83,Keweenaw County,0,3,-3
25,Massachusetts,26,Michigan,89,Leelanau County,0,13,-13
25,Massachusetts,26,Michigan,93,Livingston County,0,51,-51
25,Massachusetts,26,Michigan,99,Macomb County,23,127,-104
25,Massachusetts,26,Michigan,101,Manistee County,26,0,26
25,Massachusetts,26,Michigan,103,Marquette County,11,8,3
25,Massachusetts,26,Michigan,111,Midland County,0,2,-2
25,Massachusetts,26,Michigan,115,Monroe County,2,1,1
25,Massachusetts,26,Michigan,121,Muskegon County,0,1,-1
25,Massachusetts,26,Michigan,123,Newaygo County,10,0,10
25,Massachusetts,26,Michigan,125,Oakland County,165,371,-206
25,Massachusetts,26,Michigan,139,Ottawa County,6,323,-317
25,Massachusetts,26,Michigan,143,Roscommon County,0,13,-13
25,Massachusetts,26,Michigan,145,Saginaw County,30,0,30
25,Massachusetts,26,Michigan,147,St. Clair County,25,13,12
25,Massachusetts,26,Michigan,157,Tuscola County,0,3,-3
25,Massachusetts,26,Michigan,161,Washtenaw County,599,425,174
25,Massachusetts,26,Michigan,163,Wayne County,223,540,-317
25,Massachusetts,27,Minnesota,3,Anoka County,48,51,-3
25,Massachusetts,27,Minnesota,7,Beltrami County,0,5,-5
25,Massachusetts,27,Minnesota,9,Benton County,0,3,-3
25,Massachusetts,27,Minnesota,15,Brown County,8,0,8
25,Massachusetts,27,Minnesota,19,Carver County,39,24,15
25,Massachusetts,27,Minnesota,21,Cass County,51,0,51
25,Massachusetts,27,Minnesota,25,Chisago County,5,17,-12
25,Massachusetts,27,Minnesota,27,Clay County,0,3,-3
25,Massachusetts,27,Minnesota,37,Dakota County,106,29,77
25,Massachusetts,27,Minnesota,49,Goodhue County,17,0,17
25,Massachusetts,27,Minnesota,53,Hennepin County,387,504,-117
25,Massachusetts,27,Minnesota,61,Itasca County,45,0,45
25,Massachusetts,27,Minnesota,67,Kandiyohi County,1,0,1
25,Massachusetts,27,Minnesota,99,Mower County,5,0,5
25,Massachusetts,27,Minnesota,105,Nobles County,8,0,8
25,Massachusetts,27,Minnesota,107,Norman County,0,30,-30
25,Massachusetts,27,Minnesota,109,Olmsted County,139,50,89
25,Massachusetts,27,Minnesota,115,Pine County,21,0,21
25,Massachusetts,27,Minnesota,123,Ramsey County,55,272,-217
25,Massachusetts,27,Minnesota,131,Rice County,49,77,-28
25,Massachusetts,27,Minnesota,137,St. Louis County,13,22,-9
25,Massachusetts,27,Minnesota,139,Scott County,51,0,51
25,Massachusetts,27,Minnesota,145,Stearns County,61,9,52
25,Massachusetts,27,Minnesota,163,Washington County,7,0,7
25,Massachusetts,28,Mississippi,11,Bolivar County,38,0,38
25,Massachusetts,28,Mississippi,33,DeSoto County,13,0,13
25,Massachusetts,28,Mississippi,45,Hancock County,0,19,-19
25,Massachusetts,28,Mississippi,47,Harrison County,130,152,-22
25,Massachusetts,28,Mississippi,49,Hinds County,51,0,51
25,Massachusetts,28,Mississippi,59,Jackson County,0,91,-91
25,Massachusetts,28,Mississippi,71,Lafayette County,0,107,-107
25,Massachusetts,28,Mississippi,75,Lauderdale County,0,2,-2
25,Massachusetts,28,Mississippi,87,Lowndes County,0,18,-18
25,Massachusetts,28,Mississippi,93,Marshall County,0,6,-6
25,Massachusetts,28,Mississippi,121,Rankin County,0,4,-4
25,Massachusetts,28,Mississippi,151,Washington County,11,0,11
25,Massachusetts,29,Missouri,19,Boone County,159,0,159
25,Massachusetts,29,Missouri,31,Cape Girardeau County,12,0,12
25,Massachusetts,29,Missouri,37,Cass County,0,172,-172
25,Massachusetts,29,Missouri,47,Clay County,0,41,-41
25,Massachusetts,29,Missouri,49,Clinton County,0,1,-1
25,Massachusetts,29,Missouri,51,Cole County,55,4,51
25,Massachusetts,29,Missouri,77,Greene County,40,49,-9
25,Massachusetts,29,Missouri,91,Howell County,72,0,72
25,Massachusetts,29,Missouri,95,Jackson County,93,209,-116
25,Massachusetts,29,Missouri,97,Jasper County,19,8,11
25,Massachusetts,29,Missouri,99,Jefferson County,35,0,35
25,Massachusetts,29,Missouri,101,Johnson County,44,0,44
25,Massachusetts,29,Missouri,147,Nodaway County,29,0,29
25,Massachusetts,29,Missouri,159,Pettis County,0,17,-17
25,Massachusetts,29,Missouri,161,Phelps County,9,0,9
25,Massachusetts,29,Missouri,169,Pulaski County,200,336,-136
25,Massachusetts,29,Missouri,183,St. Charles County,19,0,19
25,Massachusetts,29,Missouri,189,St. Louis County,245,330,-85
25,Massachusetts,29,Missouri,203,Shannon County,0,9,-9
25,Massachusetts,29,Missouri,213,Taney County,0,36,-36
25,Massachusetts,29,Missouri,217,Vernon County,18,16,2
25,Massachusetts,29,Missouri,510,St. Louis city,174,220,-46
25,Massachusetts,30,Montana,13,Cascade County,0,2,-2
25,Massachusetts,30,Montana,29,Flathead County,35,0,35
25,Massachusetts,30,Montana,31,Gallatin County,0,14,-14
25,Massachusetts,30,Montana,47,Lake County,0,18,-18
25,Massachusetts,30,Montana,55,McCone County,12,0,12
25,Massachusetts,30,Montana,57,Madison County,0,14,-14
25,Massachusetts,30,Montana,63,Missoula County,11,197,-186
25,Massachusetts,30,Montana,67,Park County,0,21,-21
25,Massachusetts,30,Montana,111,Yellowstone County,6,0,6
25,Massachusetts,31,Nebraska,3,Antelope County,0,13,-13
25,Massachusetts,31,Nebraska,19,Buffalo County,56,0,56
25,Massachusetts,31,Nebraska,21,Burt County,0,1,-1
25,Massachusetts,31,Nebraska,33,Cheyenne County,14,0,14
25,Massachusetts,31,Nebraska,55,Douglas County,154,43,111
25,Massachusetts,31,Nebraska,81,Hamilton County,0,1,-1
25,Massachusetts,31,Nebraska,95,Jefferson County,0,3,-3
25,Massachusetts,31,Nebraska,109,Lancaster County,0,224,-224
25,Massachusetts,31,Nebraska,153,Sarpy County,67,8,59
25,Massachusetts,32,Nevada,1,Churchill County,0,3,-3
25,Massachusetts,32,Nevada,3,Clark County,583,512,71
25,Massachusetts,32,Nevada,13,Humboldt County,0,18,-18
25,Massachusetts,32,Nevada,19,Lyon County,13,0,13
25,Massachusetts,32,Nevada,31,Washoe County,44,77,-33
25,Massachusetts,32,Nevada,33,White Pine County,52,0,52
25,Massachusetts,32,Nevada,510,Carson City,11,36,-25
25,Massachusetts,33,New Hampshire,1,Belknap County,153,266,-113
25,Massachusetts,33,New Hampshire,3,Carroll County,459,349,110
25,Massachusetts,33,New Hampshire,5,Cheshire County,571,921,-350
25,Massachusetts,33,New Hampshire,7,Coos County,179,238,-59
25,Massachusetts,33,New Hampshire,9,Grafton County,660,1310,-650
25,Massachusetts,33,New Hampshire,11,Hillsborough County,4144,7209,-3065
25,Massachusetts,33,New Hampshire,13,Merrimack County,796,886,-90
25,Massachusetts,33,New Hampshire,15,Rockingham County,3151,5661,-2510
25,Massachusetts,33,New Hampshire,17,Strafford County,713,2011,-1298
25,Massachusetts,33,New Hampshire,19,Sullivan County,77,208,-131
25,Massachusetts,34,New Jersey,1,Atlantic County,115,39,76
25,Massachusetts,34,New Jersey,3,Bergen County,883,759,124
25,Massachusetts,34,New Jersey,5,Burlington County,176,133,43
25,Massachusetts,34,New Jersey,7,Camden County,332,15,317
25,Massachusetts,34,New Jersey,9,Cape May County,11,83,-72
25,Massachusetts,34,New Jersey,11,Cumberland County,0,8,-8
25,Massachusetts,34,New Jersey,13,Essex County,716,216,500
25,Massachusetts,34,New Jersey,15,Gloucester County,98,46,52
25,Massachusetts,34,New Jersey,17,Hudson County,497,562,-65
25,Massachusetts,34,New Jersey,19,Hunterdon County,93,15,78
25,Massachusetts,34,New Jersey,21,Mercer County,580,345,235
25,Massachusetts,34,New Jersey,23,Middlesex County,387,227,160
25,Massachusetts,34,New Jersey,25,Monmouth County,399,43,356
25,Massachusetts,34,New Jersey,27,Morris County,680,353,327
25,Massachusetts,34,New Jersey,29,Ocean County,178,129,49
25,Massachusetts,34,New Jersey,31,Passaic County,199,163,36
25,Massachusetts,34,New Jersey,35,Somerset County,461,108,353
25,Massachusetts,34,New Jersey,37,Sussex County,26,1,25
25,Massachusetts,34,New Jersey,39,Union County,594,310,284
25,Massachusetts,34,New Jersey,41,Warren County,35,46,-11
25,Massachusetts,35,New Mexico,1,Bernalillo County,242,158,84
25,Massachusetts,35,New Mexico,9,Curry County,13,0,13
25,Massachusetts,35,New Mexico,13,Doña Ana County,0,77,-77
25,Massachusetts,35,New Mexico,25,Lea County,6,0,6
25,Massachusetts,35,New Mexico,28,Los Alamos County,18,11,7
25,Massachusetts,35,New Mexico,31,McKinley County,26,58,-32
25,Massachusetts,35,New Mexico,35,Otero County,65,12,53
25,Massachusetts,35,New Mexico,43,Sandoval County,0,138,-138
25,Massachusetts,35,New Mexico,45,San Juan County,0,11,-11
25,Massachusetts,35,New Mexico,47,San Miguel County,18,0,18
25,Massachusetts,35,New Mexico,49,Santa Fe County,85,50,35
25,Massachusetts,35,New Mexico,53,Socorro County,0,4,-4
25,Massachusetts,35,New Mexico,55,Taos County,0,2,-2
25,Massachusetts,36,New York,1,Albany County,712,802,-90
25,Massachusetts,36,New York,3,Allegany County,77,27,50
25,Massachusetts,36,New York,5,Bronx County,1077,439,638
25,Massachusetts,36,New York,7,Broome County,21,11,10
25,Massachusetts,36,New York,11,Cayuga County,205,14,191
25,Massachusetts,36,New York,13,Chautauqua County,39,40,-1
25,Massachusetts,36,New York,15,Chemung County,36,22,14
25,Massachusetts,36,New York,17,Chenango County,0,36,-36
25,Massachusetts,36,New York,19,Clinton County,79,0,79
25,Massachusetts,36,New York,21,Columbia County,157,140,17
25,Massachusetts,36,New York,23,Cortland County,20,10,10
25,Massachusetts,36,New York,25,Delaware County,0,13,-13
25,Massachusetts,36,New York,27,Dutchess County,297,462,-165
25,Massachusetts,36,New York,29,Erie County,318,450,-132
25,Massachusetts,36,New York,31,Essex County,104,75,29
25,Massachusetts,36,New York,33,Franklin County,19,38,-19
25,Massachusetts,36,New York,35,Fulton County,29,34,-5
25,Massachusetts,36,New York,37,Genesee County,19,5,14
25,Massachusetts,36,New York,39,Greene County,14,70,-56
25,Massachusetts,36,New York,41,Hamilton County,18,0,18
25,Massachusetts,36,New York,43,Herkimer County,20,4,16
25,Massachusetts,36,New York,45,Jefferson County,61,183,-122
25,Massachusetts,36,New York,47,Kings County,3485,1682,1803
25,Massachusetts,36,New York,49,Lewis County,3,10,-7
25,Massachusetts,36,New York,51,Livingston County,29,0,29
25,Massachusetts,36,New York,53,Madison County,189,70,119
25,Massachusetts,36,New York,55,Monroe County,796,861,-65
25,Massachusetts,36,New York,57,Montgomery County,11,51,-40
25,Massachusetts,36,New York,59,Nassau County,1180,318,862
25,Massachusetts,36,New York,61,New York County,3746,4273,-527
25,Massachusetts,36,New York,63,Niagara County,20,0,20
25,Massachusetts,36,New York,65,Oneida County,111,76,35
25,Massachusetts,36,New York,67,Onondaga County,575,583,-8
25,Massachusetts,36,New York,69,Ontario County,57,162,-105
25,Massachusetts,36,New York,71,Orange County,153,182,-29
25,Massachusetts,36,New York,73,Orleans County,67,0,67
25,Massachusetts,36,New York,75,Oswego County,25,37,-12
25,Massachusetts,36,New York,77,Otsego County,284,11,273
25,Massachusetts,36,New York,79,Putnam County,116,0,116
25,Massachusetts,36,New York,81,Queens County,1391,1014,377
25,Massachusetts,36,New York,83,Rensselaer County,591,460,131
25,Massachusetts,36,New York,85,Richmond County,62,39,23
25,Massachusetts,36,New York,87,Rockland County,284,92,192
25,Massachusetts,36,New York,89,St. Lawrence County,40,278,-238
25,Massachusetts,36,New York,91,Saratoga County,269,432,-163
25,Massachusetts,36,New York,93,Schenectady County,348,335,13
25,Massachusetts,36,New York,95,Schoharie County,0,14,-14
25,Massachusetts,36,New York,99,Seneca County,16,21,-5
25,Massachusetts,36,New York,101,Steuben County,66,21,45
25,Massachusetts,36,New York,103,Suffolk County,1309,363,946
25,Massachusetts,36,New York,105,Sullivan County,64,36,28
25,Massachusetts,36,New York,107,Tioga County,40,0,40
25,Massachusetts,36,New York,109,Tompkins County,605,675,-70
25,Massachusetts,36,New York,111,Ulster County,118,25,93
25,Massachusetts,36,New York,113,Warren County,83,27,56
25,Massachusetts,36,New York,115,Washington County,46,72,-26
25,Massachusetts,36,New York,117,Wayne County,54,14,40
25,Massachusetts,36,New York,119,Westchester County,1455,728,727
25,Massachusetts,36,New York,121,Wyoming County,0,8,-8
25,Massachusetts,36,New York,123,Yates County,0,19,-19
25,Massachusetts,37,North Carolina,1,Alamance County,15,129,-114
25,Massachusetts,37,North Carolina,17,Bladen County,15,0,15
25,Massachusetts,37,North Carolina,19,Brunswick County,67,164,-97
25,Massachusetts,37,North Carolina,21,Buncombe County,53,92,-39
25,Massachusetts,37,North Carolina,25,Cabarrus County,40,23,17
25,Massachusetts,37,North Carolina,27,Caldwell County,0,29,-29
25,Massachusetts,37,North Carolina,31,Carteret County,0,59,-59
25,Massachusetts,37,North Carolina,35,Catawba County,9,5,4
25,Massachusetts,37,North Carolina,37,Chatham County,58,0,58
25,Massachusetts,37,North Carolina,45,Cleveland County,32,0,32
25,Massachusetts,37,North Carolina,47,Columbus County,7,10,-3
25,Massachusetts,37,North Carolina,49,Craven County,70,120,-50
25,Massachusetts,37,North Carolina,51,Cumberland County,56,152,-96
25,Massachusetts,37,North Carolina,55,Dare County,6,22,-16
25,Massachusetts,37,North Carolina,63,Durham County,238,730,-492
25,Massachusetts,37,North Carolina,65,Edgecombe County,0,14,-14
25,Massachusetts,37,North Carolina,67,Forsyth County,120,119,1
25,Massachusetts,37,North Carolina,69,Franklin County,0,5,-5
25,Massachusetts,37,North Carolina,71,Gaston County,5,67,-62
25,Massachusetts,37,North Carolina,81,Guilford County,46,136,-90
25,Massachusetts,37,North Carolina,83,Halifax County,6,22,-16
25,Massachusetts,37,North Carolina,85,Harnett County,0,84,-84
25,Massachusetts,37,North Carolina,87,Haywood County,0,18,-18
25,Massachusetts,37,North Carolina,89,Henderson County,0,75,-75
25,Massachusetts,37,North Carolina,97,Iredell County,57,124,-67
25,Massachusetts,37,North Carolina,101,Johnston County,32,33,-1
25,Massachusetts,37,North Carolina,105,Lee County,88,13,75
25,Massachusetts,37,North Carolina,109,Lincoln County,30,0,30
25,Massachusetts,37,North Carolina,113,Macon County,0,28,-28
25,Massachusetts,37,North Carolina,115,Madison County,0,9,-9
25,Massachusetts,37,North Carolina,119,Mecklenburg County,382,900,-518
25,Massachusetts,37,North Carolina,127,Nash County,0,10,-10
25,Massachusetts,37,North Carolina,129,New Hanover County,80,190,-110
25,Massachusetts,37,North Carolina,133,Onslow County,254,354,-100
25,Massachusetts,37,North Carolina,135,Orange County,264,177,87
25,Massachusetts,37,North Carolina,139,Pasquotank County,26,0,26
25,Massachusetts,37,North Carolina,141,Pender County,31,118,-87
25,Massachusetts,37,North Carolina,147,Pitt County,53,182,-129
25,Massachusetts,37,North Carolina,157,Rockingham County,161,5,156
25,Massachusetts,37,North Carolina,161,Rutherford County,0,34,-34
25,Massachusetts,37,North Carolina,165,Scotland County,34,0,34
25,Massachusetts,37,North Carolina,167,Stanly County,0,72,-72
25,Massachusetts,37,North Carolina,179,Union County,0,116,-116
25,Massachusetts,37,North Carolina,183,Wake County,829,1307,-478
25,Massachusetts,37,North Carolina,185,Warren County,0,29,-29
25,Massachusetts,37,North Carolina,189,Watauga County,10,0,10
25,Massachusetts,37,North Carolina,191,Wayne County,0,25,-25
25,Massachusetts,37,North Carolina,199,Yancey County,7,0,7
25,Massachusetts,38,North Dakota,17,Cass County,17,19,-2
25,Massachusetts,38,North Dakota,35,Grand Forks County,10,19,-9
25,Massachusetts,38,North Dakota,67,Pembina County,32,0,32
25,Massachusetts,38,North Dakota,79,Rolette County,0,10,-10
25,Massachusetts,38,North Dakota,101,Ward County,6,0,6
25,Massachusetts,38,North Dakota,105,Williams County,12,0,12
25,Massachusetts,39,Ohio,3,Allen County,33,20,13
25,Massachusetts,39,Ohio,7,Ashtabula County,19,0,19
25,Massachusetts,39,Ohio,9,Athens County,0,10,-10
25,Massachusetts,39,Ohio,15,Brown County,46,0,46
25,Massachusetts,39,Ohio,17,Butler County,46,213,-167
25,Massachusetts,39,Ohio,21,Champaign County,0,7,-7
25,Massachusetts,39,Ohio,23,Clark County,22,24,-2
25,Massachusetts,39,Ohio,25,Clermont County,40,37,3
25,Massachusetts,39,Ohio,29,Columbiana County,11,0,11
25,Massachusetts,39,Ohio,35,Cuyahoga County,312,335,-23
25,Massachusetts,39,Ohio,37,Darke County,59,0,59
25,Massachusetts,39,Ohio,41,Delaware County,138,34,104
25,Massachusetts,39,Ohio,45,Fairfield County,32,0,32
25,Massachusetts,39,Ohio,49,Franklin County,371,623,-252
25,Massachusetts,39,Ohio,57,Greene County,0,79,-79
25,Massachusetts,39,Ohio,61,Hamilton County,449,387,62
25,Massachusetts,39,Ohio,63,Hancock County,55,11,44
25,Massachusetts,39,Ohio,65,Hardin County,0,9,-9
25,Massachusetts,39,Ohio,69,Henry County,4,0,4
25,Massachusetts,39,Ohio,77,Huron County,7,0,7
25,Massachusetts,39,Ohio,83,Knox County,0,63,-63
25,Massachusetts,39,Ohio,85,Lake County,14,45,-31
25,Massachusetts,39,Ohio,89,Licking County,30,15,15
25,Massachusetts,39,Ohio,93,Lorain County,44,77,-33
25,Massachusetts,39,Ohio,95,Lucas County,39,164,-125
25,Massachusetts,39,Ohio,97,Madison County,5,60,-55
25,Massachusetts,39,Ohio,99,Mahoning County,18,0,18
25,Massachusetts,39,Ohio,101,Marion County,28,0,28
25,Massachusetts,39,Ohio,103,Medina County,32,10,22
25,Massachusetts,39,Ohio,109,Miami County,0,33,-33
25,Massachusetts,39,Ohio,113,Montgomery County,90,134,-44
25,Massachusetts,39,Ohio,119,Muskingum County,16,0,16
25,Massachusetts,39,Ohio,133,Portage County,0,102,-102
25,Massachusetts,39,Ohio,139,Richland County,20,19,1
25,Massachusetts,39,Ohio,145,Scioto County,0,5,-5
25,Massachusetts,39,Ohio,151,Stark County,37,0,37
25,Massachusetts,39,Ohio,153,Summit County,49,294,-245
25,Massachusetts,39,Ohio,165,Warren County,14,98,-84
25,Massachusetts,39,Ohio,169,Wayne County,0,4,-4
25,Massachusetts,39,Ohio,173,Wood County,24,30,-6
25,Massachusetts,4,Arizona,3,Cochise County,0,30,-30
25,Massachusetts,4,Arizona,5,Coconino County,68,78,-10
25,Massachusetts,4,Arizona,13,Maricopa County,924,1504,-580
25,Massachusetts,4,Arizona,15,Mohave County,0,97,-97
25,Massachusetts,4,Arizona,17,Navajo County,96,0,96
25,Massachusetts,4,Arizona,19,Pima County,358,768,-410
25,Massachusetts,4,Arizona,21,Pinal County,58,59,-1
25,Massachusetts,4,Arizona,23,Santa Cruz County,76,18,58
25,Massachusetts,4,Arizona,25,Yavapai County,71,30,41
25,Massachusetts,40,Oklahoma,13,Bryan County,0,137,-137
25,Massachusetts,40,Oklahoma,27,Cleveland County,13,6,7
25,Massachusetts,40,Oklahoma,31,Comanche County,0,111,-111
25,Massachusetts,40,Oklahoma,39,Custer County,0,3,-3
25,Massachusetts,40,Oklahoma,47,Garfield County,0,38,-38
25,Massachusetts,40,Oklahoma,65,Jackson County,26,0,26
25,Massachusetts,40,Oklahoma,109,Oklahoma County,194,42,152
25,Massachusetts,40,Oklahoma,115,Ottawa County,0,3,-3
25,Massachusetts,40,Oklahoma,119,Payne County,43,20,23
25,Massachusetts,40,Oklahoma,123,Pontotoc County,0,10,-10
25,Massachusetts,40,Oklahoma,137,Stephens County,113,0,113
25,Massachusetts,40,Oklahoma,143,Tulsa County,141,65,76
25,Massachusetts,40,Oklahoma,147,Washington County,0,26,-26
25,Massachusetts,40,Oklahoma,153,Woodward County,0,7,-7
25,Massachusetts,41,Oregon,3,Benton County,9,42,-33
25,Massachusetts,41,Oregon,5,Clackamas County,32,68,-36
25,Massachusetts,41,Oregon,7,Clatsop County,16,25,-9
25,Massachusetts,41,Oregon,11,Coos County,36,52,-16
25,Massachusetts,41,Oregon,17,Deschutes County,26,0,26
25,Massachusetts,41,Oregon,27,Hood River County,0,13,-13
25,Massachusetts,41,Oregon,29,Jackson County,8,41,-33
25,Massachusetts,41,Oregon,33,Josephine County,0,7,-7
25,Massachusetts,41,Oregon,39,Lane County,111,72,39
25,Massachusetts,41,Oregon,41,Lincoln County,0,21,-21
25,Massachusetts,41,Oregon,43,Linn County,33,18,15
25,Massachusetts,41,Oregon,45,Malheur County,0,18,-18
25,Massachusetts,41,Oregon,47,Marion County,36,56,-20
25,Massachusetts,41,Oregon,51,Multnomah County,171,720,-549
25,Massachusetts,41,Oregon,67,Washington County,218,235,-17
25,Massachusetts,42,Pennsylvania,1,Adams County,48,62,-14
25,Massachusetts,42,Pennsylvania,3,Allegheny County,840,618,222
25,Massachusetts,42,Pennsylvania,7,Beaver County,13,13,0
25,Massachusetts,42,Pennsylvania,9,Bedford County,10,0,10
25,Massachusetts,42,Pennsylvania,11,Berks County,199,167,32
25,Massachusetts,42,Pennsylvania,15,Bradford County,0,4,-4
25,Massachusetts,42,Pennsylvania,17,Bucks County,208,330,-122
25,Massachusetts,42,Pennsylvania,19,Butler County,3,71,-68
25,Massachusetts,42,Pennsylvania,21,Cambria County,27,0,27
25,Massachusetts,42,Pennsylvania,25,Carbon County,19,0,19
25,Massachusetts,42,Pennsylvania,27,Centre County,293,119,174
25,Massachusetts,42,Pennsylvania,29,Chester County,472,381,91
25,Massachusetts,42,Pennsylvania,31,Clarion County,0,248,-248
25,Massachusetts,42,Pennsylvania,33,Clearfield County,0,36,-36
25,Massachusetts,42,Pennsylvania,37,Columbia County,0,14,-14
25,Massachusetts,42,Pennsylvania,39,Crawford County,29,32,-3
25,Massachusetts,42,Pennsylvania,41,Cumberland County,63,122,-59
25,Massachusetts,42,Pennsylvania,43,Dauphin County,88,218,-130
25,Massachusetts,42,Pennsylvania,45,Delaware County,458,512,-54
25,Massachusetts,42,Pennsylvania,49,Erie County,26,69,-43
25,Massachusetts,42,Pennsylvania,51,Fayette County,6,0,6
25,Massachusetts,42,Pennsylvania,55,Franklin County,18,0,18
25,Massachusetts,42,Pennsylvania,61,Huntingdon County,0,19,-19
25,Massachusetts,42,Pennsylvania,63,Indiana County,3,27,-24
25,Massachusetts,42,Pennsylvania,69,Lackawanna County,230,51,179
25,Massachusetts,42,Pennsylvania,71,Lancaster County,122,139,-17
25,Massachusetts,42,Pennsylvania,73,Lawrence County,11,4,7
25,Massachusetts,42,Pennsylvania,75,Lebanon County,60,0,60
25,Massachusetts,42,Pennsylvania,77,Lehigh County,450,318,132
25,Massachusetts,42,Pennsylvania,79,Luzerne County,85,64,21
25,Massachusetts,42,Pennsylvania,81,Lycoming County,0,37,-37
25,Massachusetts,42,Pennsylvania,85,Mercer County,10,69,-59
25,Massachusetts,42,Pennsylvania,89,Monroe County,186,0,186
25,Massachusetts,42,Pennsylvania,91,Montgomery County,691,475,216
25,Massachusetts,42,Pennsylvania,93,Montour County,87,18,69
25,Massachusetts,42,Pennsylvania,95,Northampton County,178,205,-27
25,Massachusetts,42,Pennsylvania,101,Philadelphia County,1072,1651,-579
25,Massachusetts,42,Pennsylvania,103,Pike County,46,11,35
25,Massachusetts,42,Pennsylvania,105,Potter County,8,0,8
25,Massachusetts,42,Pennsylvania,107,Schuylkill County,0,13,-13
25,Massachusetts,42,Pennsylvania,111,Somerset County,0,3,-3
25,Massachusetts,42,Pennsylvania,117,Tioga County,5,5,0
25,Massachusetts,42,Pennsylvania,119,Union County,64,84,-20
25,Massachusetts,42,Pennsylvania,121,Venango County,0,4,-4
25,Massachusetts,42,Pennsylvania,125,Washington County,14,108,-94
25,Massachusetts,42,Pennsylvania,127,Wayne County,83,36,47
25,Massachusetts,42,Pennsylvania,129,Westmoreland County,28,28,0
25,Massachusetts,42,Pennsylvania,131,Wyoming County,0,3,-3
25,Massachusetts,42,Pennsylvania,133,York County,97,109,-12
25,Massachusetts,44,Rhode Island,1,Bristol County,562,773,-211
25,Massachusetts,44,Rhode Island,3,Kent County,719,661,58
25,Massachusetts,44,Rhode Island,5,Newport County,1017,1320,-303
25,Massachusetts,44,Rhode Island,7,Providence County,5632,6359,-727
25,Massachusetts,44,Rhode Island,9,Washington County,630,1222,-592
25,Massachusetts,45,South Carolina,3,Aiken County,45,73,-28
25,Massachusetts,45,South Carolina,7,Anderson County,11,27,-16
25,Massachusetts,45,South Carolina,9,Bamberg County,0,19,-19
25,Massachusetts,45,South Carolina,13,Beaufort County,66,249,-183
25,Massachusetts,45,South Carolina,15,Berkeley County,15,66,-51
25,Massachusetts,45,South Carolina,19,Charleston County,171,207,-36
25,Massachusetts,45,South Carolina,23,Chester County,0,5,-5
25,Massachusetts,45,South Carolina,27,Clarendon County,0,2,-2
25,Massachusetts,45,South Carolina,29,Colleton County,0,6,-6
25,Massachusetts,45,South Carolina,31,Darlington County,0,16,-16
25,Massachusetts,45,South Carolina,35,Dorchester County,87,84,3
25,Massachusetts,45,South Carolina,39,Fairfield County,12,0,12
25,Massachusetts,45,South Carolina,43,Georgetown County,23,39,-16
25,Massachusetts,45,South Carolina,45,Greenville County,226,140,86
25,Massachusetts,45,South Carolina,49,Hampton County,15,11,4
25,Massachusetts,45,South Carolina,51,Horry County,190,373,-183
25,Massachusetts,45,South Carolina,53,Jasper County,0,60,-60
25,Massachusetts,45,South Carolina,57,Lancaster County,44,27,17
25,Massachusetts,45,South Carolina,63,Lexington County,0,269,-269
25,Massachusetts,45,South Carolina,69,Marlboro County,5,0,5
25,Massachusetts,45,South Carolina,73,Oconee County,7,22,-15
25,Massachusetts,45,South Carolina,75,Orangeburg County,9,13,-4
25,Massachusetts,45,South Carolina,77,Pickens County,146,55,91
25,Massachusetts,45,South Carolina,79,Richland County,126,557,-431
25,Massachusetts,45,South Carolina,83,Spartanburg County,55,125,-70
25,Massachusetts,45,South Carolina,85,Sumter County,25,21,4
25,Massachusetts,45,South Carolina,89,Williamsburg County,5,0,5
25,Massachusetts,45,South Carolina,91,York County,68,118,-50
25,Massachusetts,46,South Dakota,9,Bon Homme County,0,5,-5
25,Massachusetts,46,South Dakota,11,Brookings County,0,2,-2
25,Massachusetts,46,South Dakota,27,Clay County,6,38,-32
25,Massachusetts,46,South Dakota,39,Deuel County,0,2,-2
25,Massachusetts,46,South Dakota,79,Lake County,0,21,-21
25,Massachusetts,46,South Dakota,93,Meade County,24,0,24
25,Massachusetts,46,South Dakota,99,Minnehaha County,5,0,5
25,Massachusetts,46,South Dakota,103,Pennington County,23,46,-23
25,Massachusetts,47,Tennessee,1,Anderson County,7,0,7
25,Massachusetts,47,Tennessee,11,Bradley County,0,20,-20
25,Massachusetts,47,Tennessee,19,Carter County,0,14,-14
25,Massachusetts,47,Tennessee,21,Cheatham County,26,0,26
25,Massachusetts,47,Tennessee,25,Claiborne County,0,30,-30
25,Massachusetts,47,Tennessee,35,Cumberland County,0,8,-8
25,Massachusetts,47,Tennessee,37,Davidson County,228,649,-421
25,Massachusetts,47,Tennessee,47,Fayette County,27,0,27
25,Massachusetts,47,Tennessee,59,Greene County,0,181,-181
25,Massachusetts,47,Tennessee,65,Hamilton County,12,92,-80
25,Massachusetts,47,Tennessee,77,Henderson County,8,20,-12
25,Massachusetts,47,Tennessee,79,Henry County,0,6,-6
25,Massachusetts,47,Tennessee,89,Jefferson County,0,8,-8
25,Massachusetts,47,Tennessee,93,Knox County,49,107,-58
25,Massachusetts,47,Tennessee,107,McMinn County,0,46,-46
25,Massachusetts,47,Tennessee,113,Madison County,0,10,-10
25,Massachusetts,47,Tennessee,119,Maury County,0,47,-47
25,Massachusetts,47,Tennessee,121,Meigs County,0,9,-9
25,Massachusetts,47,Tennessee,125,Montgomery County,82,74,8
25,Massachusetts,47,Tennessee,141,Putnam County,9,47,-38
25,Massachusetts,47,Tennessee,143,Rhea County,0,7,-7
25,Massachusetts,47,Tennessee,149,Rutherford County,48,221,-173
25,Massachusetts,47,Tennessee,151,Scott County,12,0,12
25,Massachusetts,47,Tennessee,157,Shelby County,96,91,5
25,Massachusetts,47,Tennessee,161,Stewart County,8,0,8
25,Massachusetts,47,Tennessee,163,Sullivan County,0,202,-202
25,Massachusetts,47,Tennessee,165,Sumner County,0,49,-49
25,Massachusetts,47,Tennessee,171,Unicoi County,10,0,10
25,Massachusetts,47,Tennessee,177,Warren County,0,5,-5
25,Massachusetts,47,Tennessee,179,Washington County,0,75,-75
25,Massachusetts,47,Tennessee,187,Williamson County,65,108,-43
25,Massachusetts,47,Tennessee,189,Wilson County,86,29,57
25,Massachusetts,48,Texas,27,Bell County,187,138,49
25,Massachusetts,48,Texas,29,Bexar County,315,335,-20
25,Massachusetts,48,Texas,37,Bowie County,0,4,-4
25,Massachusetts,48,Texas,39,Brazoria County,12,0,12
25,Massachusetts,48,Texas,41,Brazos County,67,23,44
25,Massachusetts,48,Texas,53,Burnet County,0,14,-14
25,Massachusetts,48,Texas,55,Caldwell County,0,7,-7
25,Massachusetts,48,Texas,57,Calhoun County,0,22,-22
25,Massachusetts,48,Texas,61,Cameron County,60,0,60
25,Massachusetts,48,Texas,73,Cherokee County,7,0,7
25,Massachusetts,48,Texas,85,Collin County,308,304,4
25,Massachusetts,48,Texas,91,Comal County,0,31,-31
25,Massachusetts,48,Texas,99,Coryell County,81,0,81
25,Massachusetts,48,Texas,113,Dallas County,379,739,-360
25,Massachusetts,48,Texas,121,Denton County,191,299,-108
25,Massachusetts,48,Texas,139,Ellis County,5,0,5
25,Massachusetts,48,Texas,141,El Paso County,309,275,34
25,Massachusetts,48,Texas,143,Erath County,0,18,-18
25,Massachusetts,48,Texas,157,Fort Bend County,264,301,-37
25,Massachusetts,48,Texas,167,Galveston County,0,70,-70
25,Massachusetts,48,Texas,181,Grayson County,0,46,-46
25,Massachusetts,48,Texas,183,Gregg County,6,15,-9
25,Massachusetts,48,Texas,201,Harris County,608,1371,-763
25,Massachusetts,48,Texas,209,Hays County,0,31,-31
25,Massachusetts,48,Texas,215,Hidalgo County,26,0,26
25,Massachusetts,48,Texas,221,Hood County,0,8,-8
25,Massachusetts,48,Texas,231,Hunt County,0,3,-3
25,Massachusetts,48,Texas,241,Jasper County,0,83,-83
25,Massachusetts,48,Texas,251,Johnson County,23,9,14
25,Massachusetts,48,Texas,257,Kaufman County,6,0,6
25,Massachusetts,48,Texas,259,Kendall County,94,174,-80
25,Massachusetts,48,Texas,283,La Salle County,0,59,-59
25,Massachusetts,48,Texas,285,Lavaca County,0,19,-19
25,Massachusetts,48,Texas,299,Llano County,0,15,-15
25,Massachusetts,48,Texas,303,Lubbock County,151,13,138
25,Massachusetts,48,Texas,309,McLennan County,43,12,31
25,Massachusetts,48,Texas,321,Matagorda County,19,0,19
25,Massachusetts,48,Texas,323,Maverick County,11,0,11
25,Massachusetts,48,Texas,329,Midland County,0,20,-20
25,Massachusetts,48,Texas,333,Mills County,9,0,9
25,Massachusetts,48,Texas,339,Montgomery County,85,43,42
25,Massachusetts,48,Texas,355,Nueces County,7,38,-31
25,Massachusetts,48,Texas,361,Orange County,0,16,-16
25,Massachusetts,48,Texas,367,Parker County,0,6,-6
25,Massachusetts,48,Texas,375,Potter County,18,51,-33
25,Massachusetts,48,Texas,439,Tarrant County,248,290,-42
25,Massachusetts,48,Texas,441,Taylor County,112,25,87
25,Massachusetts,48,Texas,453,Travis County,334,858,-524
25,Massachusetts,48,Texas,455,Trinity County,18,0,18
25,Massachusetts,48,Texas,473,Waller County,16,0,16
25,Massachusetts,48,Texas,485,Wichita County,19,136,-117
25,Massachusetts,48,Texas,491,Williamson County,194,256,-62
25,Massachusetts,48,Texas,497,Wise County,16,0,16
25,Massachusetts,48,Texas,499,Wood County,0,3,-3
25,Massachusetts,49,Utah,5,Cache County,66,1,65
25,Massachusetts,49,Utah,11,Davis County,0,71,-71
25,Massachusetts,49,Utah,19,Grand County,11,0,11
25,Massachusetts,49,Utah,21,Iron County,66,10,56
25,Massachusetts,49,Utah,23,Juab County,0,10,-10
25,Massachusetts,49,Utah,25,Kane County,17,0,17
25,Massachusetts,49,Utah,35,Salt Lake County,233,385,-152
25,Massachusetts,49,Utah,39,Sanpete County,0,4,-4
25,Massachusetts,49,Utah,43,Summit County,0,46,-46
25,Massachusetts,49,Utah,49,Utah County,158,211,-53
25,Massachusetts,49,Utah,51,Wasatch County,42,0,42
25,Massachusetts,49,Utah,53,Washington County,23,52,-29
25,Massachusetts,49,Utah,55,Wayne County,0,2,-2
25,Massachusetts,49,Utah,57,Weber County,57,190,-133
25,Massachusetts,5,Arkansas,7,Benton County,10,21,-11
25,Massachusetts,5,Arkansas,31,Craighead County,52,0,52
25,Massachusetts,5,Arkansas,35,Crittenden County,8,0,8
25,Massachusetts,5,Arkansas,45,Faulkner County,0,35,-35
25,Massachusetts,5,Arkansas,51,Garland County,0,9,-9
25,Massachusetts,5,Arkansas,89,Marion County,2,0,2
25,Massachusetts,5,Arkansas,107,Phillips County,17,0,17
25,Massachusetts,5,Arkansas,119,Pulaski County,149,80,69
25,Massachusetts,5,Arkansas,131,Sebastian County,40,14,26
25,Massachusetts,5,Arkansas,143,Washington County,74,23,51
25,Massachusetts,50,Vermont,1,Addison County,39,142,-103
25,Massachusetts,50,Vermont,3,Bennington County,258,183,75
25,Massachusetts,50,Vermont,5,Caledonia County,41,56,-15
25,Massachusetts,50,Vermont,7,Chittenden County,1019,1654,-635
25,Massachusetts,50,Vermont,9,Essex County,0,13,-13
25,Massachusetts,50,Vermont,11,Franklin County,86,180,-94
25,Massachusetts,50,Vermont,13,Grand Isle County,6,29,-23
25,Massachusetts,50,Vermont,15,Lamoille County,39,80,-41
25,Massachusetts,50,Vermont,17,Orange County,162,106,56
25,Massachusetts,50,Vermont,19,Orleans County,79,69,10
25,Massachusetts,50,Vermont,21,Rutland County,208,340,-132
25,Massachusetts,50,Vermont,23,Washington County,197,335,-138
25,Massachusetts,50,Vermont,25,Windham County,402,372,30
25,Massachusetts,50,Vermont,27,Windsor County,337,151,186
25,Massachusetts,51,Virginia,1,Accomack County,0,12,-12
25,Massachusetts,51,Virginia,3,Albemarle County,295,202,93
25,Massachusetts,51,Virginia,11,Appomattox County,0,14,-14
25,Massachusetts,51,Virginia,13,Arlington County,561,691,-130
25,Massachusetts,51,Virginia,15,Augusta County,0,42,-42
25,Massachusetts,51,Virginia,19,Bedford County,0,17,-17
25,Massachusetts,51,Virginia,41,Chesterfield County,149,60,89
25,Massachusetts,51,Virginia,49,Cumberland County,4,0,4
25,Massachusetts,51,Virginia,59,Fairfax County,906,646,260
25,Massachusetts,51,Virginia,61,Fauquier County,23,0,23
25,Massachusetts,51,Virginia,65,Fluvanna County,7,0,7
25,Massachusetts,51,Virginia,67,Franklin County,14,0,14
25,Massachusetts,51,Virginia,71,Giles County,26,0,26
25,Massachusetts,51,Virginia,73,Gloucester County,0,15,-15
25,Massachusetts,51,Virginia,85,Hanover County,7,52,-45
25,Massachusetts,51,Virginia,87,Henrico County,112,163,-51
25,Massachusetts,51,Virginia,89,Henry County,9,0,9
25,Massachusetts,51,Virginia,95,James City County,28,466,-438
25,Massachusetts,51,Virginia,107,Loudoun County,104,156,-52
25,Massachusetts,51,Virginia,121,Montgomery County,48,75,-27
25,Massachusetts,51,Virginia,131,Northampton County,38,0,38
25,Massachusetts,51,Virginia,143,Pittsylvania County,13,0,13
25,Massachusetts,51,Virginia,149,Prince George County,46,0,46
25,Massachusetts,51,Virginia,153,Prince William County,109,92,17
25,Massachusetts,51,Virginia,161,Roanoke County,8,0,8
25,Massachusetts,51,Virginia,163,Rockbridge County,0,59,-59
25,Massachusetts,51,Virginia,165,Rockingham County,0,8,-8
25,Massachusetts,51,Virginia,173,Smyth County,0,16,-16
25,Massachusetts,51,Virginia,177,Spotsylvania County,0,109,-109
25,Massachusetts,51,Virginia,179,Stafford County,118,9,109
25,Massachusetts,51,Virginia,187,Warren County,7,0,7
25,Massachusetts,51,Virginia,191,Washington County,65,0,65
25,Massachusetts,51,Virginia,195,Wise County,67,6,61
25,Massachusetts,51,Virginia,199,York County,0,8,-8
25,Massachusetts,51,Virginia,510,Alexandria city,359,267,92
25,Massachusetts,51,Virginia,540,Charlottesville city,114,148,-34
25,Massachusetts,51,Virginia,550,Chesapeake city,238,87,151
25,Massachusetts,51,Virginia,600,Fairfax city,63,0,63
25,Massachusetts,51,Virginia,610,Falls Church city,6,0,6
25,Massachusetts,51,Virginia,630,Fredericksburg city,19,36,-17
25,Massachusetts,51,Virginia,650,Hampton city,84,97,-13
25,Massachusetts,51,Virginia,660,Harrisonburg city,20,52,-32
25,Massachusetts,51,Virginia,678,Lexington city,21,45,-24
25,Massachusetts,51,Virginia,680,Lynchburg city,49,45,4
25,Massachusetts,51,Virginia,700,Newport News city,29,28,1
25,Massachusetts,51,Virginia,710,Norfolk city,236,111,125
25,Massachusetts,51,Virginia,735,Poquoson city,0,30,-30
25,Massachusetts,51,Virginia,740,Portsmouth city,0,43,-43
25,Massachusetts,51,Virginia,760,Richmond city,86,224,-138
25,Massachusetts,51,Virginia,770,Roanoke city,94,0,94
25,Massachusetts,51,Virginia,775,Salem city,0,10,-10
25,Massachusetts,51,Virginia,790,Staunton city,2,17,-15
25,Massachusetts,51,Virginia,800,Suffolk city,28,15,13
25,Massachusetts,51,Virginia,810,Virginia Beach city,278,215,63
25,Massachusetts,51,Virginia,820,Waynesboro city,0,17,-17
25,Massachusetts,51,Virginia,830,Williamsburg city,25,43,-18
25,Massachusetts,53,Washington,5,Benton County,22,168,-146
25,Massachusetts,53,Washington,7,Chelan County,5,0,5
25,Massachusetts,53,Washington,9,Clallam County,0,12,-12
25,Massachusetts,53,Washington,11,Clark County,12,168,-156
25,Massachusetts,53,Washington,15,Cowlitz County,32,4,28
25,Massachusetts,53,Washington,29,Island County,0,65,-65
25,Massachusetts,53,Washington,31,Jefferson County,0,192,-192
25,Massachusetts,53,Washington,33,King County,1022,1809,-787
25,Massachusetts,53,Washington,35,Kitsap County,81,47,34
25,Massachusetts,53,Washington,37,Kittitas County,44,0,44
25,Massachusetts,53,Washington,53,Pierce County,54,181,-127
25,Massachusetts,53,Washington,55,San Juan County,0,5,-5
25,Massachusetts,53,Washington,57,Skagit County,0,23,-23
25,Massachusetts,53,Washington,61,Snohomish County,74,165,-91
25,Massachusetts,53,Washington,63,Spokane County,7,31,-24
25,Massachusetts,53,Washington,67,Thurston County,91,33,58
25,Massachusetts,53,Washington,71,Walla Walla County,0,14,-14
25,Massachusetts,53,Washington,73,Whatcom County,12,77,-65
25,Massachusetts,53,Washington,75,Whitman County,8,10,-2
25,Massachusetts,53,Washington,77,Yakima County,0,70,-70
25,Massachusetts,54,West Virginia,3,Berkeley County,18,0,18
25,Massachusetts,54,West Virginia,11,Cabell County,0,39,-39
25,Massachusetts,54,West Virginia,17,Doddridge County,0,7,-7
25,Massachusetts,54,West Virginia,19,Fayette County,38,0,38
25,Massachusetts,54,West Virginia,23,Grant County,8,0,8
25,Massachusetts,54,West Virginia,25,Greenbrier County,15,0,15
25,Massachusetts,54,West Virginia,27,Hampshire County,0,2,-2
25,Massachusetts,54,West Virginia,29,Hancock County,10,0,10
25,Massachusetts,54,West Virginia,31,Hardy County,0,37,-37
25,Massachusetts,54,West Virginia,37,Jefferson County,62,7,55
25,Massachusetts,54,West Virginia,39,Kanawha County,11,13,-2
25,Massachusetts,54,West Virginia,51,Marshall County,0,11,-11
25,Massachusetts,54,West Virginia,61,Monongalia County,34,42,-8
25,Massachusetts,54,West Virginia,71,Pendleton County,0,12,-12
25,Massachusetts,54,West Virginia,91,Taylor County,7,0,7
25,Massachusetts,54,West Virginia,95,Tyler County,27,0,27
25,Massachusetts,55,Wisconsin,3,Ashland County,0,10,-10
25,Massachusetts,55,Wisconsin,9,Brown County,62,0,62
25,Massachusetts,55,Wisconsin,21,Columbia County,0,10,-10
25,Massachusetts,55,Wisconsin,25,Dane County,459,309,150
25,Massachusetts,55,Wisconsin,29,Door County,0,3,-3
25,Massachusetts,55,Wisconsin,35,Eau Claire County,12,0,12
25,Massachusetts,55,Wisconsin,39,Fond du Lac County,8,0,8
25,Massachusetts,55,Wisconsin,45,Green County,0,3,-3
25,Massachusetts,55,Wisconsin,47,Green Lake County,9,5,4
25,Massachusetts,55,Wisconsin,55,Jefferson County,47,0,47
25,Massachusetts,55,Wisconsin,63,La Crosse County,24,7,17
25,Massachusetts,55,Wisconsin,73,Marathon County,8,4,4
25,Massachusetts,55,Wisconsin,77,Marquette County,0,5,-5
25,Massachusetts,55,Wisconsin,79,Milwaukee County,165,193,-28
25,Massachusetts,55,Wisconsin,85,Oneida County,12,0,12
25,Massachusetts,55,Wisconsin,87,Outagamie County,0,11,-11
25,Massachusetts,55,Wisconsin,89,Ozaukee County,78,30,48
25,Massachusetts,55,Wisconsin,93,Pierce County,0,12,-12
25,Massachusetts,55,Wisconsin,97,Portage County,0,4,-4
25,Massachusetts,55,Wisconsin,103,Richland County,0,5,-5
25,Massachusetts,55,Wisconsin,105,Rock County,0,23,-23
25,Massachusetts,55,Wisconsin,117,Sheboygan County,0,31,-31
25,Massachusetts,55,Wisconsin,125,Vilas County,3,1,2
25,Massachusetts,55,Wisconsin,127,Walworth County,6,7,-1
25,Massachusetts,55,Wisconsin,133,Waukesha County,124,11,113
25,Massachusetts,55,Wisconsin,139,Winnebago County,0,60,-60
25,Massachusetts,55,Wisconsin,141,Wood County,0,11,-11
25,Massachusetts,56,Wyoming,11,Crook County,0,1,-1
25,Massachusetts,56,Wyoming,21,Laramie County,12,0,12
25,Massachusetts,56,Wyoming,25,Natrona County,0,9,-9
25,Massachusetts,56,Wyoming,33,Sheridan County,6,0,6
25,Massachusetts,56,Wyoming,37,Sweetwater County,0,90,-90
25,Massachusetts,56,Wyoming,39,Teton County,21,15,6
25,Massachusetts,6,California,1,Alameda County,969,778,191
25,Massachusetts,6,California,7,Butte County,23,38,-15
25,Massachusetts,6,California,13,Contra Costa County,424,396,28
25,Massachusetts,6,California,17,El Dorado County,0,27,-27
25,Massachusetts,6,California,19,Fresno County,2,111,-109
25,Massachusetts,6,California,23,Humboldt County,5,43,-38
25,Massachusetts,6,California,29,Kern County,60,8,52
25,Massachusetts,6,California,31,Kings County,0,6,-6
25,Massachusetts,6,California,37,Los Angeles County,3197,4016,-819
25,Massachusetts,6,California,41,Marin County,343,106,237
25,Massachusetts,6,California,43,Mariposa County,0,9,-9
25,Massachusetts,6,California,45,Mendocino County,6,0,6
25,Massachusetts,6,California,47,Merced County,12,0,12
25,Massachusetts,6,California,53,Monterey County,103,57,46
25,Massachusetts,6,California,55,Napa County,9,30,-21
25,Massachusetts,6,California,57,Nevada County,6,0,6
25,Massachusetts,6,California,59,Orange County,840,962,-122
25,Massachusetts,6,California,61,Placer County,0,143,-143
25,Massachusetts,6,California,65,Riverside County,293,331,-38
25,Massachusetts,6,California,67,Sacramento County,257,135,122
25,Massachusetts,6,California,71,San Bernardino County,217,132,85
25,Massachusetts,6,California,73,San Diego County,1517,1745,-228
25,Massachusetts,6,California,75,San Francisco County,915,1738,-823
25,Massachusetts,6,California,77,San Joaquin County,44,161,-117
25,Massachusetts,6,California,79,San Luis Obispo County,20,21,-1
25,Massachusetts,6,California,81,San Mateo County,383,410,-27
25,Massachusetts,6,California,83,Santa Barbara County,360,198,162
25,Massachusetts,6,California,85,Santa Clara County,981,1481,-500
25,Massachusetts,6,California,87,Santa Cruz County,231,54,177
25,Massachusetts,6,California,89,Shasta County,46,0,46
25,Massachusetts,6,California,93,Siskiyou County,0,4,-4
25,Massachusetts,6,California,95,Solano County,50,12,38
25,Massachusetts,6,California,97,Sonoma County,52,205,-153
25,Massachusetts,6,California,99,Stanislaus County,0,17,-17
25,Massachusetts,6,California,109,Tuolumne County,38,0,38
25,Massachusetts,6,California,111,Ventura County,480,250,230
25,Massachusetts,6,California,113,Yolo County,199,92,107
25,Massachusetts,72,Puerto Rico,1,Adjuntas Municipio,0,90,-90
25,Massachusetts,72,Puerto Rico,5,Aguadilla Municipio,40,4,36
25,Massachusetts,72,Puerto Rico,11,Añasco Municipio,114,0,114
25,Massachusetts,72,Puerto Rico,13,Arecibo Municipio,29,24,5
25,Massachusetts,72,Puerto Rico,15,Arroyo Municipio,0,102,-102
25,Massachusetts,72,Puerto Rico,17,Barceloneta Municipio,166,0,166
25,Massachusetts,72,Puerto Rico,21,Bayamón Municipio,7,74,-67
25,Massachusetts,72,Puerto Rico,23,Cabo Rojo Municipio,61,0,61
25,Massachusetts,72,Puerto Rico,25,Caguas Municipio,153,53,100
25,Massachusetts,72,Puerto Rico,29,Canóvanas Municipio,26,76,-50
25,Massachusetts,72,Puerto Rico,31,Carolina Municipio,342,125,217
25,Massachusetts,72,Puerto Rico,33,Cataño Municipio,0,23,-23
25,Massachusetts,72,Puerto Rico,35,Cayey Municipio,21,0,21
25,Massachusetts,72,Puerto Rico,41,Cidra Municipio,0,58,-58
25,Massachusetts,72,Puerto Rico,43,Coamo Municipio,20,80,-60
25,Massachusetts,72,Puerto Rico,45,Comerío Municipio,16,0,16
25,Massachusetts,72,Puerto Rico,47,Corozal Municipio,0,111,-111
25,Massachusetts,72,Puerto Rico,51,Dorado Municipio,28,17,11
25,Massachusetts,72,Puerto Rico,53,Fajardo Municipio,119,0,119
25,Massachusetts,72,Puerto Rico,57,Guayama Municipio,42,222,-180
25,Massachusetts,72,Puerto Rico,59,Guayanilla Municipio,69,0,69
25,Massachusetts,72,Puerto Rico,61,Guaynabo Municipio,136,37,99
25,Massachusetts,72,Puerto Rico,63,Gurabo Municipio,97,119,-22
25,Massachusetts,72,Puerto Rico,65,Hatillo Municipio,66,0,66
25,Massachusetts,72,Puerto Rico,69,Humacao Municipio,101,26,75
25,Massachusetts,72,Puerto Rico,71,Isabela Municipio,132,31,101
25,Massachusetts,72,Puerto Rico,73,Jayuya Municipio,87,1,86
25,Massachusetts,72,Puerto Rico,75,Juana Díaz Municipio,5,193,-188
25,Massachusetts,72,Puerto Rico,77,Juncos Municipio,40,0,40
25,Massachusetts,72,Puerto Rico,83,Las Marías Municipio,0,22,-22
25,Massachusetts,72,Puerto Rico,85,Las Piedras Municipio,69,0,69
25,Massachusetts,72,Puerto Rico,89,Luquillo Municipio,0,65,-65
25,Massachusetts,72,Puerto Rico,91,Manatí Municipio,46,0,46
25,Massachusetts,72,Puerto Rico,95,Maunabo Municipio,0,14,-14
25,Massachusetts,72,Puerto Rico,97,Mayagüez Municipio,86,63,23
25,Massachusetts,72,Puerto Rico,99,Moca Municipio,211,0,211
25,Massachusetts,72,Puerto Rico,107,Orocovis Municipio,28,18,10
25,Massachusetts,72,Puerto Rico,113,Ponce Municipio,45,23,22
25,Massachusetts,72,Puerto Rico,115,Quebradillas Municipio,30,0,30
25,Massachusetts,72,Puerto Rico,119,Río Grande Municipio,13,44,-31
25,Massachusetts,72,Puerto Rico,123,Salinas Municipio,98,146,-48
25,Massachusetts,72,Puerto Rico,127,San Juan Municipio,819,206,613
25,Massachusetts,72,Puerto Rico,129,San Lorenzo Municipio,170,0,170
25,Massachusetts,72,Puerto Rico,133,Santa Isabel Municipio,0,12,-12
25,Massachusetts,72,Puerto Rico,135,Toa Alta Municipio,84,0,84
25,Massachusetts,72,Puerto Rico,137,Toa Baja Municipio,156,14,142
25,Massachusetts,72,Puerto Rico,139,Trujillo Alto Municipio,9,18,-9
25,Massachusetts,72,Puerto Rico,141,Utuado Municipio,0,44,-44
25,Massachusetts,72,Puerto Rico,145,Vega Baja Municipio,140,16,124
25,Massachusetts,72,Puerto Rico,149,Villalba Municipio,0,29,-29
25,Massachusetts,72,Puerto Rico,151,Yabucoa Municipio,298,59,239
25,Massachusetts,72,Puerto Rico,153,Yauco Municipio,26,0,26
25,Massachusetts,8,Colorado,1,Adams County,137,49,88
25,Massachusetts,8,Colorado,3,Alamosa County,17,0,17
25,Massachusetts,8,Colorado,5,Arapahoe County,167,121,46
25,Massachusetts,8,Colorado,13,Boulder County,447,550,-103
25,Massachusetts,8,Colorado,14,Broomfield County,76,0,76
25,Massachusetts,8,Colorado,15,Chaffee County,13,0,13
25,Massachusetts,8,Colorado,31,Denver County,661,387,274
25,Massachusetts,8,Colorado,35,Douglas County,186,138,48
25,Massachusetts,8,Colorado,37,Eagle County,58,32,26
25,Massachusetts,8,Colorado,39,Elbert County,27,0,27
25,Massachusetts,8,Colorado,41,El Paso County,367,174,193
25,Massachusetts,8,Colorado,49,Grand County,0,67,-67
25,Massachusetts,8,Colorado,59,Jefferson County,41,356,-315
25,Massachusetts,8,Colorado,65,Lake County,0,4,-4
25,Massachusetts,8,Colorado,67,La Plata County,15,0,15
25,Massachusetts,8,Colorado,69,Larimer County,119,130,-11
25,Massachusetts,8,Colorado,89,Otero County,0,7,-7
25,Massachusetts,8,Colorado,97,Pitkin County,0,60,-60
25,Massachusetts,8,Colorado,101,Pueblo County,0,30,-30
25,Massachusetts,8,Colorado,107,Routt County,11,0,11
25,Massachusetts,8,Colorado,113,San Miguel County,0,1,-1
25,Massachusetts,8,Colorado,117,Summit County,48,27,21
25,Massachusetts,8,Colorado,123,Weld County,13,30,-17
25,Massachusetts,9,Connecticut,1,Fairfield County,2197,1347,850
25,Massachusetts,9,Connecticut,3,Hartford County,3228,3512,-284
25,Massachusetts,9,Connecticut,5,Litchfield County,276,475,-199
25,Massachusetts,9,Connecticut,7,Middlesex County,495,421,74
25,Massachusetts,9,Connecticut,9,New Haven County,2088,1281,807
25,Massachusetts,9,Connecticut,11,New London County,1004,541,463
25,Massachusetts,9,Connecticut,13,Tolland County,674,826,-152
25,Massachusetts,9,Connecticut,15,Windham County,319,590,-271
25,Massachusetts,AFR,Africa,,-,4476,0,0
25,Massachusetts,ASI,Asia,,-,25071,0,0
25,Massachusetts,CAM,Central America,,-,3545,0,0
25,Massachusetts,CAR,Caribbean,,-,5539,0,0
25,Massachusetts,EUR,Europe,,-,14530,0,0
25,Massachusetts,ISL,U.S. Island Areas,,-,448,0,0
25,Massachusetts,NAM,Northern America,,-,2163,0,0
25,Massachusetts,OCE,Oceania and At Sea,,-,849,0,0
25,Massachusetts,SAM,South America,,-,7465,0,0
26,Michigan,1,Alabama,1,Autauga County,45,0,45
26,Michigan,1,Alabama,3,Baldwin County,93,193,-100
26,Michigan,1,Alabama,9,Blount County,0,2,-2
26,Michigan,1,Alabama,15,Calhoun County,36,34,2
26,Michigan,1,Alabama,17,Chambers County,0,30,-30
26,Michigan,1,Alabama,19,Cherokee County,0,11,-11
26,Michigan,1,Alabama,31,Coffee County,0,7,-7
26,Michigan,1,Alabama,33,Colbert County,17,0,17
26,Michigan,1,Alabama,39,Covington County,8,0,8
26,Michigan,1,Alabama,43,Cullman County,42,1,41
26,Michigan,1,Alabama,45,Dale County,0,31,-31
26,Michigan,1,Alabama,49,DeKalb County,110,59,51
26,Michigan,1,Alabama,51,Elmore County,83,0,83
26,Michigan,1,Alabama,53,Escambia County,13,0,13
26,Michigan,1,Alabama,55,Etowah County,122,29,93
26,Michigan,1,Alabama,57,Fayette County,0,4,-4
26,Michigan,1,Alabama,59,Franklin County,58,0,58
26,Michigan,1,Alabama,63,Greene County,46,0,46
26,Michigan,1,Alabama,65,Hale County,0,15,-15
26,Michigan,1,Alabama,69,Houston County,38,67,-29
26,Michigan,1,Alabama,71,Jackson County,13,0,13
26,Michigan,1,Alabama,73,Jefferson County,112,409,-297
26,Michigan,1,Alabama,75,Lamar County,0,4,-4
26,Michigan,1,Alabama,77,Lauderdale County,48,94,-46
26,Michigan,1,Alabama,81,Lee County,160,80,80
26,Michigan,1,Alabama,83,Limestone County,5,195,-190
26,Michigan,1,Alabama,85,Lowndes County,0,4,-4
26,Michigan,1,Alabama,87,Macon County,0,9,-9
26,Michigan,1,Alabama,89,Madison County,294,303,-9
26,Michigan,1,Alabama,91,Marengo County,5,16,-11
26,Michigan,1,Alabama,93,Marion County,4,53,-49
26,Michigan,1,Alabama,95,Marshall County,25,37,-12
26,Michigan,1,Alabama,97,Mobile County,61,177,-116
26,Michigan,1,Alabama,101,Montgomery County,446,306,140
26,Michigan,1,Alabama,103,Morgan County,3,19,-16
26,Michigan,1,Alabama,109,Pike County,0,2,-2
26,Michigan,1,Alabama,111,Randolph County,24,0,24
26,Michigan,1,Alabama,113,Russell County,10,21,-11
26,Michigan,1,Alabama,115,St. Clair County,0,10,-10
26,Michigan,1,Alabama,117,Shelby County,135,0,135
26,Michigan,1,Alabama,121,Talladega County,249,37,212
26,Michigan,1,Alabama,123,Tallapoosa County,46,0,46
26,Michigan,1,Alabama,125,Tuscaloosa County,68,264,-196
26,Michigan,1,Alabama,127,Walker County,20,45,-25
26,Michigan,1,Alabama,129,Washington County,29,0,29
26,Michigan,10,Delaware,1,Kent County,43,38,5
26,Michigan,10,Delaware,3,New Castle County,81,106,-25
26,Michigan,10,Delaware,5,Sussex County,6,18,-12
26,Michigan,11,District of Columbia,1,District of Columbia,565,714,-149
26,Michigan,12,Florida,1,Alachua County,69,220,-151
26,Michigan,12,Florida,5,Bay County,200,44,156
26,Michigan,12,Florida,9,Brevard County,495,788,-293
26,Michigan,12,Florida,11,Broward County,1002,1085,-83
26,Michigan,12,Florida,15,Charlotte County,218,700,-482
26,Michigan,12,Florida,17,Citrus County,180,404,-224
26,Michigan,12,Florida,19,Clay County,126,1,125
26,Michigan,12,Florida,21,Collier County,311,1156,-845
26,Michigan,12,Florida,23,Columbia County,2,5,-3
26,Michigan,12,Florida,27,DeSoto County,134,87,47
26,Michigan,12,Florida,31,Duval County,857,869,-12
26,Michigan,12,Florida,33,Escambia County,172,432,-260
26,Michigan,12,Florida,35,Flagler County,101,128,-27
26,Michigan,12,Florida,43,Glades County,0,62,-62
26,Michigan,12,Florida,45,Gulf County,73,0,73
26,Michigan,12,Florida,47,Hamilton County,5,5,0
26,Michigan,12,Florida,49,Hardee County,95,19,76
26,Michigan,12,Florida,51,Hendry County,17,0,17
26,Michigan,12,Florida,53,Hernando County,157,462,-305
26,Michigan,12,Florida,55,Highlands County,300,441,-141
26,Michigan,12,Florida,57,Hillsborough County,885,1079,-194
26,Michigan,12,Florida,59,Holmes County,3,0,3
26,Michigan,12,Florida,61,Indian River County,159,79,80
26,Michigan,12,Florida,63,Jackson County,37,64,-27
26,Michigan,12,Florida,65,Jefferson County,3,38,-35
26,Michigan,12,Florida,67,Lafayette County,0,3,-3
26,Michigan,12,Florida,69,Lake County,239,512,-273
26,Michigan,12,Florida,71,Lee County,456,1756,-1300
26,Michigan,12,Florida,73,Leon County,216,196,20
26,Michigan,12,Florida,75,Levy County,0,56,-56
26,Michigan,12,Florida,79,Madison County,0,4,-4
26,Michigan,12,Florida,81,Manatee County,402,638,-236
26,Michigan,12,Florida,83,Marion County,188,432,-244
26,Michigan,12,Florida,85,Martin County,40,463,-423
26,Michigan,12,Florida,86,Miami-Dade County,680,356,324
26,Michigan,12,Florida,87,Monroe County,329,141,188
26,Michigan,12,Florida,89,Nassau County,3,55,-52
26,Michigan,12,Florida,91,Okaloosa County,167,180,-13
26,Michigan,12,Florida,93,Okeechobee County,33,14,19
26,Michigan,12,Florida,95,Orange County,622,1239,-617
26,Michigan,12,Florida,97,Osceola County,110,413,-303
26,Michigan,12,Florida,99,Palm Beach County,528,764,-236
26,Michigan,12,Florida,101,Pasco County,411,770,-359
26,Michigan,12,Florida,103,Pinellas County,639,1427,-788
26,Michigan,12,Florida,105,Polk County,216,1166,-950
26,Michigan,12,Florida,107,Putnam County,13,7,6
26,Michigan,12,Florida,109,St. Johns County,137,53,84
26,Michigan,12,Florida,111,St. Lucie County,155,204,-49
26,Michigan,12,Florida,113,Santa Rosa County,72,79,-7
26,Michigan,12,Florida,115,Sarasota County,492,1098,-606
26,Michigan,12,Florida,117,Seminole County,335,267,68
26,Michigan,12,Florida,119,Sumter County,71,535,-464
26,Michigan,12,Florida,121,Suwannee County,28,0,28
26,Michigan,12,Florida,127,Volusia County,503,620,-117
26,Michigan,12,Florida,131,Walton County,67,43,24
26,Michigan,13,Georgia,1,Appling County,4,0,4
26,Michigan,13,Georgia,7,Baker County,0,11,-11
26,Michigan,13,Georgia,9,Baldwin County,0,27,-27
26,Michigan,13,Georgia,13,Barrow County,7,55,-48
26,Michigan,13,Georgia,15,Bartow County,49,33,16
26,Michigan,13,Georgia,17,Ben Hill County,14,9,5
26,Michigan,13,Georgia,19,Berrien County,12,3,9
26,Michigan,13,Georgia,21,Bibb County,20,0,20
26,Michigan,13,Georgia,23,Bleckley County,5,0,5
26,Michigan,13,Georgia,31,Bulloch County,0,3,-3
26,Michigan,13,Georgia,39,Camden County,0,15,-15
26,Michigan,13,Georgia,45,Carroll County,19,24,-5
26,Michigan,13,Georgia,47,Catoosa County,57,0,57
26,Michigan,13,Georgia,51,Chatham County,102,178,-76
26,Michigan,13,Georgia,53,Chattahoochee County,0,25,-25
26,Michigan,13,Georgia,57,Cherokee County,57,326,-269
26,Michigan,13,Georgia,59,Clarke County,22,118,-96
26,Michigan,13,Georgia,63,Clayton County,86,313,-227
26,Michigan,13,Georgia,67,Cobb County,306,495,-189
26,Michigan,13,Georgia,71,Colquitt County,0,53,-53
26,Michigan,13,Georgia,73,Columbia County,116,217,-101
26,Michigan,13,Georgia,77,Coweta County,8,28,-20
26,Michigan,13,Georgia,83,Dade County,0,10,-10
26,Michigan,13,Georgia,89,DeKalb County,1024,762,262
26,Michigan,13,Georgia,95,Dougherty County,0,32,-32
26,Michigan,13,Georgia,97,Douglas County,149,18,131
26,Michigan,13,Georgia,101,Echols County,4,0,4
26,Michigan,13,Georgia,103,Effingham County,0,21,-21
26,Michigan,13,Georgia,107,Emanuel County,0,39,-39
26,Michigan,13,Georgia,113,Fayette County,126,0,126
26,Michigan,13,Georgia,115,Floyd County,0,59,-59
26,Michigan,13,Georgia,117,Forsyth County,7,241,-234
26,Michigan,13,Georgia,119,Franklin County,28,0,28
26,Michigan,13,Georgia,121,Fulton County,1369,1213,156
26,Michigan,13,Georgia,123,Gilmer County,0,41,-41
26,Michigan,13,Georgia,127,Glynn County,0,78,-78
26,Michigan,13,Georgia,129,Gordon County,33,15,18
26,Michigan,13,Georgia,131,Grady County,5,398,-393
26,Michigan,13,Georgia,133,Greene County,0,32,-32
26,Michigan,13,Georgia,135,Gwinnett County,724,455,269
26,Michigan,13,Georgia,139,Hall County,16,0,16
26,Michigan,13,Georgia,143,Haralson County,0,50,-50
26,Michigan,13,Georgia,145,Harris County,0,43,-43
26,Michigan,13,Georgia,151,Henry County,43,135,-92
26,Michigan,13,Georgia,153,Houston County,53,17,36
26,Michigan,13,Georgia,157,Jackson County,7,0,7
26,Michigan,13,Georgia,175,Laurens County,31,0,31
26,Michigan,13,Georgia,177,Lee County,0,28,-28
26,Michigan,13,Georgia,179,Liberty County,73,77,-4
26,Michigan,13,Georgia,185,Lowndes County,226,81,145
26,Michigan,13,Georgia,189,McDuffie County,0,32,-32
26,Michigan,13,Georgia,193,Macon County,0,23,-23
26,Michigan,13,Georgia,199,Meriwether County,33,0,33
26,Michigan,13,Georgia,205,Mitchell County,52,0,52
26,Michigan,13,Georgia,211,Morgan County,19,9,10
26,Michigan,13,Georgia,215,Muscogee County,224,160,64
26,Michigan,13,Georgia,217,Newton County,7,0,7
26,Michigan,13,Georgia,223,Paulding County,254,80,174
26,Michigan,13,Georgia,231,Pike County,0,18,-18
26,Michigan,13,Georgia,233,Polk County,0,29,-29
26,Michigan,13,Georgia,235,Pulaski County,0,49,-49
26,Michigan,13,Georgia,237,Putnam County,0,72,-72
26,Michigan,13,Georgia,239,Quitman County,0,7,-7
26,Michigan,13,Georgia,241,Rabun County,38,13,25
26,Michigan,13,Georgia,245,Richmond County,102,107,-5
26,Michigan,13,Georgia,247,Rockdale County,48,0,48
26,Michigan,13,Georgia,255,Spalding County,0,48,-48
26,Michigan,13,Georgia,261,Sumter County,12,7,5
26,Michigan,13,Georgia,267,Tattnall County,6,0,6
26,Michigan,13,Georgia,275,Thomas County,4,29,-25
26,Michigan,13,Georgia,277,Tift County,0,21,-21
26,Michigan,13,Georgia,281,Towns County,0,9,-9
26,Michigan,13,Georgia,291,Union County,0,16,-16
26,Michigan,13,Georgia,295,Walker County,7,28,-21
26,Michigan,13,Georgia,297,Walton County,0,25,-25
26,Michigan,13,Georgia,303,Washington County,0,3,-3
26,Michigan,13,Georgia,305,Wayne County,63,0,63
26,Michigan,13,Georgia,311,White County,4,0,4
26,Michigan,15,Hawaii,1,Hawaii County,20,15,5
26,Michigan,15,Hawaii,3,Honolulu County,506,453,53
26,Michigan,15,Hawaii,7,Kauai County,10,6,4
26,Michigan,15,Hawaii,9,Maui County,6,29,-23
26,Michigan,16,Idaho,1,Ada County,180,218,-38
26,Michigan,16,Idaho,5,Bannock County,22,0,22
26,Michigan,16,Idaho,9,Benewah County,0,9,-9
26,Michigan,16,Idaho,11,Bingham County,7,0,7
26,Michigan,16,Idaho,17,Bonner County,9,0,9
26,Michigan,16,Idaho,19,Bonneville County,60,9,51
26,Michigan,16,Idaho,27,Canyon County,105,0,105
26,Michigan,16,Idaho,31,Cassia County,19,0,19
26,Michigan,16,Idaho,37,Custer County,44,0,44
26,Michigan,16,Idaho,39,Elmore County,7,9,-2
26,Michigan,16,Idaho,41,Franklin County,0,4,-4
26,Michigan,16,Idaho,43,Fremont County,25,3,22
26,Michigan,16,Idaho,51,Jefferson County,12,0,12
26,Michigan,16,Idaho,55,Kootenai County,11,0,11
26,Michigan,16,Idaho,57,Latah County,173,0,173
26,Michigan,16,Idaho,59,Lemhi County,0,1,-1
26,Michigan,16,Idaho,61,Lewis County,0,4,-4
26,Michigan,16,Idaho,65,Madison County,27,153,-126
26,Michigan,16,Idaho,81,Teton County,0,18,-18
26,Michigan,16,Idaho,83,Twin Falls County,23,0,23
26,Michigan,16,Idaho,87,Washington County,0,4,-4
26,Michigan,17,Illinois,1,Adams County,13,0,13
26,Michigan,17,Illinois,7,Boone County,0,63,-63
26,Michigan,17,Illinois,11,Bureau County,0,58,-58
26,Michigan,17,Illinois,13,Calhoun County,0,4,-4
26,Michigan,17,Illinois,19,Champaign County,320,395,-75
26,Michigan,17,Illinois,27,Clinton County,0,12,-12
26,Michigan,17,Illinois,29,Coles County,13,51,-38
26,Michigan,17,Illinois,31,Cook County,7485,6163,1322
26,Michigan,17,Illinois,33,Crawford County,9,60,-51
26,Michigan,17,Illinois,37,DeKalb County,127,175,-48
26,Michigan,17,Illinois,41,Douglas County,12,0,12
26,Michigan,17,Illinois,43,DuPage County,1639,813,826
26,Michigan,17,Illinois,45,Edgar County,8,0,8
26,Michigan,17,Illinois,49,Effingham County,0,2,-2
26,Michigan,17,Illinois,55,Franklin County,11,6,5
26,Michigan,17,Illinois,57,Fulton County,13,15,-2
26,Michigan,17,Illinois,63,Grundy County,75,0,75
26,Michigan,17,Illinois,67,Hancock County,12,0,12
26,Michigan,17,Illinois,73,Henry County,0,3,-3
26,Michigan,17,Illinois,77,Jackson County,19,95,-76
26,Michigan,17,Illinois,81,Jefferson County,0,20,-20
26,Michigan,17,Illinois,83,Jersey County,0,10,-10
26,Michigan,17,Illinois,85,Jo Daviess County,0,6,-6
26,Michigan,17,Illinois,87,Johnson County,0,17,-17
26,Michigan,17,Illinois,89,Kane County,546,389,157
26,Michigan,17,Illinois,91,Kankakee County,175,162,13
26,Michigan,17,Illinois,93,Kendall County,175,153,22
26,Michigan,17,Illinois,95,Knox County,2,12,-10
26,Michigan,17,Illinois,97,Lake County,1172,754,418
26,Michigan,17,Illinois,99,LaSalle County,32,43,-11
26,Michigan,17,Illinois,105,Livingston County,8,0,8
26,Michigan,17,Illinois,107,Logan County,0,7,-7
26,Michigan,17,Illinois,109,McDonough County,7,0,7
26,Michigan,17,Illinois,111,McHenry County,226,86,140
26,Michigan,17,Illinois,113,McLean County,132,78,54
26,Michigan,17,Illinois,115,Macon County,32,68,-36
26,Michigan,17,Illinois,117,Macoupin County,89,0,89
26,Michigan,17,Illinois,119,Madison County,76,80,-4
26,Michigan,17,Illinois,121,Marion County,5,111,-106
26,Michigan,17,Illinois,123,Marshall County,8,0,8
26,Michigan,17,Illinois,129,Menard County,0,150,-150
26,Michigan,17,Illinois,131,Mercer County,13,0,13
26,Michigan,17,Illinois,137,Morgan County,9,2,7
26,Michigan,17,Illinois,141,Ogle County,33,59,-26
26,Michigan,17,Illinois,143,Peoria County,175,198,-23
26,Michigan,17,Illinois,149,Pike County,139,0,139
26,Michigan,17,Illinois,151,Pope County,0,7,-7
26,Michigan,17,Illinois,153,Pulaski County,0,2,-2
26,Michigan,17,Illinois,155,Putnam County,0,1,-1
26,Michigan,17,Illinois,159,Richland County,0,3,-3
26,Michigan,17,Illinois,161,Rock Island County,14,56,-42
26,Michigan,17,Illinois,163,St. Clair County,33,182,-149
26,Michigan,17,Illinois,167,Sangamon County,65,57,8
26,Michigan,17,Illinois,173,Shelby County,12,0,12
26,Michigan,17,Illinois,175,Stark County,23,0,23
26,Michigan,17,Illinois,177,Stephenson County,10,27,-17
26,Michigan,17,Illinois,179,Tazewell County,44,163,-119
26,Michigan,17,Illinois,189,Washington County,7,0,7
26,Michigan,17,Illinois,191,Wayne County,0,46,-46
26,Michigan,17,Illinois,195,Whiteside County,14,25,-11
26,Michigan,17,Illinois,197,Will County,806,247,559
26,Michigan,17,Illinois,199,Williamson County,78,25,53
26,Michigan,17,Illinois,201,Winnebago County,270,144,126
26,Michigan,17,Illinois,203,Woodford County,0,25,-25
26,Michigan,18,Indiana,1,Adams County,19,0,19
26,Michigan,18,Indiana,3,Allen County,681,942,-261
26,Michigan,18,Indiana,5,Bartholomew County,96,86,10
26,Michigan,18,Indiana,7,Benton County,0,9,-9
26,Michigan,18,Indiana,9,Blackford County,40,0,40
26,Michigan,18,Indiana,11,Boone County,31,94,-63
26,Michigan,18,Indiana,13,Brown County,4,0,4
26,Michigan,18,Indiana,15,Carroll County,25,0,25
26,Michigan,18,Indiana,17,Cass County,6,10,-4
26,Michigan,18,Indiana,19,Clark County,55,126,-71
26,Michigan,18,Indiana,25,Crawford County,16,0,16
26,Michigan,18,Indiana,29,Dearborn County,0,65,-65
26,Michigan,18,Indiana,31,Decatur County,33,1,32
26,Michigan,18,Indiana,33,DeKalb County,60,161,-101
26,Michigan,18,Indiana,35,Delaware County,280,144,136
26,Michigan,18,Indiana,37,Dubois County,59,2,57
26,Michigan,18,Indiana,39,Elkhart County,1548,808,740
26,Michigan,18,Indiana,41,Fayette County,31,0,31
26,Michigan,18,Indiana,43,Floyd County,30,14,16
26,Michigan,18,Indiana,47,Franklin County,8,2,6
26,Michigan,18,Indiana,49,Fulton County,64,8,56
26,Michigan,18,Indiana,51,Gibson County,0,17,-17
26,Michigan,18,Indiana,53,Grant County,108,347,-239
26,Michigan,18,Indiana,57,Hamilton County,638,394,244
26,Michigan,18,Indiana,59,Hancock County,103,36,67
26,Michigan,18,Indiana,61,Harrison County,18,2,16
26,Michigan,18,Indiana,63,Hendricks County,94,64,30
26,Michigan,18,Indiana,65,Henry County,34,0,34
26,Michigan,18,Indiana,67,Howard County,35,68,-33
26,Michigan,18,Indiana,69,Huntington County,90,26,64
26,Michigan,18,Indiana,71,Jackson County,0,40,-40
26,Michigan,18,Indiana,75,Jay County,4,0,4
26,Michigan,18,Indiana,77,Jefferson County,17,0,17
26,Michigan,18,Indiana,79,Jennings County,1,0,1
26,Michigan,18,Indiana,81,Johnson County,103,295,-192
26,Michigan,18,Indiana,85,Kosciusko County,203,136,67
26,Michigan,18,Indiana,87,LaGrange County,285,250,35
26,Michigan,18,Indiana,89,Lake County,479,274,205
26,Michigan,18,Indiana,91,LaPorte County,235,537,-302
26,Michigan,18,Indiana,93,Lawrence County,30,0,30
26,Michigan,18,Indiana,95,Madison County,60,77,-17
26,Michigan,18,Indiana,97,Marion County,926,784,142
26,Michigan,18,Indiana,99,Marshall County,66,2,64
26,Michigan,18,Indiana,103,Miami County,57,22,35
26,Michigan,18,Indiana,105,Monroe County,139,180,-41
26,Michigan,18,Indiana,107,Montgomery County,106,16,90
26,Michigan,18,Indiana,109,Morgan County,41,15,26
26,Michigan,18,Indiana,111,Newton County,11,10,1
26,Michigan,18,Indiana,113,Noble County,38,118,-80
26,Michigan,18,Indiana,119,Owen County,0,14,-14
26,Michigan,18,Indiana,121,Parke County,0,9,-9
26,Michigan,18,Indiana,123,Perry County,0,47,-47
26,Michigan,18,Indiana,125,Pike County,8,9,-1
26,Michigan,18,Indiana,127,Porter County,237,399,-162
26,Michigan,18,Indiana,129,Posey County,18,0,18
26,Michigan,18,Indiana,131,Pulaski County,4,0,4
26,Michigan,18,Indiana,133,Putnam County,0,51,-51
26,Michigan,18,Indiana,139,Rush County,13,0,13
26,Michigan,18,Indiana,141,St. Joseph County,2243,1804,439
26,Michigan,18,Indiana,145,Shelby County,0,46,-46
26,Michigan,18,Indiana,147,Spencer County,38,0,38
26,Michigan,18,Indiana,149,Starke County,64,0,64
26,Michigan,18,Indiana,151,Steuben County,155,311,-156
26,Michigan,18,Indiana,153,Sullivan County,7,0,7
26,Michigan,18,Indiana,157,Tippecanoe County,316,339,-23
26,Michigan,18,Indiana,159,Tipton County,8,7,1
26,Michigan,18,Indiana,163,Vanderburgh County,104,79,25
26,Michigan,18,Indiana,165,Vermillion County,0,4,-4
26,Michigan,18,Indiana,167,Vigo County,183,101,82
26,Michigan,18,Indiana,169,Wabash County,9,90,-81
26,Michigan,18,Indiana,171,Warren County,5,0,5
26,Michigan,18,Indiana,173,Warrick County,76,53,23
26,Michigan,18,Indiana,175,Washington County,11,0,11
26,Michigan,18,Indiana,177,Wayne County,38,55,-17
26,Michigan,18,Indiana,179,Wells County,37,16,21
26,Michigan,18,Indiana,183,Whitley County,96,93,3
26,Michigan,19,Iowa,13,Black Hawk County,36,19,17
26,Michigan,19,Iowa,15,Boone County,42,6,36
26,Michigan,19,Iowa,17,Bremer County,15,7,8
26,Michigan,19,Iowa,21,Buena Vista County,10,0,10
26,Michigan,19,Iowa,23,Butler County,13,8,5
26,Michigan,19,Iowa,33,Cerro Gordo County,16,4,12
26,Michigan,19,Iowa,45,Clinton County,51,0,51
26,Michigan,19,Iowa,49,Dallas County,22,60,-38
26,Michigan,19,Iowa,53,Decatur County,62,14,48
26,Michigan,19,Iowa,57,Des Moines County,0,20,-20
26,Michigan,19,Iowa,59,Dickinson County,0,14,-14
26,Michigan,19,Iowa,61,Dubuque County,40,56,-16
26,Michigan,19,Iowa,65,Fayette County,0,3,-3
26,Michigan,19,Iowa,75,Grundy County,0,3,-3
26,Michigan,19,Iowa,77,Guthrie County,0,1,-1
26,Michigan,19,Iowa,79,Hamilton County,0,29,-29
26,Michigan,19,Iowa,83,Hardin County,0,6,-6
26,Michigan,19,Iowa,87,Henry County,0,11,-11
26,Michigan,19,Iowa,99,Jasper County,6,0,6
26,Michigan,19,Iowa,101,Jefferson County,61,0,61
26,Michigan,19,Iowa,103,Johnson County,305,42,263
26,Michigan,19,Iowa,105,Jones County,0,25,-25
26,Michigan,19,Iowa,111,Lee County,15,0,15
26,Michigan,19,Iowa,113,Linn County,27,99,-72
26,Michigan,19,Iowa,119,Lyon County,0,8,-8
26,Michigan,19,Iowa,121,Madison County,39,0,39
26,Michigan,19,Iowa,123,Mahaska County,0,4,-4
26,Michigan,19,Iowa,125,Marion County,0,29,-29
26,Michigan,19,Iowa,145,Page County,6,0,6
26,Michigan,19,Iowa,149,Plymouth County,0,4,-4
26,Michigan,19,Iowa,151,Pocahontas County,0,1,-1
26,Michigan,19,Iowa,153,Polk County,97,142,-45
26,Michigan,19,Iowa,155,Pottawattamie County,0,6,-6
26,Michigan,19,Iowa,157,Poweshiek County,20,0,20
26,Michigan,19,Iowa,163,Scott County,80,113,-33
26,Michigan,19,Iowa,167,Sioux County,37,57,-20
26,Michigan,19,Iowa,169,Story County,54,50,4
26,Michigan,19,Iowa,181,Warren County,3,37,-34
26,Michigan,19,Iowa,183,Washington County,0,23,-23
26,Michigan,19,Iowa,187,Webster County,25,0,25
26,Michigan,19,Iowa,189,Winnebago County,0,3,-3
26,Michigan,19,Iowa,191,Winneshiek County,0,4,-4
26,Michigan,19,Iowa,193,Woodbury County,112,25,87
26,Michigan,19,Iowa,195,Worth County,3,0,3
26,Michigan,2,Alaska,16,Aleutians West Census Area,0,3,-3
26,Michigan,2,Alaska,20,Anchorage Municipality,816,218,598
26,Michigan,2,Alaska,50,Bethel Census Area,10,0,10
26,Michigan,2,Alaska,68,Denali Borough,1,13,-12
26,Michigan,2,Alaska,90,Fairbanks North Star Borough,105,109,-4
26,Michigan,2,Alaska,100,Haines Borough,0,21,-21
26,Michigan,2,Alaska,110,Juneau City and Borough,24,9,15
26,Michigan,2,Alaska,122,Kenai Peninsula Borough,348,8,340
26,Michigan,2,Alaska,130,Ketchikan Gateway Borough,202,11,191
26,Michigan,2,Alaska,150,Kodiak Island Borough,0,10,-10
26,Michigan,2,Alaska,164,Lake and Peninsula Borough,0,2,-2
26,Michigan,2,Alaska,170,Matanuska-Susitna Borough,233,38,195
26,Michigan,2,Alaska,180,Nome Census Area,50,0,50
26,Michigan,2,Alaska,188,Northwest Arctic Borough,9,20,-11
26,Michigan,2,Alaska,198,Prince of Wales-Hyder Census Area,13,0,13
26,Michigan,2,Alaska,220,Sitka City and Borough,0,1,-1
26,Michigan,2,Alaska,240,Southeast Fairbanks Census Area,5,0,5
26,Michigan,2,Alaska,261,Valdez-Cordova Census Area,16,1,15
26,Michigan,2,Alaska,290,Yukon-Koyukuk Census Area,0,5,-5
26,Michigan,20,Kansas,5,Atchison County,0,24,-24
26,Michigan,20,Kansas,9,Barton County,0,15,-15
26,Michigan,20,Kansas,23,Cheyenne County,0,2,-2
26,Michigan,20,Kansas,27,Clay County,14,0,14
26,Michigan,20,Kansas,41,Dickinson County,26,5,21
26,Michigan,20,Kansas,45,Douglas County,77,75,2
26,Michigan,20,Kansas,53,Ellsworth County,0,7,-7
26,Michigan,20,Kansas,55,Finney County,37,13,24
26,Michigan,20,Kansas,59,Franklin County,0,4,-4
26,Michigan,20,Kansas,61,Geary County,69,55,14
26,Michigan,20,Kansas,79,Harvey County,0,12,-12
26,Michigan,20,Kansas,91,Johnson County,346,316,30
26,Michigan,20,Kansas,97,Kiowa County,47,0,47
26,Michigan,20,Kansas,103,Leavenworth County,137,13,124
26,Michigan,20,Kansas,111,Lyon County,0,65,-65
26,Michigan,20,Kansas,113,McPherson County,0,2,-2
26,Michigan,20,Kansas,115,Marion County,0,1,-1
26,Michigan,20,Kansas,117,Marshall County,0,6,-6
26,Michigan,20,Kansas,125,Montgomery County,20,11,9
26,Michigan,20,Kansas,135,Ness County,0,5,-5
26,Michigan,20,Kansas,147,Phillips County,0,2,-2
26,Michigan,20,Kansas,153,Rawlins County,0,3,-3
26,Michigan,20,Kansas,155,Reno County,38,0,38
26,Michigan,20,Kansas,159,Rice County,0,2,-2
26,Michigan,20,Kansas,161,Riley County,86,176,-90
26,Michigan,20,Kansas,167,Russell County,4,0,4
26,Michigan,20,Kansas,169,Saline County,0,13,-13
26,Michigan,20,Kansas,173,Sedgwick County,368,52,316
26,Michigan,20,Kansas,175,Seward County,0,3,-3
26,Michigan,20,Kansas,177,Shawnee County,18,53,-35
26,Michigan,20,Kansas,181,Sherman County,15,0,15
26,Michigan,20,Kansas,193,Thomas County,8,0,8
26,Michigan,20,Kansas,197,Wabaunsee County,7,0,7
26,Michigan,20,Kansas,201,Washington County,0,1,-1
26,Michigan,20,Kansas,209,Wyandotte County,9,1,8
26,Michigan,21,Kentucky,3,Allen County,8,0,8
26,Michigan,21,Kentucky,9,Barren County,7,0,7
26,Michigan,21,Kentucky,13,Bell County,5,8,-3
26,Michigan,21,Kentucky,15,Boone County,87,212,-125
26,Michigan,21,Kentucky,19,Boyd County,20,0,20
26,Michigan,21,Kentucky,21,Boyle County,11,36,-25
26,Michigan,21,Kentucky,25,Breathitt County,0,9,-9
26,Michigan,21,Kentucky,27,Breckinridge County,0,13,-13
26,Michigan,21,Kentucky,29,Bullitt County,0,14,-14
26,Michigan,21,Kentucky,33,Caldwell County,0,15,-15
26,Michigan,21,Kentucky,35,Calloway County,32,50,-18
26,Michigan,21,Kentucky,37,Campbell County,5,43,-38
26,Michigan,21,Kentucky,41,Carroll County,0,15,-15
26,Michigan,21,Kentucky,43,Carter County,39,9,30
26,Michigan,21,Kentucky,45,Casey County,55,2,53
26,Michigan,21,Kentucky,47,Christian County,93,81,12
26,Michigan,21,Kentucky,49,Clark County,36,22,14
26,Michigan,21,Kentucky,51,Clay County,39,28,11
26,Michigan,21,Kentucky,55,Crittenden County,41,0,41
26,Michigan,21,Kentucky,57,Cumberland County,4,4,0
26,Michigan,21,Kentucky,59,Daviess County,45,14,31
26,Michigan,21,Kentucky,65,Estill County,11,1,10
26,Michigan,21,Kentucky,67,Fayette County,222,183,39
26,Michigan,21,Kentucky,69,Fleming County,31,0,31
26,Michigan,21,Kentucky,71,Floyd County,13,7,6
26,Michigan,21,Kentucky,73,Franklin County,76,42,34
26,Michigan,21,Kentucky,75,Fulton County,21,0,21
26,Michigan,21,Kentucky,83,Graves County,0,20,-20
26,Michigan,21,Kentucky,89,Greenup County,0,9,-9
26,Michigan,21,Kentucky,93,Hardin County,219,182,37
26,Michigan,21,Kentucky,97,Harrison County,0,77,-77
26,Michigan,21,Kentucky,101,Henderson County,6,15,-9
26,Michigan,21,Kentucky,103,Henry County,19,2,17
26,Michigan,21,Kentucky,107,Hopkins County,0,9,-9
26,Michigan,21,Kentucky,111,Jefferson County,683,712,-29
26,Michigan,21,Kentucky,113,Jessamine County,35,34,1
26,Michigan,21,Kentucky,115,Johnson County,0,24,-24
26,Michigan,21,Kentucky,117,Kenton County,103,145,-42
26,Michigan,21,Kentucky,119,Knott County,0,2,-2
26,Michigan,21,Kentucky,121,Knox County,0,7,-7
26,Michigan,21,Kentucky,125,Laurel County,9,0,9
26,Michigan,21,Kentucky,129,Lee County,0,4,-4
26,Michigan,21,Kentucky,131,Leslie County,0,11,-11
26,Michigan,21,Kentucky,135,Lewis County,0,19,-19
26,Michigan,21,Kentucky,141,Logan County,0,17,-17
26,Michigan,21,Kentucky,143,Lyon County,0,39,-39
26,Michigan,21,Kentucky,145,McCracken County,24,36,-12
26,Michigan,21,Kentucky,151,Madison County,65,62,3
26,Michigan,21,Kentucky,153,Magoffin County,0,15,-15
26,Michigan,21,Kentucky,155,Marion County,3,0,3
26,Michigan,21,Kentucky,157,Marshall County,25,83,-58
26,Michigan,21,Kentucky,159,Martin County,4,0,4
26,Michigan,21,Kentucky,161,Mason County,7,0,7
26,Michigan,21,Kentucky,163,Meade County,47,5,42
26,Michigan,21,Kentucky,167,Mercer County,0,8,-8
26,Michigan,21,Kentucky,169,Metcalfe County,11,0,11
26,Michigan,21,Kentucky,173,Montgomery County,0,50,-50
26,Michigan,21,Kentucky,175,Morgan County,0,14,-14
26,Michigan,21,Kentucky,177,Muhlenberg County,24,17,7
26,Michigan,21,Kentucky,179,Nelson County,7,79,-72
26,Michigan,21,Kentucky,183,Ohio County,15,0,15
26,Michigan,21,Kentucky,185,Oldham County,101,41,60
26,Michigan,21,Kentucky,187,Owen County,0,18,-18
26,Michigan,21,Kentucky,193,Perry County,35,0,35
26,Michigan,21,Kentucky,195,Pike County,148,10,138
26,Michigan,21,Kentucky,199,Pulaski County,15,49,-34
26,Michigan,21,Kentucky,207,Russell County,16,0,16
26,Michigan,21,Kentucky,209,Scott County,37,42,-5
26,Michigan,21,Kentucky,211,Shelby County,3,52,-49
26,Michigan,21,Kentucky,213,Simpson County,18,0,18
26,Michigan,21,Kentucky,215,Spencer County,117,0,117
26,Michigan,21,Kentucky,217,Taylor County,22,0,22
26,Michigan,21,Kentucky,219,Todd County,10,0,10
26,Michigan,21,Kentucky,221,Trigg County,6,0,6
26,Michigan,21,Kentucky,223,Trimble County,2,0,2
26,Michigan,21,Kentucky,225,Union County,0,14,-14
26,Michigan,21,Kentucky,227,Warren County,6,102,-96
26,Michigan,21,Kentucky,235,Whitley County,33,0,33
26,Michigan,21,Kentucky,237,Wolfe County,0,14,-14
26,Michigan,21,Kentucky,239,Woodford County,13,24,-11
26,Michigan,22,Louisiana,1,Acadia Parish,1,0,1
26,Michigan,22,Louisiana,3,Allen Parish,0,15,-15
26,Michigan,22,Louisiana,5,Ascension Parish,10,212,-202
26,Michigan,22,Louisiana,11,Beauregard Parish,0,11,-11
26,Michigan,22,Louisiana,15,Bossier Parish,135,15,120
26,Michigan,22,Louisiana,17,Caddo Parish,155,16,139
26,Michigan,22,Louisiana,19,Calcasieu Parish,20,8,12
26,Michigan,22,Louisiana,23,Cameron Parish,0,13,-13
26,Michigan,22,Louisiana,25,Catahoula Parish,22,0,22
26,Michigan,22,Louisiana,33,East Baton Rouge Parish,80,77,3
26,Michigan,22,Louisiana,45,Iberia Parish,0,77,-77
26,Michigan,22,Louisiana,47,Iberville Parish,16,0,16
26,Michigan,22,Louisiana,51,Jefferson Parish,100,327,-227
26,Michigan,22,Louisiana,55,Lafayette Parish,49,130,-81
26,Michigan,22,Louisiana,57,Lafourche Parish,17,15,2
26,Michigan,22,Louisiana,61,Lincoln Parish,13,39,-26
26,Michigan,22,Louisiana,63,Livingston Parish,35,0,35
26,Michigan,22,Louisiana,71,Orleans Parish,189,264,-75
26,Michigan,22,Louisiana,73,Ouachita Parish,67,13,54
26,Michigan,22,Louisiana,75,Plaquemines Parish,11,0,11
26,Michigan,22,Louisiana,79,Rapides Parish,24,171,-147
26,Michigan,22,Louisiana,87,St. Bernard Parish,0,41,-41
26,Michigan,22,Louisiana,89,St. Charles Parish,4,0,4
26,Michigan,22,Louisiana,95,St. John the Baptist Parish,61,73,-12
26,Michigan,22,Louisiana,97,St. Landry Parish,56,0,56
26,Michigan,22,Louisiana,103,St. Tammany Parish,49,76,-27
26,Michigan,22,Louisiana,105,Tangipahoa Parish,12,0,12
26,Michigan,22,Louisiana,109,Terrebonne Parish,0,49,-49
26,Michigan,22,Louisiana,115,Vernon Parish,2,11,-9
26,Michigan,22,Louisiana,117,Washington Parish,0,15,-15
26,Michigan,22,Louisiana,119,Webster Parish,8,0,8
26,Michigan,22,Louisiana,121,West Baton Rouge Parish,0,94,-94
26,Michigan,23,Maine,1,Androscoggin County,17,5,12
26,Michigan,23,Maine,3,Aroostook County,42,0,42
26,Michigan,23,Maine,5,Cumberland County,43,75,-32
26,Michigan,23,Maine,7,Franklin County,0,19,-19
26,Michigan,23,Maine,9,Hancock County,61,0,61
26,Michigan,23,Maine,11,Kennebec County,29,29,0
26,Michigan,23,Maine,15,Lincoln County,0,3,-3
26,Michigan,23,Maine,17,Oxford County,2,6,-4
26,Michigan,23,Maine,19,Penobscot County,57,41,16
26,Michigan,23,Maine,25,Somerset County,0,3,-3
26,Michigan,23,Maine,27,Waldo County,0,3,-3
26,Michigan,23,Maine,29,Washington County,27,0,27
26,Michigan,23,Maine,31,York County,98,26,72
26,Michigan,24,Maryland,1,Allegany County,24,65,-41
26,Michigan,24,Maryland,3,Anne Arundel County,162,253,-91
26,Michigan,24,Maryland,5,Baltimore County,158,175,-17
26,Michigan,24,Maryland,9,Calvert County,17,13,4
26,Michigan,24,Maryland,11,Caroline County,53,0,53
26,Michigan,24,Maryland,13,Carroll County,55,42,13
26,Michigan,24,Maryland,15,Cecil County,0,53,-53
26,Michigan,24,Maryland,17,Charles County,26,127,-101
26,Michigan,24,Maryland,21,Frederick County,24,44,-20
26,Michigan,24,Maryland,23,Garrett County,19,0,19
26,Michigan,24,Maryland,25,Harford County,30,29,1
26,Michigan,24,Maryland,27,Howard County,62,88,-26
26,Michigan,24,Maryland,29,Kent County,9,0,9
26,Michigan,24,Maryland,31,Montgomery County,295,415,-120
26,Michigan,24,Maryland,33,Prince George's County,216,129,87
26,Michigan,24,Maryland,35,Queen Anne's County,0,14,-14
26,Michigan,24,Maryland,37,St. Mary's County,8,2,6
26,Michigan,24,Maryland,41,Talbot County,0,6,-6
26,Michigan,24,Maryland,43,Washington County,4,33,-29
26,Michigan,24,Maryland,45,Wicomico County,19,0,19
26,Michigan,24,Maryland,47,Worcester County,24,0,24
26,Michigan,24,Maryland,510,Baltimore city,286,178,108
26,Michigan,25,Massachusetts,1,Barnstable County,137,33,104
26,Michigan,25,Massachusetts,3,Berkshire County,44,18,26
26,Michigan,25,Massachusetts,5,Bristol County,104,21,83
26,Michigan,25,Massachusetts,9,Essex County,242,24,218
26,Michigan,25,Massachusetts,11,Franklin County,51,0,51
26,Michigan,25,Massachusetts,13,Hampden County,39,24,15
26,Michigan,25,Massachusetts,15,Hampshire County,64,69,-5
26,Michigan,25,Massachusetts,17,Middlesex County,439,650,-211
26,Michigan,25,Massachusetts,19,Nantucket County,117,0,117
26,Michigan,25,Massachusetts,21,Norfolk County,125,131,-6
26,Michigan,25,Massachusetts,23,Plymouth County,33,23,10
26,Michigan,25,Massachusetts,25,Suffolk County,496,317,179
26,Michigan,25,Massachusetts,27,Worcester County,564,298,266
26,Michigan,26,Michigan,1,Alcona County,699,475,224
26,Michigan,26,Michigan,3,Alger County,763,833,-70
26,Michigan,26,Michigan,5,Allegan County,4968,4262,706
26,Michigan,26,Michigan,7,Alpena County,1127,1034,93
26,Michigan,26,Michigan,9,Antrim County,1286,1188,98
26,Michigan,26,Michigan,11,Arenac County,952,749,203
26,Michigan,26,Michigan,13,Baraga County,289,477,-188
26,Michigan,26,Michigan,15,Barry County,2817,2312,505
26,Michigan,26,Michigan,17,Bay County,3707,3311,396
26,Michigan,26,Michigan,19,Benzie County,736,685,51
26,Michigan,26,Michigan,21,Berrien County,5042,2815,2227
26,Michigan,26,Michigan,23,Branch County,1710,1536,174
26,Michigan,26,Michigan,25,Calhoun County,4851,4560,291
26,Michigan,26,Michigan,27,Cass County,1607,1599,8
26,Michigan,26,Michigan,29,Charlevoix County,1154,1296,-142
26,Michigan,26,Michigan,31,Cheboygan County,1009,1117,-108
26,Michigan,26,Michigan,33,Chippewa County,2260,2084,176
26,Michigan,26,Michigan,35,Clare County,1755,1678,77
26,Michigan,26,Michigan,37,Clinton County,4989,4307,682
26,Michigan,26,Michigan,39,Crawford County,926,777,149
26,Michigan,26,Michigan,41,Delta County,980,907,73
26,Michigan,26,Michigan,43,Dickinson County,379,441,-62
26,Michigan,26,Michigan,45,Eaton County,6695,7674,-979
26,Michigan,26,Michigan,47,Emmet County,1557,1248,309
26,Michigan,26,Michigan,49,Genesee County,12488,10225,2263
26,Michigan,26,Michigan,51,Gladwin County,1108,1052,56
26,Michigan,26,Michigan,53,Gogebic County,439,490,-51
26,Michigan,26,Michigan,55,Grand Traverse County,3835,4202,-367
26,Michigan,26,Michigan,57,Gratiot County,2638,2372,266
26,Michigan,26,Michigan,59,Hillsdale County,1978,1418,560
26,Michigan,26,Michigan,61,Houghton County,972,1800,-828
26,Michigan,26,Michigan,63,Huron County,1197,886,311
26,Michigan,26,Michigan,65,Ingham County,15527,23616,-8089
26,Michigan,26,Michigan,67,Ionia County,3871,3567,304
26,Michigan,26,Michigan,69,Iosco County,1933,1267,666
26,Michigan,26,Michigan,71,Iron County,224,118,106
26,Michigan,26,Michigan,73,Isabella County,3849,7457,-3608
26,Michigan,26,Michigan,75,Jackson County,6152,6901,-749
26,Michigan,26,Michigan,77,Kalamazoo County,9088,13760,-4672
26,Michigan,26,Michigan,79,Kalkaska County,1002,1112,-110
26,Michigan,26,Michigan,81,Kent County,20061,22101,-2040
26,Michigan,26,Michigan,83,Keweenaw County,104,88,16
26,Michigan,26,Michigan,85,Lake County,1009,713,296
26,Michigan,26,Michigan,87,Lapeer County,4847,4131,716
26,Michigan,26,Michigan,89,Leelanau County,1061,1037,24
26,Michigan,26,Michigan,91,Lenawee County,3323,4091,-768
26,Michigan,26,Michigan,93,Livingston County,8229,7136,1093
26,Michigan,26,Michigan,95,Luce County,434,494,-60
26,Michigan,26,Michigan,97,Mackinac County,414,438,-24
26,Michigan,26,Michigan,99,Macomb County,28774,30277,-1503
26,Michigan,26,Michigan,101,Manistee County,1222,1160,62
26,Michigan,26,Michigan,103,Marquette County,2196,2950,-754
26,Michigan,26,Michigan,105,Mason County,967,1384,-417
26,Michigan,26,Michigan,107,Mecosta County,2417,3656,-1239
26,Michigan,26,Michigan,109,Menominee County,175,588,-413
26,Michigan,26,Michigan,111,Midland County,2861,2626,235
26,Michigan,26,Michigan,113,Missaukee County,989,770,219
26,Michigan,26,Michigan,115,Monroe County,3680,3894,-214
26,Michigan,26,Michigan,117,Montcalm County,3823,3382,441
26,Michigan,26,Michigan,119,Montmorency County,399,417,-18
26,Michigan,26,Michigan,121,Muskegon County,6414,7383,-969
26,Michigan,26,Michigan,123,Newaygo County,2456,2072,384
26,Michigan,26,Michigan,125,Oakland County,45264,42512,2752
26,Michigan,26,Michigan,127,Oceana County,1023,1239,-216
26,Michigan,26,Michigan,129,Ogemaw County,851,1053,-202
26,Michigan,26,Michigan,131,Ontonagon County,132,62,70
26,Michigan,26,Michigan,133,Osceola County,1273,1002,271
26,Michigan,26,Michigan,135,Oscoda County,315,408,-93
26,Michigan,26,Michigan,137,Otsego County,1345,1362,-17
26,Michigan,26,Michigan,139,Ottawa County,13120,15978,-2858
26,Michigan,26,Michigan,141,Presque Isle County,685,487,198
26,Michigan,26,Michigan,143,Roscommon County,986,1231,-245
26,Michigan,26,Michigan,145,Saginaw County,6869,6459,410
26,Michigan,26,Michigan,147,St. Clair County,4589,5461,-872
26,Michigan,26,Michigan,149,St. Joseph County,1620,1626,-6
26,Michigan,26,Michigan,151,Sanilac County,1671,1610,61
26,Michigan,26,Michigan,153,Schoolcraft County,254,278,-24
26,Michigan,26,Michigan,155,Shiawassee County,3150,2296,854
26,Michigan,26,Michigan,157,Tuscola County,2154,2282,-128
26,Michigan,26,Michigan,159,Van Buren County,4062,2622,1440
26,Michigan,26,Michigan,161,Washtenaw County,15305,20198,-4893
26,Michigan,26,Michigan,163,Wayne County,52166,34797,17369
26,Michigan,26,Michigan,165,Wexford County,1852,1741,111
26,Michigan,27,Minnesota,3,Anoka County,70,66,4
26,Michigan,27,Minnesota,5,Becker County,5,0,5
26,Michigan,27,Minnesota,7,Beltrami County,43,3,40
26,Michigan,27,Minnesota,11,Big Stone County,0,1,-1
26,Michigan,27,Minnesota,13,Blue Earth County,21,32,-11
26,Michigan,27,Minnesota,15,Brown County,0,31,-31
26,Michigan,27,Minnesota,19,Carver County,26,28,-2
26,Michigan,27,Minnesota,25,Chisago County,0,7,-7
26,Michigan,27,Minnesota,27,Clay County,30,0,30
26,Michigan,27,Minnesota,35,Crow Wing County,24,0,24
26,Michigan,27,Minnesota,37,Dakota County,191,128,63
26,Michigan,27,Minnesota,39,Dodge County,0,9,-9
26,Michigan,27,Minnesota,47,Freeborn County,2,0,2
26,Michigan,27,Minnesota,49,Goodhue County,30,0,30
26,Michigan,27,Minnesota,53,Hennepin County,686,750,-64
26,Michigan,27,Minnesota,61,Itasca County,34,20,14
26,Michigan,27,Minnesota,67,Kandiyohi County,0,46,-46
26,Michigan,27,Minnesota,75,Lake County,11,4,7
26,Michigan,27,Minnesota,79,Le Sueur County,0,1,-1
26,Michigan,27,Minnesota,81,Lincoln County,0,7,-7
26,Michigan,27,Minnesota,85,McLeod County,60,0,60
26,Michigan,27,Minnesota,91,Martin County,0,84,-84
26,Michigan,27,Minnesota,93,Meeker County,0,1,-1
26,Michigan,27,Minnesota,95,Mille Lacs County,0,2,-2
26,Michigan,27,Minnesota,97,Morrison County,4,25,-21
26,Michigan,27,Minnesota,99,Mower County,10,17,-7
26,Michigan,27,Minnesota,101,Murray County,5,0,5
26,Michigan,27,Minnesota,103,Nicollet County,12,13,-1
26,Michigan,27,Minnesota,105,Nobles County,3,10,-7
26,Michigan,27,Minnesota,109,Olmsted County,142,164,-22
26,Michigan,27,Minnesota,111,Otter Tail County,0,13,-13
26,Michigan,27,Minnesota,113,Pennington County,0,43,-43
26,Michigan,27,Minnesota,115,Pine County,32,0,32
26,Michigan,27,Minnesota,121,Pope County,0,1,-1
26,Michigan,27,Minnesota,123,Ramsey County,167,394,-227
26,Michigan,27,Minnesota,125,Red Lake County,0,7,-7
26,Michigan,27,Minnesota,127,Redwood County,0,3,-3
26,Michigan,27,Minnesota,129,Renville County,51,0,51
26,Michigan,27,Minnesota,131,Rice County,34,1,33
26,Michigan,27,Minnesota,133,Rock County,21,0,21
26,Michigan,27,Minnesota,137,St. Louis County,108,87,21
26,Michigan,27,Minnesota,139,Scott County,69,0,69
26,Michigan,27,Minnesota,141,Sherburne County,6,0,6
26,Michigan,27,Minnesota,145,Stearns County,4,117,-113
26,Michigan,27,Minnesota,147,Steele County,91,152,-61
26,Michigan,27,Minnesota,153,Todd County,0,1,-1
26,Michigan,27,Minnesota,159,Wadena County,0,1,-1
26,Michigan,27,Minnesota,161,Waseca County,4,0,4
26,Michigan,27,Minnesota,163,Washington County,0,191,-191
26,Michigan,27,Minnesota,169,Winona County,117,102,15
26,Michigan,27,Minnesota,173,Yellow Medicine County,0,11,-11
26,Michigan,28,Mississippi,1,Adams County,39,0,39
26,Michigan,28,Mississippi,7,Attala County,0,30,-30
26,Michigan,28,Mississippi,11,Bolivar County,0,8,-8
26,Michigan,28,Mississippi,19,Choctaw County,54,0,54
26,Michigan,28,Mississippi,21,Claiborne County,26,0,26
26,Michigan,28,Mississippi,29,Copiah County,0,8,-8
26,Michigan,28,Mississippi,33,DeSoto County,38,13,25
26,Michigan,28,Mississippi,35,Forrest County,26,0,26
26,Michigan,28,Mississippi,41,Greene County,0,5,-5
26,Michigan,28,Mississippi,43,Grenada County,18,132,-114
26,Michigan,28,Mississippi,45,Hancock County,20,2,18
26,Michigan,28,Mississippi,47,Harrison County,416,160,256
26,Michigan,28,Mississippi,49,Hinds County,90,200,-110
26,Michigan,28,Mississippi,51,Holmes County,0,32,-32
26,Michigan,28,Mississippi,59,Jackson County,39,54,-15
26,Michigan,28,Mississippi,61,Jasper County,52,0,52
26,Michigan,28,Mississippi,65,Jefferson Davis County,0,22,-22
26,Michigan,28,Mississippi,71,Lafayette County,9,26,-17
26,Michigan,28,Mississippi,75,Lauderdale County,171,33,138
26,Michigan,28,Mississippi,83,Leflore County,21,0,21
26,Michigan,28,Mississippi,85,Lincoln County,31,0,31
26,Michigan,28,Mississippi,87,Lowndes County,17,14,3
26,Michigan,28,Mississippi,89,Madison County,0,106,-106
26,Michigan,28,Mississippi,91,Marion County,18,8,10
26,Michigan,28,Mississippi,93,Marshall County,36,10,26
26,Michigan,28,Mississippi,101,Newton County,0,44,-44
26,Michigan,28,Mississippi,103,Noxubee County,0,16,-16
26,Michigan,28,Mississippi,105,Oktibbeha County,58,9,49
26,Michigan,28,Mississippi,107,Panola County,10,0,10
26,Michigan,28,Mississippi,109,Pearl River County,27,110,-83
26,Michigan,28,Mississippi,121,Rankin County,14,0,14
26,Michigan,28,Mississippi,127,Simpson County,8,20,-12
26,Michigan,28,Mississippi,131,Stone County,3,0,3
26,Michigan,28,Mississippi,133,Sunflower County,83,5,78
26,Michigan,28,Mississippi,139,Tippah County,0,18,-18
26,Michigan,28,Mississippi,151,Washington County,0,30,-30
26,Michigan,28,Mississippi,159,Winston County,0,17,-17
26,Michigan,28,Mississippi,161,Yalobusha County,0,31,-31
26,Michigan,28,Mississippi,163,Yazoo County,0,12,-12
26,Michigan,29,Missouri,7,Audrain County,0,2,-2
26,Michigan,29,Missouri,15,Benton County,16,0,16
26,Michigan,29,Missouri,19,Boone County,152,134,18
26,Michigan,29,Missouri,21,Buchanan County,41,5,36
26,Michigan,29,Missouri,23,Butler County,13,2,11
26,Michigan,29,Missouri,25,Caldwell County,0,1,-1
26,Michigan,29,Missouri,29,Camden County,60,100,-40
26,Michigan,29,Missouri,31,Cape Girardeau County,14,38,-24
26,Michigan,29,Missouri,37,Cass County,46,5,41
26,Michigan,29,Missouri,39,Cedar County,62,26,36
26,Michigan,29,Missouri,47,Clay County,81,198,-117
26,Michigan,29,Missouri,51,Cole County,35,9,26
26,Michigan,29,Missouri,57,Dade County,0,16,-16
26,Michigan,29,Missouri,63,DeKalb County,0,2,-2
26,Michigan,29,Missouri,71,Franklin County,0,15,-15
26,Michigan,29,Missouri,77,Greene County,185,78,107
26,Michigan,29,Missouri,79,Grundy County,0,33,-33
26,Michigan,29,Missouri,91,Howell County,35,24,11
26,Michigan,29,Missouri,95,Jackson County,291,313,-22
26,Michigan,29,Missouri,97,Jasper County,29,231,-202
26,Michigan,29,Missouri,99,Jefferson County,148,24,124
26,Michigan,29,Missouri,101,Johnson County,90,51,39
26,Michigan,29,Missouri,105,Laclede County,0,6,-6
26,Michigan,29,Missouri,111,Lewis County,25,13,12
26,Michigan,29,Missouri,113,Lincoln County,0,35,-35
26,Michigan,29,Missouri,127,Marion County,22,0,22
26,Michigan,29,Missouri,133,Mississippi County,29,0,29
26,Michigan,29,Missouri,137,Monroe County,12,0,12
26,Michigan,29,Missouri,141,Morgan County,0,9,-9
26,Michigan,29,Missouri,143,New Madrid County,10,0,10
26,Michigan,29,Missouri,147,Nodaway County,79,24,55
26,Michigan,29,Missouri,149,Oregon County,0,3,-3
26,Michigan,29,Missouri,155,Pemiscot County,0,1,-1
26,Michigan,29,Missouri,159,Pettis County,0,24,-24
26,Michigan,29,Missouri,161,Phelps County,7,0,7
26,Michigan,29,Missouri,163,Pike County,17,0,17
26,Michigan,29,Missouri,165,Platte County,172,32,140
26,Michigan,29,Missouri,167,Polk County,0,33,-33
26,Michigan,29,Missouri,169,Pulaski County,61,382,-321
26,Michigan,29,Missouri,173,Ralls County,0,17,-17
26,Michigan,29,Missouri,177,Ray County,0,16,-16
26,Michigan,29,Missouri,181,Ripley County,7,0,7
26,Michigan,29,Missouri,183,St. Charles County,203,287,-84
26,Michigan,29,Missouri,187,St. Francois County,17,0,17
26,Michigan,29,Missouri,189,St. Louis County,540,282,258
26,Michigan,29,Missouri,201,Scott County,18,32,-14
26,Michigan,29,Missouri,209,Stone County,0,23,-23
26,Michigan,29,Missouri,213,Taney County,6,23,-17
26,Michigan,29,Missouri,215,Texas County,10,57,-47
26,Michigan,29,Missouri,217,Vernon County,7,30,-23
26,Michigan,29,Missouri,219,Warren County,14,0,14
26,Michigan,29,Missouri,223,Wayne County,0,6,-6
26,Michigan,29,Missouri,225,Webster County,7,0,7
26,Michigan,29,Missouri,510,St. Louis city,233,184,49
26,Michigan,30,Montana,7,Broadwater County,0,102,-102
26,Michigan,30,Montana,9,Carbon County,0,29,-29
26,Michigan,30,Montana,11,Carter County,0,6,-6
26,Michigan,30,Montana,13,Cascade County,6,33,-27
26,Michigan,30,Montana,23,Deer Lodge County,0,6,-6
26,Michigan,30,Montana,29,Flathead County,228,31,197
26,Michigan,30,Montana,31,Gallatin County,19,46,-27
26,Michigan,30,Montana,35,Glacier County,0,26,-26
26,Michigan,30,Montana,43,Jefferson County,0,39,-39
26,Michigan,30,Montana,47,Lake County,0,65,-65
26,Michigan,30,Montana,49,Lewis and Clark County,14,3,11
26,Michigan,30,Montana,53,Lincoln County,0,8,-8
26,Michigan,30,Montana,57,Madison County,0,14,-14
26,Michigan,30,Montana,63,Missoula County,85,78,7
26,Michigan,30,Montana,67,Park County,17,0,17
26,Michigan,30,Montana,71,Phillips County,0,7,-7
26,Michigan,30,Montana,73,Pondera County,0,15,-15
26,Michigan,30,Montana,81,Ravalli County,0,14,-14
26,Michigan,30,Montana,83,Richland County,0,29,-29
26,Michigan,30,Montana,87,Rosebud County,103,4,99
26,Michigan,30,Montana,89,Sanders County,0,19,-19
26,Michigan,30,Montana,99,Teton County,0,7,-7
26,Michigan,30,Montana,101,Toole County,0,16,-16
26,Michigan,30,Montana,107,Wheatland County,0,3,-3
26,Michigan,30,Montana,111,Yellowstone County,28,28,0
26,Michigan,31,Nebraska,1,Adams County,47,0,47
26,Michigan,31,Nebraska,13,Box Butte County,22,0,22
26,Michigan,31,Nebraska,19,Buffalo County,24,0,24
26,Michigan,31,Nebraska,25,Cass County,0,10,-10
26,Michigan,31,Nebraska,43,Dakota County,0,36,-36
26,Michigan,31,Nebraska,51,Dixon County,16,0,16
26,Michigan,31,Nebraska,55,Douglas County,368,119,249
26,Michigan,31,Nebraska,77,Greeley County,0,5,-5
26,Michigan,31,Nebraska,79,Hall County,0,46,-46
26,Michigan,31,Nebraska,83,Harlan County,0,25,-25
26,Michigan,31,Nebraska,109,Lancaster County,181,255,-74
26,Michigan,31,Nebraska,141,Platte County,0,53,-53
26,Michigan,31,Nebraska,147,Richardson County,0,18,-18
26,Michigan,31,Nebraska,153,Sarpy County,4,63,-59
26,Michigan,31,Nebraska,157,Scotts Bluff County,0,48,-48
26,Michigan,31,Nebraska,159,Seward County,2,0,2
26,Michigan,31,Nebraska,177,Washington County,0,92,-92
26,Michigan,31,Nebraska,183,Wheeler County,0,3,-3
26,Michigan,32,Nevada,1,Churchill County,0,4,-4
26,Michigan,32,Nevada,3,Clark County,1218,1599,-381
26,Michigan,32,Nevada,5,Douglas County,6,22,-16
26,Michigan,32,Nevada,7,Elko County,3,0,3
26,Michigan,32,Nevada,13,Humboldt County,25,0,25
26,Michigan,32,Nevada,19,Lyon County,54,85,-31
26,Michigan,32,Nevada,23,Nye County,0,26,-26
26,Michigan,32,Nevada,31,Washoe County,222,68,154
26,Michigan,32,Nevada,510,Carson City,61,10,51
26,Michigan,33,New Hampshire,1,Belknap County,4,26,-22
26,Michigan,33,New Hampshire,3,Carroll County,0,21,-21
26,Michigan,33,New Hampshire,5,Cheshire County,19,0,19
26,Michigan,33,New Hampshire,9,Grafton County,40,75,-35
26,Michigan,33,New Hampshire,11,Hillsborough County,158,29,129
26,Michigan,33,New Hampshire,13,Merrimack County,46,13,33
26,Michigan,33,New Hampshire,15,Rockingham County,44,89,-45
26,Michigan,33,New Hampshire,17,Strafford County,18,43,-25
26,Michigan,34,New Jersey,1,Atlantic County,13,5,8
26,Michigan,34,New Jersey,3,Bergen County,322,168,154
26,Michigan,34,New Jersey,5,Burlington County,109,31,78
26,Michigan,34,New Jersey,7,Camden County,61,200,-139
26,Michigan,34,New Jersey,9,Cape May County,58,33,25
26,Michigan,34,New Jersey,11,Cumberland County,0,2,-2
26,Michigan,34,New Jersey,13,Essex County,115,179,-64
26,Michigan,34,New Jersey,15,Gloucester County,27,16,11
26,Michigan,34,New Jersey,17,Hudson County,54,91,-37
26,Michigan,34,New Jersey,19,Hunterdon County,0,5,-5
26,Michigan,34,New Jersey,21,Mercer County,141,60,81
26,Michigan,34,New Jersey,23,Middlesex County,169,69,100
26,Michigan,34,New Jersey,25,Monmouth County,118,32,86
26,Michigan,34,New Jersey,27,Morris County,221,210,11
26,Michigan,34,New Jersey,29,Ocean County,13,140,-127
26,Michigan,34,New Jersey,31,Passaic County,28,403,-375
26,Michigan,34,New Jersey,33,Salem County,5,2,3
26,Michigan,34,New Jersey,35,Somerset County,50,23,27
26,Michigan,34,New Jersey,37,Sussex County,67,8,59
26,Michigan,34,New Jersey,39,Union County,150,72,78
26,Michigan,34,New Jersey,41,Warren County,16,36,-20
26,Michigan,35,New Mexico,1,Bernalillo County,233,196,37
26,Michigan,35,New Mexico,5,Chaves County,95,41,54
26,Michigan,35,New Mexico,7,Colfax County,8,0,8
26,Michigan,35,New Mexico,9,Curry County,0,21,-21
26,Michigan,35,New Mexico,13,Doña Ana County,38,118,-80
26,Michigan,35,New Mexico,15,Eddy County,63,0,63
26,Michigan,35,New Mexico,17,Grant County,58,12,46
26,Michigan,35,New Mexico,25,Lea County,0,12,-12
26,Michigan,35,New Mexico,27,Lincoln County,0,37,-37
26,Michigan,35,New Mexico,31,McKinley County,44,52,-8
26,Michigan,35,New Mexico,35,Otero County,24,18,6
26,Michigan,35,New Mexico,39,Rio Arriba County,0,11,-11
26,Michigan,35,New Mexico,43,Sandoval County,12,95,-83
26,Michigan,35,New Mexico,45,San Juan County,2,28,-26
26,Michigan,35,New Mexico,47,San Miguel County,0,40,-40
26,Michigan,35,New Mexico,49,Santa Fe County,38,107,-69
26,Michigan,35,New Mexico,57,Torrance County,9,0,9
26,Michigan,35,New Mexico,61,Valencia County,37,46,-9
26,Michigan,36,New York,1,Albany County,245,51,194
26,Michigan,36,New York,5,Bronx County,125,115,10
26,Michigan,36,New York,7,Broome County,142,0,142
26,Michigan,36,New York,9,Cattaraugus County,36,3,33
26,Michigan,36,New York,11,Cayuga County,0,13,-13
26,Michigan,36,New York,13,Chautauqua County,14,0,14
26,Michigan,36,New York,17,Chenango County,0,4,-4
26,Michigan,36,New York,19,Clinton County,31,8,23
26,Michigan,36,New York,23,Cortland County,8,0,8
26,Michigan,36,New York,25,Delaware County,0,14,-14
26,Michigan,36,New York,27,Dutchess County,51,30,21
26,Michigan,36,New York,29,Erie County,549,184,365
26,Michigan,36,New York,31,Essex County,7,6,1
26,Michigan,36,New York,33,Franklin County,0,5,-5
26,Michigan,36,New York,43,Herkimer County,0,8,-8
26,Michigan,36,New York,45,Jefferson County,181,173,8
26,Michigan,36,New York,47,Kings County,1110,225,885
26,Michigan,36,New York,49,Lewis County,0,15,-15
26,Michigan,36,New York,51,Livingston County,7,2,5
26,Michigan,36,New York,53,Madison County,29,16,13
26,Michigan,36,New York,55,Monroe County,251,205,46
26,Michigan,36,New York,57,Montgomery County,64,4,60
26,Michigan,36,New York,59,Nassau County,252,91,161
26,Michigan,36,New York,61,New York County,827,998,-171
26,Michigan,36,New York,63,Niagara County,33,0,33
26,Michigan,36,New York,65,Oneida County,16,26,-10
26,Michigan,36,New York,67,Onondaga County,134,108,26
26,Michigan,36,New York,69,Ontario County,0,13,-13
26,Michigan,36,New York,71,Orange County,166,47,119
26,Michigan,36,New York,75,Oswego County,38,65,-27
26,Michigan,36,New York,77,Otsego County,107,4,103
26,Michigan,36,New York,81,Queens County,204,126,78
26,Michigan,36,New York,83,Rensselaer County,136,57,79
26,Michigan,36,New York,85,Richmond County,53,2,51
26,Michigan,36,New York,87,Rockland County,160,20,140
26,Michigan,36,New York,89,St. Lawrence County,55,53,2
26,Michigan,36,New York,91,Saratoga County,34,51,-17
26,Michigan,36,New York,93,Schenectady County,38,80,-42
26,Michigan,36,New York,101,Steuben County,27,51,-24
26,Michigan,36,New York,103,Suffolk County,123,134,-11
26,Michigan,36,New York,105,Sullivan County,31,0,31
26,Michigan,36,New York,107,Tioga County,0,20,-20
26,Michigan,36,New York,109,Tompkins County,51,64,-13
26,Michigan,36,New York,111,Ulster County,14,57,-43
26,Michigan,36,New York,113,Warren County,12,7,5
26,Michigan,36,New York,115,Washington County,0,71,-71
26,Michigan,36,New York,117,Wayne County,48,4,44
26,Michigan,36,New York,119,Westchester County,236,171,65
26,Michigan,36,New York,121,Wyoming County,0,7,-7
26,Michigan,37,North Carolina,1,Alamance County,66,18,48
26,Michigan,37,North Carolina,3,Alexander County,11,0,11
26,Michigan,37,North Carolina,5,Alleghany County,0,14,-14
26,Michigan,37,North Carolina,13,Beaufort County,0,4,-4
26,Michigan,37,North Carolina,19,Brunswick County,49,4,45
26,Michigan,37,North Carolina,21,Buncombe County,166,158,8
26,Michigan,37,North Carolina,23,Burke County,13,86,-73
26,Michigan,37,North Carolina,25,Cabarrus County,52,176,-124
26,Michigan,37,North Carolina,27,Caldwell County,6,277,-271
26,Michigan,37,North Carolina,31,Carteret County,43,21,22
26,Michigan,37,North Carolina,33,Caswell County,0,8,-8
26,Michigan,37,North Carolina,35,Catawba County,146,80,66
26,Michigan,37,North Carolina,37,Chatham County,0,122,-122
26,Michigan,37,North Carolina,39,Cherokee County,0,17,-17
26,Michigan,37,North Carolina,43,Clay County,6,59,-53
26,Michigan,37,North Carolina,47,Columbus County,41,0,41
26,Michigan,37,North Carolina,49,Craven County,131,131,0
26,Michigan,37,North Carolina,51,Cumberland County,175,412,-237
26,Michigan,37,North Carolina,53,Currituck County,28,0,28
26,Michigan,37,North Carolina,55,Dare County,0,42,-42
26,Michigan,37,North Carolina,57,Davidson County,0,22,-22
26,Michigan,37,North Carolina,59,Davie County,31,0,31
26,Michigan,37,North Carolina,61,Duplin County,0,9,-9
26,Michigan,37,North Carolina,63,Durham County,79,172,-93
26,Michigan,37,North Carolina,65,Edgecombe County,10,0,10
26,Michigan,37,North Carolina,67,Forsyth County,119,138,-19
26,Michigan,37,North Carolina,69,Franklin County,38,37,1
26,Michigan,37,North Carolina,71,Gaston County,42,135,-93
26,Michigan,37,North Carolina,81,Guilford County,135,258,-123
26,Michigan,37,North Carolina,85,Harnett County,28,21,7
26,Michigan,37,North Carolina,87,Haywood County,0,23,-23
26,Michigan,37,North Carolina,89,Henderson County,21,177,-156
26,Michigan,37,North Carolina,91,Hertford County,0,3,-3
26,Michigan,37,North Carolina,93,Hoke County,16,0,16
26,Michigan,37,North Carolina,97,Iredell County,109,103,6
26,Michigan,37,North Carolina,99,Jackson County,17,0,17
26,Michigan,37,North Carolina,101,Johnston County,62,52,10
26,Michigan,37,North Carolina,107,Lenoir County,7,17,-10
26,Michigan,37,North Carolina,109,Lincoln County,26,9,17
26,Michigan,37,North Carolina,111,McDowell County,5,0,5
26,Michigan,37,North Carolina,113,Macon County,0,18,-18
26,Michigan,37,North Carolina,115,Madison County,0,7,-7
26,Michigan,37,North Carolina,117,Martin County,0,15,-15
26,Michigan,37,North Carolina,119,Mecklenburg County,733,957,-224
26,Michigan,37,North Carolina,127,Nash County,73,23,50
26,Michigan,37,North Carolina,129,New Hanover County,7,156,-149
26,Michigan,37,North Carolina,131,Northampton County,0,6,-6
26,Michigan,37,North Carolina,133,Onslow County,481,479,2
26,Michigan,37,North Carolina,135,Orange County,284,95,189
26,Michigan,37,North Carolina,137,Pamlico County,0,4,-4
26,Michigan,37,North Carolina,139,Pasquotank County,0,6,-6
26,Michigan,37,North Carolina,141,Pender County,0,42,-42
26,Michigan,37,North Carolina,147,Pitt County,0,139,-139
26,Michigan,37,North Carolina,149,Polk County,0,1,-1
26,Michigan,37,North Carolina,151,Randolph County,4,40,-36
26,Michigan,37,North Carolina,153,Richmond County,0,50,-50
26,Michigan,37,North Carolina,155,Robeson County,0,3,-3
26,Michigan,37,North Carolina,157,Rockingham County,0,17,-17
26,Michigan,37,North Carolina,159,Rowan County,78,60,18
26,Michigan,37,North Carolina,161,Rutherford County,44,0,44
26,Michigan,37,North Carolina,163,Sampson County,0,13,-13
26,Michigan,37,North Carolina,165,Scotland County,0,33,-33
26,Michigan,37,North Carolina,167,Stanly County,32,0,32
26,Michigan,37,North Carolina,171,Surry County,8,0,8
26,Michigan,37,North Carolina,173,Swain County,28,0,28
26,Michigan,37,North Carolina,179,Union County,47,38,9
26,Michigan,37,North Carolina,183,Wake County,450,945,-495
26,Michigan,37,North Carolina,185,Warren County,0,12,-12
26,Michigan,37,North Carolina,189,Watauga County,0,31,-31
26,Michigan,37,North Carolina,191,Wayne County,81,7,74
26,Michigan,37,North Carolina,193,Wilkes County,29,0,29
26,Michigan,38,North Dakota,3,Barnes County,6,36,-30
26,Michigan,38,North Dakota,9,Bottineau County,0,7,-7
26,Michigan,38,North Dakota,11,Bowman County,0,26,-26
26,Michigan,38,North Dakota,13,Burke County,0,7,-7
26,Michigan,38,North Dakota,15,Burleigh County,33,134,-101
26,Michigan,38,North Dakota,17,Cass County,116,155,-39
26,Michigan,38,North Dakota,27,Eddy County,10,0,10
26,Michigan,38,North Dakota,35,Grand Forks County,34,102,-68
26,Michigan,38,North Dakota,37,Grant County,44,0,44
26,Michigan,38,North Dakota,49,McHenry County,0,47,-47
26,Michigan,38,North Dakota,53,McKenzie County,81,44,37
26,Michigan,38,North Dakota,55,McLean County,11,0,11
26,Michigan,38,North Dakota,59,Morton County,0,2,-2
26,Michigan,38,North Dakota,61,Mountrail County,60,0,60
26,Michigan,38,North Dakota,63,Nelson County,6,0,6
26,Michigan,38,North Dakota,69,Pierce County,0,5,-5
26,Michigan,38,North Dakota,71,Ramsey County,0,12,-12
26,Michigan,38,North Dakota,73,Ransom County,0,12,-12
26,Michigan,38,North Dakota,77,Richland County,0,12,-12
26,Michigan,38,North Dakota,79,Rolette County,3,0,3
26,Michigan,38,North Dakota,89,Stark County,47,10,37
26,Michigan,38,North Dakota,93,Stutsman County,20,0,20
26,Michigan,38,North Dakota,95,Towner County,0,4,-4
26,Michigan,38,North Dakota,101,Ward County,50,117,-67
26,Michigan,38,North Dakota,105,Williams County,170,89,81
26,Michigan,39,Ohio,1,Adams County,0,4,-4
26,Michigan,39,Ohio,3,Allen County,245,240,5
26,Michigan,39,Ohio,5,Ashland County,134,92,42
26,Michigan,39,Ohio,7,Ashtabula County,70,118,-48
26,Michigan,39,Ohio,9,Athens County,170,102,68
26,Michigan,39,Ohio,11,Auglaize County,53,0,53
26,Michigan,39,Ohio,13,Belmont County,5,0,5
26,Michigan,39,Ohio,15,Brown County,1,56,-55
26,Michigan,39,Ohio,17,Butler County,231,419,-188
26,Michigan,39,Ohio,19,Carroll County,21,23,-2
26,Michigan,39,Ohio,21,Champaign County,0,5,-5
26,Michigan,39,Ohio,23,Clark County,78,43,35
26,Michigan,39,Ohio,25,Clermont County,71,39,32
26,Michigan,39,Ohio,27,Clinton County,28,0,28
26,Michigan,39,Ohio,29,Columbiana County,4,62,-58
26,Michigan,39,Ohio,31,Coshocton County,0,37,-37
26,Michigan,39,Ohio,33,Crawford County,31,0,31
26,Michigan,39,Ohio,35,Cuyahoga County,1259,1296,-37
26,Michigan,39,Ohio,37,Darke County,0,1,-1
26,Michigan,39,Ohio,39,Defiance County,93,46,47
26,Michigan,39,Ohio,41,Delaware County,157,172,-15
26,Michigan,39,Ohio,43,Erie County,61,265,-204
26,Michigan,39,Ohio,45,Fairfield County,13,99,-86
26,Michigan,39,Ohio,47,Fayette County,0,7,-7
26,Michigan,39,Ohio,49,Franklin County,1256,2006,-750
26,Michigan,39,Ohio,51,Fulton County,323,268,55
26,Michigan,39,Ohio,53,Gallia County,92,5,87
26,Michigan,39,Ohio,55,Geauga County,103,94,9
26,Michigan,39,Ohio,57,Greene County,200,423,-223
26,Michigan,39,Ohio,59,Guernsey County,66,63,3
26,Michigan,39,Ohio,61,Hamilton County,537,426,111
26,Michigan,39,Ohio,63,Hancock County,214,101,113
26,Michigan,39,Ohio,65,Hardin County,5,40,-35
26,Michigan,39,Ohio,67,Harrison County,3,2,1
26,Michigan,39,Ohio,69,Henry County,71,57,14
26,Michigan,39,Ohio,73,Hocking County,0,5,-5
26,Michigan,39,Ohio,75,Holmes County,3,0,3
26,Michigan,39,Ohio,77,Huron County,146,71,75
26,Michigan,39,Ohio,79,Jackson County,0,9,-9
26,Michigan,39,Ohio,81,Jefferson County,8,16,-8
26,Michigan,39,Ohio,83,Knox County,59,12,47
26,Michigan,39,Ohio,85,Lake County,77,80,-3
26,Michigan,39,Ohio,87,Lawrence County,10,10,0
26,Michigan,39,Ohio,89,Licking County,35,32,3
26,Michigan,39,Ohio,91,Logan County,29,0,29
26,Michigan,39,Ohio,93,Lorain County,426,125,301
26,Michigan,39,Ohio,95,Lucas County,2679,3098,-419
26,Michigan,39,Ohio,97,Madison County,16,29,-13
26,Michigan,39,Ohio,99,Mahoning County,203,129,74
26,Michigan,39,Ohio,101,Marion County,19,60,-41
26,Michigan,39,Ohio,103,Medina County,148,53,95
26,Michigan,39,Ohio,105,Meigs County,0,4,-4
26,Michigan,39,Ohio,107,Mercer County,6,109,-103
26,Michigan,39,Ohio,113,Montgomery County,486,445,41
26,Michigan,39,Ohio,117,Morrow County,7,16,-9
26,Michigan,39,Ohio,119,Muskingum County,89,0,89
26,Michigan,39,Ohio,123,Ottawa County,86,45,41
26,Michigan,39,Ohio,125,Paulding County,106,9,97
26,Michigan,39,Ohio,129,Pickaway County,27,17,10
26,Michigan,39,Ohio,133,Portage County,40,125,-85
26,Michigan,39,Ohio,135,Preble County,22,0,22
26,Michigan,39,Ohio,137,Putnam County,0,20,-20
26,Michigan,39,Ohio,139,Richland County,131,0,131
26,Michigan,39,Ohio,141,Ross County,11,0,11
26,Michigan,39,Ohio,143,Sandusky County,40,40,0
26,Michigan,39,Ohio,145,Scioto County,131,1,130
26,Michigan,39,Ohio,147,Seneca County,10,286,-276
26,Michigan,39,Ohio,149,Shelby County,23,30,-7
26,Michigan,39,Ohio,151,Stark County,42,71,-29
26,Michigan,39,Ohio,153,Summit County,558,495,63
26,Michigan,39,Ohio,155,Trumbull County,72,85,-13
26,Michigan,39,Ohio,157,Tuscarawas County,95,57,38
26,Michigan,39,Ohio,159,Union County,180,53,127
26,Michigan,39,Ohio,161,Van Wert County,40,4,36
26,Michigan,39,Ohio,163,Vinton County,0,2,-2
26,Michigan,39,Ohio,165,Warren County,243,261,-18
26,Michigan,39,Ohio,167,Washington County,19,62,-43
26,Michigan,39,Ohio,169,Wayne County,157,94,63
26,Michigan,39,Ohio,171,Williams County,210,133,77
26,Michigan,39,Ohio,173,Wood County,865,657,208
26,Michigan,39,Ohio,175,Wyandot County,0,1,-1
26,Michigan,4,Arizona,1,Apache County,0,59,-59
26,Michigan,4,Arizona,3,Cochise County,107,28,79
26,Michigan,4,Arizona,5,Coconino County,26,226,-200
26,Michigan,4,Arizona,7,Gila County,23,0,23
26,Michigan,4,Arizona,12,La Paz County,94,12,82
26,Michigan,4,Arizona,13,Maricopa County,2732,4500,-1768
26,Michigan,4,Arizona,15,Mohave County,283,222,61
26,Michigan,4,Arizona,17,Navajo County,0,9,-9
26,Michigan,4,Arizona,19,Pima County,878,1273,-395
26,Michigan,4,Arizona,21,Pinal County,258,827,-569
26,Michigan,4,Arizona,23,Santa Cruz County,10,9,1
26,Michigan,4,Arizona,25,Yavapai County,12,148,-136
26,Michigan,4,Arizona,27,Yuma County,49,229,-180
26,Michigan,40,Oklahoma,11,Blaine County,26,0,26
26,Michigan,40,Oklahoma,13,Bryan County,0,21,-21
26,Michigan,40,Oklahoma,17,Canadian County,43,16,27
26,Michigan,40,Oklahoma,19,Carter County,35,0,35
26,Michigan,40,Oklahoma,27,Cleveland County,69,129,-60
26,Michigan,40,Oklahoma,31,Comanche County,138,125,13
26,Michigan,40,Oklahoma,37,Creek County,37,0,37
26,Michigan,40,Oklahoma,39,Custer County,41,678,-637
26,Michigan,40,Oklahoma,41,Delaware County,2,15,-13
26,Michigan,40,Oklahoma,47,Garfield County,0,4,-4
26,Michigan,40,Oklahoma,63,Hughes County,0,14,-14
26,Michigan,40,Oklahoma,65,Jackson County,0,49,-49
26,Michigan,40,Oklahoma,69,Johnston County,0,4,-4
26,Michigan,40,Oklahoma,71,Kay County,33,2,31
26,Michigan,40,Oklahoma,77,Latimer County,3,0,3
26,Michigan,40,Oklahoma,79,Le Flore County,7,25,-18
26,Michigan,40,Oklahoma,81,Lincoln County,0,5,-5
26,Michigan,40,Oklahoma,83,Logan County,0,9,-9
26,Michigan,40,Oklahoma,87,McClain County,7,0,7
26,Michigan,40,Oklahoma,89,McCurtain County,0,3,-3
26,Michigan,40,Oklahoma,97,Mayes County,32,118,-86
26,Michigan,40,Oklahoma,101,Muskogee County,0,36,-36
26,Michigan,40,Oklahoma,109,Oklahoma County,117,262,-145
26,Michigan,40,Oklahoma,115,Ottawa County,0,3,-3
26,Michigan,40,Oklahoma,119,Payne County,0,121,-121
26,Michigan,40,Oklahoma,123,Pontotoc County,21,6,15
26,Michigan,40,Oklahoma,125,Pottawatomie County,20,7,13
26,Michigan,40,Oklahoma,131,Rogers County,14,12,2
26,Michigan,40,Oklahoma,133,Seminole County,0,123,-123
26,Michigan,40,Oklahoma,135,Sequoyah County,26,3,23
26,Michigan,40,Oklahoma,137,Stephens County,0,11,-11
26,Michigan,40,Oklahoma,141,Tillman County,0,26,-26
26,Michigan,40,Oklahoma,143,Tulsa County,230,364,-134
26,Michigan,40,Oklahoma,145,Wagoner County,7,0,7
26,Michigan,40,Oklahoma,147,Washington County,19,10,9
26,Michigan,40,Oklahoma,149,Washita County,3,0,3
26,Michigan,40,Oklahoma,153,Woodward County,0,3,-3
26,Michigan,41,Oregon,3,Benton County,26,10,16
26,Michigan,41,Oregon,5,Clackamas County,33,185,-152
26,Michigan,41,Oregon,7,Clatsop County,42,23,19
26,Michigan,41,Oregon,9,Columbia County,0,54,-54
26,Michigan,41,Oregon,11,Coos County,7,0,7
26,Michigan,41,Oregon,13,Crook County,3,0,3
26,Michigan,41,Oregon,15,Curry County,3,2,1
26,Michigan,41,Oregon,17,Deschutes County,12,12,0
26,Michigan,41,Oregon,19,Douglas County,0,169,-169
26,Michigan,41,Oregon,27,Hood River County,10,0,10
26,Michigan,41,Oregon,29,Jackson County,16,12,4
26,Michigan,41,Oregon,33,Josephine County,0,15,-15
26,Michigan,41,Oregon,35,Klamath County,0,6,-6
26,Michigan,41,Oregon,39,Lane County,139,23,116
26,Michigan,41,Oregon,43,Linn County,0,3,-3
26,Michigan,41,Oregon,47,Marion County,62,45,17
26,Michigan,41,Oregon,51,Multnomah County,185,317,-132
26,Michigan,41,Oregon,53,Polk County,0,15,-15
26,Michigan,41,Oregon,57,Tillamook County,4,0,4
26,Michigan,41,Oregon,67,Washington County,363,332,31
26,Michigan,41,Oregon,71,Yamhill County,0,24,-24
26,Michigan,42,Pennsylvania,1,Adams County,38,3,35
26,Michigan,42,Pennsylvania,3,Allegheny County,606,588,18
26,Michigan,42,Pennsylvania,5,Armstrong County,0,4,-4
26,Michigan,42,Pennsylvania,7,Beaver County,147,50,97
26,Michigan,42,Pennsylvania,9,Bedford County,97,7,90
26,Michigan,42,Pennsylvania,11,Berks County,15,3,12
26,Michigan,42,Pennsylvania,13,Blair County,18,31,-13
26,Michigan,42,Pennsylvania,15,Bradford County,0,8,-8
26,Michigan,42,Pennsylvania,17,Bucks County,53,75,-22
26,Michigan,42,Pennsylvania,19,Butler County,178,44,134
26,Michigan,42,Pennsylvania,21,Cambria County,17,43,-26
26,Michigan,42,Pennsylvania,27,Centre County,49,179,-130
26,Michigan,42,Pennsylvania,29,Chester County,377,188,189
26,Michigan,42,Pennsylvania,33,Clearfield County,0,3,-3
26,Michigan,42,Pennsylvania,35,Clinton County,60,9,51
26,Michigan,42,Pennsylvania,37,Columbia County,4,11,-7
26,Michigan,42,Pennsylvania,39,Crawford County,108,3,105
26,Michigan,42,Pennsylvania,41,Cumberland County,66,279,-213
26,Michigan,42,Pennsylvania,43,Dauphin County,7,82,-75
26,Michigan,42,Pennsylvania,45,Delaware County,100,104,-4
26,Michigan,42,Pennsylvania,49,Erie County,228,110,118
26,Michigan,42,Pennsylvania,51,Fayette County,56,13,43
26,Michigan,42,Pennsylvania,55,Franklin County,78,62,16
26,Michigan,42,Pennsylvania,59,Greene County,6,12,-6
26,Michigan,42,Pennsylvania,63,Indiana County,10,120,-110
26,Michigan,42,Pennsylvania,65,Jefferson County,0,6,-6
26,Michigan,42,Pennsylvania,69,Lackawanna County,33,10,23
26,Michigan,42,Pennsylvania,71,Lancaster County,70,76,-6
26,Michigan,42,Pennsylvania,73,Lawrence County,0,23,-23
26,Michigan,42,Pennsylvania,75,Lebanon County,27,83,-56
26,Michigan,42,Pennsylvania,77,Lehigh County,11,136,-125
26,Michigan,42,Pennsylvania,79,Luzerne County,42,33,9
26,Michigan,42,Pennsylvania,83,McKean County,47,41,6
26,Michigan,42,Pennsylvania,85,Mercer County,21,39,-18
26,Michigan,42,Pennsylvania,89,Monroe County,0,133,-133
26,Michigan,42,Pennsylvania,91,Montgomery County,193,92,101
26,Michigan,42,Pennsylvania,93,Montour County,38,0,38
26,Michigan,42,Pennsylvania,95,Northampton County,57,58,-1
26,Michigan,42,Pennsylvania,97,Northumberland County,0,6,-6
26,Michigan,42,Pennsylvania,101,Philadelphia County,422,426,-4
26,Michigan,42,Pennsylvania,103,Pike County,14,14,0
26,Michigan,42,Pennsylvania,105,Potter County,0,8,-8
26,Michigan,42,Pennsylvania,107,Schuylkill County,159,3,156
26,Michigan,42,Pennsylvania,109,Snyder County,32,11,21
26,Michigan,42,Pennsylvania,111,Somerset County,14,12,2
26,Michigan,42,Pennsylvania,113,Sullivan County,0,2,-2
26,Michigan,42,Pennsylvania,115,Susquehanna County,0,19,-19
26,Michigan,42,Pennsylvania,117,Tioga County,31,3,28
26,Michigan,42,Pennsylvania,119,Union County,0,25,-25
26,Michigan,42,Pennsylvania,121,Venango County,9,0,9
26,Michigan,42,Pennsylvania,123,Warren County,79,10,69
26,Michigan,42,Pennsylvania,125,Washington County,22,114,-92
26,Michigan,42,Pennsylvania,127,Wayne County,0,25,-25
26,Michigan,42,Pennsylvania,129,Westmoreland County,5,38,-33
26,Michigan,42,Pennsylvania,133,York County,127,64,63
26,Michigan,44,Rhode Island,1,Bristol County,99,0,99
26,Michigan,44,Rhode Island,3,Kent County,51,0,51
26,Michigan,44,Rhode Island,5,Newport County,26,41,-15
26,Michigan,44,Rhode Island,7,Providence County,131,371,-240
26,Michigan,44,Rhode Island,9,Washington County,3,23,-20
26,Michigan,45,South Carolina,1,Abbeville County,0,30,-30
26,Michigan,45,South Carolina,3,Aiken County,18,72,-54
26,Michigan,45,South Carolina,7,Anderson County,30,106,-76
26,Michigan,45,South Carolina,9,Bamberg County,0,5,-5
26,Michigan,45,South Carolina,13,Beaufort County,62,368,-306
26,Michigan,45,South Carolina,15,Berkeley County,91,195,-104
26,Michigan,45,South Carolina,17,Calhoun County,0,8,-8
26,Michigan,45,South Carolina,19,Charleston County,288,243,45
26,Michigan,45,South Carolina,23,Chester County,0,6,-6
26,Michigan,45,South Carolina,27,Clarendon County,3,0,3
26,Michigan,45,South Carolina,29,Colleton County,82,0,82
26,Michigan,45,South Carolina,35,Dorchester County,46,25,21
26,Michigan,45,South Carolina,37,Edgefield County,19,2,17
26,Michigan,45,South Carolina,41,Florence County,66,57,9
26,Michigan,45,South Carolina,43,Georgetown County,0,15,-15
26,Michigan,45,South Carolina,45,Greenville County,556,772,-216
26,Michigan,45,South Carolina,47,Greenwood County,0,31,-31
26,Michigan,45,South Carolina,49,Hampton County,4,0,4
26,Michigan,45,South Carolina,51,Horry County,114,127,-13
26,Michigan,45,South Carolina,55,Kershaw County,62,22,40
26,Michigan,45,South Carolina,57,Lancaster County,12,87,-75
26,Michigan,45,South Carolina,59,Laurens County,2,0,2
26,Michigan,45,South Carolina,61,Lee County,0,30,-30
26,Michigan,45,South Carolina,63,Lexington County,194,152,42
26,Michigan,45,South Carolina,65,McCormick County,0,7,-7
26,Michigan,45,South Carolina,73,Oconee County,27,5,22
26,Michigan,45,South Carolina,75,Orangeburg County,6,0,6
26,Michigan,45,South Carolina,77,Pickens County,106,86,20
26,Michigan,45,South Carolina,79,Richland County,216,704,-488
26,Michigan,45,South Carolina,81,Saluda County,8,0,8
26,Michigan,45,South Carolina,83,Spartanburg County,100,51,49
26,Michigan,45,South Carolina,85,Sumter County,0,26,-26
26,Michigan,45,South Carolina,91,York County,276,97,179
26,Michigan,46,South Dakota,5,Beadle County,7,0,7
26,Michigan,46,South Dakota,11,Brookings County,42,0,42
26,Michigan,46,South Dakota,13,Brown County,0,6,-6
26,Michigan,46,South Dakota,15,Brule County,0,2,-2
26,Michigan,46,South Dakota,19,Butte County,0,4,-4
26,Michigan,46,South Dakota,29,Codington County,50,0,50
26,Michigan,46,South Dakota,31,Corson County,0,2,-2
26,Michigan,46,South Dakota,33,Custer County,0,7,-7
26,Michigan,46,South Dakota,35,Davison County,0,8,-8
26,Michigan,46,South Dakota,37,Day County,22,0,22
26,Michigan,46,South Dakota,43,Douglas County,0,2,-2
26,Michigan,46,South Dakota,51,Grant County,0,1,-1
26,Michigan,46,South Dakota,53,Gregory County,27,0,27
26,Michigan,46,South Dakota,57,Hamlin County,25,13,12
26,Michigan,46,South Dakota,59,Hand County,0,5,-5
26,Michigan,46,South Dakota,61,Hanson County,30,0,30
26,Michigan,46,South Dakota,65,Hughes County,6,0,6
26,Michigan,46,South Dakota,79,Lake County,8,0,8
26,Michigan,46,South Dakota,83,Lincoln County,9,0,9
26,Michigan,46,South Dakota,93,Meade County,0,5,-5
26,Michigan,46,South Dakota,99,Minnehaha County,38,0,38
26,Michigan,46,South Dakota,103,Pennington County,30,25,5
26,Michigan,46,South Dakota,105,Perkins County,0,38,-38
26,Michigan,46,South Dakota,109,Roberts County,0,4,-4
26,Michigan,46,South Dakota,111,Sanborn County,4,0,4
26,Michigan,46,South Dakota,125,Turner County,0,3,-3
26,Michigan,46,South Dakota,135,Yankton County,21,11,10
26,Michigan,47,Tennessee,1,Anderson County,48,111,-63
26,Michigan,47,Tennessee,3,Bedford County,0,41,-41
26,Michigan,47,Tennessee,7,Bledsoe County,0,16,-16
26,Michigan,47,Tennessee,9,Blount County,71,14,57
26,Michigan,47,Tennessee,11,Bradley County,0,112,-112
26,Michigan,47,Tennessee,13,Campbell County,0,68,-68
26,Michigan,47,Tennessee,19,Carter County,0,18,-18
26,Michigan,47,Tennessee,21,Cheatham County,10,0,10
26,Michigan,47,Tennessee,23,Chester County,17,3,14
26,Michigan,47,Tennessee,25,Claiborne County,14,8,6
26,Michigan,47,Tennessee,29,Cocke County,0,66,-66
26,Michigan,47,Tennessee,31,Coffee County,53,144,-91
26,Michigan,47,Tennessee,33,Crockett County,36,16,20
26,Michigan,47,Tennessee,35,Cumberland County,111,74,37
26,Michigan,47,Tennessee,37,Davidson County,633,1216,-583
26,Michigan,47,Tennessee,39,Decatur County,0,6,-6
26,Michigan,47,Tennessee,43,Dickson County,5,26,-21
26,Michigan,47,Tennessee,45,Dyer County,46,0,46
26,Michigan,47,Tennessee,47,Fayette County,0,40,-40
26,Michigan,47,Tennessee,51,Franklin County,18,22,-4
26,Michigan,47,Tennessee,53,Gibson County,8,0,8
26,Michigan,47,Tennessee,55,Giles County,21,12,9
26,Michigan,47,Tennessee,57,Grainger County,69,0,69
26,Michigan,47,Tennessee,59,Greene County,0,55,-55
26,Michigan,47,Tennessee,63,Hamblen County,34,47,-13
26,Michigan,47,Tennessee,65,Hamilton County,237,194,43
26,Michigan,47,Tennessee,69,Hardeman County,74,0,74
26,Michigan,47,Tennessee,75,Haywood County,129,4,125
26,Michigan,47,Tennessee,79,Henry County,13,59,-46
26,Michigan,47,Tennessee,85,Humphreys County,0,33,-33
26,Michigan,47,Tennessee,89,Jefferson County,19,30,-11
26,Michigan,47,Tennessee,91,Johnson County,6,5,1
26,Michigan,47,Tennessee,93,Knox County,743,332,411
26,Michigan,47,Tennessee,95,Lake County,9,0,9
26,Michigan,47,Tennessee,97,Lauderdale County,0,27,-27
26,Michigan,47,Tennessee,99,Lawrence County,0,53,-53
26,Michigan,47,Tennessee,101,Lewis County,0,25,-25
26,Michigan,47,Tennessee,103,Lincoln County,0,50,-50
26,Michigan,47,Tennessee,105,Loudon County,8,235,-227
26,Michigan,47,Tennessee,107,McMinn County,208,10,198
26,Michigan,47,Tennessee,109,McNairy County,21,11,10
26,Michigan,47,Tennessee,111,Macon County,0,18,-18
26,Michigan,47,Tennessee,113,Madison County,90,25,65
26,Michigan,47,Tennessee,115,Marion County,4,5,-1
26,Michigan,47,Tennessee,117,Marshall County,104,48,56
26,Michigan,47,Tennessee,119,Maury County,191,113,78
26,Michigan,47,Tennessee,123,Monroe County,17,0,17
26,Michigan,47,Tennessee,125,Montgomery County,277,133,144
26,Michigan,47,Tennessee,129,Morgan County,0,5,-5
26,Michigan,47,Tennessee,131,Obion County,14,0,14
26,Michigan,47,Tennessee,135,Perry County,0,9,-9
26,Michigan,47,Tennessee,139,Polk County,22,0,22
26,Michigan,47,Tennessee,141,Putnam County,88,39,49
26,Michigan,47,Tennessee,143,Rhea County,0,75,-75
26,Michigan,47,Tennessee,145,Roane County,0,128,-128
26,Michigan,47,Tennessee,147,Robertson County,59,33,26
26,Michigan,47,Tennessee,149,Rutherford County,381,367,14
26,Michigan,47,Tennessee,155,Sevier County,78,65,13
26,Michigan,47,Tennessee,157,Shelby County,766,331,435
26,Michigan,47,Tennessee,163,Sullivan County,63,216,-153
26,Michigan,47,Tennessee,165,Sumner County,75,199,-124
26,Michigan,47,Tennessee,167,Tipton County,35,0,35
26,Michigan,47,Tennessee,171,Unicoi County,10,0,10
26,Michigan,47,Tennessee,177,Warren County,3,7,-4
26,Michigan,47,Tennessee,179,Washington County,0,23,-23
26,Michigan,47,Tennessee,181,Wayne County,19,25,-6
26,Michigan,47,Tennessee,183,Weakley County,0,3,-3
26,Michigan,47,Tennessee,185,White County,0,33,-33
26,Michigan,47,Tennessee,187,Williamson County,99,215,-116
26,Michigan,47,Tennessee,189,Wilson County,0,178,-178
26,Michigan,48,Texas,3,Andrews County,8,0,8
26,Michigan,48,Texas,5,Angelina County,0,8,-8
26,Michigan,48,Texas,13,Atascosa County,8,0,8
26,Michigan,48,Texas,15,Austin County,2,0,2
26,Michigan,48,Texas,21,Bastrop County,7,67,-60
26,Michigan,48,Texas,23,Baylor County,5,0,5
26,Michigan,48,Texas,25,Bee County,0,7,-7
26,Michigan,48,Texas,27,Bell County,293,227,66
26,Michigan,48,Texas,29,Bexar County,385,609,-224
26,Michigan,48,Texas,37,Bowie County,65,0,65
26,Michigan,48,Texas,39,Brazoria County,31,61,-30
26,Michigan,48,Texas,41,Brazos County,203,25,178
26,Michigan,48,Texas,47,Brooks County,0,16,-16
26,Michigan,48,Texas,49,Brown County,0,10,-10
26,Michigan,48,Texas,53,Burnet County,10,0,10
26,Michigan,48,Texas,55,Caldwell County,0,11,-11
26,Michigan,48,Texas,57,Calhoun County,0,10,-10
26,Michigan,48,Texas,61,Cameron County,191,210,-19
26,Michigan,48,Texas,67,Cass County,60,0,60
26,Michigan,48,Texas,71,Chambers County,25,0,25
26,Michigan,48,Texas,85,Collin County,427,431,-4
26,Michigan,48,Texas,91,Comal County,17,42,-25
26,Michigan,48,Texas,97,Cooke County,6,0,6
26,Michigan,48,Texas,99,Coryell County,90,300,-210
26,Michigan,48,Texas,113,Dallas County,750,1057,-307
26,Michigan,48,Texas,121,Denton County,237,330,-93
26,Michigan,48,Texas,133,Eastland County,4,0,4
26,Michigan,48,Texas,139,Ellis County,60,47,13
26,Michigan,48,Texas,141,El Paso County,394,534,-140
26,Michigan,48,Texas,145,Falls County,0,52,-52
26,Michigan,48,Texas,157,Fort Bend County,147,223,-76
26,Michigan,48,Texas,163,Frio County,8,0,8
26,Michigan,48,Texas,165,Gaines County,0,11,-11
26,Michigan,48,Texas,167,Galveston County,28,182,-154
26,Michigan,48,Texas,171,Gillespie County,11,0,11
26,Michigan,48,Texas,179,Gray County,26,0,26
26,Michigan,48,Texas,181,Grayson County,2,16,-14
26,Michigan,48,Texas,183,Gregg County,48,89,-41
26,Michigan,48,Texas,187,Guadalupe County,0,20,-20
26,Michigan,48,Texas,189,Hale County,20,0,20
26,Michigan,48,Texas,201,Harris County,1385,1550,-165
26,Michigan,48,Texas,203,Harrison County,9,0,9
26,Michigan,48,Texas,209,Hays County,3,11,-8
26,Michigan,48,Texas,215,Hidalgo County,945,480,465
26,Michigan,48,Texas,221,Hood County,15,59,-44
26,Michigan,48,Texas,225,Houston County,8,0,8
26,Michigan,48,Texas,227,Howard County,0,84,-84
26,Michigan,48,Texas,231,Hunt County,39,14,25
26,Michigan,48,Texas,237,Jack County,0,17,-17
26,Michigan,48,Texas,239,Jackson County,19,0,19
26,Michigan,48,Texas,241,Jasper County,32,0,32
26,Michigan,48,Texas,245,Jefferson County,30,22,8
26,Michigan,48,Texas,249,Jim Wells County,1,0,1
26,Michigan,48,Texas,251,Johnson County,5,21,-16
26,Michigan,48,Texas,255,Karnes County,0,7,-7
26,Michigan,48,Texas,257,Kaufman County,17,32,-15
26,Michigan,48,Texas,259,Kendall County,9,21,-12
26,Michigan,48,Texas,281,Lampasas County,0,39,-39
26,Michigan,48,Texas,289,Leon County,4,0,4
26,Michigan,48,Texas,299,Llano County,0,17,-17
26,Michigan,48,Texas,303,Lubbock County,277,0,277
26,Michigan,48,Texas,309,McLennan County,4,27,-23
26,Michigan,48,Texas,317,Martin County,14,0,14
26,Michigan,48,Texas,323,Maverick County,13,0,13
26,Michigan,48,Texas,325,Medina County,5,14,-9
26,Michigan,48,Texas,329,Midland County,27,68,-41
26,Michigan,48,Texas,337,Montague County,21,0,21
26,Michigan,48,Texas,339,Montgomery County,236,289,-53
26,Michigan,48,Texas,347,Nacogdoches County,0,16,-16
26,Michigan,48,Texas,351,Newton County,0,2,-2
26,Michigan,48,Texas,355,Nueces County,46,46,0
26,Michigan,48,Texas,361,Orange County,31,0,31
26,Michigan,48,Texas,363,Palo Pinto County,0,29,-29
26,Michigan,48,Texas,367,Parker County,18,30,-12
26,Michigan,48,Texas,381,Randall County,0,9,-9
26,Michigan,48,Texas,397,Rockwall County,22,77,-55
26,Michigan,48,Texas,399,Runnels County,0,5,-5
26,Michigan,48,Texas,401,Rusk County,22,0,22
26,Michigan,48,Texas,409,San Patricio County,0,68,-68
26,Michigan,48,Texas,411,San Saba County,0,22,-22
26,Michigan,48,Texas,423,Smith County,4,4,0
26,Michigan,48,Texas,427,Starr County,0,6,-6
26,Michigan,48,Texas,439,Tarrant County,511,966,-455
26,Michigan,48,Texas,441,Taylor County,0,63,-63
26,Michigan,48,Texas,451,Tom Green County,16,3,13
26,Michigan,48,Texas,453,Travis County,761,668,93
26,Michigan,48,Texas,459,Upshur County,27,43,-16
26,Michigan,48,Texas,469,Victoria County,49,10,39
26,Michigan,48,Texas,471,Walker County,29,0,29
26,Michigan,48,Texas,475,Ward County,0,36,-36
26,Michigan,48,Texas,477,Washington County,0,8,-8
26,Michigan,48,Texas,479,Webb County,15,5,10
26,Michigan,48,Texas,481,Wharton County,0,25,-25
26,Michigan,48,Texas,485,Wichita County,57,68,-11
26,Michigan,48,Texas,489,Willacy County,0,83,-83
26,Michigan,48,Texas,491,Williamson County,100,285,-185
26,Michigan,48,Texas,493,Wilson County,13,0,13
26,Michigan,48,Texas,495,Winkler County,0,2,-2
26,Michigan,48,Texas,503,Young County,6,0,6
26,Michigan,49,Utah,3,Box Elder County,0,131,-131
26,Michigan,49,Utah,5,Cache County,15,0,15
26,Michigan,49,Utah,7,Carbon County,0,5,-5
26,Michigan,49,Utah,11,Davis County,32,131,-99
26,Michigan,49,Utah,13,Duchesne County,0,5,-5
26,Michigan,49,Utah,17,Garfield County,0,3,-3
26,Michigan,49,Utah,25,Kane County,23,10,13
26,Michigan,49,Utah,29,Morgan County,0,13,-13
26,Michigan,49,Utah,35,Salt Lake County,445,316,129
26,Michigan,49,Utah,39,Sanpete County,0,3,-3
26,Michigan,49,Utah,41,Sevier County,0,6,-6
26,Michigan,49,Utah,45,Tooele County,15,0,15
26,Michigan,49,Utah,47,Uintah County,23,0,23
26,Michigan,49,Utah,49,Utah County,168,331,-163
26,Michigan,49,Utah,51,Wasatch County,0,55,-55
26,Michigan,49,Utah,53,Washington County,20,0,20
26,Michigan,49,Utah,57,Weber County,0,33,-33
26,Michigan,5,Arkansas,7,Benton County,39,74,-35
26,Michigan,5,Arkansas,9,Boone County,30,28,2
26,Michigan,5,Arkansas,19,Clark County,0,7,-7
26,Michigan,5,Arkansas,21,Clay County,0,21,-21
26,Michigan,5,Arkansas,31,Craighead County,34,0,34
26,Michigan,5,Arkansas,33,Crawford County,0,139,-139
26,Michigan,5,Arkansas,35,Crittenden County,0,18,-18
26,Michigan,5,Arkansas,43,Drew County,8,29,-21
26,Michigan,5,Arkansas,45,Faulkner County,6,27,-21
26,Michigan,5,Arkansas,47,Franklin County,0,10,-10
26,Michigan,5,Arkansas,49,Fulton County,2,0,2
26,Michigan,5,Arkansas,55,Greene County,0,60,-60
26,Michigan,5,Arkansas,59,Hot Spring County,6,0,6
26,Michigan,5,Arkansas,63,Independence County,81,12,69
26,Michigan,5,Arkansas,65,Izard County,16,4,12
26,Michigan,5,Arkansas,69,Jefferson County,247,31,216
26,Michigan,5,Arkansas,73,Lafayette County,0,7,-7
26,Michigan,5,Arkansas,75,Lawrence County,8,29,-21
26,Michigan,5,Arkansas,77,Lee County,0,9,-9
26,Michigan,5,Arkansas,85,Lonoke County,6,0,6
26,Michigan,5,Arkansas,89,Marion County,21,0,21
26,Michigan,5,Arkansas,93,Mississippi County,92,13,79
26,Michigan,5,Arkansas,103,Ouachita County,38,0,38
26,Michigan,5,Arkansas,105,Perry County,70,0,70
26,Michigan,5,Arkansas,107,Phillips County,197,0,197
26,Michigan,5,Arkansas,109,Pike County,4,0,4
26,Michigan,5,Arkansas,113,Polk County,0,15,-15
26,Michigan,5,Arkansas,115,Pope County,0,15,-15
26,Michigan,5,Arkansas,117,Prairie County,0,11,-11
26,Michigan,5,Arkansas,119,Pulaski County,215,186,29
26,Michigan,5,Arkansas,125,Saline County,12,8,4
26,Michigan,5,Arkansas,131,Sebastian County,8,85,-77
26,Michigan,5,Arkansas,135,Sharp County,11,0,11
26,Michigan,5,Arkansas,137,Stone County,11,0,11
26,Michigan,5,Arkansas,143,Washington County,168,88,80
26,Michigan,5,Arkansas,145,White County,9,64,-55
26,Michigan,50,Vermont,1,Addison County,0,21,-21
26,Michigan,50,Vermont,5,Caledonia County,1,17,-16
26,Michigan,50,Vermont,7,Chittenden County,140,73,67
26,Michigan,50,Vermont,11,Franklin County,41,2,39
26,Michigan,50,Vermont,17,Orange County,0,7,-7
26,Michigan,50,Vermont,19,Orleans County,0,6,-6
26,Michigan,50,Vermont,21,Rutland County,16,0,16
26,Michigan,50,Vermont,23,Washington County,16,117,-101
26,Michigan,50,Vermont,25,Windham County,0,11,-11
26,Michigan,50,Vermont,27,Windsor County,0,22,-22
26,Michigan,51,Virginia,1,Accomack County,10,0,10
26,Michigan,51,Virginia,3,Albemarle County,63,0,63
26,Michigan,51,Virginia,9,Amherst County,16,0,16
26,Michigan,51,Virginia,13,Arlington County,128,139,-11
26,Michigan,51,Virginia,15,Augusta County,0,33,-33
26,Michigan,51,Virginia,19,Bedford County,47,0,47
26,Michigan,51,Virginia,27,Buchanan County,3,0,3
26,Michigan,51,Virginia,31,Campbell County,14,0,14
26,Michigan,51,Virginia,33,Caroline County,0,66,-66
26,Michigan,51,Virginia,41,Chesterfield County,38,47,-9
26,Michigan,51,Virginia,47,Culpeper County,7,0,7
26,Michigan,51,Virginia,59,Fairfax County,478,493,-15
26,Michigan,51,Virginia,65,Fluvanna County,44,0,44
26,Michigan,51,Virginia,79,Greene County,22,0,22
26,Michigan,51,Virginia,83,Halifax County,0,2,-2
26,Michigan,51,Virginia,85,Hanover County,0,37,-37
26,Michigan,51,Virginia,87,Henrico County,31,0,31
26,Michigan,51,Virginia,89,Henry County,31,0,31
26,Michigan,51,Virginia,93,Isle of Wight County,45,29,16
26,Michigan,51,Virginia,95,James City County,6,107,-101
26,Michigan,51,Virginia,105,Lee County,8,0,8
26,Michigan,51,Virginia,107,Loudoun County,163,92,71
26,Michigan,51,Virginia,109,Louisa County,5,0,5
26,Michigan,51,Virginia,113,Madison County,2,0,2
26,Michigan,51,Virginia,119,Middlesex County,31,0,31
26,Michigan,51,Virginia,133,Northumberland County,5,0,5
26,Michigan,51,Virginia,149,Prince George County,0,11,-11
26,Michigan,51,Virginia,153,Prince William County,65,115,-50
26,Michigan,51,Virginia,155,Pulaski County,0,17,-17
26,Michigan,51,Virginia,161,Roanoke County,12,24,-12
26,Michigan,51,Virginia,167,Russell County,0,4,-4
26,Michigan,51,Virginia,171,Shenandoah County,0,87,-87
26,Michigan,51,Virginia,173,Smyth County,13,0,13
26,Michigan,51,Virginia,177,Spotsylvania County,38,17,21
26,Michigan,51,Virginia,179,Stafford County,95,110,-15
26,Michigan,51,Virginia,187,Warren County,36,0,36
26,Michigan,51,Virginia,191,Washington County,22,30,-8
26,Michigan,51,Virginia,195,Wise County,10,40,-30
26,Michigan,51,Virginia,197,Wythe County,0,9,-9
26,Michigan,51,Virginia,199,York County,55,36,19
26,Michigan,51,Virginia,510,Alexandria city,51,103,-52
26,Michigan,51,Virginia,520,Bristol city,0,15,-15
26,Michigan,51,Virginia,540,Charlottesville city,44,14,30
26,Michigan,51,Virginia,550,Chesapeake city,34,33,1
26,Michigan,51,Virginia,580,Covington city,0,15,-15
26,Michigan,51,Virginia,590,Danville city,0,9,-9
26,Michigan,51,Virginia,595,Emporia city,0,4,-4
26,Michigan,51,Virginia,600,Fairfax city,0,29,-29
26,Michigan,51,Virginia,610,Falls Church city,25,8,17
26,Michigan,51,Virginia,630,Fredericksburg city,93,0,93
26,Michigan,51,Virginia,650,Hampton city,126,67,59
26,Michigan,51,Virginia,660,Harrisonburg city,0,39,-39
26,Michigan,51,Virginia,678,Lexington city,0,10,-10
26,Michigan,51,Virginia,680,Lynchburg city,105,132,-27
26,Michigan,51,Virginia,683,Manassas city,24,28,-4
26,Michigan,51,Virginia,685,Manassas Park city,0,10,-10
26,Michigan,51,Virginia,700,Newport News city,106,49,57
26,Michigan,51,Virginia,710,Norfolk city,87,523,-436
26,Michigan,51,Virginia,735,Poquoson city,5,0,5
26,Michigan,51,Virginia,740,Portsmouth city,43,41,2
26,Michigan,51,Virginia,760,Richmond city,53,246,-193
26,Michigan,51,Virginia,770,Roanoke city,21,43,-22
26,Michigan,51,Virginia,800,Suffolk city,0,17,-17
26,Michigan,51,Virginia,810,Virginia Beach city,313,421,-108
26,Michigan,51,Virginia,830,Williamsburg city,8,13,-5
26,Michigan,53,Washington,5,Benton County,10,12,-2
26,Michigan,53,Washington,7,Chelan County,0,42,-42
26,Michigan,53,Washington,9,Clallam County,28,24,4
26,Michigan,53,Washington,11,Clark County,188,105,83
26,Michigan,53,Washington,15,Cowlitz County,18,46,-28
26,Michigan,53,Washington,25,Grant County,45,17,28
26,Michigan,53,Washington,27,Grays Harbor County,25,18,7
26,Michigan,53,Washington,29,Island County,43,66,-23
26,Michigan,53,Washington,31,Jefferson County,26,40,-14
26,Michigan,53,Washington,33,King County,556,1645,-1089
26,Michigan,53,Washington,35,Kitsap County,60,105,-45
26,Michigan,53,Washington,41,Lewis County,0,3,-3
26,Michigan,53,Washington,49,Pacific County,12,0,12
26,Michigan,53,Washington,53,Pierce County,299,624,-325
26,Michigan,53,Washington,55,San Juan County,0,5,-5
26,Michigan,53,Washington,57,Skagit County,23,4,19
26,Michigan,53,Washington,59,Skamania County,0,2,-2
26,Michigan,53,Washington,61,Snohomish County,359,109,250
26,Michigan,53,Washington,63,Spokane County,104,100,4
26,Michigan,53,Washington,65,Stevens County,10,0,10
26,Michigan,53,Washington,67,Thurston County,57,78,-21
26,Michigan,53,Washington,71,Walla Walla County,37,8,29
26,Michigan,53,Washington,73,Whatcom County,10,216,-206
26,Michigan,53,Washington,75,Whitman County,0,80,-80
26,Michigan,53,Washington,77,Yakima County,9,8,1
26,Michigan,54,West Virginia,1,Barbour County,0,82,-82
26,Michigan,54,West Virginia,9,Brooke County,0,4,-4
26,Michigan,54,West Virginia,11,Cabell County,60,37,23
26,Michigan,54,West Virginia,15,Clay County,29,4,25
26,Michigan,54,West Virginia,17,Doddridge County,0,13,-13
26,Michigan,54,West Virginia,19,Fayette County,103,21,82
26,Michigan,54,West Virginia,25,Greenbrier County,18,53,-35
26,Michigan,54,West Virginia,29,Hancock County,0,13,-13
26,Michigan,54,West Virginia,33,Harrison County,22,20,2
26,Michigan,54,West Virginia,35,Jackson County,24,0,24
26,Michigan,54,West Virginia,37,Jefferson County,0,4,-4
26,Michigan,54,West Virginia,39,Kanawha County,75,18,57
26,Michigan,54,West Virginia,45,Logan County,0,25,-25
26,Michigan,54,West Virginia,47,McDowell County,0,7,-7
26,Michigan,54,West Virginia,51,Marshall County,0,15,-15
26,Michigan,54,West Virginia,55,Mercer County,0,2,-2
26,Michigan,54,West Virginia,61,Monongalia County,65,70,-5
26,Michigan,54,West Virginia,67,Nicholas County,0,139,-139
26,Michigan,54,West Virginia,69,Ohio County,53,0,53
26,Michigan,54,West Virginia,77,Preston County,13,103,-90
26,Michigan,54,West Virginia,79,Putnam County,6,0,6
26,Michigan,54,West Virginia,81,Raleigh County,21,28,-7
26,Michigan,54,West Virginia,85,Ritchie County,0,18,-18
26,Michigan,54,West Virginia,87,Roane County,23,17,6
26,Michigan,54,West Virginia,97,Upshur County,0,12,-12
26,Michigan,54,West Virginia,103,Wetzel County,0,14,-14
26,Michigan,54,West Virginia,107,Wood County,19,7,12
26,Michigan,55,Wisconsin,1,Adams County,29,0,29
26,Michigan,55,Wisconsin,3,Ashland County,26,3,23
26,Michigan,55,Wisconsin,7,Bayfield County,17,29,-12
26,Michigan,55,Wisconsin,9,Brown County,410,494,-84
26,Michigan,55,Wisconsin,13,Burnett County,0,1,-1
26,Michigan,55,Wisconsin,15,Calumet County,38,0,38
26,Michigan,55,Wisconsin,17,Chippewa County,30,6,24
26,Michigan,55,Wisconsin,19,Clark County,14,18,-4
26,Michigan,55,Wisconsin,21,Columbia County,52,12,40
26,Michigan,55,Wisconsin,25,Dane County,580,528,52
26,Michigan,55,Wisconsin,27,Dodge County,35,125,-90
26,Michigan,55,Wisconsin,29,Door County,33,32,1
26,Michigan,55,Wisconsin,31,Douglas County,5,53,-48
26,Michigan,55,Wisconsin,33,Dunn County,0,21,-21
26,Michigan,55,Wisconsin,35,Eau Claire County,119,54,65
26,Michigan,55,Wisconsin,37,Florence County,10,160,-150
26,Michigan,55,Wisconsin,39,Fond du Lac County,38,56,-18
26,Michigan,55,Wisconsin,41,Forest County,0,7,-7
26,Michigan,55,Wisconsin,43,Grant County,4,13,-9
26,Michigan,55,Wisconsin,45,Green County,0,18,-18
26,Michigan,55,Wisconsin,51,Iron County,30,123,-93
26,Michigan,55,Wisconsin,53,Jackson County,37,26,11
26,Michigan,55,Wisconsin,55,Jefferson County,75,103,-28
26,Michigan,55,Wisconsin,57,Juneau County,0,3,-3
26,Michigan,55,Wisconsin,59,Kenosha County,171,107,64
26,Michigan,55,Wisconsin,61,Kewaunee County,0,20,-20
26,Michigan,55,Wisconsin,63,La Crosse County,43,56,-13
26,Michigan,55,Wisconsin,69,Lincoln County,35,8,27
26,Michigan,55,Wisconsin,71,Manitowoc County,171,34,137
26,Michigan,55,Wisconsin,73,Marathon County,123,113,10
26,Michigan,55,Wisconsin,75,Marinette County,568,718,-150
26,Michigan,55,Wisconsin,77,Marquette County,28,5,23
26,Michigan,55,Wisconsin,78,Menominee County,0,7,-7
26,Michigan,55,Wisconsin,79,Milwaukee County,556,686,-130
26,Michigan,55,Wisconsin,81,Monroe County,36,3,33
26,Michigan,55,Wisconsin,83,Oconto County,9,19,-10
26,Michigan,55,Wisconsin,85,Oneida County,101,9,92
26,Michigan,55,Wisconsin,87,Outagamie County,333,66,267
26,Michigan,55,Wisconsin,89,Ozaukee County,29,236,-207
26,Michigan,55,Wisconsin,97,Portage County,53,9,44
26,Michigan,55,Wisconsin,99,Price County,20,21,-1
26,Michigan,55,Wisconsin,101,Racine County,200,130,70
26,Michigan,55,Wisconsin,103,Richland County,0,4,-4
26,Michigan,55,Wisconsin,105,Rock County,17,39,-22
26,Michigan,55,Wisconsin,107,Rusk County,18,0,18
26,Michigan,55,Wisconsin,111,Sauk County,49,24,25
26,Michigan,55,Wisconsin,113,Sawyer County,0,4,-4
26,Michigan,55,Wisconsin,115,Shawano County,4,15,-11
26,Michigan,55,Wisconsin,117,Sheboygan County,4,121,-117
26,Michigan,55,Wisconsin,119,Taylor County,30,0,30
26,Michigan,55,Wisconsin,121,Trempealeau County,0,6,-6
26,Michigan,55,Wisconsin,123,Vernon County,11,3,8
26,Michigan,55,Wisconsin,125,Vilas County,57,79,-22
26,Michigan,55,Wisconsin,127,Walworth County,75,28,47
26,Michigan,55,Wisconsin,129,Washburn County,11,10,1
26,Michigan,55,Wisconsin,131,Washington County,16,20,-4
26,Michigan,55,Wisconsin,133,Waukesha County,281,479,-198
26,Michigan,55,Wisconsin,135,Waupaca County,78,24,54
26,Michigan,55,Wisconsin,137,Waushara County,0,5,-5
26,Michigan,55,Wisconsin,139,Winnebago County,80,331,-251
26,Michigan,55,Wisconsin,141,Wood County,33,65,-32
26,Michigan,56,Wyoming,1,Albany County,0,20,-20
26,Michigan,56,Wyoming,5,Campbell County,9,139,-130
26,Michigan,56,Wyoming,7,Carbon County,41,31,10
26,Michigan,56,Wyoming,9,Converse County,76,21,55
26,Michigan,56,Wyoming,11,Crook County,5,0,5
26,Michigan,56,Wyoming,13,Fremont County,9,15,-6
26,Michigan,56,Wyoming,15,Goshen County,11,6,5
26,Michigan,56,Wyoming,17,Hot Springs County,0,5,-5
26,Michigan,56,Wyoming,21,Laramie County,174,8,166
26,Michigan,56,Wyoming,23,Lincoln County,62,0,62
26,Michigan,56,Wyoming,25,Natrona County,49,45,4
26,Michigan,56,Wyoming,29,Park County,5,1,4
26,Michigan,56,Wyoming,33,Sheridan County,14,3,11
26,Michigan,56,Wyoming,35,Sublette County,12,0,12
26,Michigan,56,Wyoming,37,Sweetwater County,42,0,42
26,Michigan,56,Wyoming,39,Teton County,0,19,-19
26,Michigan,6,California,1,Alameda County,703,710,-7
26,Michigan,6,California,7,Butte County,89,0,89
26,Michigan,6,California,9,Calaveras County,4,0,4
26,Michigan,6,California,13,Contra Costa County,301,335,-34
26,Michigan,6,California,15,Del Norte County,101,0,101
26,Michigan,6,California,17,El Dorado County,43,20,23
26,Michigan,6,California,19,Fresno County,109,29,80
26,Michigan,6,California,21,Glenn County,4,0,4
26,Michigan,6,California,23,Humboldt County,9,15,-6
26,Michigan,6,California,27,Inyo County,0,30,-30
26,Michigan,6,California,29,Kern County,49,27,22
26,Michigan,6,California,33,Lake County,14,0,14
26,Michigan,6,California,37,Los Angeles County,1769,2202,-433
26,Michigan,6,California,39,Madera County,29,0,29
26,Michigan,6,California,41,Marin County,65,62,3
26,Michigan,6,California,43,Mariposa County,0,52,-52
26,Michigan,6,California,47,Merced County,26,13,13
26,Michigan,6,California,53,Monterey County,22,55,-33
26,Michigan,6,California,55,Napa County,23,9,14
26,Michigan,6,California,57,Nevada County,0,17,-17
26,Michigan,6,California,59,Orange County,951,495,456
26,Michigan,6,California,61,Placer County,12,110,-98
26,Michigan,6,California,63,Plumas County,0,14,-14
26,Michigan,6,California,65,Riverside County,224,494,-270
26,Michigan,6,California,67,Sacramento County,343,246,97
26,Michigan,6,California,71,San Bernardino County,540,312,228
26,Michigan,6,California,73,San Diego County,1937,2038,-101
26,Michigan,6,California,75,San Francisco County,255,776,-521
26,Michigan,6,California,77,San Joaquin County,68,174,-106
26,Michigan,6,California,79,San Luis Obispo County,91,86,5
26,Michigan,6,California,81,San Mateo County,137,289,-152
26,Michigan,6,California,83,Santa Barbara County,25,88,-63
26,Michigan,6,California,85,Santa Clara County,603,1037,-434
26,Michigan,6,California,87,Santa Cruz County,84,74,10
26,Michigan,6,California,89,Shasta County,23,39,-16
26,Michigan,6,California,93,Siskiyou County,0,61,-61
26,Michigan,6,California,95,Solano County,154,121,33
26,Michigan,6,California,97,Sonoma County,31,43,-12
26,Michigan,6,California,99,Stanislaus County,22,37,-15
26,Michigan,6,California,101,Sutter County,16,0,16
26,Michigan,6,California,107,Tulare County,46,33,13
26,Michigan,6,California,111,Ventura County,346,127,219
26,Michigan,6,California,113,Yolo County,59,84,-25
26,Michigan,6,California,115,Yuba County,11,26,-15
26,Michigan,72,Puerto Rico,15,Arroyo Municipio,59,0,59
26,Michigan,72,Puerto Rico,19,Barranquitas Municipio,29,0,29
26,Michigan,72,Puerto Rico,21,Bayamón Municipio,72,14,58
26,Michigan,72,Puerto Rico,25,Caguas Municipio,93,0,93
26,Michigan,72,Puerto Rico,29,Canóvanas Municipio,0,20,-20
26,Michigan,72,Puerto Rico,33,Cataño Municipio,31,0,31
26,Michigan,72,Puerto Rico,53,Fajardo Municipio,41,22,19
26,Michigan,72,Puerto Rico,61,Guaynabo Municipio,124,39,85
26,Michigan,72,Puerto Rico,75,Juana Díaz Municipio,44,0,44
26,Michigan,72,Puerto Rico,81,Lares Municipio,149,0,149
26,Michigan,72,Puerto Rico,97,Mayagüez Municipio,104,0,104
26,Michigan,72,Puerto Rico,105,Naranjito Municipio,9,0,9
26,Michigan,72,Puerto Rico,113,Ponce Municipio,11,0,11
26,Michigan,72,Puerto Rico,119,Río Grande Municipio,17,0,17
26,Michigan,72,Puerto Rico,127,San Juan Municipio,250,20,230
26,Michigan,72,Puerto Rico,131,San Sebastián Municipio,27,0,27
26,Michigan,72,Puerto Rico,135,Toa Alta Municipio,15,0,15
26,Michigan,72,Puerto Rico,139,Trujillo Alto Municipio,119,0,119
26,Michigan,72,Puerto Rico,141,Utuado Municipio,10,0,10
26,Michigan,8,Colorado,1,Adams County,103,257,-154
26,Michigan,8,Colorado,3,Alamosa County,0,66,-66
26,Michigan,8,Colorado,5,Arapahoe County,144,693,-549
26,Michigan,8,Colorado,7,Archuleta County,0,5,-5
26,Michigan,8,Colorado,11,Bent County,0,7,-7
26,Michigan,8,Colorado,13,Boulder County,229,352,-123
26,Michigan,8,Colorado,14,Broomfield County,0,114,-114
26,Michigan,8,Colorado,15,Chaffee County,10,0,10
26,Michigan,8,Colorado,19,Clear Creek County,0,2,-2
26,Michigan,8,Colorado,31,Denver County,427,432,-5
26,Michigan,8,Colorado,35,Douglas County,77,107,-30
26,Michigan,8,Colorado,37,Eagle County,3,3,0
26,Michigan,8,Colorado,39,Elbert County,0,3,-3
26,Michigan,8,Colorado,41,El Paso County,444,606,-162
26,Michigan,8,Colorado,43,Fremont County,24,0,24
26,Michigan,8,Colorado,45,Garfield County,57,0,57
26,Michigan,8,Colorado,47,Gilpin County,0,17,-17
26,Michigan,8,Colorado,49,Grand County,0,26,-26
26,Michigan,8,Colorado,51,Gunnison County,20,0,20
26,Michigan,8,Colorado,59,Jefferson County,154,172,-18
26,Michigan,8,Colorado,67,La Plata County,0,34,-34
26,Michigan,8,Colorado,69,Larimer County,180,97,83
26,Michigan,8,Colorado,71,Las Animas County,0,5,-5
26,Michigan,8,Colorado,73,Lincoln County,0,1,-1
26,Michigan,8,Colorado,75,Logan County,0,50,-50
26,Michigan,8,Colorado,77,Mesa County,69,52,17
26,Michigan,8,Colorado,85,Montrose County,7,21,-14
26,Michigan,8,Colorado,89,Otero County,0,2,-2
26,Michigan,8,Colorado,91,Ouray County,58,0,58
26,Michigan,8,Colorado,93,Park County,28,0,28
26,Michigan,8,Colorado,97,Pitkin County,14,0,14
26,Michigan,8,Colorado,99,Prowers County,0,8,-8
26,Michigan,8,Colorado,101,Pueblo County,31,48,-17
26,Michigan,8,Colorado,103,Rio Blanco County,0,1,-1
26,Michigan,8,Colorado,107,Routt County,14,23,-9
26,Michigan,8,Colorado,109,Saguache County,6,0,6
26,Michigan,8,Colorado,117,Summit County,9,0,9
26,Michigan,8,Colorado,121,Washington County,11,0,11
26,Michigan,8,Colorado,123,Weld County,92,14,78
26,Michigan,9,Connecticut,1,Fairfield County,215,81,134
26,Michigan,9,Connecticut,3,Hartford County,419,142,277
26,Michigan,9,Connecticut,5,Litchfield County,110,7,103
26,Michigan,9,Connecticut,7,Middlesex County,16,0,16
26,Michigan,9,Connecticut,9,New Haven County,232,164,68
26,Michigan,9,Connecticut,11,New London County,18,116,-98
26,Michigan,9,Connecticut,13,Tolland County,3,0,3
26,Michigan,9,Connecticut,15,Windham County,24,0,24
26,Michigan,AFR,Africa,,-,2398,0,0
26,Michigan,ASI,Asia,,-,27978,0,0
26,Michigan,CAM,Central America,,-,3788,0,0
26,Michigan,CAR,Caribbean,,-,1527,0,0
26,Michigan,EUR,Europe,,-,6911,0,0
26,Michigan,ISL,U.S. Island Areas,,-,189,0,0
26,Michigan,NAM,Northern America,,-,2884,0,0
26,Michigan,OCE,Oceania and At Sea,,-,561,0,0
26,Michigan,SAM,South America,,-,1747,0,0
27,Minnesota,1,Alabama,1,Autauga County,0,3,-3
27,Minnesota,1,Alabama,5,Barbour County,0,7,-7
27,Minnesota,1,Alabama,15,Calhoun County,3,0,3
27,Minnesota,1,Alabama,25,Clarke County,7,6,1
27,Minnesota,1,Alabama,29,Cleburne County,0,8,-8
27,Minnesota,1,Alabama,39,Covington County,7,0,7
27,Minnesota,1,Alabama,45,Dale County,0,26,-26
27,Minnesota,1,Alabama,51,Elmore County,122,0,122
27,Minnesota,1,Alabama,55,Etowah County,0,12,-12
27,Minnesota,1,Alabama,69,Houston County,0,1,-1
27,Minnesota,1,Alabama,73,Jefferson County,22,15,7
27,Minnesota,1,Alabama,79,Lawrence County,10,0,10
27,Minnesota,1,Alabama,81,Lee County,11,0,11
27,Minnesota,1,Alabama,83,Limestone County,0,28,-28
27,Minnesota,1,Alabama,89,Madison County,20,25,-5
27,Minnesota,1,Alabama,95,Marshall County,1,4,-3
27,Minnesota,1,Alabama,97,Mobile County,0,4,-4
27,Minnesota,1,Alabama,99,Monroe County,0,50,-50
27,Minnesota,1,Alabama,101,Montgomery County,46,0,46
27,Minnesota,1,Alabama,107,Pickens County,0,21,-21
27,Minnesota,1,Alabama,113,Russell County,2,0,2
27,Minnesota,1,Alabama,115,St. Clair County,0,70,-70
27,Minnesota,1,Alabama,117,Shelby County,15,69,-54
27,Minnesota,1,Alabama,125,Tuscaloosa County,49,0,49
27,Minnesota,10,Delaware,1,Kent County,0,43,-43
27,Minnesota,10,Delaware,3,New Castle County,84,150,-66
27,Minnesota,10,Delaware,5,Sussex County,28,0,28
27,Minnesota,11,District of Columbia,1,District of Columbia,247,332,-85
27,Minnesota,12,Florida,1,Alachua County,36,41,-5
27,Minnesota,12,Florida,5,Bay County,14,129,-115
27,Minnesota,12,Florida,9,Brevard County,140,126,14
27,Minnesota,12,Florida,11,Broward County,209,470,-261
27,Minnesota,12,Florida,13,Calhoun County,10,0,10
27,Minnesota,12,Florida,15,Charlotte County,38,69,-31
27,Minnesota,12,Florida,17,Citrus County,48,280,-232
27,Minnesota,12,Florida,19,Clay County,51,199,-148
27,Minnesota,12,Florida,21,Collier County,96,199,-103
27,Minnesota,12,Florida,31,Duval County,131,138,-7
27,Minnesota,12,Florida,33,Escambia County,26,110,-84
27,Minnesota,12,Florida,35,Flagler County,0,21,-21
27,Minnesota,12,Florida,37,Franklin County,37,0,37
27,Minnesota,12,Florida,43,Glades County,0,20,-20
27,Minnesota,12,Florida,53,Hernando County,58,30,28
27,Minnesota,12,Florida,57,Hillsborough County,165,112,53
27,Minnesota,12,Florida,61,Indian River County,4,72,-68
27,Minnesota,12,Florida,69,Lake County,29,171,-142
27,Minnesota,12,Florida,71,Lee County,151,723,-572
27,Minnesota,12,Florida,73,Leon County,35,0,35
27,Minnesota,12,Florida,75,Levy County,0,10,-10
27,Minnesota,12,Florida,81,Manatee County,22,487,-465
27,Minnesota,12,Florida,83,Marion County,61,112,-51
27,Minnesota,12,Florida,85,Martin County,12,0,12
27,Minnesota,12,Florida,86,Miami-Dade County,310,154,156
27,Minnesota,12,Florida,87,Monroe County,14,6,8
27,Minnesota,12,Florida,89,Nassau County,0,72,-72
27,Minnesota,12,Florida,91,Okaloosa County,17,159,-142
27,Minnesota,12,Florida,93,Okeechobee County,5,0,5
27,Minnesota,12,Florida,95,Orange County,384,401,-17
27,Minnesota,12,Florida,97,Osceola County,8,68,-60
27,Minnesota,12,Florida,99,Palm Beach County,273,175,98
27,Minnesota,12,Florida,101,Pasco County,81,147,-66
27,Minnesota,12,Florida,103,Pinellas County,277,418,-141
27,Minnesota,12,Florida,105,Polk County,102,181,-79
27,Minnesota,12,Florida,107,Putnam County,3,20,-17
27,Minnesota,12,Florida,109,St. Johns County,5,108,-103
27,Minnesota,12,Florida,111,St. Lucie County,0,134,-134
27,Minnesota,12,Florida,113,Santa Rosa County,9,57,-48
27,Minnesota,12,Florida,115,Sarasota County,129,156,-27
27,Minnesota,12,Florida,117,Seminole County,88,90,-2
27,Minnesota,12,Florida,119,Sumter County,39,104,-65
27,Minnesota,12,Florida,121,Suwannee County,5,0,5
27,Minnesota,12,Florida,125,Union County,0,5,-5
27,Minnesota,12,Florida,127,Volusia County,144,134,10
27,Minnesota,12,Florida,129,Wakulla County,9,4,5
27,Minnesota,12,Florida,131,Walton County,51,0,51
27,Minnesota,13,Georgia,13,Barrow County,49,14,35
27,Minnesota,13,Georgia,15,Bartow County,0,41,-41
27,Minnesota,13,Georgia,17,Ben Hill County,0,7,-7
27,Minnesota,13,Georgia,21,Bibb County,28,36,-8
27,Minnesota,13,Georgia,31,Bulloch County,0,22,-22
27,Minnesota,13,Georgia,45,Carroll County,25,29,-4
27,Minnesota,13,Georgia,51,Chatham County,25,262,-237
27,Minnesota,13,Georgia,53,Chattahoochee County,0,26,-26
27,Minnesota,13,Georgia,59,Clarke County,4,18,-14
27,Minnesota,13,Georgia,63,Clayton County,0,84,-84
27,Minnesota,13,Georgia,67,Cobb County,80,227,-147
27,Minnesota,13,Georgia,71,Colquitt County,0,10,-10
27,Minnesota,13,Georgia,77,Coweta County,18,0,18
27,Minnesota,13,Georgia,85,Dawson County,0,31,-31
27,Minnesota,13,Georgia,89,DeKalb County,367,137,230
27,Minnesota,13,Georgia,95,Dougherty County,39,0,39
27,Minnesota,13,Georgia,97,Douglas County,0,48,-48
27,Minnesota,13,Georgia,99,Early County,69,0,69
27,Minnesota,13,Georgia,101,Echols County,2,0,2
27,Minnesota,13,Georgia,113,Fayette County,16,16,0
27,Minnesota,13,Georgia,115,Floyd County,129,0,129
27,Minnesota,13,Georgia,117,Forsyth County,77,0,77
27,Minnesota,13,Georgia,121,Fulton County,675,282,393
27,Minnesota,13,Georgia,127,Glynn County,5,15,-10
27,Minnesota,13,Georgia,133,Greene County,0,22,-22
27,Minnesota,13,Georgia,135,Gwinnett County,219,295,-76
27,Minnesota,13,Georgia,137,Habersham County,0,46,-46
27,Minnesota,13,Georgia,139,Hall County,20,0,20
27,Minnesota,13,Georgia,151,Henry County,30,0,30
27,Minnesota,13,Georgia,153,Houston County,3,46,-43
27,Minnesota,13,Georgia,157,Jackson County,50,0,50
27,Minnesota,13,Georgia,177,Lee County,2,0,2
27,Minnesota,13,Georgia,179,Liberty County,25,35,-10
27,Minnesota,13,Georgia,183,Long County,11,0,11
27,Minnesota,13,Georgia,185,Lowndes County,17,0,17
27,Minnesota,13,Georgia,197,Marion County,7,0,7
27,Minnesota,13,Georgia,199,Meriwether County,3,0,3
27,Minnesota,13,Georgia,215,Muscogee County,15,158,-143
27,Minnesota,13,Georgia,223,Paulding County,149,39,110
27,Minnesota,13,Georgia,233,Polk County,8,0,8
27,Minnesota,13,Georgia,245,Richmond County,43,59,-16
27,Minnesota,13,Georgia,247,Rockdale County,7,17,-10
27,Minnesota,13,Georgia,255,Spalding County,2,0,2
27,Minnesota,13,Georgia,257,Stephens County,29,0,29
27,Minnesota,13,Georgia,281,Towns County,0,9,-9
27,Minnesota,13,Georgia,305,Wayne County,0,8,-8
27,Minnesota,13,Georgia,313,Whitfield County,50,0,50
27,Minnesota,13,Georgia,315,Wilcox County,8,0,8
27,Minnesota,13,Georgia,321,Worth County,12,0,12
27,Minnesota,15,Hawaii,1,Hawaii County,95,46,49
27,Minnesota,15,Hawaii,3,Honolulu County,313,139,174
27,Minnesota,15,Hawaii,7,Kauai County,0,48,-48
27,Minnesota,15,Hawaii,9,Maui County,41,176,-135
27,Minnesota,16,Idaho,1,Ada County,122,141,-19
27,Minnesota,16,Idaho,5,Bannock County,34,11,23
27,Minnesota,16,Idaho,13,Blaine County,4,0,4
27,Minnesota,16,Idaho,17,Bonner County,24,47,-23
27,Minnesota,16,Idaho,19,Bonneville County,82,68,14
27,Minnesota,16,Idaho,27,Canyon County,0,17,-17
27,Minnesota,16,Idaho,39,Elmore County,2,0,2
27,Minnesota,16,Idaho,49,Idaho County,7,40,-33
27,Minnesota,16,Idaho,53,Jerome County,0,2,-2
27,Minnesota,16,Idaho,55,Kootenai County,18,88,-70
27,Minnesota,16,Idaho,57,Latah County,21,24,-3
27,Minnesota,16,Idaho,63,Lincoln County,0,3,-3
27,Minnesota,16,Idaho,65,Madison County,42,0,42
27,Minnesota,16,Idaho,69,Nez Perce County,0,3,-3
27,Minnesota,16,Idaho,79,Shoshone County,16,0,16
27,Minnesota,16,Idaho,81,Teton County,0,47,-47
27,Minnesota,16,Idaho,83,Twin Falls County,12,34,-22
27,Minnesota,16,Idaho,85,Valley County,3,0,3
27,Minnesota,17,Illinois,1,Adams County,14,0,14
27,Minnesota,17,Illinois,5,Bond County,26,16,10
27,Minnesota,17,Illinois,7,Boone County,38,0,38
27,Minnesota,17,Illinois,9,Brown County,5,0,5
27,Minnesota,17,Illinois,11,Bureau County,0,15,-15
27,Minnesota,17,Illinois,15,Carroll County,3,0,3
27,Minnesota,17,Illinois,17,Cass County,16,0,16
27,Minnesota,17,Illinois,19,Champaign County,87,126,-39
27,Minnesota,17,Illinois,27,Clinton County,10,0,10
27,Minnesota,17,Illinois,29,Coles County,31,10,21
27,Minnesota,17,Illinois,31,Cook County,3999,2301,1698
27,Minnesota,17,Illinois,33,Crawford County,0,16,-16
27,Minnesota,17,Illinois,37,DeKalb County,64,11,53
27,Minnesota,17,Illinois,41,Douglas County,1,0,1
27,Minnesota,17,Illinois,43,DuPage County,825,636,189
27,Minnesota,17,Illinois,49,Effingham County,2,0,2
27,Minnesota,17,Illinois,51,Fayette County,29,0,29
27,Minnesota,17,Illinois,55,Franklin County,35,0,35
27,Minnesota,17,Illinois,57,Fulton County,0,25,-25
27,Minnesota,17,Illinois,63,Grundy County,86,0,86
27,Minnesota,17,Illinois,73,Henry County,10,6,4
27,Minnesota,17,Illinois,75,Iroquois County,1,0,1
27,Minnesota,17,Illinois,77,Jackson County,37,66,-29
27,Minnesota,17,Illinois,81,Jefferson County,0,24,-24
27,Minnesota,17,Illinois,83,Jersey County,0,3,-3
27,Minnesota,17,Illinois,85,Jo Daviess County,11,0,11
27,Minnesota,17,Illinois,89,Kane County,357,18,339
27,Minnesota,17,Illinois,91,Kankakee County,98,17,81
27,Minnesota,17,Illinois,93,Kendall County,28,2,26
27,Minnesota,17,Illinois,95,Knox County,53,9,44
27,Minnesota,17,Illinois,97,Lake County,361,305,56
27,Minnesota,17,Illinois,99,LaSalle County,14,0,14
27,Minnesota,17,Illinois,103,Lee County,40,3,37
27,Minnesota,17,Illinois,105,Livingston County,7,0,7
27,Minnesota,17,Illinois,107,Logan County,7,0,7
27,Minnesota,17,Illinois,109,McDonough County,54,0,54
27,Minnesota,17,Illinois,111,McHenry County,238,81,157
27,Minnesota,17,Illinois,113,McLean County,76,10,66
27,Minnesota,17,Illinois,115,Macon County,6,3,3
27,Minnesota,17,Illinois,117,Macoupin County,11,0,11
27,Minnesota,17,Illinois,119,Madison County,25,39,-14
27,Minnesota,17,Illinois,129,Menard County,3,0,3
27,Minnesota,17,Illinois,133,Monroe County,8,0,8
27,Minnesota,17,Illinois,135,Montgomery County,0,20,-20
27,Minnesota,17,Illinois,137,Morgan County,34,11,23
27,Minnesota,17,Illinois,141,Ogle County,58,16,42
27,Minnesota,17,Illinois,143,Peoria County,203,49,154
27,Minnesota,17,Illinois,161,Rock Island County,55,52,3
27,Minnesota,17,Illinois,163,St. Clair County,128,14,114
27,Minnesota,17,Illinois,167,Sangamon County,129,201,-72
27,Minnesota,17,Illinois,177,Stephenson County,28,8,20
27,Minnesota,17,Illinois,179,Tazewell County,139,92,47
27,Minnesota,17,Illinois,183,Vermilion County,7,18,-11
27,Minnesota,17,Illinois,193,White County,12,0,12
27,Minnesota,17,Illinois,197,Will County,252,125,127
27,Minnesota,17,Illinois,199,Williamson County,10,150,-140
27,Minnesota,17,Illinois,201,Winnebago County,285,76,209
27,Minnesota,17,Illinois,203,Woodford County,0,13,-13
27,Minnesota,18,Indiana,1,Adams County,45,0,45
27,Minnesota,18,Indiana,3,Allen County,181,87,94
27,Minnesota,18,Indiana,5,Bartholomew County,30,9,21
27,Minnesota,18,Indiana,19,Clark County,0,55,-55
27,Minnesota,18,Indiana,27,Daviess County,13,0,13
27,Minnesota,18,Indiana,29,Dearborn County,8,0,8
27,Minnesota,18,Indiana,35,Delaware County,0,36,-36
27,Minnesota,18,Indiana,39,Elkhart County,36,20,16
27,Minnesota,18,Indiana,53,Grant County,47,95,-48
27,Minnesota,18,Indiana,57,Hamilton County,31,40,-9
27,Minnesota,18,Indiana,63,Hendricks County,7,0,7
27,Minnesota,18,Indiana,65,Henry County,0,2,-2
27,Minnesota,18,Indiana,67,Howard County,0,164,-164
27,Minnesota,18,Indiana,81,Johnson County,263,99,164
27,Minnesota,18,Indiana,85,Kosciusko County,8,0,8
27,Minnesota,18,Indiana,89,Lake County,418,90,328
27,Minnesota,18,Indiana,91,LaPorte County,48,13,35
27,Minnesota,18,Indiana,95,Madison County,11,32,-21
27,Minnesota,18,Indiana,97,Marion County,287,233,54
27,Minnesota,18,Indiana,99,Marshall County,0,3,-3
27,Minnesota,18,Indiana,103,Miami County,12,14,-2
27,Minnesota,18,Indiana,105,Monroe County,96,131,-35
27,Minnesota,18,Indiana,119,Owen County,0,19,-19
27,Minnesota,18,Indiana,127,Porter County,12,63,-51
27,Minnesota,18,Indiana,131,Pulaski County,0,4,-4
27,Minnesota,18,Indiana,133,Putnam County,11,16,-5
27,Minnesota,18,Indiana,139,Rush County,2,0,2
27,Minnesota,18,Indiana,141,St. Joseph County,81,83,-2
27,Minnesota,18,Indiana,145,Shelby County,17,0,17
27,Minnesota,18,Indiana,147,Spencer County,0,7,-7
27,Minnesota,18,Indiana,157,Tippecanoe County,169,89,80
27,Minnesota,18,Indiana,163,Vanderburgh County,34,10,24
27,Minnesota,18,Indiana,167,Vigo County,0,7,-7
27,Minnesota,18,Indiana,173,Warrick County,3,0,3
27,Minnesota,18,Indiana,175,Washington County,0,8,-8
27,Minnesota,18,Indiana,177,Wayne County,61,53,8
27,Minnesota,18,Indiana,181,White County,10,4,6
27,Minnesota,19,Iowa,5,Allamakee County,76,105,-29
27,Minnesota,19,Iowa,7,Appanoose County,22,0,22
27,Minnesota,19,Iowa,9,Audubon County,0,6,-6
27,Minnesota,19,Iowa,11,Benton County,20,12,8
27,Minnesota,19,Iowa,13,Black Hawk County,254,382,-128
27,Minnesota,19,Iowa,15,Boone County,10,9,1
27,Minnesota,19,Iowa,17,Bremer County,43,15,28
27,Minnesota,19,Iowa,19,Buchanan County,0,29,-29
27,Minnesota,19,Iowa,21,Buena Vista County,95,22,73
27,Minnesota,19,Iowa,23,Butler County,47,0,47
27,Minnesota,19,Iowa,25,Calhoun County,1,13,-12
27,Minnesota,19,Iowa,27,Carroll County,62,76,-14
27,Minnesota,19,Iowa,29,Cass County,14,0,14
27,Minnesota,19,Iowa,31,Cedar County,8,40,-32
27,Minnesota,19,Iowa,33,Cerro Gordo County,183,144,39
27,Minnesota,19,Iowa,35,Cherokee County,3,1,2
27,Minnesota,19,Iowa,37,Chickasaw County,124,10,114
27,Minnesota,19,Iowa,39,Clarke County,2,0,2
27,Minnesota,19,Iowa,41,Clay County,14,51,-37
27,Minnesota,19,Iowa,43,Clayton County,40,64,-24
27,Minnesota,19,Iowa,45,Clinton County,44,111,-67
27,Minnesota,19,Iowa,47,Crawford County,17,32,-15
27,Minnesota,19,Iowa,49,Dallas County,297,260,37
27,Minnesota,19,Iowa,53,Decatur County,23,0,23
27,Minnesota,19,Iowa,55,Delaware County,22,71,-49
27,Minnesota,19,Iowa,57,Des Moines County,55,47,8
27,Minnesota,19,Iowa,59,Dickinson County,135,191,-56
27,Minnesota,19,Iowa,61,Dubuque County,146,202,-56
27,Minnesota,19,Iowa,63,Emmet County,82,204,-122
27,Minnesota,19,Iowa,65,Fayette County,23,22,1
27,Minnesota,19,Iowa,67,Floyd County,0,2,-2
27,Minnesota,19,Iowa,69,Franklin County,12,6,6
27,Minnesota,19,Iowa,71,Fremont County,0,31,-31
27,Minnesota,19,Iowa,73,Greene County,8,27,-19
27,Minnesota,19,Iowa,75,Grundy County,23,4,19
27,Minnesota,19,Iowa,77,Guthrie County,0,35,-35
27,Minnesota,19,Iowa,79,Hamilton County,0,7,-7
27,Minnesota,19,Iowa,81,Hancock County,30,0,30
27,Minnesota,19,Iowa,83,Hardin County,0,31,-31
27,Minnesota,19,Iowa,85,Harrison County,82,0,82
27,Minnesota,19,Iowa,87,Henry County,0,6,-6
27,Minnesota,19,Iowa,89,Howard County,85,199,-114
27,Minnesota,19,Iowa,91,Humboldt County,12,48,-36
27,Minnesota,19,Iowa,93,Ida County,1,14,-13
27,Minnesota,19,Iowa,95,Iowa County,8,0,8
27,Minnesota,19,Iowa,97,Jackson County,0,4,-4
27,Minnesota,19,Iowa,99,Jasper County,16,58,-42
27,Minnesota,19,Iowa,101,Jefferson County,1,4,-3
27,Minnesota,19,Iowa,103,Johnson County,373,567,-194
27,Minnesota,19,Iowa,105,Jones County,0,2,-2
27,Minnesota,19,Iowa,109,Kossuth County,90,98,-8
27,Minnesota,19,Iowa,111,Lee County,146,0,146
27,Minnesota,19,Iowa,113,Linn County,320,287,33
27,Minnesota,19,Iowa,115,Louisa County,6,1,5
27,Minnesota,19,Iowa,117,Lucas County,17,0,17
27,Minnesota,19,Iowa,119,Lyon County,28,21,7
27,Minnesota,19,Iowa,121,Madison County,3,76,-73
27,Minnesota,19,Iowa,123,Mahaska County,39,108,-69
27,Minnesota,19,Iowa,125,Marion County,61,0,61
27,Minnesota,19,Iowa,127,Marshall County,50,78,-28
27,Minnesota,19,Iowa,129,Mills County,3,0,3
27,Minnesota,19,Iowa,131,Mitchell County,86,17,69
27,Minnesota,19,Iowa,133,Monona County,41,13,28
27,Minnesota,19,Iowa,135,Monroe County,0,57,-57
27,Minnesota,19,Iowa,137,Montgomery County,16,56,-40
27,Minnesota,19,Iowa,141,O'Brien County,114,32,82
27,Minnesota,19,Iowa,143,Osceola County,39,65,-26
27,Minnesota,19,Iowa,145,Page County,0,81,-81
27,Minnesota,19,Iowa,147,Palo Alto County,12,19,-7
27,Minnesota,19,Iowa,149,Plymouth County,58,183,-125
27,Minnesota,19,Iowa,151,Pocahontas County,14,0,14
27,Minnesota,19,Iowa,153,Polk County,605,805,-200
27,Minnesota,19,Iowa,155,Pottawattamie County,36,31,5
27,Minnesota,19,Iowa,157,Poweshiek County,18,18,0
27,Minnesota,19,Iowa,159,Ringgold County,3,6,-3
27,Minnesota,19,Iowa,161,Sac County,4,15,-11
27,Minnesota,19,Iowa,163,Scott County,223,68,155
27,Minnesota,19,Iowa,165,Shelby County,39,1,38
27,Minnesota,19,Iowa,167,Sioux County,42,560,-518
27,Minnesota,19,Iowa,169,Story County,718,1432,-714
27,Minnesota,19,Iowa,171,Tama County,15,5,10
27,Minnesota,19,Iowa,173,Taylor County,5,0,5
27,Minnesota,19,Iowa,175,Union County,10,18,-8
27,Minnesota,19,Iowa,179,Wapello County,20,50,-30
27,Minnesota,19,Iowa,181,Warren County,54,105,-51
27,Minnesota,19,Iowa,183,Washington County,4,31,-27
27,Minnesota,19,Iowa,185,Wayne County,3,0,3
27,Minnesota,19,Iowa,187,Webster County,45,44,1
27,Minnesota,19,Iowa,189,Winnebago County,31,81,-50
27,Minnesota,19,Iowa,191,Winneshiek County,258,499,-241
27,Minnesota,19,Iowa,193,Woodbury County,311,179,132
27,Minnesota,19,Iowa,195,Worth County,31,31,0
27,Minnesota,19,Iowa,197,Wright County,62,55,7
27,Minnesota,2,Alaska,16,Aleutians West Census Area,2,2,0
27,Minnesota,2,Alaska,20,Anchorage Municipality,342,166,176
27,Minnesota,2,Alaska,68,Denali Borough,0,1,-1
27,Minnesota,2,Alaska,70,Dillingham Census Area,6,4,2
27,Minnesota,2,Alaska,90,Fairbanks North Star Borough,174,97,77
27,Minnesota,2,Alaska,105,Hoonah-Angoon Census Area,0,3,-3
27,Minnesota,2,Alaska,110,Juneau City and Borough,5,3,2
27,Minnesota,2,Alaska,122,Kenai Peninsula Borough,73,154,-81
27,Minnesota,2,Alaska,150,Kodiak Island Borough,7,2,5
27,Minnesota,2,Alaska,170,Matanuska-Susitna Borough,81,27,54
27,Minnesota,2,Alaska,180,Nome Census Area,14,0,14
27,Minnesota,2,Alaska,220,Sitka City and Borough,8,4,4
27,Minnesota,2,Alaska,230,Skagway Municipality,14,5,9
27,Minnesota,2,Alaska,261,Valdez-Cordova Census Area,8,20,-12
27,Minnesota,2,Alaska,290,Yukon-Koyukuk Census Area,0,5,-5
27,Minnesota,20,Kansas,3,Anderson County,0,65,-65
27,Minnesota,20,Kansas,5,Atchison County,37,50,-13
27,Minnesota,20,Kansas,9,Barton County,6,0,6
27,Minnesota,20,Kansas,13,Brown County,2,0,2
27,Minnesota,20,Kansas,15,Butler County,0,21,-21
27,Minnesota,20,Kansas,17,Chase County,4,0,4
27,Minnesota,20,Kansas,35,Cowley County,0,1,-1
27,Minnesota,20,Kansas,37,Crawford County,0,8,-8
27,Minnesota,20,Kansas,41,Dickinson County,6,3,3
27,Minnesota,20,Kansas,45,Douglas County,76,160,-84
27,Minnesota,20,Kansas,47,Edwards County,0,16,-16
27,Minnesota,20,Kansas,55,Finney County,14,24,-10
27,Minnesota,20,Kansas,57,Ford County,11,9,2
27,Minnesota,20,Kansas,59,Franklin County,0,36,-36
27,Minnesota,20,Kansas,61,Geary County,42,4,38
27,Minnesota,20,Kansas,63,Gove County,0,5,-5
27,Minnesota,20,Kansas,77,Harper County,0,14,-14
27,Minnesota,20,Kansas,79,Harvey County,0,17,-17
27,Minnesota,20,Kansas,87,Jefferson County,0,2,-2
27,Minnesota,20,Kansas,91,Johnson County,536,274,262
27,Minnesota,20,Kansas,103,Leavenworth County,10,37,-27
27,Minnesota,20,Kansas,105,Lincoln County,0,2,-2
27,Minnesota,20,Kansas,107,Linn County,4,0,4
27,Minnesota,20,Kansas,111,Lyon County,0,58,-58
27,Minnesota,20,Kansas,113,McPherson County,0,8,-8
27,Minnesota,20,Kansas,115,Marion County,0,3,-3
27,Minnesota,20,Kansas,121,Miami County,0,23,-23
27,Minnesota,20,Kansas,125,Montgomery County,0,2,-2
27,Minnesota,20,Kansas,135,Ness County,0,3,-3
27,Minnesota,20,Kansas,137,Norton County,0,11,-11
27,Minnesota,20,Kansas,139,Osage County,8,4,4
27,Minnesota,20,Kansas,149,Pottawatomie County,16,0,16
27,Minnesota,20,Kansas,151,Pratt County,0,1,-1
27,Minnesota,20,Kansas,155,Reno County,11,17,-6
27,Minnesota,20,Kansas,161,Riley County,49,125,-76
27,Minnesota,20,Kansas,173,Sedgwick County,47,56,-9
27,Minnesota,20,Kansas,177,Shawnee County,32,123,-91
27,Minnesota,20,Kansas,185,Stafford County,0,4,-4
27,Minnesota,20,Kansas,191,Sumner County,0,4,-4
27,Minnesota,20,Kansas,197,Wabaunsee County,2,0,2
27,Minnesota,20,Kansas,201,Washington County,0,6,-6
27,Minnesota,20,Kansas,209,Wyandotte County,189,0,189
27,Minnesota,21,Kentucky,7,Ballard County,3,0,3
27,Minnesota,21,Kentucky,17,Bourbon County,0,3,-3
27,Minnesota,21,Kentucky,37,Campbell County,31,99,-68
27,Minnesota,21,Kentucky,47,Christian County,5,27,-22
27,Minnesota,21,Kentucky,51,Clay County,0,8,-8
27,Minnesota,21,Kentucky,59,Daviess County,0,9,-9
27,Minnesota,21,Kentucky,67,Fayette County,119,36,83
27,Minnesota,21,Kentucky,73,Franklin County,0,15,-15
27,Minnesota,21,Kentucky,83,Graves County,10,0,10
27,Minnesota,21,Kentucky,93,Hardin County,0,15,-15
27,Minnesota,21,Kentucky,111,Jefferson County,44,104,-60
27,Minnesota,21,Kentucky,113,Jessamine County,27,7,20
27,Minnesota,21,Kentucky,117,Kenton County,23,95,-72
27,Minnesota,21,Kentucky,129,Lee County,7,0,7
27,Minnesota,21,Kentucky,141,Logan County,2,0,2
27,Minnesota,21,Kentucky,145,McCracken County,27,0,27
27,Minnesota,21,Kentucky,147,McCreary County,0,7,-7
27,Minnesota,21,Kentucky,151,Madison County,0,47,-47
27,Minnesota,21,Kentucky,161,Mason County,8,0,8
27,Minnesota,21,Kentucky,169,Metcalfe County,18,0,18
27,Minnesota,21,Kentucky,183,Ohio County,0,19,-19
27,Minnesota,21,Kentucky,185,Oldham County,6,0,6
27,Minnesota,21,Kentucky,191,Pendleton County,0,34,-34
27,Minnesota,21,Kentucky,205,Rowan County,0,176,-176
27,Minnesota,21,Kentucky,209,Scott County,6,0,6
27,Minnesota,21,Kentucky,211,Shelby County,0,18,-18
27,Minnesota,21,Kentucky,227,Warren County,1,41,-40
27,Minnesota,22,Louisiana,3,Allen Parish,24,1,23
27,Minnesota,22,Louisiana,5,Ascension Parish,21,0,21
27,Minnesota,22,Louisiana,11,Beauregard Parish,0,2,-2
27,Minnesota,22,Louisiana,15,Bossier Parish,0,35,-35
27,Minnesota,22,Louisiana,17,Caddo Parish,11,8,3
27,Minnesota,22,Louisiana,19,Calcasieu Parish,34,30,4
27,Minnesota,22,Louisiana,25,Catahoula Parish,0,7,-7
27,Minnesota,22,Louisiana,33,East Baton Rouge Parish,5,65,-60
27,Minnesota,22,Louisiana,37,East Feliciana Parish,0,4,-4
27,Minnesota,22,Louisiana,51,Jefferson Parish,14,29,-15
27,Minnesota,22,Louisiana,57,Lafourche Parish,51,0,51
27,Minnesota,22,Louisiana,69,Natchitoches Parish,20,0,20
27,Minnesota,22,Louisiana,71,Orleans Parish,148,26,122
27,Minnesota,22,Louisiana,73,Ouachita Parish,10,70,-60
27,Minnesota,22,Louisiana,79,Rapides Parish,0,31,-31
27,Minnesota,22,Louisiana,89,St. Charles Parish,0,35,-35
27,Minnesota,22,Louisiana,93,St. James Parish,13,0,13
27,Minnesota,22,Louisiana,97,St. Landry Parish,0,38,-38
27,Minnesota,22,Louisiana,101,St. Mary Parish,23,0,23
27,Minnesota,22,Louisiana,103,St. Tammany Parish,41,0,41
27,Minnesota,22,Louisiana,115,Vernon Parish,10,52,-42
27,Minnesota,22,Louisiana,121,West Baton Rouge Parish,0,85,-85
27,Minnesota,22,Louisiana,123,West Carroll Parish,0,83,-83
27,Minnesota,22,Louisiana,125,West Feliciana Parish,4,0,4
27,Minnesota,22,Louisiana,127,Winn Parish,0,6,-6
27,Minnesota,23,Maine,1,Androscoggin County,5,19,-14
27,Minnesota,23,Maine,5,Cumberland County,10,76,-66
27,Minnesota,23,Maine,9,Hancock County,38,0,38
27,Minnesota,23,Maine,11,Kennebec County,21,21,0
27,Minnesota,23,Maine,13,Knox County,5,1,4
27,Minnesota,23,Maine,19,Penobscot County,42,50,-8
27,Minnesota,23,Maine,27,Waldo County,0,5,-5
27,Minnesota,23,Maine,31,York County,10,4,6
27,Minnesota,24,Maryland,1,Allegany County,15,0,15
27,Minnesota,24,Maryland,3,Anne Arundel County,102,98,4
27,Minnesota,24,Maryland,5,Baltimore County,61,44,17
27,Minnesota,24,Maryland,9,Calvert County,19,0,19
27,Minnesota,24,Maryland,15,Cecil County,9,0,9
27,Minnesota,24,Maryland,21,Frederick County,41,27,14
27,Minnesota,24,Maryland,25,Harford County,26,0,26
27,Minnesota,24,Maryland,27,Howard County,14,117,-103
27,Minnesota,24,Maryland,31,Montgomery County,443,253,190
27,Minnesota,24,Maryland,33,Prince George's County,85,75,10
27,Minnesota,24,Maryland,37,St. Mary's County,0,37,-37
27,Minnesota,24,Maryland,510,Baltimore city,59,60,-1
27,Minnesota,25,Massachusetts,1,Barnstable County,5,14,-9
27,Minnesota,25,Massachusetts,3,Berkshire County,36,18,18
27,Minnesota,25,Massachusetts,5,Bristol County,37,8,29
27,Minnesota,25,Massachusetts,9,Essex County,74,148,-74
27,Minnesota,25,Massachusetts,11,Franklin County,27,5,22
27,Minnesota,25,Massachusetts,13,Hampden County,140,77,63
27,Minnesota,25,Massachusetts,15,Hampshire County,4,64,-60
27,Minnesota,25,Massachusetts,17,Middlesex County,269,353,-84
27,Minnesota,25,Massachusetts,21,Norfolk County,98,79,19
27,Minnesota,25,Massachusetts,23,Plymouth County,0,26,-26
27,Minnesota,25,Massachusetts,25,Suffolk County,304,163,141
27,Minnesota,25,Massachusetts,27,Worcester County,102,161,-59
27,Minnesota,26,Michigan,1,Alcona County,5,0,5
27,Minnesota,26,Michigan,5,Allegan County,17,15,2
27,Minnesota,26,Michigan,7,Alpena County,25,0,25
27,Minnesota,26,Michigan,13,Baraga County,0,4,-4
27,Minnesota,26,Michigan,15,Barry County,21,31,-10
27,Minnesota,26,Michigan,17,Bay County,14,0,14
27,Minnesota,26,Michigan,19,Benzie County,3,0,3
27,Minnesota,26,Michigan,21,Berrien County,1,6,-5
27,Minnesota,26,Michigan,25,Calhoun County,37,4,33
27,Minnesota,26,Michigan,27,Cass County,18,0,18
27,Minnesota,26,Michigan,29,Charlevoix County,11,43,-32
27,Minnesota,26,Michigan,31,Cheboygan County,0,11,-11
27,Minnesota,26,Michigan,33,Chippewa County,0,5,-5
27,Minnesota,26,Michigan,35,Clare County,0,3,-3
27,Minnesota,26,Michigan,41,Delta County,104,0,104
27,Minnesota,26,Michigan,43,Dickinson County,7,0,7
27,Minnesota,26,Michigan,45,Eaton County,15,30,-15
27,Minnesota,26,Michigan,47,Emmet County,0,51,-51
27,Minnesota,26,Michigan,49,Genesee County,60,17,43
27,Minnesota,26,Michigan,53,Gogebic County,21,51,-30
27,Minnesota,26,Michigan,55,Grand Traverse County,33,31,2
27,Minnesota,26,Michigan,57,Gratiot County,33,11,22
27,Minnesota,26,Michigan,59,Hillsdale County,73,28,45
27,Minnesota,26,Michigan,61,Houghton County,55,150,-95
27,Minnesota,26,Michigan,63,Huron County,0,9,-9
27,Minnesota,26,Michigan,65,Ingham County,359,212,147
27,Minnesota,26,Michigan,67,Ionia County,4,7,-3
27,Minnesota,26,Michigan,69,Iosco County,7,0,7
27,Minnesota,26,Michigan,71,Iron County,24,0,24
27,Minnesota,26,Michigan,73,Isabella County,80,45,35
27,Minnesota,26,Michigan,75,Jackson County,0,10,-10
27,Minnesota,26,Michigan,77,Kalamazoo County,166,114,52
27,Minnesota,26,Michigan,81,Kent County,223,333,-110
27,Minnesota,26,Michigan,87,Lapeer County,0,4,-4
27,Minnesota,26,Michigan,89,Leelanau County,12,0,12
27,Minnesota,26,Michigan,91,Lenawee County,0,7,-7
27,Minnesota,26,Michigan,93,Livingston County,24,0,24
27,Minnesota,26,Michigan,95,Luce County,8,0,8
27,Minnesota,26,Michigan,97,Mackinac County,5,0,5
27,Minnesota,26,Michigan,99,Macomb County,48,42,6
27,Minnesota,26,Michigan,101,Manistee County,1,0,1
27,Minnesota,26,Michigan,103,Marquette County,143,184,-41
27,Minnesota,26,Michigan,105,Mason County,8,0,8
27,Minnesota,26,Michigan,107,Mecosta County,14,0,14
27,Minnesota,26,Michigan,109,Menominee County,12,0,12
27,Minnesota,26,Michigan,111,Midland County,56,42,14
27,Minnesota,26,Michigan,121,Muskegon County,15,18,-3
27,Minnesota,26,Michigan,123,Newaygo County,0,12,-12
27,Minnesota,26,Michigan,125,Oakland County,234,131,103
27,Minnesota,26,Michigan,129,Ogemaw County,0,8,-8
27,Minnesota,26,Michigan,131,Ontonagon County,0,8,-8
27,Minnesota,26,Michigan,133,Osceola County,0,3,-3
27,Minnesota,26,Michigan,139,Ottawa County,70,69,1
27,Minnesota,26,Michigan,145,Saginaw County,21,20,1
27,Minnesota,26,Michigan,153,Schoolcraft County,6,0,6
27,Minnesota,26,Michigan,155,Shiawassee County,35,0,35
27,Minnesota,26,Michigan,157,Tuscola County,6,12,-6
27,Minnesota,26,Michigan,159,Van Buren County,33,0,33
27,Minnesota,26,Michigan,161,Washtenaw County,227,213,14
27,Minnesota,26,Michigan,163,Wayne County,179,119,60
27,Minnesota,27,Minnesota,1,Aitkin County,837,664,173
27,Minnesota,27,Minnesota,3,Anoka County,16549,16122,427
27,Minnesota,27,Minnesota,5,Becker County,1093,1021,72
27,Minnesota,27,Minnesota,7,Beltrami County,1762,2488,-726
27,Minnesota,27,Minnesota,9,Benton County,2861,3128,-267
27,Minnesota,27,Minnesota,11,Big Stone County,203,155,48
27,Minnesota,27,Minnesota,13,Blue Earth County,4208,5188,-980
27,Minnesota,27,Minnesota,15,Brown County,1183,487,696
27,Minnesota,27,Minnesota,17,Carlton County,1501,1731,-230
27,Minnesota,27,Minnesota,19,Carver County,4782,5826,-1044
27,Minnesota,27,Minnesota,21,Cass County,1253,1288,-35
27,Minnesota,27,Minnesota,23,Chippewa County,476,622,-146
27,Minnesota,27,Minnesota,25,Chisago County,2865,3853,-988
27,Minnesota,27,Minnesota,27,Clay County,1766,2536,-770
27,Minnesota,27,Minnesota,29,Clearwater County,487,303,184
27,Minnesota,27,Minnesota,31,Cook County,265,141,124
27,Minnesota,27,Minnesota,33,Cottonwood County,471,706,-235
27,Minnesota,27,Minnesota,35,Crow Wing County,2806,2505,301
27,Minnesota,27,Minnesota,37,Dakota County,19477,18248,1229
27,Minnesota,27,Minnesota,39,Dodge County,993,1272,-279
27,Minnesota,27,Minnesota,41,Douglas County,1380,1818,-438
27,Minnesota,27,Minnesota,43,Faribault County,515,543,-28
27,Minnesota,27,Minnesota,45,Fillmore County,984,493,491
27,Minnesota,27,Minnesota,47,Freeborn County,848,842,6
27,Minnesota,27,Minnesota,49,Goodhue County,2010,2016,-6
27,Minnesota,27,Minnesota,51,Grant County,439,284,155
27,Minnesota,27,Minnesota,53,Hennepin County,44304,41275,3029
27,Minnesota,27,Minnesota,55,Houston County,384,322,62
27,Minnesota,27,Minnesota,57,Hubbard County,885,1112,-227
27,Minnesota,27,Minnesota,59,Isanti County,1813,2483,-670
27,Minnesota,27,Minnesota,61,Itasca County,1150,1924,-774
27,Minnesota,27,Minnesota,63,Jackson County,279,316,-37
27,Minnesota,27,Minnesota,65,Kanabec County,731,939,-208
27,Minnesota,27,Minnesota,67,Kandiyohi County,1464,1264,200
27,Minnesota,27,Minnesota,69,Kittson County,159,124,35
27,Minnesota,27,Minnesota,71,Koochiching County,487,212,275
27,Minnesota,27,Minnesota,73,Lac qui Parle County,187,175,12
27,Minnesota,27,Minnesota,75,Lake County,287,251,36
27,Minnesota,27,Minnesota,77,Lake of the Woods County,149,139,10
27,Minnesota,27,Minnesota,79,Le Sueur County,1737,1336,401
27,Minnesota,27,Minnesota,81,Lincoln County,211,194,17
27,Minnesota,27,Minnesota,83,Lyon County,1230,1281,-51
27,Minnesota,27,Minnesota,85,McLeod County,1900,1227,673
27,Minnesota,27,Minnesota,87,Mahnomen County,178,204,-26
27,Minnesota,27,Minnesota,89,Marshall County,265,242,23
27,Minnesota,27,Minnesota,91,Martin County,554,642,-88
27,Minnesota,27,Minnesota,93,Meeker County,938,1181,-243
27,Minnesota,27,Minnesota,95,Mille Lacs County,1762,1729,33
27,Minnesota,27,Minnesota,97,Morrison County,1664,1198,466
27,Minnesota,27,Minnesota,99,Mower County,1540,1384,156
27,Minnesota,27,Minnesota,101,Murray County,178,351,-173
27,Minnesota,27,Minnesota,103,Nicollet County,2093,2895,-802
27,Minnesota,27,Minnesota,105,Nobles County,1086,309,777
27,Minnesota,27,Minnesota,107,Norman County,147,115,32
27,Minnesota,27,Minnesota,109,Olmsted County,5321,4326,995
27,Minnesota,27,Minnesota,111,Otter Tail County,1823,1833,-10
27,Minnesota,27,Minnesota,113,Pennington County,667,511,156
27,Minnesota,27,Minnesota,115,Pine County,1486,1403,83
27,Minnesota,27,Minnesota,117,Pipestone County,244,252,-8
27,Minnesota,27,Minnesota,119,Polk County,886,970,-84
27,Minnesota,27,Minnesota,121,Pope County,679,592,87
27,Minnesota,27,Minnesota,123,Ramsey County,31077,30333,744
27,Minnesota,27,Minnesota,125,Red Lake County,144,123,21
27,Minnesota,27,Minnesota,127,Redwood County,869,421,448
27,Minnesota,27,Minnesota,129,Renville County,445,531,-86
27,Minnesota,27,Minnesota,131,Rice County,4031,3919,112
27,Minnesota,27,Minnesota,133,Rock County,95,230,-135
27,Minnesota,27,Minnesota,135,Roseau County,515,370,145
27,Minnesota,27,Minnesota,137,St. Louis County,6223,7573,-1350
27,Minnesota,27,Minnesota,139,Scott County,8054,7526,528
27,Minnesota,27,Minnesota,141,Sherburne County,6377,5838,539
27,Minnesota,27,Minnesota,143,Sibley County,622,580,42
27,Minnesota,27,Minnesota,145,Stearns County,7982,11439,-3457
27,Minnesota,27,Minnesota,147,Steele County,1732,1467,265
27,Minnesota,27,Minnesota,149,Stevens County,544,724,-180
27,Minnesota,27,Minnesota,151,Swift County,482,414,68
27,Minnesota,27,Minnesota,153,Todd County,1328,1146,182
27,Minnesota,27,Minnesota,155,Traverse County,136,134,2
27,Minnesota,27,Minnesota,157,Wabasha County,1105,860,245
27,Minnesota,27,Minnesota,159,Wadena County,616,666,-50
27,Minnesota,27,Minnesota,161,Waseca County,805,1000,-195
27,Minnesota,27,Minnesota,163,Washington County,13687,13232,455
27,Minnesota,27,Minnesota,165,Watonwan County,447,298,149
27,Minnesota,27,Minnesota,167,Wilkin County,201,119,82
27,Minnesota,27,Minnesota,169,Winona County,1590,2500,-910
27,Minnesota,27,Minnesota,171,Wright County,6335,5947,388
27,Minnesota,27,Minnesota,173,Yellow Medicine County,439,382,57
27,Minnesota,28,Mississippi,5,Amite County,0,3,-3
27,Minnesota,28,Mississippi,27,Coahoma County,70,0,70
27,Minnesota,28,Mississippi,33,DeSoto County,82,16,66
27,Minnesota,28,Mississippi,47,Harrison County,33,8,25
27,Minnesota,28,Mississippi,49,Hinds County,15,30,-15
27,Minnesota,28,Mississippi,59,Jackson County,24,0,24
27,Minnesota,28,Mississippi,67,Jones County,0,8,-8
27,Minnesota,28,Mississippi,75,Lauderdale County,0,16,-16
27,Minnesota,28,Mississippi,81,Lee County,22,0,22
27,Minnesota,28,Mississippi,105,Oktibbeha County,5,15,-10
27,Minnesota,28,Mississippi,113,Pike County,15,0,15
27,Minnesota,28,Mississippi,119,Quitman County,11,0,11
27,Minnesota,28,Mississippi,121,Rankin County,41,0,41
27,Minnesota,28,Mississippi,123,Scott County,5,0,5
27,Minnesota,28,Mississippi,143,Tunica County,0,46,-46
27,Minnesota,28,Mississippi,149,Warren County,1,0,1
27,Minnesota,28,Mississippi,153,Wayne County,9,0,9
27,Minnesota,28,Mississippi,155,Webster County,9,0,9
27,Minnesota,28,Mississippi,161,Yalobusha County,0,9,-9
27,Minnesota,29,Missouri,1,Adair County,88,46,42
27,Minnesota,29,Missouri,3,Andrew County,0,11,-11
27,Minnesota,29,Missouri,7,Audrain County,0,14,-14
27,Minnesota,29,Missouri,11,Barton County,1,0,1
27,Minnesota,29,Missouri,15,Benton County,0,27,-27
27,Minnesota,29,Missouri,19,Boone County,112,228,-116
27,Minnesota,29,Missouri,21,Buchanan County,22,82,-60
27,Minnesota,29,Missouri,23,Butler County,1,0,1
27,Minnesota,29,Missouri,27,Callaway County,11,0,11
27,Minnesota,29,Missouri,29,Camden County,3,15,-12
27,Minnesota,29,Missouri,31,Cape Girardeau County,23,12,11
27,Minnesota,29,Missouri,37,Cass County,0,2,-2
27,Minnesota,29,Missouri,39,Cedar County,0,3,-3
27,Minnesota,29,Missouri,43,Christian County,6,0,6
27,Minnesota,29,Missouri,47,Clay County,58,22,36
27,Minnesota,29,Missouri,49,Clinton County,4,2,2
27,Minnesota,29,Missouri,51,Cole County,0,13,-13
27,Minnesota,29,Missouri,57,Dade County,0,5,-5
27,Minnesota,29,Missouri,59,Dallas County,2,0,2
27,Minnesota,29,Missouri,61,Daviess County,0,23,-23
27,Minnesota,29,Missouri,69,Dunklin County,0,2,-2
27,Minnesota,29,Missouri,71,Franklin County,27,0,27
27,Minnesota,29,Missouri,77,Greene County,94,58,36
27,Minnesota,29,Missouri,79,Grundy County,0,2,-2
27,Minnesota,29,Missouri,89,Howard County,0,10,-10
27,Minnesota,29,Missouri,93,Iron County,0,3,-3
27,Minnesota,29,Missouri,95,Jackson County,434,172,262
27,Minnesota,29,Missouri,97,Jasper County,31,0,31
27,Minnesota,29,Missouri,99,Jefferson County,0,46,-46
27,Minnesota,29,Missouri,101,Johnson County,16,2,14
27,Minnesota,29,Missouri,109,Lawrence County,10,0,10
27,Minnesota,29,Missouri,113,Lincoln County,0,2,-2
27,Minnesota,29,Missouri,117,Livingston County,6,2,4
27,Minnesota,29,Missouri,127,Marion County,7,43,-36
27,Minnesota,29,Missouri,129,Mercer County,0,9,-9
27,Minnesota,29,Missouri,139,Montgomery County,0,6,-6
27,Minnesota,29,Missouri,141,Morgan County,0,1,-1
27,Minnesota,29,Missouri,143,New Madrid County,0,10,-10
27,Minnesota,29,Missouri,145,Newton County,0,5,-5
27,Minnesota,29,Missouri,147,Nodaway County,8,11,-3
27,Minnesota,29,Missouri,149,Oregon County,1,0,1
27,Minnesota,29,Missouri,161,Phelps County,75,119,-44
27,Minnesota,29,Missouri,165,Platte County,0,16,-16
27,Minnesota,29,Missouri,167,Polk County,71,0,71
27,Minnesota,29,Missouri,169,Pulaski County,11,63,-52
27,Minnesota,29,Missouri,171,Putnam County,0,2,-2
27,Minnesota,29,Missouri,175,Randolph County,2,8,-6
27,Minnesota,29,Missouri,183,St. Charles County,164,55,109
27,Minnesota,29,Missouri,189,St. Louis County,245,384,-139
27,Minnesota,29,Missouri,205,Shelby County,0,12,-12
27,Minnesota,29,Missouri,209,Stone County,8,0,8
27,Minnesota,29,Missouri,211,Sullivan County,0,10,-10
27,Minnesota,29,Missouri,213,Taney County,6,130,-124
27,Minnesota,29,Missouri,215,Texas County,0,40,-40
27,Minnesota,29,Missouri,217,Vernon County,0,13,-13
27,Minnesota,29,Missouri,219,Warren County,9,0,9
27,Minnesota,29,Missouri,225,Webster County,0,40,-40
27,Minnesota,29,Missouri,510,St. Louis city,276,196,80
27,Minnesota,30,Montana,1,Beaverhead County,9,6,3
27,Minnesota,30,Montana,5,Blaine County,0,1,-1
27,Minnesota,30,Montana,9,Carbon County,25,0,25
27,Minnesota,30,Montana,13,Cascade County,56,4,52
27,Minnesota,30,Montana,17,Custer County,23,16,7
27,Minnesota,30,Montana,21,Dawson County,27,28,-1
27,Minnesota,30,Montana,23,Deer Lodge County,0,3,-3
27,Minnesota,30,Montana,27,Fergus County,0,15,-15
27,Minnesota,30,Montana,29,Flathead County,14,63,-49
27,Minnesota,30,Montana,31,Gallatin County,92,218,-126
27,Minnesota,30,Montana,41,Hill County,5,0,5
27,Minnesota,30,Montana,43,Jefferson County,13,104,-91
27,Minnesota,30,Montana,47,Lake County,8,0,8
27,Minnesota,30,Montana,49,Lewis and Clark County,76,71,5
27,Minnesota,30,Montana,53,Lincoln County,2,0,2
27,Minnesota,30,Montana,55,McCone County,0,9,-9
27,Minnesota,30,Montana,63,Missoula County,82,96,-14
27,Minnesota,30,Montana,65,Musselshell County,12,0,12
27,Minnesota,30,Montana,67,Park County,0,7,-7
27,Minnesota,30,Montana,73,Pondera County,0,8,-8
27,Minnesota,30,Montana,79,Prairie County,12,0,12
27,Minnesota,30,Montana,81,Ravalli County,33,29,4
27,Minnesota,30,Montana,83,Richland County,11,19,-8
27,Minnesota,30,Montana,85,Roosevelt County,32,13,19
27,Minnesota,30,Montana,89,Sanders County,0,25,-25
27,Minnesota,30,Montana,91,Sheridan County,34,0,34
27,Minnesota,30,Montana,93,Silver Bow County,0,100,-100
27,Minnesota,30,Montana,99,Teton County,0,16,-16
27,Minnesota,30,Montana,105,Valley County,8,0,8
27,Minnesota,30,Montana,111,Yellowstone County,78,166,-88
27,Minnesota,31,Nebraska,1,Adams County,0,2,-2
27,Minnesota,31,Nebraska,3,Antelope County,0,14,-14
27,Minnesota,31,Nebraska,11,Boone County,16,0,16
27,Minnesota,31,Nebraska,19,Buffalo County,11,238,-227
27,Minnesota,31,Nebraska,21,Burt County,3,11,-8
27,Minnesota,31,Nebraska,25,Cass County,3,0,3
27,Minnesota,31,Nebraska,27,Cedar County,0,7,-7
27,Minnesota,31,Nebraska,29,Chase County,4,0,4
27,Minnesota,31,Nebraska,31,Cherry County,22,0,22
27,Minnesota,31,Nebraska,33,Cheyenne County,186,8,178
27,Minnesota,31,Nebraska,35,Clay County,2,0,2
27,Minnesota,31,Nebraska,37,Colfax County,0,15,-15
27,Minnesota,31,Nebraska,43,Dakota County,14,0,14
27,Minnesota,31,Nebraska,47,Dawson County,0,2,-2
27,Minnesota,31,Nebraska,51,Dixon County,7,0,7
27,Minnesota,31,Nebraska,53,Dodge County,5,41,-36
27,Minnesota,31,Nebraska,55,Douglas County,786,850,-64
27,Minnesota,31,Nebraska,57,Dundy County,0,20,-20
27,Minnesota,31,Nebraska,65,Furnas County,0,1,-1
27,Minnesota,31,Nebraska,67,Gage County,26,14,12
27,Minnesota,31,Nebraska,79,Hall County,7,60,-53
27,Minnesota,31,Nebraska,81,Hamilton County,23,0,23
27,Minnesota,31,Nebraska,83,Harlan County,9,3,6
27,Minnesota,31,Nebraska,89,Holt County,8,18,-10
27,Minnesota,31,Nebraska,91,Hooker County,0,3,-3
27,Minnesota,31,Nebraska,95,Jefferson County,1,11,-10
27,Minnesota,31,Nebraska,107,Knox County,39,9,30
27,Minnesota,31,Nebraska,109,Lancaster County,242,289,-47
27,Minnesota,31,Nebraska,111,Lincoln County,8,28,-20
27,Minnesota,31,Nebraska,119,Madison County,34,7,27
27,Minnesota,31,Nebraska,123,Morrill County,0,2,-2
27,Minnesota,31,Nebraska,131,Otoe County,0,1,-1
27,Minnesota,31,Nebraska,141,Platte County,0,26,-26
27,Minnesota,31,Nebraska,143,Polk County,9,0,9
27,Minnesota,31,Nebraska,145,Red Willow County,0,3,-3
27,Minnesota,31,Nebraska,151,Saline County,7,12,-5
27,Minnesota,31,Nebraska,153,Sarpy County,196,153,43
27,Minnesota,31,Nebraska,155,Saunders County,0,14,-14
27,Minnesota,31,Nebraska,157,Scotts Bluff County,7,4,3
27,Minnesota,31,Nebraska,159,Seward County,9,38,-29
27,Minnesota,31,Nebraska,161,Sheridan County,0,2,-2
27,Minnesota,31,Nebraska,173,Thurston County,0,3,-3
27,Minnesota,31,Nebraska,177,Washington County,2,4,-2
27,Minnesota,31,Nebraska,179,Wayne County,13,7,6
27,Minnesota,31,Nebraska,181,Webster County,6,1,5
27,Minnesota,31,Nebraska,185,York County,3,4,-1
27,Minnesota,32,Nevada,3,Clark County,560,1336,-776
27,Minnesota,32,Nevada,9,Esmeralda County,25,0,25
27,Minnesota,32,Nevada,13,Humboldt County,22,0,22
27,Minnesota,32,Nevada,19,Lyon County,29,16,13
27,Minnesota,32,Nevada,23,Nye County,0,44,-44
27,Minnesota,32,Nevada,27,Pershing County,1,0,1
27,Minnesota,32,Nevada,31,Washoe County,192,236,-44
27,Minnesota,32,Nevada,510,Carson City,24,0,24
27,Minnesota,33,New Hampshire,3,Carroll County,5,0,5
27,Minnesota,33,New Hampshire,5,Cheshire County,23,7,16
27,Minnesota,33,New Hampshire,9,Grafton County,71,74,-3
27,Minnesota,33,New Hampshire,11,Hillsborough County,6,0,6
27,Minnesota,33,New Hampshire,13,Merrimack County,8,0,8
27,Minnesota,33,New Hampshire,15,Rockingham County,47,53,-6
27,Minnesota,34,New Jersey,1,Atlantic County,15,0,15
27,Minnesota,34,New Jersey,3,Bergen County,119,16,103
27,Minnesota,34,New Jersey,5,Burlington County,19,0,19
27,Minnesota,34,New Jersey,7,Camden County,63,48,15
27,Minnesota,34,New Jersey,9,Cape May County,0,16,-16
27,Minnesota,34,New Jersey,13,Essex County,10,75,-65
27,Minnesota,34,New Jersey,15,Gloucester County,0,36,-36
27,Minnesota,34,New Jersey,17,Hudson County,22,86,-64
27,Minnesota,34,New Jersey,19,Hunterdon County,4,29,-25
27,Minnesota,34,New Jersey,21,Mercer County,201,137,64
27,Minnesota,34,New Jersey,23,Middlesex County,83,96,-13
27,Minnesota,34,New Jersey,25,Monmouth County,0,21,-21
27,Minnesota,34,New Jersey,27,Morris County,137,10,127
27,Minnesota,34,New Jersey,29,Ocean County,10,5,5
27,Minnesota,34,New Jersey,31,Passaic County,12,88,-76
27,Minnesota,34,New Jersey,33,Salem County,25,4,21
27,Minnesota,34,New Jersey,35,Somerset County,52,77,-25
27,Minnesota,34,New Jersey,39,Union County,25,6,19
27,Minnesota,35,New Mexico,1,Bernalillo County,347,271,76
27,Minnesota,35,New Mexico,5,Chaves County,10,0,10
27,Minnesota,35,New Mexico,6,Cibola County,1,0,1
27,Minnesota,35,New Mexico,9,Curry County,3,13,-10
27,Minnesota,35,New Mexico,13,Doña Ana County,0,8,-8
27,Minnesota,35,New Mexico,15,Eddy County,13,0,13
27,Minnesota,35,New Mexico,17,Grant County,9,0,9
27,Minnesota,35,New Mexico,23,Hidalgo County,3,0,3
27,Minnesota,35,New Mexico,25,Lea County,52,0,52
27,Minnesota,35,New Mexico,29,Luna County,11,0,11
27,Minnesota,35,New Mexico,31,McKinley County,9,0,9
27,Minnesota,35,New Mexico,35,Otero County,0,40,-40
27,Minnesota,35,New Mexico,39,Rio Arriba County,7,4,3
27,Minnesota,35,New Mexico,43,Sandoval County,8,25,-17
27,Minnesota,35,New Mexico,45,San Juan County,4,0,4
27,Minnesota,35,New Mexico,47,San Miguel County,0,6,-6
27,Minnesota,35,New Mexico,49,Santa Fe County,51,72,-21
27,Minnesota,35,New Mexico,51,Sierra County,17,8,9
27,Minnesota,35,New Mexico,55,Taos County,12,0,12
27,Minnesota,35,New Mexico,57,Torrance County,17,0,17
27,Minnesota,36,New York,1,Albany County,190,17,173
27,Minnesota,36,New York,5,Bronx County,207,28,179
27,Minnesota,36,New York,7,Broome County,0,16,-16
27,Minnesota,36,New York,13,Chautauqua County,21,0,21
27,Minnesota,36,New York,27,Dutchess County,45,59,-14
27,Minnesota,36,New York,29,Erie County,184,53,131
27,Minnesota,36,New York,31,Essex County,11,0,11
27,Minnesota,36,New York,35,Fulton County,28,0,28
27,Minnesota,36,New York,41,Hamilton County,33,0,33
27,Minnesota,36,New York,43,Herkimer County,32,4,28
27,Minnesota,36,New York,45,Jefferson County,192,0,192
27,Minnesota,36,New York,47,Kings County,430,172,258
27,Minnesota,36,New York,49,Lewis County,4,0,4
27,Minnesota,36,New York,51,Livingston County,6,0,6
27,Minnesota,36,New York,53,Madison County,27,0,27
27,Minnesota,36,New York,55,Monroe County,132,77,55
27,Minnesota,36,New York,59,Nassau County,42,8,34
27,Minnesota,36,New York,61,New York County,294,418,-124
27,Minnesota,36,New York,65,Oneida County,8,1,7
27,Minnesota,36,New York,67,Onondaga County,152,218,-66
27,Minnesota,36,New York,69,Ontario County,0,26,-26
27,Minnesota,36,New York,71,Orange County,7,65,-58
27,Minnesota,36,New York,73,Orleans County,2,0,2
27,Minnesota,36,New York,81,Queens County,261,33,228
27,Minnesota,36,New York,83,Rensselaer County,0,47,-47
27,Minnesota,36,New York,85,Richmond County,13,9,4
27,Minnesota,36,New York,87,Rockland County,4,0,4
27,Minnesota,36,New York,89,St. Lawrence County,14,0,14
27,Minnesota,36,New York,91,Saratoga County,52,9,43
27,Minnesota,36,New York,93,Schenectady County,12,24,-12
27,Minnesota,36,New York,101,Steuben County,25,30,-5
27,Minnesota,36,New York,103,Suffolk County,96,45,51
27,Minnesota,36,New York,109,Tompkins County,41,22,19
27,Minnesota,36,New York,111,Ulster County,14,17,-3
27,Minnesota,36,New York,117,Wayne County,7,0,7
27,Minnesota,36,New York,119,Westchester County,64,61,3
27,Minnesota,37,North Carolina,1,Alamance County,33,3,30
27,Minnesota,37,North Carolina,3,Alexander County,17,0,17
27,Minnesota,37,North Carolina,13,Beaufort County,0,12,-12
27,Minnesota,37,North Carolina,19,Brunswick County,50,22,28
27,Minnesota,37,North Carolina,21,Buncombe County,142,98,44
27,Minnesota,37,North Carolina,25,Cabarrus County,140,53,87
27,Minnesota,37,North Carolina,35,Catawba County,22,15,7
27,Minnesota,37,North Carolina,39,Cherokee County,2,0,2
27,Minnesota,37,North Carolina,49,Craven County,87,120,-33
27,Minnesota,37,North Carolina,51,Cumberland County,36,28,8
27,Minnesota,37,North Carolina,55,Dare County,4,9,-5
27,Minnesota,37,North Carolina,57,Davidson County,1,23,-22
27,Minnesota,37,North Carolina,61,Duplin County,0,20,-20
27,Minnesota,37,North Carolina,63,Durham County,57,120,-63
27,Minnesota,37,North Carolina,67,Forsyth County,0,7,-7
27,Minnesota,37,North Carolina,71,Gaston County,30,63,-33
27,Minnesota,37,North Carolina,79,Greene County,39,0,39
27,Minnesota,37,North Carolina,81,Guilford County,167,71,96
27,Minnesota,37,North Carolina,87,Haywood County,0,6,-6
27,Minnesota,37,North Carolina,89,Henderson County,0,29,-29
27,Minnesota,37,North Carolina,93,Hoke County,2,0,2
27,Minnesota,37,North Carolina,95,Hyde County,0,1,-1
27,Minnesota,37,North Carolina,97,Iredell County,24,23,1
27,Minnesota,37,North Carolina,101,Johnston County,0,262,-262
27,Minnesota,37,North Carolina,107,Lenoir County,10,0,10
27,Minnesota,37,North Carolina,115,Madison County,0,4,-4
27,Minnesota,37,North Carolina,119,Mecklenburg County,116,466,-350
27,Minnesota,37,North Carolina,125,Moore County,46,36,10
27,Minnesota,37,North Carolina,127,Nash County,0,34,-34
27,Minnesota,37,North Carolina,129,New Hanover County,16,325,-309
27,Minnesota,37,North Carolina,133,Onslow County,196,258,-62
27,Minnesota,37,North Carolina,135,Orange County,14,97,-83
27,Minnesota,37,North Carolina,139,Pasquotank County,9,0,9
27,Minnesota,37,North Carolina,143,Perquimans County,38,0,38
27,Minnesota,37,North Carolina,147,Pitt County,0,124,-124
27,Minnesota,37,North Carolina,151,Randolph County,3,0,3
27,Minnesota,37,North Carolina,155,Robeson County,0,11,-11
27,Minnesota,37,North Carolina,169,Stokes County,0,8,-8
27,Minnesota,37,North Carolina,175,Transylvania County,15,0,15
27,Minnesota,37,North Carolina,179,Union County,0,6,-6
27,Minnesota,37,North Carolina,183,Wake County,277,118,159
27,Minnesota,37,North Carolina,189,Watauga County,14,10,4
27,Minnesota,38,North Dakota,3,Barnes County,220,67,153
27,Minnesota,38,North Dakota,5,Benson County,126,1,125
27,Minnesota,38,North Dakota,7,Billings County,0,6,-6
27,Minnesota,38,North Dakota,9,Bottineau County,21,73,-52
27,Minnesota,38,North Dakota,11,Bowman County,10,0,10
27,Minnesota,38,North Dakota,15,Burleigh County,463,466,-3
27,Minnesota,38,North Dakota,17,Cass County,4601,7212,-2611
27,Minnesota,38,North Dakota,19,Cavalier County,0,2,-2
27,Minnesota,38,North Dakota,21,Dickey County,24,34,-10
27,Minnesota,38,North Dakota,23,Divide County,0,24,-24
27,Minnesota,38,North Dakota,25,Dunn County,0,2,-2
27,Minnesota,38,North Dakota,27,Eddy County,5,6,-1
27,Minnesota,38,North Dakota,29,Emmons County,0,2,-2
27,Minnesota,38,North Dakota,31,Foster County,4,5,-1
27,Minnesota,38,North Dakota,35,Grand Forks County,1644,3458,-1814
27,Minnesota,38,North Dakota,37,Grant County,23,0,23
27,Minnesota,38,North Dakota,39,Griggs County,0,4,-4
27,Minnesota,38,North Dakota,41,Hettinger County,42,18,24
27,Minnesota,38,North Dakota,43,Kidder County,3,5,-2
27,Minnesota,38,North Dakota,45,LaMoure County,15,6,9
27,Minnesota,38,North Dakota,47,Logan County,0,1,-1
27,Minnesota,38,North Dakota,49,McHenry County,5,0,5
27,Minnesota,38,North Dakota,51,McIntosh County,0,11,-11
27,Minnesota,38,North Dakota,53,McKenzie County,111,28,83
27,Minnesota,38,North Dakota,55,McLean County,23,17,6
27,Minnesota,38,North Dakota,57,Mercer County,75,7,68
27,Minnesota,38,North Dakota,59,Morton County,161,324,-163
27,Minnesota,38,North Dakota,61,Mountrail County,87,23,64
27,Minnesota,38,North Dakota,63,Nelson County,0,2,-2
27,Minnesota,38,North Dakota,67,Pembina County,81,97,-16
27,Minnesota,38,North Dakota,69,Pierce County,11,35,-24
27,Minnesota,38,North Dakota,71,Ramsey County,8,53,-45
27,Minnesota,38,North Dakota,73,Ransom County,45,27,18
27,Minnesota,38,North Dakota,75,Renville County,9,0,9
27,Minnesota,38,North Dakota,77,Richland County,259,596,-337
27,Minnesota,38,North Dakota,79,Rolette County,16,24,-8
27,Minnesota,38,North Dakota,81,Sargent County,0,9,-9
27,Minnesota,38,North Dakota,85,Sioux County,1,9,-8
27,Minnesota,38,North Dakota,89,Stark County,394,96,298
27,Minnesota,38,North Dakota,91,Steele County,6,0,6
27,Minnesota,38,North Dakota,93,Stutsman County,191,230,-39
27,Minnesota,38,North Dakota,95,Towner County,12,3,9
27,Minnesota,38,North Dakota,97,Traill County,143,113,30
27,Minnesota,38,North Dakota,99,Walsh County,72,13,59
27,Minnesota,38,North Dakota,101,Ward County,408,513,-105
27,Minnesota,38,North Dakota,103,Wells County,17,3,14
27,Minnesota,38,North Dakota,105,Williams County,197,241,-44
27,Minnesota,39,Ohio,9,Athens County,30,9,21
27,Minnesota,39,Ohio,11,Auglaize County,0,8,-8
27,Minnesota,39,Ohio,15,Brown County,23,0,23
27,Minnesota,39,Ohio,17,Butler County,35,134,-99
27,Minnesota,39,Ohio,23,Clark County,37,0,37
27,Minnesota,39,Ohio,25,Clermont County,212,0,212
27,Minnesota,39,Ohio,27,Clinton County,9,0,9
27,Minnesota,39,Ohio,35,Cuyahoga County,576,205,371
27,Minnesota,39,Ohio,41,Delaware County,13,8,5
27,Minnesota,39,Ohio,43,Erie County,21,0,21
27,Minnesota,39,Ohio,45,Fairfield County,2,0,2
27,Minnesota,39,Ohio,49,Franklin County,288,378,-90
27,Minnesota,39,Ohio,55,Geauga County,16,0,16
27,Minnesota,39,Ohio,57,Greene County,0,116,-116
27,Minnesota,39,Ohio,59,Guernsey County,20,0,20
27,Minnesota,39,Ohio,61,Hamilton County,307,183,124
27,Minnesota,39,Ohio,63,Hancock County,3,25,-22
27,Minnesota,39,Ohio,69,Henry County,31,0,31
27,Minnesota,39,Ohio,81,Jefferson County,7,21,-14
27,Minnesota,39,Ohio,83,Knox County,0,7,-7
27,Minnesota,39,Ohio,85,Lake County,78,30,48
27,Minnesota,39,Ohio,87,Lawrence County,1,0,1
27,Minnesota,39,Ohio,89,Licking County,82,84,-2
27,Minnesota,39,Ohio,93,Lorain County,47,132,-85
27,Minnesota,39,Ohio,95,Lucas County,50,41,9
27,Minnesota,39,Ohio,97,Madison County,3,82,-79
27,Minnesota,39,Ohio,99,Mahoning County,10,13,-3
27,Minnesota,39,Ohio,103,Medina County,13,8,5
27,Minnesota,39,Ohio,111,Monroe County,2,0,2
27,Minnesota,39,Ohio,113,Montgomery County,71,109,-38
27,Minnesota,39,Ohio,119,Muskingum County,12,0,12
27,Minnesota,39,Ohio,133,Portage County,0,37,-37
27,Minnesota,39,Ohio,139,Richland County,49,11,38
27,Minnesota,39,Ohio,141,Ross County,29,0,29
27,Minnesota,39,Ohio,143,Sandusky County,12,8,4
27,Minnesota,39,Ohio,147,Seneca County,32,0,32
27,Minnesota,39,Ohio,151,Stark County,38,14,24
27,Minnesota,39,Ohio,153,Summit County,97,3,94
27,Minnesota,39,Ohio,155,Trumbull County,42,0,42
27,Minnesota,39,Ohio,157,Tuscarawas County,0,23,-23
27,Minnesota,39,Ohio,159,Union County,0,12,-12
27,Minnesota,39,Ohio,165,Warren County,70,41,29
27,Minnesota,39,Ohio,169,Wayne County,57,18,39
27,Minnesota,39,Ohio,173,Wood County,26,40,-14
27,Minnesota,4,Arizona,1,Apache County,0,9,-9
27,Minnesota,4,Arizona,3,Cochise County,168,46,122
27,Minnesota,4,Arizona,5,Coconino County,19,48,-29
27,Minnesota,4,Arizona,7,Gila County,9,45,-36
27,Minnesota,4,Arizona,12,La Paz County,12,10,2
27,Minnesota,4,Arizona,13,Maricopa County,1964,3870,-1906
27,Minnesota,4,Arizona,15,Mohave County,173,231,-58
27,Minnesota,4,Arizona,17,Navajo County,23,0,23
27,Minnesota,4,Arizona,19,Pima County,628,791,-163
27,Minnesota,4,Arizona,21,Pinal County,126,1003,-877
27,Minnesota,4,Arizona,25,Yavapai County,154,134,20
27,Minnesota,4,Arizona,27,Yuma County,98,52,46
27,Minnesota,40,Oklahoma,9,Beckham County,19,0,19
27,Minnesota,40,Oklahoma,15,Caddo County,0,3,-3
27,Minnesota,40,Oklahoma,17,Canadian County,73,0,73
27,Minnesota,40,Oklahoma,21,Cherokee County,54,0,54
27,Minnesota,40,Oklahoma,27,Cleveland County,35,92,-57
27,Minnesota,40,Oklahoma,31,Comanche County,11,203,-192
27,Minnesota,40,Oklahoma,41,Delaware County,0,9,-9
27,Minnesota,40,Oklahoma,47,Garfield County,0,38,-38
27,Minnesota,40,Oklahoma,71,Kay County,0,12,-12
27,Minnesota,40,Oklahoma,77,Latimer County,0,5,-5
27,Minnesota,40,Oklahoma,87,McClain County,0,2,-2
27,Minnesota,40,Oklahoma,99,Murray County,2,0,2
27,Minnesota,40,Oklahoma,101,Muskogee County,214,0,214
27,Minnesota,40,Oklahoma,103,Noble County,0,7,-7
27,Minnesota,40,Oklahoma,105,Nowata County,0,9,-9
27,Minnesota,40,Oklahoma,109,Oklahoma County,169,142,27
27,Minnesota,40,Oklahoma,111,Okmulgee County,6,0,6
27,Minnesota,40,Oklahoma,113,Osage County,31,0,31
27,Minnesota,40,Oklahoma,115,Ottawa County,0,1,-1
27,Minnesota,40,Oklahoma,117,Pawnee County,17,0,17
27,Minnesota,40,Oklahoma,119,Payne County,41,40,1
27,Minnesota,40,Oklahoma,121,Pittsburg County,2,11,-9
27,Minnesota,40,Oklahoma,125,Pottawatomie County,2,0,2
27,Minnesota,40,Oklahoma,133,Seminole County,12,0,12
27,Minnesota,40,Oklahoma,137,Stephens County,0,68,-68
27,Minnesota,40,Oklahoma,143,Tulsa County,95,141,-46
27,Minnesota,40,Oklahoma,145,Wagoner County,4,20,-16
27,Minnesota,40,Oklahoma,147,Washington County,0,12,-12
27,Minnesota,41,Oregon,1,Baker County,0,16,-16
27,Minnesota,41,Oregon,3,Benton County,23,29,-6
27,Minnesota,41,Oregon,5,Clackamas County,87,96,-9
27,Minnesota,41,Oregon,7,Clatsop County,12,0,12
27,Minnesota,41,Oregon,11,Coos County,9,66,-57
27,Minnesota,41,Oregon,17,Deschutes County,57,54,3
27,Minnesota,41,Oregon,19,Douglas County,0,1,-1
27,Minnesota,41,Oregon,23,Grant County,0,5,-5
27,Minnesota,41,Oregon,29,Jackson County,83,277,-194
27,Minnesota,41,Oregon,31,Jefferson County,5,5,0
27,Minnesota,41,Oregon,33,Josephine County,0,19,-19
27,Minnesota,41,Oregon,35,Klamath County,0,16,-16
27,Minnesota,41,Oregon,39,Lane County,152,122,30
27,Minnesota,41,Oregon,41,Lincoln County,1,4,-3
27,Minnesota,41,Oregon,43,Linn County,0,31,-31
27,Minnesota,41,Oregon,47,Marion County,72,0,72
27,Minnesota,41,Oregon,51,Multnomah County,280,482,-202
27,Minnesota,41,Oregon,53,Polk County,12,21,-9
27,Minnesota,41,Oregon,57,Tillamook County,0,7,-7
27,Minnesota,41,Oregon,59,Umatilla County,7,21,-14
27,Minnesota,41,Oregon,67,Washington County,455,434,21
27,Minnesota,41,Oregon,69,Wheeler County,0,3,-3
27,Minnesota,41,Oregon,71,Yamhill County,12,0,12
27,Minnesota,42,Pennsylvania,1,Adams County,0,24,-24
27,Minnesota,42,Pennsylvania,3,Allegheny County,270,363,-93
27,Minnesota,42,Pennsylvania,7,Beaver County,22,0,22
27,Minnesota,42,Pennsylvania,11,Berks County,8,68,-60
27,Minnesota,42,Pennsylvania,15,Bradford County,34,0,34
27,Minnesota,42,Pennsylvania,17,Bucks County,26,46,-20
27,Minnesota,42,Pennsylvania,19,Butler County,17,6,11
27,Minnesota,42,Pennsylvania,21,Cambria County,0,15,-15
27,Minnesota,42,Pennsylvania,27,Centre County,14,53,-39
27,Minnesota,42,Pennsylvania,29,Chester County,0,60,-60
27,Minnesota,42,Pennsylvania,33,Clearfield County,0,33,-33
27,Minnesota,42,Pennsylvania,35,Clinton County,0,5,-5
27,Minnesota,42,Pennsylvania,39,Crawford County,12,2,10
27,Minnesota,42,Pennsylvania,41,Cumberland County,14,49,-35
27,Minnesota,42,Pennsylvania,43,Dauphin County,0,14,-14
27,Minnesota,42,Pennsylvania,45,Delaware County,73,42,31
27,Minnesota,42,Pennsylvania,49,Erie County,91,0,91
27,Minnesota,42,Pennsylvania,51,Fayette County,0,4,-4
27,Minnesota,42,Pennsylvania,53,Forest County,0,3,-3
27,Minnesota,42,Pennsylvania,55,Franklin County,40,0,40
27,Minnesota,42,Pennsylvania,59,Greene County,30,0,30
27,Minnesota,42,Pennsylvania,61,Huntingdon County,0,6,-6
27,Minnesota,42,Pennsylvania,65,Jefferson County,0,10,-10
27,Minnesota,42,Pennsylvania,69,Lackawanna County,0,12,-12
27,Minnesota,42,Pennsylvania,71,Lancaster County,40,43,-3
27,Minnesota,42,Pennsylvania,73,Lawrence County,18,0,18
27,Minnesota,42,Pennsylvania,77,Lehigh County,74,47,27
27,Minnesota,42,Pennsylvania,79,Luzerne County,0,10,-10
27,Minnesota,42,Pennsylvania,83,McKean County,0,3,-3
27,Minnesota,42,Pennsylvania,85,Mercer County,30,0,30
27,Minnesota,42,Pennsylvania,91,Montgomery County,36,246,-210
27,Minnesota,42,Pennsylvania,93,Montour County,16,0,16
27,Minnesota,42,Pennsylvania,95,Northampton County,53,0,53
27,Minnesota,42,Pennsylvania,101,Philadelphia County,125,205,-80
27,Minnesota,42,Pennsylvania,107,Schuylkill County,6,0,6
27,Minnesota,42,Pennsylvania,109,Snyder County,0,13,-13
27,Minnesota,42,Pennsylvania,111,Somerset County,4,0,4
27,Minnesota,42,Pennsylvania,115,Susquehanna County,10,0,10
27,Minnesota,42,Pennsylvania,117,Tioga County,8,2,6
27,Minnesota,42,Pennsylvania,119,Union County,15,0,15
27,Minnesota,42,Pennsylvania,125,Washington County,27,0,27
27,Minnesota,42,Pennsylvania,129,Westmoreland County,29,0,29
27,Minnesota,42,Pennsylvania,133,York County,4,21,-17
27,Minnesota,44,Rhode Island,1,Bristol County,0,34,-34
27,Minnesota,44,Rhode Island,5,Newport County,0,14,-14
27,Minnesota,44,Rhode Island,7,Providence County,145,129,16
27,Minnesota,44,Rhode Island,9,Washington County,2,8,-6
27,Minnesota,45,South Carolina,3,Aiken County,0,27,-27
27,Minnesota,45,South Carolina,7,Anderson County,15,18,-3
27,Minnesota,45,South Carolina,13,Beaufort County,12,52,-40
27,Minnesota,45,South Carolina,15,Berkeley County,11,61,-50
27,Minnesota,45,South Carolina,19,Charleston County,38,111,-73
27,Minnesota,45,South Carolina,35,Dorchester County,0,14,-14
27,Minnesota,45,South Carolina,41,Florence County,12,49,-37
27,Minnesota,45,South Carolina,43,Georgetown County,0,39,-39
27,Minnesota,45,South Carolina,45,Greenville County,55,6,49
27,Minnesota,45,South Carolina,51,Horry County,115,141,-26
27,Minnesota,45,South Carolina,55,Kershaw County,0,11,-11
27,Minnesota,45,South Carolina,63,Lexington County,0,89,-89
27,Minnesota,45,South Carolina,65,McCormick County,19,0,19
27,Minnesota,45,South Carolina,67,Marion County,0,8,-8
27,Minnesota,45,South Carolina,75,Orangeburg County,23,8,15
27,Minnesota,45,South Carolina,79,Richland County,57,290,-233
27,Minnesota,45,South Carolina,83,Spartanburg County,54,0,54
27,Minnesota,45,South Carolina,85,Sumter County,1,7,-6
27,Minnesota,45,South Carolina,89,Williamsburg County,8,0,8
27,Minnesota,45,South Carolina,91,York County,63,33,30
27,Minnesota,46,South Dakota,3,Aurora County,21,8,13
27,Minnesota,46,South Dakota,5,Beadle County,108,33,75
27,Minnesota,46,South Dakota,7,Bennett County,0,9,-9
27,Minnesota,46,South Dakota,9,Bon Homme County,27,23,4
27,Minnesota,46,South Dakota,11,Brookings County,505,880,-375
27,Minnesota,46,South Dakota,13,Brown County,255,351,-96
27,Minnesota,46,South Dakota,15,Brule County,0,19,-19
27,Minnesota,46,South Dakota,19,Butte County,3,9,-6
27,Minnesota,46,South Dakota,21,Campbell County,8,2,6
27,Minnesota,46,South Dakota,23,Charles Mix County,0,22,-22
27,Minnesota,46,South Dakota,25,Clark County,39,2,37
27,Minnesota,46,South Dakota,27,Clay County,183,258,-75
27,Minnesota,46,South Dakota,29,Codington County,245,138,107
27,Minnesota,46,South Dakota,33,Custer County,0,1,-1
27,Minnesota,46,South Dakota,35,Davison County,22,13,9
27,Minnesota,46,South Dakota,37,Day County,13,26,-13
27,Minnesota,46,South Dakota,39,Deuel County,33,77,-44
27,Minnesota,46,South Dakota,43,Douglas County,0,13,-13
27,Minnesota,46,South Dakota,45,Edmunds County,0,5,-5
27,Minnesota,46,South Dakota,47,Fall River County,15,14,1
27,Minnesota,46,South Dakota,49,Faulk County,5,27,-22
27,Minnesota,46,South Dakota,51,Grant County,110,78,32
27,Minnesota,46,South Dakota,53,Gregory County,5,3,2
27,Minnesota,46,South Dakota,57,Hamlin County,34,38,-4
27,Minnesota,46,South Dakota,59,Hand County,10,0,10
27,Minnesota,46,South Dakota,61,Hanson County,12,2,10
27,Minnesota,46,South Dakota,65,Hughes County,27,56,-29
27,Minnesota,46,South Dakota,67,Hutchinson County,17,41,-24
27,Minnesota,46,South Dakota,71,Jackson County,0,17,-17
27,Minnesota,46,South Dakota,77,Kingsbury County,0,10,-10
27,Minnesota,46,South Dakota,79,Lake County,125,112,13
27,Minnesota,46,South Dakota,81,Lawrence County,111,167,-56
27,Minnesota,46,South Dakota,83,Lincoln County,253,325,-72
27,Minnesota,46,South Dakota,87,McCook County,3,2,1
27,Minnesota,46,South Dakota,91,Marshall County,26,27,-1
27,Minnesota,46,South Dakota,93,Meade County,29,61,-32
27,Minnesota,46,South Dakota,95,Mellette County,0,4,-4
27,Minnesota,46,South Dakota,97,Miner County,3,45,-42
27,Minnesota,46,South Dakota,99,Minnehaha County,1717,1166,551
27,Minnesota,46,South Dakota,101,Moody County,0,4,-4
27,Minnesota,46,South Dakota,102,Oglala Lakota County,8,29,-21
27,Minnesota,46,South Dakota,103,Pennington County,325,257,68
27,Minnesota,46,South Dakota,105,Perkins County,0,13,-13
27,Minnesota,46,South Dakota,107,Potter County,0,3,-3
27,Minnesota,46,South Dakota,109,Roberts County,157,54,103
27,Minnesota,46,South Dakota,111,Sanborn County,0,2,-2
27,Minnesota,46,South Dakota,115,Spink County,3,2,1
27,Minnesota,46,South Dakota,117,Stanley County,8,6,2
27,Minnesota,46,South Dakota,119,Sully County,0,3,-3
27,Minnesota,46,South Dakota,121,Todd County,0,3,-3
27,Minnesota,46,South Dakota,123,Tripp County,8,0,8
27,Minnesota,46,South Dakota,125,Turner County,39,21,18
27,Minnesota,46,South Dakota,127,Union County,26,1,25
27,Minnesota,46,South Dakota,129,Walworth County,8,0,8
27,Minnesota,46,South Dakota,135,Yankton County,168,45,123
27,Minnesota,47,Tennessee,11,Bradley County,15,50,-35
27,Minnesota,47,Tennessee,15,Cannon County,39,0,39
27,Minnesota,47,Tennessee,17,Carroll County,14,0,14
27,Minnesota,47,Tennessee,19,Carter County,13,0,13
27,Minnesota,47,Tennessee,31,Coffee County,7,0,7
27,Minnesota,47,Tennessee,35,Cumberland County,0,29,-29
27,Minnesota,47,Tennessee,37,Davidson County,480,412,68
27,Minnesota,47,Tennessee,43,Dickson County,3,0,3
27,Minnesota,47,Tennessee,45,Dyer County,0,12,-12
27,Minnesota,47,Tennessee,47,Fayette County,23,0,23
27,Minnesota,47,Tennessee,51,Franklin County,0,113,-113
27,Minnesota,47,Tennessee,59,Greene County,0,11,-11
27,Minnesota,47,Tennessee,61,Grundy County,20,0,20
27,Minnesota,47,Tennessee,65,Hamilton County,0,6,-6
27,Minnesota,47,Tennessee,73,Hawkins County,6,0,6
27,Minnesota,47,Tennessee,79,Henry County,7,0,7
27,Minnesota,47,Tennessee,89,Jefferson County,8,10,-2
27,Minnesota,47,Tennessee,91,Johnson County,0,8,-8
27,Minnesota,47,Tennessee,93,Knox County,63,206,-143
27,Minnesota,47,Tennessee,97,Lauderdale County,0,64,-64
27,Minnesota,47,Tennessee,113,Madison County,8,0,8
27,Minnesota,47,Tennessee,125,Montgomery County,37,240,-203
27,Minnesota,47,Tennessee,147,Robertson County,21,4,17
27,Minnesota,47,Tennessee,149,Rutherford County,141,89,52
27,Minnesota,47,Tennessee,155,Sevier County,9,0,9
27,Minnesota,47,Tennessee,157,Shelby County,322,219,103
27,Minnesota,47,Tennessee,163,Sullivan County,0,11,-11
27,Minnesota,47,Tennessee,165,Sumner County,44,0,44
27,Minnesota,47,Tennessee,179,Washington County,11,35,-24
27,Minnesota,47,Tennessee,187,Williamson County,69,0,69
27,Minnesota,47,Tennessee,189,Wilson County,66,97,-31
27,Minnesota,48,Texas,1,Anderson County,18,0,18
27,Minnesota,48,Texas,5,Angelina County,0,35,-35
27,Minnesota,48,Texas,7,Aransas County,25,0,25
27,Minnesota,48,Texas,19,Bandera County,2,36,-34
27,Minnesota,48,Texas,21,Bastrop County,0,5,-5
27,Minnesota,48,Texas,27,Bell County,51,131,-80
27,Minnesota,48,Texas,29,Bexar County,326,460,-134
27,Minnesota,48,Texas,35,Bosque County,17,0,17
27,Minnesota,48,Texas,37,Bowie County,3,4,-1
27,Minnesota,48,Texas,39,Brazoria County,0,63,-63
27,Minnesota,48,Texas,41,Brazos County,47,0,47
27,Minnesota,48,Texas,43,Brewster County,0,11,-11
27,Minnesota,48,Texas,49,Brown County,19,0,19
27,Minnesota,48,Texas,53,Burnet County,0,11,-11
27,Minnesota,48,Texas,61,Cameron County,8,107,-99
27,Minnesota,48,Texas,65,Carson County,0,5,-5
27,Minnesota,48,Texas,77,Clay County,7,0,7
27,Minnesota,48,Texas,83,Coleman County,0,5,-5
27,Minnesota,48,Texas,85,Collin County,399,507,-108
27,Minnesota,48,Texas,89,Colorado County,75,0,75
27,Minnesota,48,Texas,91,Comal County,4,11,-7
27,Minnesota,48,Texas,99,Coryell County,14,23,-9
27,Minnesota,48,Texas,113,Dallas County,707,443,264
27,Minnesota,48,Texas,117,Deaf Smith County,9,0,9
27,Minnesota,48,Texas,119,Delta County,3,0,3
27,Minnesota,48,Texas,121,Denton County,287,478,-191
27,Minnesota,48,Texas,123,DeWitt County,6,0,6
27,Minnesota,48,Texas,129,Donley County,0,21,-21
27,Minnesota,48,Texas,141,El Paso County,201,220,-19
27,Minnesota,48,Texas,147,Fannin County,5,0,5
27,Minnesota,48,Texas,151,Fisher County,0,1,-1
27,Minnesota,48,Texas,157,Fort Bend County,41,41,0
27,Minnesota,48,Texas,167,Galveston County,26,57,-31
27,Minnesota,48,Texas,169,Garza County,0,11,-11
27,Minnesota,48,Texas,171,Gillespie County,0,9,-9
27,Minnesota,48,Texas,183,Gregg County,0,23,-23
27,Minnesota,48,Texas,187,Guadalupe County,3,83,-80
27,Minnesota,48,Texas,189,Hale County,8,0,8
27,Minnesota,48,Texas,201,Harris County,762,685,77
27,Minnesota,48,Texas,209,Hays County,70,6,64
27,Minnesota,48,Texas,215,Hidalgo County,244,377,-133
27,Minnesota,48,Texas,219,Hockley County,5,0,5
27,Minnesota,48,Texas,221,Hood County,56,0,56
27,Minnesota,48,Texas,231,Hunt County,106,20,86
27,Minnesota,48,Texas,241,Jasper County,49,0,49
27,Minnesota,48,Texas,245,Jefferson County,5,66,-61
27,Minnesota,48,Texas,251,Johnson County,1,0,1
27,Minnesota,48,Texas,253,Jones County,4,0,4
27,Minnesota,48,Texas,259,Kendall County,8,0,8
27,Minnesota,48,Texas,265,Kerr County,0,3,-3
27,Minnesota,48,Texas,273,Kleberg County,0,65,-65
27,Minnesota,48,Texas,275,Knox County,0,5,-5
27,Minnesota,48,Texas,277,Lamar County,0,16,-16
27,Minnesota,48,Texas,283,La Salle County,0,59,-59
27,Minnesota,48,Texas,303,Lubbock County,52,50,2
27,Minnesota,48,Texas,309,McLennan County,85,54,31
27,Minnesota,48,Texas,315,Marion County,0,7,-7
27,Minnesota,48,Texas,323,Maverick County,27,252,-225
27,Minnesota,48,Texas,329,Midland County,15,57,-42
27,Minnesota,48,Texas,333,Mills County,8,0,8
27,Minnesota,48,Texas,339,Montgomery County,18,0,18
27,Minnesota,48,Texas,355,Nueces County,25,104,-79
27,Minnesota,48,Texas,367,Parker County,0,18,-18
27,Minnesota,48,Texas,375,Potter County,51,0,51
27,Minnesota,48,Texas,381,Randall County,35,5,30
27,Minnesota,48,Texas,383,Reagan County,0,30,-30
27,Minnesota,48,Texas,387,Red River County,0,6,-6
27,Minnesota,48,Texas,389,Reeves County,0,9,-9
27,Minnesota,48,Texas,397,Rockwall County,10,0,10
27,Minnesota,48,Texas,407,San Jacinto County,0,7,-7
27,Minnesota,48,Texas,415,Scurry County,0,3,-3
27,Minnesota,48,Texas,423,Smith County,49,42,7
27,Minnesota,48,Texas,427,Starr County,26,0,26
27,Minnesota,48,Texas,439,Tarrant County,423,1090,-667
27,Minnesota,48,Texas,441,Taylor County,6,0,6
27,Minnesota,48,Texas,453,Travis County,310,557,-247
27,Minnesota,48,Texas,467,Van Zandt County,0,41,-41
27,Minnesota,48,Texas,471,Walker County,9,0,9
27,Minnesota,48,Texas,479,Webb County,190,0,190
27,Minnesota,48,Texas,485,Wichita County,0,112,-112
27,Minnesota,48,Texas,491,Williamson County,114,327,-213
27,Minnesota,48,Texas,493,Wilson County,0,55,-55
27,Minnesota,48,Texas,497,Wise County,19,6,13
27,Minnesota,48,Texas,507,Zavala County,2,0,2
27,Minnesota,49,Utah,3,Box Elder County,9,18,-9
27,Minnesota,49,Utah,5,Cache County,49,29,20
27,Minnesota,49,Utah,7,Carbon County,0,9,-9
27,Minnesota,49,Utah,11,Davis County,237,44,193
27,Minnesota,49,Utah,27,Millard County,1,4,-3
27,Minnesota,49,Utah,29,Morgan County,0,42,-42
27,Minnesota,49,Utah,35,Salt Lake County,328,379,-51
27,Minnesota,49,Utah,43,Summit County,0,16,-16
27,Minnesota,49,Utah,45,Tooele County,103,8,95
27,Minnesota,49,Utah,47,Uintah County,3,0,3
27,Minnesota,49,Utah,49,Utah County,18,190,-172
27,Minnesota,49,Utah,51,Wasatch County,246,20,226
27,Minnesota,49,Utah,53,Washington County,20,28,-8
27,Minnesota,49,Utah,57,Weber County,91,6,85
27,Minnesota,5,Arkansas,1,Arkansas County,5,0,5
27,Minnesota,5,Arkansas,5,Baxter County,41,18,23
27,Minnesota,5,Arkansas,7,Benton County,163,81,82
27,Minnesota,5,Arkansas,9,Boone County,1,0,1
27,Minnesota,5,Arkansas,23,Cleburne County,3,0,3
27,Minnesota,5,Arkansas,33,Crawford County,29,0,29
27,Minnesota,5,Arkansas,35,Crittenden County,0,17,-17
27,Minnesota,5,Arkansas,37,Cross County,2,0,2
27,Minnesota,5,Arkansas,45,Faulkner County,130,26,104
27,Minnesota,5,Arkansas,51,Garland County,0,7,-7
27,Minnesota,5,Arkansas,75,Lawrence County,0,13,-13
27,Minnesota,5,Arkansas,83,Logan County,1,0,1
27,Minnesota,5,Arkansas,85,Lonoke County,68,0,68
27,Minnesota,5,Arkansas,89,Marion County,5,9,-4
27,Minnesota,5,Arkansas,107,Phillips County,31,0,31
27,Minnesota,5,Arkansas,113,Polk County,0,43,-43
27,Minnesota,5,Arkansas,119,Pulaski County,88,161,-73
27,Minnesota,5,Arkansas,123,St. Francis County,21,0,21
27,Minnesota,5,Arkansas,125,Saline County,21,0,21
27,Minnesota,5,Arkansas,129,Searcy County,20,0,20
27,Minnesota,5,Arkansas,131,Sebastian County,0,14,-14
27,Minnesota,5,Arkansas,139,Union County,6,0,6
27,Minnesota,5,Arkansas,141,Van Buren County,0,17,-17
27,Minnesota,5,Arkansas,143,Washington County,20,57,-37
27,Minnesota,50,Vermont,1,Addison County,20,4,16
27,Minnesota,50,Vermont,5,Caledonia County,5,0,5
27,Minnesota,50,Vermont,7,Chittenden County,5,15,-10
27,Minnesota,50,Vermont,19,Orleans County,8,3,5
27,Minnesota,50,Vermont,25,Windham County,40,0,40
27,Minnesota,50,Vermont,27,Windsor County,0,2,-2
27,Minnesota,51,Virginia,3,Albemarle County,90,79,11
27,Minnesota,51,Virginia,13,Arlington County,92,100,-8
27,Minnesota,51,Virginia,15,Augusta County,9,0,9
27,Minnesota,51,Virginia,19,Bedford County,84,24,60
27,Minnesota,51,Virginia,25,Brunswick County,0,8,-8
27,Minnesota,51,Virginia,31,Campbell County,0,22,-22
27,Minnesota,51,Virginia,41,Chesterfield County,149,0,149
27,Minnesota,51,Virginia,47,Culpeper County,0,57,-57
27,Minnesota,51,Virginia,59,Fairfax County,466,591,-125
27,Minnesota,51,Virginia,63,Floyd County,0,50,-50
27,Minnesota,51,Virginia,67,Franklin County,0,37,-37
27,Minnesota,51,Virginia,69,Frederick County,14,0,14
27,Minnesota,51,Virginia,73,Gloucester County,0,64,-64
27,Minnesota,51,Virginia,81,Greensville County,25,0,25
27,Minnesota,51,Virginia,85,Hanover County,81,0,81
27,Minnesota,51,Virginia,87,Henrico County,71,30,41
27,Minnesota,51,Virginia,99,King George County,44,0,44
27,Minnesota,51,Virginia,107,Loudoun County,9,7,2
27,Minnesota,51,Virginia,113,Madison County,0,15,-15
27,Minnesota,51,Virginia,121,Montgomery County,20,0,20
27,Minnesota,51,Virginia,143,Pittsylvania County,0,11,-11
27,Minnesota,51,Virginia,149,Prince George County,44,0,44
27,Minnesota,51,Virginia,153,Prince William County,20,72,-52
27,Minnesota,51,Virginia,161,Roanoke County,0,14,-14
27,Minnesota,51,Virginia,167,Russell County,10,0,10
27,Minnesota,51,Virginia,177,Spotsylvania County,0,23,-23
27,Minnesota,51,Virginia,179,Stafford County,0,29,-29
27,Minnesota,51,Virginia,191,Washington County,0,20,-20
27,Minnesota,51,Virginia,199,York County,9,0,9
27,Minnesota,51,Virginia,510,Alexandria city,19,102,-83
27,Minnesota,51,Virginia,540,Charlottesville city,39,57,-18
27,Minnesota,51,Virginia,550,Chesapeake city,135,68,67
27,Minnesota,51,Virginia,600,Fairfax city,49,0,49
27,Minnesota,51,Virginia,650,Hampton city,16,0,16
27,Minnesota,51,Virginia,660,Harrisonburg city,23,8,15
27,Minnesota,51,Virginia,678,Lexington city,0,49,-49
27,Minnesota,51,Virginia,680,Lynchburg city,10,27,-17
27,Minnesota,51,Virginia,700,Newport News city,46,81,-35
27,Minnesota,51,Virginia,710,Norfolk city,112,193,-81
27,Minnesota,51,Virginia,740,Portsmouth city,0,65,-65
27,Minnesota,51,Virginia,760,Richmond city,44,178,-134
27,Minnesota,51,Virginia,775,Salem city,21,0,21
27,Minnesota,51,Virginia,800,Suffolk city,0,56,-56
27,Minnesota,51,Virginia,810,Virginia Beach city,107,130,-23
27,Minnesota,51,Virginia,830,Williamsburg city,0,4,-4
27,Minnesota,51,Virginia,840,Winchester city,70,0,70
27,Minnesota,53,Washington,1,Adams County,14,0,14
27,Minnesota,53,Washington,5,Benton County,56,90,-34
27,Minnesota,53,Washington,7,Chelan County,56,11,45
27,Minnesota,53,Washington,9,Clallam County,0,138,-138
27,Minnesota,53,Washington,11,Clark County,166,103,63
27,Minnesota,53,Washington,15,Cowlitz County,38,19,19
27,Minnesota,53,Washington,21,Franklin County,56,0,56
27,Minnesota,53,Washington,23,Garfield County,0,22,-22
27,Minnesota,53,Washington,25,Grant County,4,0,4
27,Minnesota,53,Washington,29,Island County,68,10,58
27,Minnesota,53,Washington,31,Jefferson County,10,17,-7
27,Minnesota,53,Washington,33,King County,958,1561,-603
27,Minnesota,53,Washington,35,Kitsap County,139,15,124
27,Minnesota,53,Washington,37,Kittitas County,2,4,-2
27,Minnesota,53,Washington,41,Lewis County,23,0,23
27,Minnesota,53,Washington,45,Mason County,7,42,-35
27,Minnesota,53,Washington,49,Pacific County,1,0,1
27,Minnesota,53,Washington,53,Pierce County,135,454,-319
27,Minnesota,53,Washington,55,San Juan County,11,20,-9
27,Minnesota,53,Washington,57,Skagit County,30,5,25
27,Minnesota,53,Washington,61,Snohomish County,333,308,25
27,Minnesota,53,Washington,63,Spokane County,149,74,75
27,Minnesota,53,Washington,67,Thurston County,141,132,9
27,Minnesota,53,Washington,69,Wahkiakum County,40,0,40
27,Minnesota,53,Washington,71,Walla Walla County,26,46,-20
27,Minnesota,53,Washington,73,Whatcom County,70,253,-183
27,Minnesota,53,Washington,75,Whitman County,57,22,35
27,Minnesota,53,Washington,77,Yakima County,6,0,6
27,Minnesota,54,West Virginia,35,Jackson County,39,0,39
27,Minnesota,54,West Virginia,37,Jefferson County,0,20,-20
27,Minnesota,54,West Virginia,39,Kanawha County,123,36,87
27,Minnesota,54,West Virginia,51,Marshall County,0,17,-17
27,Minnesota,54,West Virginia,55,Mercer County,0,6,-6
27,Minnesota,54,West Virginia,61,Monongalia County,51,48,3
27,Minnesota,54,West Virginia,69,Ohio County,0,12,-12
27,Minnesota,54,West Virginia,77,Preston County,9,0,9
27,Minnesota,54,West Virginia,99,Wayne County,86,0,86
27,Minnesota,54,West Virginia,107,Wood County,98,0,98
27,Minnesota,55,Wisconsin,1,Adams County,15,130,-115
27,Minnesota,55,Wisconsin,3,Ashland County,120,97,23
27,Minnesota,55,Wisconsin,5,Barron County,363,265,98
27,Minnesota,55,Wisconsin,7,Bayfield County,157,48,109
27,Minnesota,55,Wisconsin,9,Brown County,921,483,438
27,Minnesota,55,Wisconsin,11,Buffalo County,180,152,28
27,Minnesota,55,Wisconsin,13,Burnett County,234,309,-75
27,Minnesota,55,Wisconsin,15,Calumet County,2,4,-2
27,Minnesota,55,Wisconsin,17,Chippewa County,237,222,15
27,Minnesota,55,Wisconsin,19,Clark County,187,24,163
27,Minnesota,55,Wisconsin,21,Columbia County,142,52,90
27,Minnesota,55,Wisconsin,23,Crawford County,55,42,13
27,Minnesota,55,Wisconsin,25,Dane County,1566,1860,-294
27,Minnesota,55,Wisconsin,27,Dodge County,47,74,-27
27,Minnesota,55,Wisconsin,29,Door County,58,48,10
27,Minnesota,55,Wisconsin,31,Douglas County,1003,1693,-690
27,Minnesota,55,Wisconsin,33,Dunn County,530,1330,-800
27,Minnesota,55,Wisconsin,35,Eau Claire County,909,1302,-393
27,Minnesota,55,Wisconsin,37,Florence County,0,7,-7
27,Minnesota,55,Wisconsin,39,Fond du Lac County,210,69,141
27,Minnesota,55,Wisconsin,41,Forest County,19,1,18
27,Minnesota,55,Wisconsin,43,Grant County,71,39,32
27,Minnesota,55,Wisconsin,47,Green Lake County,8,11,-3
27,Minnesota,55,Wisconsin,49,Iowa County,43,22,21
27,Minnesota,55,Wisconsin,51,Iron County,14,12,2
27,Minnesota,55,Wisconsin,53,Jackson County,25,107,-82
27,Minnesota,55,Wisconsin,55,Jefferson County,81,49,32
27,Minnesota,55,Wisconsin,57,Juneau County,91,69,22
27,Minnesota,55,Wisconsin,59,Kenosha County,204,27,177
27,Minnesota,55,Wisconsin,61,Kewaunee County,0,53,-53
27,Minnesota,55,Wisconsin,63,La Crosse County,1396,1542,-146
27,Minnesota,55,Wisconsin,65,Lafayette County,0,2,-2
27,Minnesota,55,Wisconsin,67,Langlade County,91,0,91
27,Minnesota,55,Wisconsin,69,Lincoln County,54,17,37
27,Minnesota,55,Wisconsin,71,Manitowoc County,239,3,236
27,Minnesota,55,Wisconsin,73,Marathon County,508,182,326
27,Minnesota,55,Wisconsin,75,Marinette County,85,30,55
27,Minnesota,55,Wisconsin,77,Marquette County,74,17,57
27,Minnesota,55,Wisconsin,79,Milwaukee County,1339,955,384
27,Minnesota,55,Wisconsin,81,Monroe County,61,33,28
27,Minnesota,55,Wisconsin,83,Oconto County,0,8,-8
27,Minnesota,55,Wisconsin,85,Oneida County,62,68,-6
27,Minnesota,55,Wisconsin,87,Outagamie County,318,243,75
27,Minnesota,55,Wisconsin,89,Ozaukee County,109,41,68
27,Minnesota,55,Wisconsin,91,Pepin County,3,27,-24
27,Minnesota,55,Wisconsin,93,Pierce County,1438,1837,-399
27,Minnesota,55,Wisconsin,95,Polk County,533,660,-127
27,Minnesota,55,Wisconsin,97,Portage County,377,187,190
27,Minnesota,55,Wisconsin,99,Price County,45,36,9
27,Minnesota,55,Wisconsin,101,Racine County,275,22,253
27,Minnesota,55,Wisconsin,103,Richland County,81,11,70
27,Minnesota,55,Wisconsin,105,Rock County,72,69,3
27,Minnesota,55,Wisconsin,107,Rusk County,63,44,19
27,Minnesota,55,Wisconsin,109,St. Croix County,1903,1957,-54
27,Minnesota,55,Wisconsin,111,Sauk County,109,85,24
27,Minnesota,55,Wisconsin,113,Sawyer County,133,130,3
27,Minnesota,55,Wisconsin,115,Shawano County,9,35,-26
27,Minnesota,55,Wisconsin,117,Sheboygan County,76,137,-61
27,Minnesota,55,Wisconsin,119,Taylor County,17,92,-75
27,Minnesota,55,Wisconsin,121,Trempealeau County,344,118,226
27,Minnesota,55,Wisconsin,123,Vernon County,44,67,-23
27,Minnesota,55,Wisconsin,125,Vilas County,29,48,-19
27,Minnesota,55,Wisconsin,127,Walworth County,81,0,81
27,Minnesota,55,Wisconsin,129,Washburn County,121,95,26
27,Minnesota,55,Wisconsin,131,Washington County,247,85,162
27,Minnesota,55,Wisconsin,133,Waukesha County,714,343,371
27,Minnesota,55,Wisconsin,135,Waupaca County,19,17,2
27,Minnesota,55,Wisconsin,137,Waushara County,9,8,1
27,Minnesota,55,Wisconsin,139,Winnebago County,166,185,-19
27,Minnesota,55,Wisconsin,141,Wood County,204,168,36
27,Minnesota,56,Wyoming,1,Albany County,138,117,21
27,Minnesota,56,Wyoming,3,Big Horn County,2,0,2
27,Minnesota,56,Wyoming,5,Campbell County,20,0,20
27,Minnesota,56,Wyoming,11,Crook County,0,1,-1
27,Minnesota,56,Wyoming,13,Fremont County,11,10,1
27,Minnesota,56,Wyoming,15,Goshen County,18,22,-4
27,Minnesota,56,Wyoming,21,Laramie County,118,61,57
27,Minnesota,56,Wyoming,25,Natrona County,29,49,-20
27,Minnesota,56,Wyoming,29,Park County,0,62,-62
27,Minnesota,56,Wyoming,31,Platte County,17,0,17
27,Minnesota,56,Wyoming,33,Sheridan County,10,2,8
27,Minnesota,56,Wyoming,37,Sweetwater County,0,41,-41
27,Minnesota,56,Wyoming,39,Teton County,32,28,4
27,Minnesota,56,Wyoming,41,Uinta County,6,0,6
27,Minnesota,56,Wyoming,43,Washakie County,0,1,-1
27,Minnesota,56,Wyoming,45,Weston County,4,38,-34
27,Minnesota,6,California,1,Alameda County,378,346,32
27,Minnesota,6,California,5,Amador County,0,71,-71
27,Minnesota,6,California,7,Butte County,40,10,30
27,Minnesota,6,California,13,Contra Costa County,99,93,6
27,Minnesota,6,California,17,El Dorado County,44,20,24
27,Minnesota,6,California,19,Fresno County,33,89,-56
27,Minnesota,6,California,21,Glenn County,26,0,26
27,Minnesota,6,California,23,Humboldt County,44,75,-31
27,Minnesota,6,California,25,Imperial County,10,0,10
27,Minnesota,6,California,27,Inyo County,0,43,-43
27,Minnesota,6,California,29,Kern County,19,70,-51
27,Minnesota,6,California,31,Kings County,9,0,9
27,Minnesota,6,California,33,Lake County,16,0,16
27,Minnesota,6,California,37,Los Angeles County,1594,1371,223
27,Minnesota,6,California,39,Madera County,15,0,15
27,Minnesota,6,California,41,Marin County,14,69,-55
27,Minnesota,6,California,43,Mariposa County,6,0,6
27,Minnesota,6,California,45,Mendocino County,3,43,-40
27,Minnesota,6,California,47,Merced County,12,17,-5
27,Minnesota,6,California,51,Mono County,32,0,32
27,Minnesota,6,California,53,Monterey County,94,107,-13
27,Minnesota,6,California,55,Napa County,11,54,-43
27,Minnesota,6,California,57,Nevada County,30,53,-23
27,Minnesota,6,California,59,Orange County,426,978,-552
27,Minnesota,6,California,61,Placer County,129,8,121
27,Minnesota,6,California,65,Riverside County,221,239,-18
27,Minnesota,6,California,67,Sacramento County,280,313,-33
27,Minnesota,6,California,71,San Bernardino County,415,286,129
27,Minnesota,6,California,73,San Diego County,895,1115,-220
27,Minnesota,6,California,75,San Francisco County,535,295,240
27,Minnesota,6,California,77,San Joaquin County,87,160,-73
27,Minnesota,6,California,79,San Luis Obispo County,0,62,-62
27,Minnesota,6,California,81,San Mateo County,143,156,-13
27,Minnesota,6,California,83,Santa Barbara County,15,52,-37
27,Minnesota,6,California,85,Santa Clara County,574,840,-266
27,Minnesota,6,California,87,Santa Cruz County,16,102,-86
27,Minnesota,6,California,89,Shasta County,14,0,14
27,Minnesota,6,California,93,Siskiyou County,0,23,-23
27,Minnesota,6,California,95,Solano County,29,115,-86
27,Minnesota,6,California,97,Sonoma County,107,247,-140
27,Minnesota,6,California,99,Stanislaus County,73,0,73
27,Minnesota,6,California,101,Sutter County,13,58,-45
27,Minnesota,6,California,107,Tulare County,12,0,12
27,Minnesota,6,California,109,Tuolumne County,0,8,-8
27,Minnesota,6,California,111,Ventura County,75,246,-171
27,Minnesota,6,California,113,Yolo County,3,0,3
27,Minnesota,6,California,115,Yuba County,4,0,4
27,Minnesota,72,Puerto Rico,7,Aguas Buenas Municipio,146,0,146
27,Minnesota,72,Puerto Rico,25,Caguas Municipio,46,0,46
27,Minnesota,72,Puerto Rico,27,Camuy Municipio,4,0,4
27,Minnesota,72,Puerto Rico,31,Carolina Municipio,52,0,52
27,Minnesota,72,Puerto Rico,53,Fajardo Municipio,0,114,-114
27,Minnesota,72,Puerto Rico,97,Mayagüez Municipio,7,0,7
27,Minnesota,72,Puerto Rico,107,Orocovis Municipio,18,0,18
27,Minnesota,72,Puerto Rico,113,Ponce Municipio,0,11,-11
27,Minnesota,72,Puerto Rico,117,Rincón Municipio,139,0,139
27,Minnesota,72,Puerto Rico,127,San Juan Municipio,20,0,20
27,Minnesota,72,Puerto Rico,131,San Sebastián Municipio,45,0,45
27,Minnesota,72,Puerto Rico,145,Vega Baja Municipio,21,0,21
27,Minnesota,72,Puerto Rico,151,Yabucoa Municipio,3,0,3
27,Minnesota,8,Colorado,1,Adams County,239,302,-63
27,Minnesota,8,Colorado,3,Alamosa County,13,0,13
27,Minnesota,8,Colorado,5,Arapahoe County,235,608,-373
27,Minnesota,8,Colorado,7,Archuleta County,0,3,-3
27,Minnesota,8,Colorado,13,Boulder County,219,592,-373
27,Minnesota,8,Colorado,14,Broomfield County,75,104,-29
27,Minnesota,8,Colorado,19,Clear Creek County,13,0,13
27,Minnesota,8,Colorado,23,Costilla County,0,6,-6
27,Minnesota,8,Colorado,27,Custer County,22,0,22
27,Minnesota,8,Colorado,29,Delta County,0,3,-3
27,Minnesota,8,Colorado,31,Denver County,675,429,246
27,Minnesota,8,Colorado,35,Douglas County,106,312,-206
27,Minnesota,8,Colorado,37,Eagle County,78,15,63
27,Minnesota,8,Colorado,39,Elbert County,0,4,-4
27,Minnesota,8,Colorado,41,El Paso County,736,514,222
27,Minnesota,8,Colorado,43,Fremont County,48,0,48
27,Minnesota,8,Colorado,45,Garfield County,9,77,-68
27,Minnesota,8,Colorado,49,Grand County,0,11,-11
27,Minnesota,8,Colorado,51,Gunnison County,19,50,-31
27,Minnesota,8,Colorado,55,Huerfano County,1,0,1
27,Minnesota,8,Colorado,59,Jefferson County,239,338,-99
27,Minnesota,8,Colorado,65,Lake County,0,4,-4
27,Minnesota,8,Colorado,67,La Plata County,0,25,-25
27,Minnesota,8,Colorado,69,Larimer County,259,445,-186
27,Minnesota,8,Colorado,73,Lincoln County,17,0,17
27,Minnesota,8,Colorado,75,Logan County,41,0,41
27,Minnesota,8,Colorado,77,Mesa County,14,30,-16
27,Minnesota,8,Colorado,85,Montrose County,1,52,-51
27,Minnesota,8,Colorado,87,Morgan County,9,1,8
27,Minnesota,8,Colorado,89,Otero County,0,16,-16
27,Minnesota,8,Colorado,93,Park County,6,0,6
27,Minnesota,8,Colorado,99,Prowers County,0,4,-4
27,Minnesota,8,Colorado,101,Pueblo County,0,66,-66
27,Minnesota,8,Colorado,107,Routt County,1,19,-18
27,Minnesota,8,Colorado,113,San Miguel County,63,21,42
27,Minnesota,8,Colorado,117,Summit County,136,43,93
27,Minnesota,8,Colorado,119,Teller County,0,25,-25
27,Minnesota,8,Colorado,123,Weld County,54,73,-19
27,Minnesota,8,Colorado,125,Yuma County,1,0,1
27,Minnesota,9,Connecticut,1,Fairfield County,299,219,80
27,Minnesota,9,Connecticut,3,Hartford County,85,166,-81
27,Minnesota,9,Connecticut,5,Litchfield County,26,10,16
27,Minnesota,9,Connecticut,7,Middlesex County,27,0,27
27,Minnesota,9,Connecticut,9,New Haven County,64,111,-47
27,Minnesota,9,Connecticut,11,New London County,30,33,-3
27,Minnesota,9,Connecticut,13,Tolland County,8,25,-17
27,Minnesota,AFR,Africa,,-,4527,0,0
27,Minnesota,ASI,Asia,,-,12308,0,0
27,Minnesota,CAM,Central America,,-,2472,0,0
27,Minnesota,CAR,Caribbean,,-,567,0,0
27,Minnesota,EUR,Europe,,-,4349,0,0
27,Minnesota,ISL,U.S. Island Areas,,-,136,0,0
27,Minnesota,NAM,Northern America,,-,1283,0,0
27,Minnesota,OCE,Oceania and At Sea,,-,502,0,0
27,Minnesota,SAM,South America,,-,1680,0,0
28,Mississippi,1,Alabama,1,Autauga County,21,27,-6
28,Mississippi,1,Alabama,3,Baldwin County,484,566,-82
28,Mississippi,1,Alabama,7,Bibb County,44,0,44
28,Mississippi,1,Alabama,9,Blount County,0,89,-89
28,Mississippi,1,Alabama,13,Butler County,10,0,10
28,Mississippi,1,Alabama,15,Calhoun County,313,85,228
28,Mississippi,1,Alabama,19,Cherokee County,20,21,-1
28,Mississippi,1,Alabama,21,Chilton County,8,0,8
28,Mississippi,1,Alabama,23,Choctaw County,221,40,181
28,Mississippi,1,Alabama,25,Clarke County,18,127,-109
28,Mississippi,1,Alabama,31,Coffee County,0,63,-63
28,Mississippi,1,Alabama,33,Colbert County,56,50,6
28,Mississippi,1,Alabama,35,Conecuh County,9,0,9
28,Mississippi,1,Alabama,37,Coosa County,0,16,-16
28,Mississippi,1,Alabama,39,Covington County,0,21,-21
28,Mississippi,1,Alabama,43,Cullman County,9,0,9
28,Mississippi,1,Alabama,45,Dale County,47,34,13
28,Mississippi,1,Alabama,47,Dallas County,57,20,37
28,Mississippi,1,Alabama,49,DeKalb County,0,29,-29
28,Mississippi,1,Alabama,51,Elmore County,0,157,-157
28,Mississippi,1,Alabama,53,Escambia County,47,10,37
28,Mississippi,1,Alabama,55,Etowah County,288,15,273
28,Mississippi,1,Alabama,57,Fayette County,0,10,-10
28,Mississippi,1,Alabama,59,Franklin County,54,248,-194
28,Mississippi,1,Alabama,61,Geneva County,0,8,-8
28,Mississippi,1,Alabama,65,Hale County,0,1,-1
28,Mississippi,1,Alabama,67,Henry County,19,2,17
28,Mississippi,1,Alabama,69,Houston County,17,33,-16
28,Mississippi,1,Alabama,71,Jackson County,17,28,-11
28,Mississippi,1,Alabama,73,Jefferson County,711,681,30
28,Mississippi,1,Alabama,75,Lamar County,252,83,169
28,Mississippi,1,Alabama,77,Lauderdale County,239,389,-150
28,Mississippi,1,Alabama,79,Lawrence County,0,21,-21
28,Mississippi,1,Alabama,81,Lee County,217,378,-161
28,Mississippi,1,Alabama,83,Limestone County,93,7,86
28,Mississippi,1,Alabama,85,Lowndes County,0,5,-5
28,Mississippi,1,Alabama,87,Macon County,0,26,-26
28,Mississippi,1,Alabama,89,Madison County,601,356,245
28,Mississippi,1,Alabama,91,Marengo County,3,1,2
28,Mississippi,1,Alabama,93,Marion County,47,30,17
28,Mississippi,1,Alabama,95,Marshall County,18,42,-24
28,Mississippi,1,Alabama,97,Mobile County,1199,1352,-153
28,Mississippi,1,Alabama,99,Monroe County,22,12,10
28,Mississippi,1,Alabama,101,Montgomery County,130,227,-97
28,Mississippi,1,Alabama,103,Morgan County,91,26,65
28,Mississippi,1,Alabama,105,Perry County,20,4,16
28,Mississippi,1,Alabama,107,Pickens County,101,189,-88
28,Mississippi,1,Alabama,109,Pike County,0,12,-12
28,Mississippi,1,Alabama,111,Randolph County,8,7,1
28,Mississippi,1,Alabama,113,Russell County,72,201,-129
28,Mississippi,1,Alabama,115,St. Clair County,13,31,-18
28,Mississippi,1,Alabama,117,Shelby County,422,291,131
28,Mississippi,1,Alabama,119,Sumter County,82,18,64
28,Mississippi,1,Alabama,121,Talladega County,8,23,-15
28,Mississippi,1,Alabama,123,Tallapoosa County,0,149,-149
28,Mississippi,1,Alabama,125,Tuscaloosa County,322,749,-427
28,Mississippi,1,Alabama,127,Walker County,0,53,-53
28,Mississippi,1,Alabama,129,Washington County,26,24,2
28,Mississippi,1,Alabama,133,Winston County,11,0,11
28,Mississippi,10,Delaware,1,Kent County,45,6,39
28,Mississippi,10,Delaware,3,New Castle County,19,64,-45
28,Mississippi,10,Delaware,5,Sussex County,0,6,-6
28,Mississippi,11,District of Columbia,1,District of Columbia,25,139,-114
28,Mississippi,12,Florida,1,Alachua County,42,0,42
28,Mississippi,12,Florida,5,Bay County,199,74,125
28,Mississippi,12,Florida,7,Bradford County,1,0,1
28,Mississippi,12,Florida,9,Brevard County,104,170,-66
28,Mississippi,12,Florida,11,Broward County,107,78,29
28,Mississippi,12,Florida,15,Charlotte County,45,35,10
28,Mississippi,12,Florida,19,Clay County,174,328,-154
28,Mississippi,12,Florida,21,Collier County,26,17,9
28,Mississippi,12,Florida,23,Columbia County,0,26,-26
28,Mississippi,12,Florida,29,Dixie County,6,0,6
28,Mississippi,12,Florida,31,Duval County,310,559,-249
28,Mississippi,12,Florida,33,Escambia County,825,529,296
28,Mississippi,12,Florida,37,Franklin County,0,12,-12
28,Mississippi,12,Florida,39,Gadsden County,18,0,18
28,Mississippi,12,Florida,41,Gilchrist County,0,17,-17
28,Mississippi,12,Florida,43,Glades County,0,54,-54
28,Mississippi,12,Florida,49,Hardee County,96,0,96
28,Mississippi,12,Florida,51,Hendry County,92,0,92
28,Mississippi,12,Florida,53,Hernando County,36,0,36
28,Mississippi,12,Florida,55,Highlands County,4,0,4
28,Mississippi,12,Florida,57,Hillsborough County,335,286,49
28,Mississippi,12,Florida,61,Indian River County,25,0,25
28,Mississippi,12,Florida,63,Jackson County,80,7,73
28,Mississippi,12,Florida,69,Lake County,30,0,30
28,Mississippi,12,Florida,71,Lee County,36,80,-44
28,Mississippi,12,Florida,73,Leon County,86,94,-8
28,Mississippi,12,Florida,75,Levy County,0,3,-3
28,Mississippi,12,Florida,79,Madison County,14,0,14
28,Mississippi,12,Florida,81,Manatee County,34,386,-352
28,Mississippi,12,Florida,83,Marion County,40,324,-284
28,Mississippi,12,Florida,85,Martin County,0,12,-12
28,Mississippi,12,Florida,86,Miami-Dade County,212,38,174
28,Mississippi,12,Florida,87,Monroe County,61,17,44
28,Mississippi,12,Florida,89,Nassau County,13,0,13
28,Mississippi,12,Florida,91,Okaloosa County,313,820,-507
28,Mississippi,12,Florida,93,Okeechobee County,0,5,-5
28,Mississippi,12,Florida,95,Orange County,188,242,-54
28,Mississippi,12,Florida,97,Osceola County,31,53,-22
28,Mississippi,12,Florida,99,Palm Beach County,325,15,310
28,Mississippi,12,Florida,101,Pasco County,115,142,-27
28,Mississippi,12,Florida,103,Pinellas County,66,26,40
28,Mississippi,12,Florida,105,Polk County,167,416,-249
28,Mississippi,12,Florida,107,Putnam County,31,0,31
28,Mississippi,12,Florida,109,St. Johns County,350,110,240
28,Mississippi,12,Florida,111,St. Lucie County,26,18,8
28,Mississippi,12,Florida,113,Santa Rosa County,250,214,36
28,Mississippi,12,Florida,115,Sarasota County,2,34,-32
28,Mississippi,12,Florida,117,Seminole County,81,46,35
28,Mississippi,12,Florida,119,Sumter County,31,25,6
28,Mississippi,12,Florida,121,Suwannee County,6,0,6
28,Mississippi,12,Florida,127,Volusia County,26,90,-64
28,Mississippi,12,Florida,131,Walton County,69,128,-59
28,Mississippi,12,Florida,133,Washington County,7,0,7
28,Mississippi,13,Georgia,9,Baldwin County,23,6,17
28,Mississippi,13,Georgia,13,Barrow County,51,0,51
28,Mississippi,13,Georgia,15,Bartow County,32,161,-129
28,Mississippi,13,Georgia,21,Bibb County,15,10,5
28,Mississippi,13,Georgia,31,Bulloch County,0,12,-12
28,Mississippi,13,Georgia,35,Butts County,0,21,-21
28,Mississippi,13,Georgia,39,Camden County,91,0,91
28,Mississippi,13,Georgia,45,Carroll County,0,73,-73
28,Mississippi,13,Georgia,47,Catoosa County,80,33,47
28,Mississippi,13,Georgia,51,Chatham County,92,168,-76
28,Mississippi,13,Georgia,53,Chattahoochee County,0,19,-19
28,Mississippi,13,Georgia,55,Chattooga County,0,5,-5
28,Mississippi,13,Georgia,57,Cherokee County,88,375,-287
28,Mississippi,13,Georgia,59,Clarke County,11,87,-76
28,Mississippi,13,Georgia,63,Clayton County,43,169,-126
28,Mississippi,13,Georgia,65,Clinch County,0,29,-29
28,Mississippi,13,Georgia,67,Cobb County,217,646,-429
28,Mississippi,13,Georgia,71,Colquitt County,17,0,17
28,Mississippi,13,Georgia,73,Columbia County,21,0,21
28,Mississippi,13,Georgia,77,Coweta County,6,21,-15
28,Mississippi,13,Georgia,79,Crawford County,55,0,55
28,Mississippi,13,Georgia,81,Crisp County,0,4,-4
28,Mississippi,13,Georgia,85,Dawson County,20,99,-79
28,Mississippi,13,Georgia,87,Decatur County,0,91,-91
28,Mississippi,13,Georgia,89,DeKalb County,252,441,-189
28,Mississippi,13,Georgia,91,Dodge County,0,4,-4
28,Mississippi,13,Georgia,97,Douglas County,36,355,-319
28,Mississippi,13,Georgia,103,Effingham County,26,9,17
28,Mississippi,13,Georgia,105,Elbert County,14,0,14
28,Mississippi,13,Georgia,107,Emanuel County,0,8,-8
28,Mississippi,13,Georgia,113,Fayette County,17,69,-52
28,Mississippi,13,Georgia,115,Floyd County,4,0,4
28,Mississippi,13,Georgia,117,Forsyth County,37,1,36
28,Mississippi,13,Georgia,119,Franklin County,0,13,-13
28,Mississippi,13,Georgia,121,Fulton County,853,339,514
28,Mississippi,13,Georgia,127,Glynn County,44,0,44
28,Mississippi,13,Georgia,129,Gordon County,23,0,23
28,Mississippi,13,Georgia,131,Grady County,6,0,6
28,Mississippi,13,Georgia,135,Gwinnett County,399,356,43
28,Mississippi,13,Georgia,139,Hall County,135,60,75
28,Mississippi,13,Georgia,145,Harris County,0,1,-1
28,Mississippi,13,Georgia,149,Heard County,0,4,-4
28,Mississippi,13,Georgia,151,Henry County,28,103,-75
28,Mississippi,13,Georgia,153,Houston County,27,258,-231
28,Mississippi,13,Georgia,157,Jackson County,6,0,6
28,Mississippi,13,Georgia,167,Johnson County,21,0,21
28,Mississippi,13,Georgia,169,Jones County,0,24,-24
28,Mississippi,13,Georgia,171,Lamar County,0,9,-9
28,Mississippi,13,Georgia,175,Laurens County,15,0,15
28,Mississippi,13,Georgia,179,Liberty County,102,31,71
28,Mississippi,13,Georgia,183,Long County,0,21,-21
28,Mississippi,13,Georgia,185,Lowndes County,214,20,194
28,Mississippi,13,Georgia,187,Lumpkin County,50,0,50
28,Mississippi,13,Georgia,189,McDuffie County,89,0,89
28,Mississippi,13,Georgia,197,Marion County,0,9,-9
28,Mississippi,13,Georgia,201,Miller County,62,0,62
28,Mississippi,13,Georgia,207,Monroe County,35,0,35
28,Mississippi,13,Georgia,209,Montgomery County,0,11,-11
28,Mississippi,13,Georgia,211,Morgan County,39,0,39
28,Mississippi,13,Georgia,213,Murray County,0,34,-34
28,Mississippi,13,Georgia,215,Muscogee County,180,165,15
28,Mississippi,13,Georgia,217,Newton County,0,99,-99
28,Mississippi,13,Georgia,219,Oconee County,0,8,-8
28,Mississippi,13,Georgia,223,Paulding County,22,20,2
28,Mississippi,13,Georgia,225,Peach County,94,0,94
28,Mississippi,13,Georgia,241,Rabun County,0,11,-11
28,Mississippi,13,Georgia,245,Richmond County,107,17,90
28,Mississippi,13,Georgia,247,Rockdale County,0,18,-18
28,Mississippi,13,Georgia,255,Spalding County,0,27,-27
28,Mississippi,13,Georgia,273,Terrell County,235,0,235
28,Mississippi,13,Georgia,279,Toombs County,0,58,-58
28,Mississippi,13,Georgia,285,Troup County,0,37,-37
28,Mississippi,13,Georgia,291,Union County,22,90,-68
28,Mississippi,13,Georgia,297,Walton County,0,13,-13
28,Mississippi,13,Georgia,305,Wayne County,11,0,11
28,Mississippi,13,Georgia,311,White County,11,3,8
28,Mississippi,13,Georgia,313,Whitfield County,5,10,-5
28,Mississippi,13,Georgia,319,Wilkinson County,0,1,-1
28,Mississippi,15,Hawaii,1,Hawaii County,68,0,68
28,Mississippi,15,Hawaii,3,Honolulu County,287,167,120
28,Mississippi,16,Idaho,1,Ada County,74,78,-4
28,Mississippi,16,Idaho,7,Bear Lake County,21,0,21
28,Mississippi,16,Idaho,13,Blaine County,9,0,9
28,Mississippi,16,Idaho,27,Canyon County,4,0,4
28,Mississippi,16,Idaho,39,Elmore County,168,12,156
28,Mississippi,16,Idaho,57,Latah County,78,0,78
28,Mississippi,16,Idaho,65,Madison County,25,0,25
28,Mississippi,16,Idaho,73,Owyhee County,0,5,-5
28,Mississippi,17,Illinois,1,Adams County,13,0,13
28,Mississippi,17,Illinois,5,Bond County,10,0,10
28,Mississippi,17,Illinois,7,Boone County,11,0,11
28,Mississippi,17,Illinois,15,Carroll County,0,13,-13
28,Mississippi,17,Illinois,19,Champaign County,100,17,83
28,Mississippi,17,Illinois,29,Coles County,120,34,86
28,Mississippi,17,Illinois,31,Cook County,893,871,22
28,Mississippi,17,Illinois,37,DeKalb County,0,12,-12
28,Mississippi,17,Illinois,43,DuPage County,236,16,220
28,Mississippi,17,Illinois,49,Effingham County,0,29,-29
28,Mississippi,17,Illinois,55,Franklin County,0,21,-21
28,Mississippi,17,Illinois,57,Fulton County,0,1,-1
28,Mississippi,17,Illinois,73,Henry County,90,35,55
28,Mississippi,17,Illinois,83,Jersey County,0,9,-9
28,Mississippi,17,Illinois,89,Kane County,126,17,109
28,Mississippi,17,Illinois,91,Kankakee County,68,19,49
28,Mississippi,17,Illinois,93,Kendall County,25,28,-3
28,Mississippi,17,Illinois,95,Knox County,13,0,13
28,Mississippi,17,Illinois,97,Lake County,112,224,-112
28,Mississippi,17,Illinois,101,Lawrence County,2,0,2
28,Mississippi,17,Illinois,103,Lee County,0,1,-1
28,Mississippi,17,Illinois,107,Logan County,0,3,-3
28,Mississippi,17,Illinois,111,McHenry County,17,1,16
28,Mississippi,17,Illinois,113,McLean County,7,20,-13
28,Mississippi,17,Illinois,115,Macon County,139,39,100
28,Mississippi,17,Illinois,119,Madison County,149,163,-14
28,Mississippi,17,Illinois,121,Marion County,0,6,-6
28,Mississippi,17,Illinois,133,Monroe County,28,0,28
28,Mississippi,17,Illinois,135,Montgomery County,0,8,-8
28,Mississippi,17,Illinois,137,Morgan County,0,11,-11
28,Mississippi,17,Illinois,143,Peoria County,52,0,52
28,Mississippi,17,Illinois,161,Rock Island County,0,15,-15
28,Mississippi,17,Illinois,163,St. Clair County,171,12,159
28,Mississippi,17,Illinois,167,Sangamon County,24,129,-105
28,Mississippi,17,Illinois,173,Shelby County,0,11,-11
28,Mississippi,17,Illinois,179,Tazewell County,0,6,-6
28,Mississippi,17,Illinois,181,Union County,0,21,-21
28,Mississippi,17,Illinois,183,Vermilion County,0,5,-5
28,Mississippi,17,Illinois,189,Washington County,0,3,-3
28,Mississippi,17,Illinois,193,White County,0,4,-4
28,Mississippi,17,Illinois,195,Whiteside County,36,11,25
28,Mississippi,17,Illinois,197,Will County,83,39,44
28,Mississippi,17,Illinois,199,Williamson County,8,10,-2
28,Mississippi,17,Illinois,201,Winnebago County,294,64,230
28,Mississippi,18,Indiana,3,Allen County,19,26,-7
28,Mississippi,18,Indiana,9,Blackford County,0,7,-7
28,Mississippi,18,Indiana,11,Boone County,8,0,8
28,Mississippi,18,Indiana,17,Cass County,10,5,5
28,Mississippi,18,Indiana,19,Clark County,0,37,-37
28,Mississippi,18,Indiana,23,Clinton County,0,6,-6
28,Mississippi,18,Indiana,29,Dearborn County,0,13,-13
28,Mississippi,18,Indiana,35,Delaware County,0,12,-12
28,Mississippi,18,Indiana,39,Elkhart County,0,26,-26
28,Mississippi,18,Indiana,43,Floyd County,0,19,-19
28,Mississippi,18,Indiana,51,Gibson County,18,129,-111
28,Mississippi,18,Indiana,53,Grant County,0,11,-11
28,Mississippi,18,Indiana,57,Hamilton County,2,0,2
28,Mississippi,18,Indiana,63,Hendricks County,6,11,-5
28,Mississippi,18,Indiana,65,Henry County,0,17,-17
28,Mississippi,18,Indiana,73,Jasper County,13,0,13
28,Mississippi,18,Indiana,77,Jefferson County,91,14,77
28,Mississippi,18,Indiana,79,Jennings County,35,7,28
28,Mississippi,18,Indiana,83,Knox County,0,5,-5
28,Mississippi,18,Indiana,89,Lake County,114,40,74
28,Mississippi,18,Indiana,91,LaPorte County,25,34,-9
28,Mississippi,18,Indiana,95,Madison County,0,28,-28
28,Mississippi,18,Indiana,97,Marion County,157,209,-52
28,Mississippi,18,Indiana,99,Marshall County,5,0,5
28,Mississippi,18,Indiana,103,Miami County,0,16,-16
28,Mississippi,18,Indiana,105,Monroe County,24,7,17
28,Mississippi,18,Indiana,127,Porter County,8,33,-25
28,Mississippi,18,Indiana,139,Rush County,82,0,82
28,Mississippi,18,Indiana,141,St. Joseph County,43,0,43
28,Mississippi,18,Indiana,157,Tippecanoe County,54,15,39
28,Mississippi,18,Indiana,163,Vanderburgh County,0,60,-60
28,Mississippi,18,Indiana,165,Vermillion County,0,4,-4
28,Mississippi,18,Indiana,167,Vigo County,0,26,-26
28,Mississippi,18,Indiana,173,Warrick County,85,17,68
28,Mississippi,18,Indiana,175,Washington County,16,0,16
28,Mississippi,18,Indiana,177,Wayne County,0,5,-5
28,Mississippi,19,Iowa,13,Black Hawk County,21,50,-29
28,Mississippi,19,Iowa,21,Buena Vista County,0,34,-34
28,Mississippi,19,Iowa,33,Cerro Gordo County,0,1,-1
28,Mississippi,19,Iowa,35,Cherokee County,0,3,-3
28,Mississippi,19,Iowa,37,Chickasaw County,18,0,18
28,Mississippi,19,Iowa,45,Clinton County,7,5,2
28,Mississippi,19,Iowa,57,Des Moines County,0,32,-32
28,Mississippi,19,Iowa,61,Dubuque County,0,2,-2
28,Mississippi,19,Iowa,65,Fayette County,0,3,-3
28,Mississippi,19,Iowa,71,Fremont County,0,12,-12
28,Mississippi,19,Iowa,79,Hamilton County,0,15,-15
28,Mississippi,19,Iowa,91,Humboldt County,7,0,7
28,Mississippi,19,Iowa,103,Johnson County,32,5,27
28,Mississippi,19,Iowa,111,Lee County,4,20,-16
28,Mississippi,19,Iowa,113,Linn County,0,6,-6
28,Mississippi,19,Iowa,115,Louisa County,0,48,-48
28,Mississippi,19,Iowa,117,Lucas County,0,9,-9
28,Mississippi,19,Iowa,129,Mills County,36,0,36
28,Mississippi,19,Iowa,133,Monona County,0,41,-41
28,Mississippi,19,Iowa,139,Muscatine County,20,0,20
28,Mississippi,19,Iowa,153,Polk County,0,21,-21
28,Mississippi,19,Iowa,155,Pottawattamie County,13,5,8
28,Mississippi,19,Iowa,157,Poweshiek County,12,0,12
28,Mississippi,19,Iowa,163,Scott County,51,0,51
28,Mississippi,19,Iowa,167,Sioux County,0,1,-1
28,Mississippi,19,Iowa,169,Story County,0,7,-7
28,Mississippi,19,Iowa,187,Webster County,23,0,23
28,Mississippi,19,Iowa,193,Woodbury County,0,17,-17
28,Mississippi,2,Alaska,20,Anchorage Municipality,152,55,97
28,Mississippi,2,Alaska,90,Fairbanks North Star Borough,32,24,8
28,Mississippi,2,Alaska,110,Juneau City and Borough,0,10,-10
28,Mississippi,2,Alaska,122,Kenai Peninsula Borough,0,28,-28
28,Mississippi,2,Alaska,198,Prince of Wales-Hyder Census Area,0,12,-12
28,Mississippi,2,Alaska,220,Sitka City and Borough,0,5,-5
28,Mississippi,2,Alaska,230,Skagway Municipality,0,2,-2
28,Mississippi,2,Alaska,261,Valdez-Cordova Census Area,0,2,-2
28,Mississippi,2,Alaska,290,Yukon-Koyukuk Census Area,0,2,-2
28,Mississippi,20,Kansas,11,Bourbon County,0,24,-24
28,Mississippi,20,Kansas,35,Cowley County,30,0,30
28,Mississippi,20,Kansas,45,Douglas County,39,0,39
28,Mississippi,20,Kansas,47,Edwards County,0,8,-8
28,Mississippi,20,Kansas,57,Ford County,0,15,-15
28,Mississippi,20,Kansas,61,Geary County,16,0,16
28,Mississippi,20,Kansas,79,Harvey County,7,0,7
28,Mississippi,20,Kansas,85,Jackson County,0,7,-7
28,Mississippi,20,Kansas,91,Johnson County,34,72,-38
28,Mississippi,20,Kansas,103,Leavenworth County,39,0,39
28,Mississippi,20,Kansas,115,Marion County,0,1,-1
28,Mississippi,20,Kansas,133,Neosho County,0,8,-8
28,Mississippi,20,Kansas,145,Pawnee County,0,10,-10
28,Mississippi,20,Kansas,161,Riley County,7,0,7
28,Mississippi,20,Kansas,173,Sedgwick County,41,24,17
28,Mississippi,20,Kansas,209,Wyandotte County,9,0,9
28,Mississippi,21,Kentucky,1,Adair County,43,0,43
28,Mississippi,21,Kentucky,9,Barren County,4,0,4
28,Mississippi,21,Kentucky,13,Bell County,0,13,-13
28,Mississippi,21,Kentucky,15,Boone County,40,0,40
28,Mississippi,21,Kentucky,19,Boyd County,10,1,9
28,Mississippi,21,Kentucky,25,Breathitt County,3,0,3
28,Mississippi,21,Kentucky,27,Breckinridge County,2,0,2
28,Mississippi,21,Kentucky,33,Caldwell County,0,36,-36
28,Mississippi,21,Kentucky,35,Calloway County,0,14,-14
28,Mississippi,21,Kentucky,37,Campbell County,7,0,7
28,Mississippi,21,Kentucky,43,Carter County,3,0,3
28,Mississippi,21,Kentucky,47,Christian County,223,206,17
28,Mississippi,21,Kentucky,51,Clay County,0,7,-7
28,Mississippi,21,Kentucky,55,Crittenden County,6,0,6
28,Mississippi,21,Kentucky,59,Daviess County,0,1,-1
28,Mississippi,21,Kentucky,61,Edmonson County,0,20,-20
28,Mississippi,21,Kentucky,65,Estill County,12,5,7
28,Mississippi,21,Kentucky,67,Fayette County,29,215,-186
28,Mississippi,21,Kentucky,73,Franklin County,6,50,-44
28,Mississippi,21,Kentucky,75,Fulton County,0,1,-1
28,Mississippi,21,Kentucky,81,Grant County,4,0,4
28,Mississippi,21,Kentucky,83,Graves County,0,1,-1
28,Mississippi,21,Kentucky,93,Hardin County,66,21,45
28,Mississippi,21,Kentucky,95,Harlan County,0,2,-2
28,Mississippi,21,Kentucky,111,Jefferson County,262,90,172
28,Mississippi,21,Kentucky,113,Jessamine County,0,21,-21
28,Mississippi,21,Kentucky,117,Kenton County,15,0,15
28,Mississippi,21,Kentucky,123,Larue County,0,1,-1
28,Mississippi,21,Kentucky,127,Lawrence County,10,40,-30
28,Mississippi,21,Kentucky,141,Logan County,11,0,11
28,Mississippi,21,Kentucky,145,McCracken County,22,0,22
28,Mississippi,21,Kentucky,147,McCreary County,0,13,-13
28,Mississippi,21,Kentucky,151,Madison County,16,0,16
28,Mississippi,21,Kentucky,165,Menifee County,0,2,-2
28,Mississippi,21,Kentucky,167,Mercer County,7,0,7
28,Mississippi,21,Kentucky,173,Montgomery County,0,3,-3
28,Mississippi,21,Kentucky,175,Morgan County,10,0,10
28,Mississippi,21,Kentucky,179,Nelson County,0,1,-1
28,Mississippi,21,Kentucky,185,Oldham County,8,42,-34
28,Mississippi,21,Kentucky,191,Pendleton County,1,0,1
28,Mississippi,21,Kentucky,199,Pulaski County,5,0,5
28,Mississippi,21,Kentucky,217,Taylor County,0,4,-4
28,Mississippi,21,Kentucky,225,Union County,0,43,-43
28,Mississippi,21,Kentucky,227,Warren County,0,48,-48
28,Mississippi,21,Kentucky,231,Wayne County,2,0,2
28,Mississippi,21,Kentucky,233,Webster County,5,0,5
28,Mississippi,22,Louisiana,1,Acadia Parish,21,48,-27
28,Mississippi,22,Louisiana,3,Allen Parish,22,11,11
28,Mississippi,22,Louisiana,5,Ascension Parish,320,138,182
28,Mississippi,22,Louisiana,7,Assumption Parish,91,42,49
28,Mississippi,22,Louisiana,9,Avoyelles Parish,0,19,-19
28,Mississippi,22,Louisiana,11,Beauregard Parish,0,12,-12
28,Mississippi,22,Louisiana,15,Bossier Parish,315,462,-147
28,Mississippi,22,Louisiana,17,Caddo Parish,39,119,-80
28,Mississippi,22,Louisiana,19,Calcasieu Parish,69,396,-327
28,Mississippi,22,Louisiana,25,Catahoula Parish,0,4,-4
28,Mississippi,22,Louisiana,29,Concordia Parish,163,250,-87
28,Mississippi,22,Louisiana,31,De Soto Parish,17,3,14
28,Mississippi,22,Louisiana,33,East Baton Rouge Parish,689,1411,-722
28,Mississippi,22,Louisiana,35,East Carroll Parish,107,54,53
28,Mississippi,22,Louisiana,37,East Feliciana Parish,30,11,19
28,Mississippi,22,Louisiana,39,Evangeline Parish,0,69,-69
28,Mississippi,22,Louisiana,41,Franklin Parish,25,0,25
28,Mississippi,22,Louisiana,43,Grant Parish,0,18,-18
28,Mississippi,22,Louisiana,51,Jefferson Parish,1251,522,729
28,Mississippi,22,Louisiana,55,Lafayette Parish,125,286,-161
28,Mississippi,22,Louisiana,57,Lafourche Parish,73,121,-48
28,Mississippi,22,Louisiana,59,LaSalle Parish,0,13,-13
28,Mississippi,22,Louisiana,61,Lincoln Parish,5,28,-23
28,Mississippi,22,Louisiana,63,Livingston Parish,207,230,-23
28,Mississippi,22,Louisiana,65,Madison Parish,138,90,48
28,Mississippi,22,Louisiana,67,Morehouse Parish,2,39,-37
28,Mississippi,22,Louisiana,69,Natchitoches Parish,198,7,191
28,Mississippi,22,Louisiana,71,Orleans Parish,486,881,-395
28,Mississippi,22,Louisiana,73,Ouachita Parish,197,78,119
28,Mississippi,22,Louisiana,75,Plaquemines Parish,40,14,26
28,Mississippi,22,Louisiana,77,Pointe Coupee Parish,0,34,-34
28,Mississippi,22,Louisiana,79,Rapides Parish,36,203,-167
28,Mississippi,22,Louisiana,81,Red River Parish,0,1,-1
28,Mississippi,22,Louisiana,83,Richland Parish,0,44,-44
28,Mississippi,22,Louisiana,85,Sabine Parish,0,15,-15
28,Mississippi,22,Louisiana,87,St. Bernard Parish,122,125,-3
28,Mississippi,22,Louisiana,89,St. Charles Parish,50,46,4
28,Mississippi,22,Louisiana,93,St. James Parish,11,0,11
28,Mississippi,22,Louisiana,95,St. John the Baptist Parish,74,6,68
28,Mississippi,22,Louisiana,97,St. Landry Parish,57,3,54
28,Mississippi,22,Louisiana,99,St. Martin Parish,0,26,-26
28,Mississippi,22,Louisiana,101,St. Mary Parish,0,43,-43
28,Mississippi,22,Louisiana,103,St. Tammany Parish,1524,964,560
28,Mississippi,22,Louisiana,105,Tangipahoa Parish,284,488,-204
28,Mississippi,22,Louisiana,107,Tensas Parish,8,22,-14
28,Mississippi,22,Louisiana,109,Terrebonne Parish,194,204,-10
28,Mississippi,22,Louisiana,111,Union Parish,11,7,4
28,Mississippi,22,Louisiana,113,Vermilion Parish,58,1,57
28,Mississippi,22,Louisiana,115,Vernon Parish,18,233,-215
28,Mississippi,22,Louisiana,117,Washington Parish,652,410,242
28,Mississippi,22,Louisiana,119,Webster Parish,19,0,19
28,Mississippi,22,Louisiana,121,West Baton Rouge Parish,17,166,-149
28,Mississippi,22,Louisiana,123,West Carroll Parish,88,0,88
28,Mississippi,22,Louisiana,125,West Feliciana Parish,0,42,-42
28,Mississippi,22,Louisiana,127,Winn Parish,0,12,-12
28,Mississippi,23,Maine,3,Aroostook County,13,0,13
28,Mississippi,23,Maine,5,Cumberland County,36,0,36
28,Mississippi,23,Maine,17,Oxford County,18,0,18
28,Mississippi,23,Maine,19,Penobscot County,0,4,-4
28,Mississippi,23,Maine,31,York County,0,6,-6
28,Mississippi,24,Maryland,1,Allegany County,0,33,-33
28,Mississippi,24,Maryland,3,Anne Arundel County,71,25,46
28,Mississippi,24,Maryland,5,Baltimore County,21,23,-2
28,Mississippi,24,Maryland,9,Calvert County,43,55,-12
28,Mississippi,24,Maryland,17,Charles County,9,10,-1
28,Mississippi,24,Maryland,27,Howard County,11,210,-199
28,Mississippi,24,Maryland,31,Montgomery County,133,92,41
28,Mississippi,24,Maryland,33,Prince George's County,123,104,19
28,Mississippi,24,Maryland,37,St. Mary's County,45,176,-131
28,Mississippi,24,Maryland,39,Somerset County,0,15,-15
28,Mississippi,24,Maryland,41,Talbot County,17,0,17
28,Mississippi,24,Maryland,43,Washington County,50,31,19
28,Mississippi,24,Maryland,510,Baltimore city,16,14,2
28,Mississippi,25,Massachusetts,1,Barnstable County,57,0,57
28,Mississippi,25,Massachusetts,5,Bristol County,21,114,-93
28,Mississippi,25,Massachusetts,9,Essex County,0,33,-33
28,Mississippi,25,Massachusetts,11,Franklin County,0,8,-8
28,Mississippi,25,Massachusetts,13,Hampden County,20,0,20
28,Mississippi,25,Massachusetts,15,Hampshire County,0,22,-22
28,Mississippi,25,Massachusetts,17,Middlesex County,116,24,92
28,Mississippi,25,Massachusetts,21,Norfolk County,118,12,106
28,Mississippi,25,Massachusetts,23,Plymouth County,19,22,-3
28,Mississippi,25,Massachusetts,27,Worcester County,48,8,40
28,Mississippi,26,Michigan,5,Allegan County,0,13,-13
28,Mississippi,26,Michigan,7,Alpena County,7,0,7
28,Mississippi,26,Michigan,13,Baraga County,0,7,-7
28,Mississippi,26,Michigan,17,Bay County,12,39,-27
28,Mississippi,26,Michigan,19,Benzie County,0,16,-16
28,Mississippi,26,Michigan,21,Berrien County,28,125,-97
28,Mississippi,26,Michigan,23,Branch County,0,10,-10
28,Mississippi,26,Michigan,25,Calhoun County,93,31,62
28,Mississippi,26,Michigan,29,Charlevoix County,19,6,13
28,Mississippi,26,Michigan,45,Eaton County,0,36,-36
28,Mississippi,26,Michigan,49,Genesee County,26,57,-31
28,Mississippi,26,Michigan,59,Hillsdale County,0,5,-5
28,Mississippi,26,Michigan,63,Huron County,0,5,-5
28,Mississippi,26,Michigan,65,Ingham County,12,23,-11
28,Mississippi,26,Michigan,71,Iron County,0,10,-10
28,Mississippi,26,Michigan,77,Kalamazoo County,61,250,-189
28,Mississippi,26,Michigan,79,Kalkaska County,0,8,-8
28,Mississippi,26,Michigan,81,Kent County,82,14,68
28,Mississippi,26,Michigan,95,Luce County,0,3,-3
28,Mississippi,26,Michigan,97,Mackinac County,0,2,-2
28,Mississippi,26,Michigan,99,Macomb County,27,72,-45
28,Mississippi,26,Michigan,105,Mason County,0,23,-23
28,Mississippi,26,Michigan,107,Mecosta County,99,0,99
28,Mississippi,26,Michigan,115,Monroe County,0,6,-6
28,Mississippi,26,Michigan,121,Muskegon County,5,25,-20
28,Mississippi,26,Michigan,123,Newaygo County,0,22,-22
28,Mississippi,26,Michigan,125,Oakland County,25,60,-35
28,Mississippi,26,Michigan,139,Ottawa County,33,54,-21
28,Mississippi,26,Michigan,143,Roscommon County,0,12,-12
28,Mississippi,26,Michigan,145,Saginaw County,32,35,-3
28,Mississippi,26,Michigan,147,St. Clair County,168,16,152
28,Mississippi,26,Michigan,157,Tuscola County,0,18,-18
28,Mississippi,26,Michigan,161,Washtenaw County,23,55,-32
28,Mississippi,26,Michigan,163,Wayne County,423,264,159
28,Mississippi,26,Michigan,165,Wexford County,0,2,-2
28,Mississippi,27,Minnesota,1,Aitkin County,0,22,-22
28,Mississippi,27,Minnesota,3,Anoka County,0,19,-19
28,Mississippi,27,Minnesota,9,Benton County,0,1,-1
28,Mississippi,27,Minnesota,15,Brown County,0,3,-3
28,Mississippi,27,Minnesota,37,Dakota County,0,12,-12
28,Mississippi,27,Minnesota,47,Freeborn County,11,0,11
28,Mississippi,27,Minnesota,53,Hennepin County,32,40,-8
28,Mississippi,27,Minnesota,55,Houston County,0,7,-7
28,Mississippi,27,Minnesota,75,Lake County,0,1,-1
28,Mississippi,27,Minnesota,79,Le Sueur County,0,11,-11
28,Mississippi,27,Minnesota,89,Marshall County,0,9,-9
28,Mississippi,27,Minnesota,95,Mille Lacs County,0,12,-12
28,Mississippi,27,Minnesota,109,Olmsted County,16,18,-2
28,Mississippi,27,Minnesota,123,Ramsey County,46,45,1
28,Mississippi,27,Minnesota,139,Scott County,10,0,10
28,Mississippi,27,Minnesota,145,Stearns County,21,0,21
28,Mississippi,27,Minnesota,147,Steele County,0,72,-72
28,Mississippi,27,Minnesota,163,Washington County,0,70,-70
28,Mississippi,27,Minnesota,173,Yellow Medicine County,15,0,15
28,Mississippi,28,Mississippi,1,Adams County,1381,155,1226
28,Mississippi,28,Mississippi,3,Alcorn County,1333,1197,136
28,Mississippi,28,Mississippi,5,Amite County,173,316,-143
28,Mississippi,28,Mississippi,7,Attala County,659,871,-212
28,Mississippi,28,Mississippi,9,Benton County,469,334,135
28,Mississippi,28,Mississippi,11,Bolivar County,1675,1056,619
28,Mississippi,28,Mississippi,13,Calhoun County,583,415,168
28,Mississippi,28,Mississippi,15,Carroll County,681,198,483
28,Mississippi,28,Mississippi,17,Chickasaw County,1022,696,326
28,Mississippi,28,Mississippi,19,Choctaw County,504,363,141
28,Mississippi,28,Mississippi,21,Claiborne County,257,196,61
28,Mississippi,28,Mississippi,23,Clarke County,616,221,395
28,Mississippi,28,Mississippi,25,Clay County,693,458,235
28,Mississippi,28,Mississippi,27,Coahoma County,895,377,518
28,Mississippi,28,Mississippi,29,Copiah County,1020,720,300
28,Mississippi,28,Mississippi,31,Covington County,530,571,-41
28,Mississippi,28,Mississippi,33,DeSoto County,2956,3791,-835
28,Mississippi,28,Mississippi,35,Forrest County,7119,6043,1076
28,Mississippi,28,Mississippi,37,Franklin County,295,145,150
28,Mississippi,28,Mississippi,39,George County,477,847,-370
28,Mississippi,28,Mississippi,41,Greene County,736,1431,-695
28,Mississippi,28,Mississippi,43,Grenada County,913,572,341
28,Mississippi,28,Mississippi,45,Hancock County,1333,1028,305
28,Mississippi,28,Mississippi,47,Harrison County,4669,7269,-2600
28,Mississippi,28,Mississippi,49,Hinds County,8804,8021,783
28,Mississippi,28,Mississippi,51,Holmes County,821,455,366
28,Mississippi,28,Mississippi,53,Humphreys County,134,104,30
28,Mississippi,28,Mississippi,55,Issaquena County,50,195,-145
28,Mississippi,28,Mississippi,57,Itawamba County,890,1699,-809
28,Mississippi,28,Mississippi,59,Jackson County,4060,2760,1300
28,Mississippi,28,Mississippi,61,Jasper County,743,637,106
28,Mississippi,28,Mississippi,63,Jefferson County,257,139,118
28,Mississippi,28,Mississippi,65,Jefferson Davis County,537,362,175
28,Mississippi,28,Mississippi,67,Jones County,1498,1300,198
28,Mississippi,28,Mississippi,69,Kemper County,297,434,-137
28,Mississippi,28,Mississippi,71,Lafayette County,2183,3251,-1068
28,Mississippi,28,Mississippi,73,Lamar County,3519,6177,-2658
28,Mississippi,28,Mississippi,75,Lauderdale County,1594,1994,-400
28,Mississippi,28,Mississippi,77,Lawrence County,247,300,-53
28,Mississippi,28,Mississippi,79,Leake County,1186,898,288
28,Mississippi,28,Mississippi,81,Lee County,4123,3488,635
28,Mississippi,28,Mississippi,83,Leflore County,705,626,79
28,Mississippi,28,Mississippi,85,Lincoln County,757,757,0
28,Mississippi,28,Mississippi,87,Lowndes County,1677,1347,330
28,Mississippi,28,Mississippi,89,Madison County,4317,5785,-1468
28,Mississippi,28,Mississippi,91,Marion County,961,1050,-89
28,Mississippi,28,Mississippi,93,Marshall County,1428,1169,259
28,Mississippi,28,Mississippi,95,Monroe County,1125,1059,66
28,Mississippi,28,Mississippi,97,Montgomery County,224,300,-76
28,Mississippi,28,Mississippi,99,Neshoba County,1370,975,395
28,Mississippi,28,Mississippi,101,Newton County,741,1073,-332
28,Mississippi,28,Mississippi,103,Noxubee County,443,89,354
28,Mississippi,28,Mississippi,105,Oktibbeha County,2349,3716,-1367
28,Mississippi,28,Mississippi,107,Panola County,1439,1094,345
28,Mississippi,28,Mississippi,109,Pearl River County,1159,1212,-53
28,Mississippi,28,Mississippi,111,Perry County,807,377,430
28,Mississippi,28,Mississippi,113,Pike County,791,846,-55
28,Mississippi,28,Mississippi,115,Pontotoc County,1208,1485,-277
28,Mississippi,28,Mississippi,117,Prentiss County,896,1209,-313
28,Mississippi,28,Mississippi,119,Quitman County,591,171,420
28,Mississippi,28,Mississippi,121,Rankin County,5748,8047,-2299
28,Mississippi,28,Mississippi,123,Scott County,1451,789,662
28,Mississippi,28,Mississippi,125,Sharkey County,260,131,129
28,Mississippi,28,Mississippi,127,Simpson County,1283,1348,-65
28,Mississippi,28,Mississippi,129,Smith County,640,415,225
28,Mississippi,28,Mississippi,131,Stone County,1438,468,970
28,Mississippi,28,Mississippi,133,Sunflower County,1600,1594,6
28,Mississippi,28,Mississippi,135,Tallahatchie County,336,161,175
28,Mississippi,28,Mississippi,137,Tate County,1607,2029,-422
28,Mississippi,28,Mississippi,139,Tippah County,661,376,285
28,Mississippi,28,Mississippi,141,Tishomingo County,740,437,303
28,Mississippi,28,Mississippi,143,Tunica County,416,888,-472
28,Mississippi,28,Mississippi,145,Union County,1289,661,628
28,Mississippi,28,Mississippi,147,Walthall County,347,338,9
28,Mississippi,28,Mississippi,149,Warren County,1022,643,379
28,Mississippi,28,Mississippi,151,Washington County,1102,706,396
28,Mississippi,28,Mississippi,153,Wayne County,247,482,-235
28,Mississippi,28,Mississippi,155,Webster County,379,359,20
28,Mississippi,28,Mississippi,157,Wilkinson County,415,547,-132
28,Mississippi,28,Mississippi,159,Winston County,887,873,14
28,Mississippi,28,Mississippi,161,Yalobusha County,419,306,113
28,Mississippi,28,Mississippi,163,Yazoo County,785,570,215
28,Mississippi,29,Missouri,19,Boone County,90,80,10
28,Mississippi,29,Missouri,21,Buchanan County,0,12,-12
28,Mississippi,29,Missouri,23,Butler County,50,3,47
28,Mississippi,29,Missouri,25,Caldwell County,0,11,-11
28,Mississippi,29,Missouri,27,Callaway County,14,0,14
28,Mississippi,29,Missouri,31,Cape Girardeau County,64,24,40
28,Mississippi,29,Missouri,37,Cass County,276,0,276
28,Mississippi,29,Missouri,43,Christian County,9,13,-4
28,Mississippi,29,Missouri,47,Clay County,16,0,16
28,Mississippi,29,Missouri,51,Cole County,13,0,13
28,Mississippi,29,Missouri,59,Dallas County,0,5,-5
28,Mississippi,29,Missouri,65,Dent County,0,2,-2
28,Mississippi,29,Missouri,69,Dunklin County,0,30,-30
28,Mississippi,29,Missouri,71,Franklin County,56,3,53
28,Mississippi,29,Missouri,73,Gasconade County,79,0,79
28,Mississippi,29,Missouri,77,Greene County,6,73,-67
28,Mississippi,29,Missouri,85,Hickory County,16,0,16
28,Mississippi,29,Missouri,95,Jackson County,11,99,-88
28,Mississippi,29,Missouri,97,Jasper County,16,60,-44
28,Mississippi,29,Missouri,99,Jefferson County,18,147,-129
28,Mississippi,29,Missouri,101,Johnson County,0,27,-27
28,Mississippi,29,Missouri,107,Lafayette County,0,38,-38
28,Mississippi,29,Missouri,113,Lincoln County,17,9,8
28,Mississippi,29,Missouri,119,McDonald County,31,0,31
28,Mississippi,29,Missouri,143,New Madrid County,0,11,-11
28,Mississippi,29,Missouri,145,Newton County,0,12,-12
28,Mississippi,29,Missouri,147,Nodaway County,0,3,-3
28,Mississippi,29,Missouri,153,Ozark County,0,13,-13
28,Mississippi,29,Missouri,155,Pemiscot County,23,4,19
28,Mississippi,29,Missouri,157,Perry County,0,39,-39
28,Mississippi,29,Missouri,159,Pettis County,0,24,-24
28,Mississippi,29,Missouri,161,Phelps County,0,36,-36
28,Mississippi,29,Missouri,165,Platte County,0,32,-32
28,Mississippi,29,Missouri,169,Pulaski County,76,302,-226
28,Mississippi,29,Missouri,183,St. Charles County,0,55,-55
28,Mississippi,29,Missouri,185,St. Clair County,0,40,-40
28,Mississippi,29,Missouri,187,St. Francois County,0,32,-32
28,Mississippi,29,Missouri,189,St. Louis County,207,244,-37
28,Mississippi,29,Missouri,207,Stoddard County,25,0,25
28,Mississippi,29,Missouri,213,Taney County,30,51,-21
28,Mississippi,29,Missouri,215,Texas County,0,3,-3
28,Mississippi,29,Missouri,510,St. Louis city,87,47,40
28,Mississippi,30,Montana,3,Big Horn County,0,21,-21
28,Mississippi,30,Montana,9,Carbon County,10,7,3
28,Mississippi,30,Montana,13,Cascade County,42,111,-69
28,Mississippi,30,Montana,29,Flathead County,58,0,58
28,Mississippi,30,Montana,47,Lake County,5,0,5
28,Mississippi,30,Montana,49,Lewis and Clark County,0,24,-24
28,Mississippi,30,Montana,63,Missoula County,17,0,17
28,Mississippi,30,Montana,81,Ravalli County,6,0,6
28,Mississippi,30,Montana,83,Richland County,36,0,36
28,Mississippi,30,Montana,101,Toole County,39,0,39
28,Mississippi,30,Montana,111,Yellowstone County,40,25,15
28,Mississippi,31,Nebraska,25,Cass County,9,0,9
28,Mississippi,31,Nebraska,43,Dakota County,14,0,14
28,Mississippi,31,Nebraska,53,Dodge County,0,8,-8
28,Mississippi,31,Nebraska,55,Douglas County,130,27,103
28,Mississippi,31,Nebraska,83,Harlan County,0,1,-1
28,Mississippi,31,Nebraska,109,Lancaster County,105,60,45
28,Mississippi,31,Nebraska,119,Madison County,163,0,163
28,Mississippi,31,Nebraska,153,Sarpy County,83,42,41
28,Mississippi,31,Nebraska,185,York County,9,0,9
28,Mississippi,32,Nevada,1,Churchill County,0,20,-20
28,Mississippi,32,Nevada,3,Clark County,331,414,-83
28,Mississippi,32,Nevada,5,Douglas County,75,0,75
28,Mississippi,32,Nevada,13,Humboldt County,10,0,10
28,Mississippi,32,Nevada,31,Washoe County,19,0,19
28,Mississippi,33,New Hampshire,9,Grafton County,0,87,-87
28,Mississippi,33,New Hampshire,11,Hillsborough County,0,38,-38
28,Mississippi,33,New Hampshire,15,Rockingham County,24,0,24
28,Mississippi,33,New Hampshire,17,Strafford County,0,31,-31
28,Mississippi,33,New Hampshire,19,Sullivan County,43,0,43
28,Mississippi,34,New Jersey,3,Bergen County,266,0,266
28,Mississippi,34,New Jersey,5,Burlington County,189,76,113
28,Mississippi,34,New Jersey,7,Camden County,50,10,40
28,Mississippi,34,New Jersey,11,Cumberland County,0,17,-17
28,Mississippi,34,New Jersey,13,Essex County,10,0,10
28,Mississippi,34,New Jersey,15,Gloucester County,8,0,8
28,Mississippi,34,New Jersey,17,Hudson County,0,19,-19
28,Mississippi,34,New Jersey,19,Hunterdon County,22,0,22
28,Mississippi,34,New Jersey,21,Mercer County,0,13,-13
28,Mississippi,34,New Jersey,23,Middlesex County,16,0,16
28,Mississippi,34,New Jersey,27,Morris County,6,0,6
28,Mississippi,34,New Jersey,29,Ocean County,4,56,-52
28,Mississippi,34,New Jersey,31,Passaic County,12,0,12
28,Mississippi,34,New Jersey,33,Salem County,0,15,-15
28,Mississippi,34,New Jersey,41,Warren County,24,0,24
28,Mississippi,35,New Mexico,1,Bernalillo County,94,59,35
28,Mississippi,35,New Mexico,3,Catron County,0,12,-12
28,Mississippi,35,New Mexico,5,Chaves County,0,20,-20
28,Mississippi,35,New Mexico,9,Curry County,8,0,8
28,Mississippi,35,New Mexico,13,Doña Ana County,70,28,42
28,Mississippi,35,New Mexico,17,Grant County,0,21,-21
28,Mississippi,35,New Mexico,25,Lea County,11,0,11
28,Mississippi,35,New Mexico,28,Los Alamos County,0,8,-8
28,Mississippi,35,New Mexico,31,McKinley County,0,44,-44
28,Mississippi,35,New Mexico,35,Otero County,26,138,-112
28,Mississippi,35,New Mexico,41,Roosevelt County,0,16,-16
28,Mississippi,35,New Mexico,43,Sandoval County,0,13,-13
28,Mississippi,35,New Mexico,49,Santa Fe County,1,0,1
28,Mississippi,35,New Mexico,55,Taos County,25,0,25
28,Mississippi,35,New Mexico,57,Torrance County,19,0,19
28,Mississippi,35,New Mexico,61,Valencia County,0,45,-45
28,Mississippi,36,New York,3,Allegany County,0,5,-5
28,Mississippi,36,New York,5,Bronx County,22,0,22
28,Mississippi,36,New York,7,Broome County,0,19,-19
28,Mississippi,36,New York,15,Chemung County,0,2,-2
28,Mississippi,36,New York,17,Chenango County,0,25,-25
28,Mississippi,36,New York,19,Clinton County,0,32,-32
28,Mississippi,36,New York,21,Columbia County,14,0,14
28,Mississippi,36,New York,23,Cortland County,6,0,6
28,Mississippi,36,New York,25,Delaware County,0,9,-9
28,Mississippi,36,New York,27,Dutchess County,35,24,11
28,Mississippi,36,New York,29,Erie County,0,38,-38
28,Mississippi,36,New York,33,Franklin County,0,4,-4
28,Mississippi,36,New York,37,Genesee County,0,106,-106
28,Mississippi,36,New York,39,Greene County,0,2,-2
28,Mississippi,36,New York,45,Jefferson County,12,34,-22
28,Mississippi,36,New York,47,Kings County,78,55,23
28,Mississippi,36,New York,53,Madison County,48,0,48
28,Mississippi,36,New York,55,Monroe County,24,29,-5
28,Mississippi,36,New York,59,Nassau County,6,2,4
28,Mississippi,36,New York,61,New York County,30,219,-189
28,Mississippi,36,New York,67,Onondaga County,34,96,-62
28,Mississippi,36,New York,69,Ontario County,0,9,-9
28,Mississippi,36,New York,71,Orange County,0,17,-17
28,Mississippi,36,New York,75,Oswego County,32,0,32
28,Mississippi,36,New York,81,Queens County,37,90,-53
28,Mississippi,36,New York,87,Rockland County,24,0,24
28,Mississippi,36,New York,89,St. Lawrence County,44,0,44
28,Mississippi,36,New York,93,Schenectady County,26,0,26
28,Mississippi,36,New York,101,Steuben County,20,5,15
28,Mississippi,36,New York,103,Suffolk County,0,113,-113
28,Mississippi,36,New York,109,Tompkins County,27,0,27
28,Mississippi,36,New York,111,Ulster County,28,0,28
28,Mississippi,36,New York,117,Wayne County,0,18,-18
28,Mississippi,36,New York,119,Westchester County,5,0,5
28,Mississippi,36,New York,123,Yates County,15,7,8
28,Mississippi,37,North Carolina,1,Alamance County,0,3,-3
28,Mississippi,37,North Carolina,7,Anson County,0,19,-19
28,Mississippi,37,North Carolina,13,Beaufort County,3,0,3
28,Mississippi,37,North Carolina,19,Brunswick County,10,6,4
28,Mississippi,37,North Carolina,21,Buncombe County,20,78,-58
28,Mississippi,37,North Carolina,23,Burke County,0,7,-7
28,Mississippi,37,North Carolina,27,Caldwell County,66,0,66
28,Mississippi,37,North Carolina,31,Carteret County,0,6,-6
28,Mississippi,37,North Carolina,35,Catawba County,9,0,9
28,Mississippi,37,North Carolina,39,Cherokee County,0,10,-10
28,Mississippi,37,North Carolina,45,Cleveland County,0,2,-2
28,Mississippi,37,North Carolina,49,Craven County,82,18,64
28,Mississippi,37,North Carolina,51,Cumberland County,83,150,-67
28,Mississippi,37,North Carolina,57,Davidson County,26,65,-39
28,Mississippi,37,North Carolina,59,Davie County,4,0,4
28,Mississippi,37,North Carolina,61,Duplin County,11,0,11
28,Mississippi,37,North Carolina,63,Durham County,19,58,-39
28,Mississippi,37,North Carolina,65,Edgecombe County,0,7,-7
28,Mississippi,37,North Carolina,67,Forsyth County,1,45,-44
28,Mississippi,37,North Carolina,69,Franklin County,2,0,2
28,Mississippi,37,North Carolina,71,Gaston County,32,0,32
28,Mississippi,37,North Carolina,75,Graham County,0,64,-64
28,Mississippi,37,North Carolina,79,Greene County,0,31,-31
28,Mississippi,37,North Carolina,81,Guilford County,15,0,15
28,Mississippi,37,North Carolina,85,Harnett County,64,38,26
28,Mississippi,37,North Carolina,87,Haywood County,22,0,22
28,Mississippi,37,North Carolina,93,Hoke County,25,102,-77
28,Mississippi,37,North Carolina,97,Iredell County,0,20,-20
28,Mississippi,37,North Carolina,99,Jackson County,65,0,65
28,Mississippi,37,North Carolina,101,Johnston County,17,0,17
28,Mississippi,37,North Carolina,107,Lenoir County,44,0,44
28,Mississippi,37,North Carolina,113,Macon County,0,4,-4
28,Mississippi,37,North Carolina,119,Mecklenburg County,283,189,94
28,Mississippi,37,North Carolina,125,Moore County,0,7,-7
28,Mississippi,37,North Carolina,127,Nash County,0,1,-1
28,Mississippi,37,North Carolina,129,New Hanover County,0,65,-65
28,Mississippi,37,North Carolina,133,Onslow County,65,61,4
28,Mississippi,37,North Carolina,135,Orange County,0,114,-114
28,Mississippi,37,North Carolina,153,Richmond County,0,1,-1
28,Mississippi,37,North Carolina,157,Rockingham County,0,1,-1
28,Mississippi,37,North Carolina,159,Rowan County,18,0,18
28,Mississippi,37,North Carolina,165,Scotland County,19,1,18
28,Mississippi,37,North Carolina,167,Stanly County,0,15,-15
28,Mississippi,37,North Carolina,175,Transylvania County,0,8,-8
28,Mississippi,37,North Carolina,179,Union County,0,21,-21
28,Mississippi,37,North Carolina,181,Vance County,0,13,-13
28,Mississippi,37,North Carolina,183,Wake County,117,68,49
28,Mississippi,37,North Carolina,189,Watauga County,23,11,12
28,Mississippi,37,North Carolina,191,Wayne County,121,14,107
28,Mississippi,37,North Carolina,195,Wilson County,9,0,9
28,Mississippi,38,North Dakota,15,Burleigh County,0,7,-7
28,Mississippi,38,North Dakota,17,Cass County,4,0,4
28,Mississippi,38,North Dakota,25,Dunn County,0,26,-26
28,Mississippi,38,North Dakota,35,Grand Forks County,0,116,-116
28,Mississippi,38,North Dakota,51,McIntosh County,0,3,-3
28,Mississippi,38,North Dakota,57,Mercer County,0,66,-66
28,Mississippi,38,North Dakota,61,Mountrail County,0,16,-16
28,Mississippi,38,North Dakota,93,Stutsman County,0,12,-12
28,Mississippi,38,North Dakota,101,Ward County,0,122,-122
28,Mississippi,38,North Dakota,105,Williams County,2,10,-8
28,Mississippi,39,Ohio,7,Ashtabula County,0,6,-6
28,Mississippi,39,Ohio,9,Athens County,54,0,54
28,Mississippi,39,Ohio,11,Auglaize County,19,0,19
28,Mississippi,39,Ohio,13,Belmont County,0,37,-37
28,Mississippi,39,Ohio,17,Butler County,47,10,37
28,Mississippi,39,Ohio,23,Clark County,0,26,-26
28,Mississippi,39,Ohio,25,Clermont County,11,0,11
28,Mississippi,39,Ohio,29,Columbiana County,4,0,4
28,Mississippi,39,Ohio,35,Cuyahoga County,23,223,-200
28,Mississippi,39,Ohio,45,Fairfield County,0,25,-25
28,Mississippi,39,Ohio,49,Franklin County,240,78,162
28,Mississippi,39,Ohio,51,Fulton County,15,1,14
28,Mississippi,39,Ohio,57,Greene County,4,0,4
28,Mississippi,39,Ohio,59,Guernsey County,88,4,84
28,Mississippi,39,Ohio,61,Hamilton County,34,169,-135
28,Mississippi,39,Ohio,85,Lake County,10,10,0
28,Mississippi,39,Ohio,93,Lorain County,0,99,-99
28,Mississippi,39,Ohio,95,Lucas County,41,55,-14
28,Mississippi,39,Ohio,99,Mahoning County,0,9,-9
28,Mississippi,39,Ohio,103,Medina County,96,0,96
28,Mississippi,39,Ohio,107,Mercer County,31,0,31
28,Mississippi,39,Ohio,109,Miami County,15,0,15
28,Mississippi,39,Ohio,113,Montgomery County,15,32,-17
28,Mississippi,39,Ohio,115,Morgan County,13,0,13
28,Mississippi,39,Ohio,117,Morrow County,14,98,-84
28,Mississippi,39,Ohio,131,Pike County,0,4,-4
28,Mississippi,39,Ohio,133,Portage County,15,0,15
28,Mississippi,39,Ohio,139,Richland County,0,30,-30
28,Mississippi,39,Ohio,143,Sandusky County,4,0,4
28,Mississippi,39,Ohio,151,Stark County,15,10,5
28,Mississippi,39,Ohio,153,Summit County,45,0,45
28,Mississippi,39,Ohio,155,Trumbull County,59,0,59
28,Mississippi,39,Ohio,157,Tuscarawas County,0,2,-2
28,Mississippi,39,Ohio,165,Warren County,56,0,56
28,Mississippi,39,Ohio,167,Washington County,3,0,3
28,Mississippi,39,Ohio,171,Williams County,16,0,16
28,Mississippi,39,Ohio,173,Wood County,37,0,37
28,Mississippi,4,Arizona,3,Cochise County,70,56,14
28,Mississippi,4,Arizona,5,Coconino County,18,54,-36
28,Mississippi,4,Arizona,7,Gila County,12,10,2
28,Mississippi,4,Arizona,11,Greenlee County,27,0,27
28,Mississippi,4,Arizona,13,Maricopa County,229,242,-13
28,Mississippi,4,Arizona,15,Mohave County,99,0,99
28,Mississippi,4,Arizona,17,Navajo County,5,0,5
28,Mississippi,4,Arizona,19,Pima County,66,143,-77
28,Mississippi,4,Arizona,21,Pinal County,214,180,34
28,Mississippi,4,Arizona,25,Yavapai County,0,9,-9
28,Mississippi,4,Arizona,27,Yuma County,0,6,-6
28,Mississippi,40,Oklahoma,1,Adair County,21,0,21
28,Mississippi,40,Oklahoma,9,Beckham County,188,23,165
28,Mississippi,40,Oklahoma,13,Bryan County,0,24,-24
28,Mississippi,40,Oklahoma,15,Caddo County,18,0,18
28,Mississippi,40,Oklahoma,17,Canadian County,8,154,-146
28,Mississippi,40,Oklahoma,23,Choctaw County,66,10,56
28,Mississippi,40,Oklahoma,27,Cleveland County,41,228,-187
28,Mississippi,40,Oklahoma,31,Comanche County,5,169,-164
28,Mississippi,40,Oklahoma,37,Creek County,0,5,-5
28,Mississippi,40,Oklahoma,39,Custer County,0,4,-4
28,Mississippi,40,Oklahoma,47,Garfield County,0,3,-3
28,Mississippi,40,Oklahoma,65,Jackson County,46,108,-62
28,Mississippi,40,Oklahoma,71,Kay County,0,16,-16
28,Mississippi,40,Oklahoma,77,Latimer County,0,4,-4
28,Mississippi,40,Oklahoma,97,Mayes County,0,2,-2
28,Mississippi,40,Oklahoma,101,Muskogee County,0,6,-6
28,Mississippi,40,Oklahoma,109,Oklahoma County,205,194,11
28,Mississippi,40,Oklahoma,111,Okmulgee County,0,14,-14
28,Mississippi,40,Oklahoma,115,Ottawa County,0,14,-14
28,Mississippi,40,Oklahoma,119,Payne County,124,8,116
28,Mississippi,40,Oklahoma,121,Pittsburg County,0,19,-19
28,Mississippi,40,Oklahoma,123,Pontotoc County,0,17,-17
28,Mississippi,40,Oklahoma,131,Rogers County,0,30,-30
28,Mississippi,40,Oklahoma,133,Seminole County,10,0,10
28,Mississippi,40,Oklahoma,143,Tulsa County,28,110,-82
28,Mississippi,40,Oklahoma,145,Wagoner County,0,4,-4
28,Mississippi,40,Oklahoma,147,Washington County,0,16,-16
28,Mississippi,40,Oklahoma,153,Woodward County,0,1,-1
28,Mississippi,41,Oregon,5,Clackamas County,23,0,23
28,Mississippi,41,Oregon,17,Deschutes County,19,23,-4
28,Mississippi,41,Oregon,33,Josephine County,9,292,-283
28,Mississippi,41,Oregon,35,Klamath County,0,11,-11
28,Mississippi,41,Oregon,39,Lane County,14,23,-9
28,Mississippi,41,Oregon,43,Linn County,34,0,34
28,Mississippi,41,Oregon,47,Marion County,6,0,6
28,Mississippi,41,Oregon,51,Multnomah County,72,55,17
28,Mississippi,41,Oregon,61,Union County,0,25,-25
28,Mississippi,41,Oregon,67,Washington County,0,25,-25
28,Mississippi,41,Oregon,71,Yamhill County,38,0,38
28,Mississippi,42,Pennsylvania,3,Allegheny County,39,70,-31
28,Mississippi,42,Pennsylvania,7,Beaver County,0,19,-19
28,Mississippi,42,Pennsylvania,11,Berks County,39,0,39
28,Mississippi,42,Pennsylvania,13,Blair County,7,0,7
28,Mississippi,42,Pennsylvania,15,Bradford County,5,1,4
28,Mississippi,42,Pennsylvania,17,Bucks County,15,0,15
28,Mississippi,42,Pennsylvania,19,Butler County,0,71,-71
28,Mississippi,42,Pennsylvania,21,Cambria County,42,18,24
28,Mississippi,42,Pennsylvania,27,Centre County,12,0,12
28,Mississippi,42,Pennsylvania,29,Chester County,20,0,20
28,Mississippi,42,Pennsylvania,33,Clearfield County,22,0,22
28,Mississippi,42,Pennsylvania,41,Cumberland County,0,24,-24
28,Mississippi,42,Pennsylvania,45,Delaware County,0,91,-91
28,Mississippi,42,Pennsylvania,49,Erie County,95,0,95
28,Mississippi,42,Pennsylvania,51,Fayette County,10,0,10
28,Mississippi,42,Pennsylvania,53,Forest County,6,0,6
28,Mississippi,42,Pennsylvania,55,Franklin County,97,0,97
28,Mississippi,42,Pennsylvania,63,Indiana County,0,15,-15
28,Mississippi,42,Pennsylvania,73,Lawrence County,0,5,-5
28,Mississippi,42,Pennsylvania,77,Lehigh County,16,125,-109
28,Mississippi,42,Pennsylvania,79,Luzerne County,55,4,51
28,Mississippi,42,Pennsylvania,81,Lycoming County,14,11,3
28,Mississippi,42,Pennsylvania,87,Mifflin County,4,0,4
28,Mississippi,42,Pennsylvania,89,Monroe County,0,9,-9
28,Mississippi,42,Pennsylvania,91,Montgomery County,0,8,-8
28,Mississippi,42,Pennsylvania,95,Northampton County,0,34,-34
28,Mississippi,42,Pennsylvania,101,Philadelphia County,79,70,9
28,Mississippi,42,Pennsylvania,107,Schuylkill County,14,0,14
28,Mississippi,42,Pennsylvania,109,Snyder County,10,0,10
28,Mississippi,42,Pennsylvania,119,Union County,58,20,38
28,Mississippi,42,Pennsylvania,125,Washington County,19,6,13
28,Mississippi,42,Pennsylvania,127,Wayne County,73,0,73
28,Mississippi,42,Pennsylvania,129,Westmoreland County,8,14,-6
28,Mississippi,42,Pennsylvania,131,Wyoming County,0,46,-46
28,Mississippi,42,Pennsylvania,133,York County,25,0,25
28,Mississippi,44,Rhode Island,3,Kent County,0,75,-75
28,Mississippi,44,Rhode Island,5,Newport County,0,14,-14
28,Mississippi,44,Rhode Island,7,Providence County,11,77,-66
28,Mississippi,44,Rhode Island,9,Washington County,4,0,4
28,Mississippi,45,South Carolina,3,Aiken County,25,5,20
28,Mississippi,45,South Carolina,7,Anderson County,33,18,15
28,Mississippi,45,South Carolina,13,Beaufort County,139,76,63
28,Mississippi,45,South Carolina,15,Berkeley County,8,0,8
28,Mississippi,45,South Carolina,19,Charleston County,127,115,12
28,Mississippi,45,South Carolina,21,Cherokee County,7,0,7
28,Mississippi,45,South Carolina,23,Chester County,0,12,-12
28,Mississippi,45,South Carolina,29,Colleton County,0,38,-38
28,Mississippi,45,South Carolina,35,Dorchester County,0,21,-21
28,Mississippi,45,South Carolina,45,Greenville County,211,26,185
28,Mississippi,45,South Carolina,49,Hampton County,0,23,-23
28,Mississippi,45,South Carolina,51,Horry County,0,9,-9
28,Mississippi,45,South Carolina,57,Lancaster County,0,56,-56
28,Mississippi,45,South Carolina,63,Lexington County,325,90,235
28,Mississippi,45,South Carolina,69,Marlboro County,31,16,15
28,Mississippi,45,South Carolina,73,Oconee County,0,13,-13
28,Mississippi,45,South Carolina,77,Pickens County,29,28,1
28,Mississippi,45,South Carolina,79,Richland County,82,365,-283
28,Mississippi,45,South Carolina,83,Spartanburg County,2,133,-131
28,Mississippi,45,South Carolina,85,Sumter County,112,100,12
28,Mississippi,45,South Carolina,91,York County,46,24,22
28,Mississippi,46,South Dakota,19,Butte County,0,9,-9
28,Mississippi,46,South Dakota,35,Davison County,0,3,-3
28,Mississippi,46,South Dakota,39,Deuel County,0,2,-2
28,Mississippi,46,South Dakota,65,Hughes County,0,1,-1
28,Mississippi,46,South Dakota,79,Lake County,0,16,-16
28,Mississippi,46,South Dakota,127,Union County,11,0,11
28,Mississippi,46,South Dakota,135,Yankton County,0,5,-5
28,Mississippi,47,Tennessee,1,Anderson County,28,12,16
28,Mississippi,47,Tennessee,3,Bedford County,0,3,-3
28,Mississippi,47,Tennessee,5,Benton County,30,11,19
28,Mississippi,47,Tennessee,9,Blount County,20,82,-62
28,Mississippi,47,Tennessee,11,Bradley County,0,18,-18
28,Mississippi,47,Tennessee,13,Campbell County,0,15,-15
28,Mississippi,47,Tennessee,17,Carroll County,12,47,-35
28,Mississippi,47,Tennessee,19,Carter County,0,19,-19
28,Mississippi,47,Tennessee,21,Cheatham County,46,17,29
28,Mississippi,47,Tennessee,23,Chester County,0,2,-2
28,Mississippi,47,Tennessee,25,Claiborne County,0,13,-13
28,Mississippi,47,Tennessee,31,Coffee County,0,43,-43
28,Mississippi,47,Tennessee,33,Crockett County,0,13,-13
28,Mississippi,47,Tennessee,35,Cumberland County,0,17,-17
28,Mississippi,47,Tennessee,37,Davidson County,515,716,-201
28,Mississippi,47,Tennessee,39,Decatur County,19,10,9
28,Mississippi,47,Tennessee,41,DeKalb County,0,24,-24
28,Mississippi,47,Tennessee,43,Dickson County,0,26,-26
28,Mississippi,47,Tennessee,45,Dyer County,162,90,72
28,Mississippi,47,Tennessee,47,Fayette County,68,151,-83
28,Mississippi,47,Tennessee,51,Franklin County,0,3,-3
28,Mississippi,47,Tennessee,53,Gibson County,115,69,46
28,Mississippi,47,Tennessee,55,Giles County,61,0,61
28,Mississippi,47,Tennessee,57,Grainger County,0,4,-4
28,Mississippi,47,Tennessee,59,Greene County,8,94,-86
28,Mississippi,47,Tennessee,61,Grundy County,21,0,21
28,Mississippi,47,Tennessee,65,Hamilton County,69,223,-154
28,Mississippi,47,Tennessee,69,Hardeman County,0,67,-67
28,Mississippi,47,Tennessee,71,Hardin County,112,78,34
28,Mississippi,47,Tennessee,73,Hawkins County,2,0,2
28,Mississippi,47,Tennessee,79,Henry County,0,9,-9
28,Mississippi,47,Tennessee,81,Hickman County,0,114,-114
28,Mississippi,47,Tennessee,83,Houston County,18,0,18
28,Mississippi,47,Tennessee,85,Humphreys County,0,2,-2
28,Mississippi,47,Tennessee,89,Jefferson County,15,0,15
28,Mississippi,47,Tennessee,91,Johnson County,0,11,-11
28,Mississippi,47,Tennessee,93,Knox County,52,111,-59
28,Mississippi,47,Tennessee,95,Lake County,10,0,10
28,Mississippi,47,Tennessee,97,Lauderdale County,53,0,53
28,Mississippi,47,Tennessee,99,Lawrence County,108,27,81
28,Mississippi,47,Tennessee,109,McNairy County,290,72,218
28,Mississippi,47,Tennessee,111,Macon County,2,0,2
28,Mississippi,47,Tennessee,113,Madison County,336,34,302
28,Mississippi,47,Tennessee,117,Marshall County,0,18,-18
28,Mississippi,47,Tennessee,119,Maury County,3,22,-19
28,Mississippi,47,Tennessee,123,Monroe County,0,38,-38
28,Mississippi,47,Tennessee,125,Montgomery County,195,297,-102
28,Mississippi,47,Tennessee,131,Obion County,64,15,49
28,Mississippi,47,Tennessee,135,Perry County,10,0,10
28,Mississippi,47,Tennessee,139,Polk County,0,2,-2
28,Mississippi,47,Tennessee,141,Putnam County,95,0,95
28,Mississippi,47,Tennessee,143,Rhea County,8,25,-17
28,Mississippi,47,Tennessee,145,Roane County,0,289,-289
28,Mississippi,47,Tennessee,147,Robertson County,5,1,4
28,Mississippi,47,Tennessee,149,Rutherford County,267,261,6
28,Mississippi,47,Tennessee,155,Sevier County,142,387,-245
28,Mississippi,47,Tennessee,157,Shelby County,6486,5278,1208
28,Mississippi,47,Tennessee,159,Smith County,0,4,-4
28,Mississippi,47,Tennessee,163,Sullivan County,16,39,-23
28,Mississippi,47,Tennessee,165,Sumner County,42,106,-64
28,Mississippi,47,Tennessee,167,Tipton County,465,104,361
28,Mississippi,47,Tennessee,175,Van Buren County,109,0,109
28,Mississippi,47,Tennessee,177,Warren County,0,22,-22
28,Mississippi,47,Tennessee,179,Washington County,4,24,-20
28,Mississippi,47,Tennessee,181,Wayne County,2,3,-1
28,Mississippi,47,Tennessee,183,Weakley County,79,11,68
28,Mississippi,47,Tennessee,187,Williamson County,167,90,77
28,Mississippi,47,Tennessee,189,Wilson County,105,24,81
28,Mississippi,48,Texas,1,Anderson County,0,29,-29
28,Mississippi,48,Texas,5,Angelina County,79,0,79
28,Mississippi,48,Texas,21,Bastrop County,7,0,7
28,Mississippi,48,Texas,23,Baylor County,6,0,6
28,Mississippi,48,Texas,27,Bell County,227,217,10
28,Mississippi,48,Texas,29,Bexar County,489,539,-50
28,Mississippi,48,Texas,35,Bosque County,133,0,133
28,Mississippi,48,Texas,37,Bowie County,196,46,150
28,Mississippi,48,Texas,39,Brazoria County,17,100,-83
28,Mississippi,48,Texas,41,Brazos County,71,172,-101
28,Mississippi,48,Texas,45,Briscoe County,8,0,8
28,Mississippi,48,Texas,53,Burnet County,17,9,8
28,Mississippi,48,Texas,55,Caldwell County,0,16,-16
28,Mississippi,48,Texas,61,Cameron County,6,0,6
28,Mississippi,48,Texas,67,Cass County,0,29,-29
28,Mississippi,48,Texas,71,Chambers County,0,29,-29
28,Mississippi,48,Texas,73,Cherokee County,6,0,6
28,Mississippi,48,Texas,83,Coleman County,0,22,-22
28,Mississippi,48,Texas,85,Collin County,321,553,-232
28,Mississippi,48,Texas,91,Comal County,90,36,54
28,Mississippi,48,Texas,99,Coryell County,0,89,-89
28,Mississippi,48,Texas,113,Dallas County,718,812,-94
28,Mississippi,48,Texas,121,Denton County,263,220,43
28,Mississippi,48,Texas,135,Ector County,17,14,3
28,Mississippi,48,Texas,141,El Paso County,226,104,122
28,Mississippi,48,Texas,147,Fannin County,0,2,-2
28,Mississippi,48,Texas,157,Fort Bend County,106,406,-300
28,Mississippi,48,Texas,159,Franklin County,7,0,7
28,Mississippi,48,Texas,167,Galveston County,223,98,125
28,Mississippi,48,Texas,181,Grayson County,0,176,-176
28,Mississippi,48,Texas,183,Gregg County,37,65,-28
28,Mississippi,48,Texas,187,Guadalupe County,94,194,-100
28,Mississippi,48,Texas,199,Hardin County,0,151,-151
28,Mississippi,48,Texas,201,Harris County,915,1088,-173
28,Mississippi,48,Texas,203,Harrison County,0,8,-8
28,Mississippi,48,Texas,209,Hays County,64,0,64
28,Mississippi,48,Texas,213,Henderson County,0,24,-24
28,Mississippi,48,Texas,215,Hidalgo County,265,30,235
28,Mississippi,48,Texas,217,Hill County,0,3,-3
28,Mississippi,48,Texas,223,Hopkins County,0,26,-26
28,Mississippi,48,Texas,225,Houston County,0,10,-10
28,Mississippi,48,Texas,227,Howard County,0,13,-13
28,Mississippi,48,Texas,233,Hutchinson County,0,17,-17
28,Mississippi,48,Texas,245,Jefferson County,46,377,-331
28,Mississippi,48,Texas,255,Karnes County,0,10,-10
28,Mississippi,48,Texas,259,Kendall County,7,0,7
28,Mississippi,48,Texas,265,Kerr County,10,6,4
28,Mississippi,48,Texas,273,Kleberg County,5,0,5
28,Mississippi,48,Texas,277,Lamar County,11,10,1
28,Mississippi,48,Texas,281,Lampasas County,14,3,11
28,Mississippi,48,Texas,285,Lavaca County,0,2,-2
28,Mississippi,48,Texas,289,Leon County,3,45,-42
28,Mississippi,48,Texas,291,Liberty County,19,0,19
28,Mississippi,48,Texas,297,Live Oak County,80,0,80
28,Mississippi,48,Texas,303,Lubbock County,51,18,33
28,Mississippi,48,Texas,307,McCulloch County,5,0,5
28,Mississippi,48,Texas,309,McLennan County,3,39,-36
28,Mississippi,48,Texas,329,Midland County,102,12,90
28,Mississippi,48,Texas,339,Montgomery County,114,1300,-1186
28,Mississippi,48,Texas,347,Nacogdoches County,0,88,-88
28,Mississippi,48,Texas,349,Navarro County,6,10,-4
28,Mississippi,48,Texas,355,Nueces County,190,400,-210
28,Mississippi,48,Texas,361,Orange County,152,65,87
28,Mississippi,48,Texas,363,Palo Pinto County,0,71,-71
28,Mississippi,48,Texas,365,Panola County,0,4,-4
28,Mississippi,48,Texas,367,Parker County,0,31,-31
28,Mississippi,48,Texas,373,Polk County,12,0,12
28,Mississippi,48,Texas,381,Randall County,0,67,-67
28,Mississippi,48,Texas,387,Red River County,8,0,8
28,Mississippi,48,Texas,389,Reeves County,0,7,-7
28,Mississippi,48,Texas,391,Refugio County,29,0,29
28,Mississippi,48,Texas,397,Rockwall County,9,0,9
28,Mississippi,48,Texas,401,Rusk County,127,9,118
28,Mississippi,48,Texas,403,Sabine County,0,37,-37
28,Mississippi,48,Texas,405,San Augustine County,0,33,-33
28,Mississippi,48,Texas,407,San Jacinto County,0,3,-3
28,Mississippi,48,Texas,409,San Patricio County,14,0,14
28,Mississippi,48,Texas,419,Shelby County,0,60,-60
28,Mississippi,48,Texas,423,Smith County,31,99,-68
28,Mississippi,48,Texas,439,Tarrant County,367,1384,-1017
28,Mississippi,48,Texas,441,Taylor County,0,44,-44
28,Mississippi,48,Texas,449,Titus County,0,22,-22
28,Mississippi,48,Texas,451,Tom Green County,26,109,-83
28,Mississippi,48,Texas,453,Travis County,269,317,-48
28,Mississippi,48,Texas,457,Tyler County,0,55,-55
28,Mississippi,48,Texas,465,Val Verde County,87,5,82
28,Mississippi,48,Texas,467,Van Zandt County,14,0,14
28,Mississippi,48,Texas,479,Webb County,0,26,-26
28,Mississippi,48,Texas,485,Wichita County,32,59,-27
28,Mississippi,48,Texas,491,Williamson County,163,198,-35
28,Mississippi,48,Texas,495,Winkler County,0,2,-2
28,Mississippi,48,Texas,499,Wood County,0,9,-9
28,Mississippi,48,Texas,507,Zavala County,0,18,-18
28,Mississippi,49,Utah,3,Box Elder County,0,8,-8
28,Mississippi,49,Utah,5,Cache County,0,21,-21
28,Mississippi,49,Utah,7,Carbon County,0,42,-42
28,Mississippi,49,Utah,11,Davis County,17,120,-103
28,Mississippi,49,Utah,21,Iron County,0,77,-77
28,Mississippi,49,Utah,25,Kane County,7,0,7
28,Mississippi,49,Utah,35,Salt Lake County,5,241,-236
28,Mississippi,49,Utah,45,Tooele County,62,0,62
28,Mississippi,49,Utah,49,Utah County,24,55,-31
28,Mississippi,49,Utah,53,Washington County,0,13,-13
28,Mississippi,49,Utah,57,Weber County,0,32,-32
28,Mississippi,5,Arkansas,1,Arkansas County,0,10,-10
28,Mississippi,5,Arkansas,5,Baxter County,89,3,86
28,Mississippi,5,Arkansas,7,Benton County,61,0,61
28,Mississippi,5,Arkansas,9,Boone County,36,2,34
28,Mississippi,5,Arkansas,11,Bradley County,64,3,61
28,Mississippi,5,Arkansas,15,Carroll County,0,62,-62
28,Mississippi,5,Arkansas,17,Chicot County,24,90,-66
28,Mississippi,5,Arkansas,21,Clay County,0,17,-17
28,Mississippi,5,Arkansas,23,Cleburne County,22,145,-123
28,Mississippi,5,Arkansas,27,Columbia County,0,35,-35
28,Mississippi,5,Arkansas,31,Craighead County,178,223,-45
28,Mississippi,5,Arkansas,33,Crawford County,7,0,7
28,Mississippi,5,Arkansas,35,Crittenden County,156,147,9
28,Mississippi,5,Arkansas,37,Cross County,0,64,-64
28,Mississippi,5,Arkansas,43,Drew County,0,48,-48
28,Mississippi,5,Arkansas,45,Faulkner County,59,35,24
28,Mississippi,5,Arkansas,47,Franklin County,0,1,-1
28,Mississippi,5,Arkansas,49,Fulton County,4,21,-17
28,Mississippi,5,Arkansas,51,Garland County,86,49,37
28,Mississippi,5,Arkansas,53,Grant County,83,71,12
28,Mississippi,5,Arkansas,55,Greene County,24,24,0
28,Mississippi,5,Arkansas,63,Independence County,96,50,46
28,Mississippi,5,Arkansas,69,Jefferson County,46,47,-1
28,Mississippi,5,Arkansas,71,Johnson County,0,23,-23
28,Mississippi,5,Arkansas,73,Lafayette County,0,3,-3
28,Mississippi,5,Arkansas,75,Lawrence County,0,124,-124
28,Mississippi,5,Arkansas,77,Lee County,0,8,-8
28,Mississippi,5,Arkansas,83,Logan County,0,20,-20
28,Mississippi,5,Arkansas,85,Lonoke County,0,26,-26
28,Mississippi,5,Arkansas,91,Miller County,0,6,-6
28,Mississippi,5,Arkansas,93,Mississippi County,27,392,-365
28,Mississippi,5,Arkansas,97,Montgomery County,0,17,-17
28,Mississippi,5,Arkansas,107,Phillips County,59,44,15
28,Mississippi,5,Arkansas,109,Pike County,10,0,10
28,Mississippi,5,Arkansas,111,Poinsett County,0,44,-44
28,Mississippi,5,Arkansas,113,Polk County,0,4,-4
28,Mississippi,5,Arkansas,115,Pope County,90,77,13
28,Mississippi,5,Arkansas,117,Prairie County,10,0,10
28,Mississippi,5,Arkansas,119,Pulaski County,180,258,-78
28,Mississippi,5,Arkansas,121,Randolph County,0,42,-42
28,Mississippi,5,Arkansas,123,St. Francis County,181,16,165
28,Mississippi,5,Arkansas,125,Saline County,90,23,67
28,Mississippi,5,Arkansas,127,Scott County,0,7,-7
28,Mississippi,5,Arkansas,131,Sebastian County,53,97,-44
28,Mississippi,5,Arkansas,133,Sevier County,0,33,-33
28,Mississippi,5,Arkansas,135,Sharp County,0,14,-14
28,Mississippi,5,Arkansas,137,Stone County,30,36,-6
28,Mississippi,5,Arkansas,139,Union County,224,0,224
28,Mississippi,5,Arkansas,143,Washington County,34,215,-181
28,Mississippi,5,Arkansas,145,White County,9,286,-277
28,Mississippi,5,Arkansas,147,Woodruff County,0,12,-12
28,Mississippi,5,Arkansas,149,Yell County,13,9,4
28,Mississippi,50,Vermont,1,Addison County,0,8,-8
28,Mississippi,50,Vermont,27,Windsor County,0,7,-7
28,Mississippi,51,Virginia,1,Accomack County,1,0,1
28,Mississippi,51,Virginia,3,Albemarle County,0,28,-28
28,Mississippi,51,Virginia,9,Amherst County,0,10,-10
28,Mississippi,51,Virginia,13,Arlington County,60,21,39
28,Mississippi,51,Virginia,15,Augusta County,0,46,-46
28,Mississippi,51,Virginia,19,Bedford County,0,23,-23
28,Mississippi,51,Virginia,35,Carroll County,8,0,8
28,Mississippi,51,Virginia,41,Chesterfield County,10,60,-50
28,Mississippi,51,Virginia,59,Fairfax County,64,110,-46
28,Mississippi,51,Virginia,63,Floyd County,0,36,-36
28,Mississippi,51,Virginia,67,Franklin County,0,65,-65
28,Mississippi,51,Virginia,69,Frederick County,4,0,4
28,Mississippi,51,Virginia,79,Greene County,0,39,-39
28,Mississippi,51,Virginia,85,Hanover County,7,22,-15
28,Mississippi,51,Virginia,87,Henrico County,42,0,42
28,Mississippi,51,Virginia,99,King George County,98,0,98
28,Mississippi,51,Virginia,107,Loudoun County,34,55,-21
28,Mississippi,51,Virginia,121,Montgomery County,13,0,13
28,Mississippi,51,Virginia,131,Northampton County,17,0,17
28,Mississippi,51,Virginia,153,Prince William County,30,76,-46
28,Mississippi,51,Virginia,167,Russell County,12,0,12
28,Mississippi,51,Virginia,177,Spotsylvania County,0,25,-25
28,Mississippi,51,Virginia,179,Stafford County,20,35,-15
28,Mississippi,51,Virginia,195,Wise County,14,0,14
28,Mississippi,51,Virginia,199,York County,32,0,32
28,Mississippi,51,Virginia,510,Alexandria city,9,0,9
28,Mississippi,51,Virginia,550,Chesapeake city,149,0,149
28,Mississippi,51,Virginia,590,Danville city,8,0,8
28,Mississippi,51,Virginia,650,Hampton city,40,86,-46
28,Mississippi,51,Virginia,678,Lexington city,0,28,-28
28,Mississippi,51,Virginia,680,Lynchburg city,0,90,-90
28,Mississippi,51,Virginia,700,Newport News city,64,60,4
28,Mississippi,51,Virginia,710,Norfolk city,159,165,-6
28,Mississippi,51,Virginia,740,Portsmouth city,0,7,-7
28,Mississippi,51,Virginia,760,Richmond city,0,41,-41
28,Mississippi,51,Virginia,790,Staunton city,19,0,19
28,Mississippi,51,Virginia,800,Suffolk city,0,5,-5
28,Mississippi,51,Virginia,810,Virginia Beach city,148,221,-73
28,Mississippi,53,Washington,5,Benton County,4,0,4
28,Mississippi,53,Washington,9,Clallam County,0,9,-9
28,Mississippi,53,Washington,11,Clark County,13,15,-2
28,Mississippi,53,Washington,17,Douglas County,52,0,52
28,Mississippi,53,Washington,19,Ferry County,8,0,8
28,Mississippi,53,Washington,21,Franklin County,7,15,-8
28,Mississippi,53,Washington,25,Grant County,196,0,196
28,Mississippi,53,Washington,29,Island County,0,50,-50
28,Mississippi,53,Washington,33,King County,127,155,-28
28,Mississippi,53,Washington,35,Kitsap County,0,63,-63
28,Mississippi,53,Washington,45,Mason County,214,0,214
28,Mississippi,53,Washington,53,Pierce County,323,57,266
28,Mississippi,53,Washington,57,Skagit County,44,0,44
28,Mississippi,53,Washington,61,Snohomish County,26,10,16
28,Mississippi,53,Washington,63,Spokane County,16,133,-117
28,Mississippi,53,Washington,67,Thurston County,25,39,-14
28,Mississippi,53,Washington,73,Whatcom County,21,0,21
28,Mississippi,53,Washington,77,Yakima County,0,9,-9
28,Mississippi,54,West Virginia,3,Berkeley County,27,0,27
28,Mississippi,54,West Virginia,11,Cabell County,29,61,-32
28,Mississippi,54,West Virginia,21,Gilmer County,39,0,39
28,Mississippi,54,West Virginia,39,Kanawha County,188,42,146
28,Mississippi,54,West Virginia,47,McDowell County,70,0,70
28,Mississippi,54,West Virginia,59,Mingo County,34,0,34
28,Mississippi,54,West Virginia,67,Nicholas County,7,9,-2
28,Mississippi,54,West Virginia,69,Ohio County,0,2,-2
28,Mississippi,54,West Virginia,71,Pendleton County,10,0,10
28,Mississippi,54,West Virginia,73,Pleasants County,0,34,-34
28,Mississippi,54,West Virginia,77,Preston County,37,5,32
28,Mississippi,54,West Virginia,103,Wetzel County,37,0,37
28,Mississippi,54,West Virginia,107,Wood County,4,19,-15
28,Mississippi,54,West Virginia,109,Wyoming County,13,0,13
28,Mississippi,55,Wisconsin,3,Ashland County,16,0,16
28,Mississippi,55,Wisconsin,9,Brown County,0,15,-15
28,Mississippi,55,Wisconsin,25,Dane County,89,166,-77
28,Mississippi,55,Wisconsin,27,Dodge County,14,1,13
28,Mississippi,55,Wisconsin,31,Douglas County,0,4,-4
28,Mississippi,55,Wisconsin,33,Dunn County,9,0,9
28,Mississippi,55,Wisconsin,39,Fond du Lac County,8,0,8
28,Mississippi,55,Wisconsin,49,Iowa County,0,5,-5
28,Mississippi,55,Wisconsin,53,Jackson County,0,11,-11
28,Mississippi,55,Wisconsin,59,Kenosha County,30,65,-35
28,Mississippi,55,Wisconsin,67,Langlade County,60,0,60
28,Mississippi,55,Wisconsin,73,Marathon County,0,2,-2
28,Mississippi,55,Wisconsin,75,Marinette County,0,11,-11
28,Mississippi,55,Wisconsin,79,Milwaukee County,152,235,-83
28,Mississippi,55,Wisconsin,81,Monroe County,20,0,20
28,Mississippi,55,Wisconsin,87,Outagamie County,10,12,-2
28,Mississippi,55,Wisconsin,101,Racine County,94,0,94
28,Mississippi,55,Wisconsin,105,Rock County,6,41,-35
28,Mississippi,55,Wisconsin,107,Rusk County,0,32,-32
28,Mississippi,55,Wisconsin,115,Shawano County,0,2,-2
28,Mississippi,55,Wisconsin,117,Sheboygan County,26,0,26
28,Mississippi,55,Wisconsin,127,Walworth County,0,7,-7
28,Mississippi,55,Wisconsin,129,Washburn County,5,0,5
28,Mississippi,55,Wisconsin,133,Waukesha County,17,7,10
28,Mississippi,55,Wisconsin,139,Winnebago County,9,0,9
28,Mississippi,55,Wisconsin,141,Wood County,14,2,12
28,Mississippi,56,Wyoming,1,Albany County,28,0,28
28,Mississippi,56,Wyoming,25,Natrona County,19,0,19
28,Mississippi,56,Wyoming,39,Teton County,4,0,4
28,Mississippi,6,California,1,Alameda County,7,67,-60
28,Mississippi,6,California,7,Butte County,87,0,87
28,Mississippi,6,California,9,Calaveras County,0,27,-27
28,Mississippi,6,California,13,Contra Costa County,82,0,82
28,Mississippi,6,California,15,Del Norte County,0,13,-13
28,Mississippi,6,California,17,El Dorado County,40,12,28
28,Mississippi,6,California,19,Fresno County,307,0,307
28,Mississippi,6,California,25,Imperial County,31,0,31
28,Mississippi,6,California,27,Inyo County,0,2,-2
28,Mississippi,6,California,29,Kern County,269,335,-66
28,Mississippi,6,California,31,Kings County,4,106,-102
28,Mississippi,6,California,35,Lassen County,48,31,17
28,Mississippi,6,California,37,Los Angeles County,1062,338,724
28,Mississippi,6,California,41,Marin County,20,57,-37
28,Mississippi,6,California,53,Monterey County,91,39,52
28,Mississippi,6,California,59,Orange County,159,21,138
28,Mississippi,6,California,61,Placer County,23,19,4
28,Mississippi,6,California,63,Plumas County,0,1,-1
28,Mississippi,6,California,65,Riverside County,177,125,52
28,Mississippi,6,California,67,Sacramento County,203,111,92
28,Mississippi,6,California,71,San Bernardino County,130,87,43
28,Mississippi,6,California,73,San Diego County,807,374,433
28,Mississippi,6,California,75,San Francisco County,36,122,-86
28,Mississippi,6,California,77,San Joaquin County,64,7,57
28,Mississippi,6,California,79,San Luis Obispo County,151,60,91
28,Mississippi,6,California,81,San Mateo County,0,28,-28
28,Mississippi,6,California,83,Santa Barbara County,58,5,53
28,Mississippi,6,California,85,Santa Clara County,0,145,-145
28,Mississippi,6,California,87,Santa Cruz County,20,98,-78
28,Mississippi,6,California,95,Solano County,86,45,41
28,Mississippi,6,California,97,Sonoma County,6,14,-8
28,Mississippi,6,California,99,Stanislaus County,0,18,-18
28,Mississippi,6,California,101,Sutter County,0,9,-9
28,Mississippi,6,California,107,Tulare County,53,0,53
28,Mississippi,6,California,109,Tuolumne County,0,14,-14
28,Mississippi,6,California,111,Ventura County,133,112,21
28,Mississippi,6,California,115,Yuba County,86,96,-10
28,Mississippi,72,Puerto Rico,21,Bayamón Municipio,183,0,183
28,Mississippi,72,Puerto Rico,23,Cabo Rojo Municipio,19,0,19
28,Mississippi,72,Puerto Rico,25,Caguas Municipio,6,0,6
28,Mississippi,72,Puerto Rico,61,Guaynabo Municipio,32,21,11
28,Mississippi,72,Puerto Rico,77,Juncos Municipio,4,0,4
28,Mississippi,72,Puerto Rico,123,Salinas Municipio,14,0,14
28,Mississippi,72,Puerto Rico,127,San Juan Municipio,219,0,219
28,Mississippi,72,Puerto Rico,151,Yabucoa Municipio,16,0,16
28,Mississippi,72,Puerto Rico,153,Yauco Municipio,0,33,-33
28,Mississippi,8,Colorado,1,Adams County,10,43,-33
28,Mississippi,8,Colorado,5,Arapahoe County,36,6,30
28,Mississippi,8,Colorado,14,Broomfield County,0,102,-102
28,Mississippi,8,Colorado,31,Denver County,43,94,-51
28,Mississippi,8,Colorado,35,Douglas County,22,0,22
28,Mississippi,8,Colorado,39,Elbert County,7,28,-21
28,Mississippi,8,Colorado,41,El Paso County,484,496,-12
28,Mississippi,8,Colorado,59,Jefferson County,11,11,0
28,Mississippi,8,Colorado,67,La Plata County,0,16,-16
28,Mississippi,8,Colorado,69,Larimer County,39,57,-18
28,Mississippi,8,Colorado,71,Las Animas County,0,23,-23
28,Mississippi,8,Colorado,75,Logan County,0,17,-17
28,Mississippi,8,Colorado,77,Mesa County,0,92,-92
28,Mississippi,8,Colorado,85,Montrose County,9,0,9
28,Mississippi,8,Colorado,91,Ouray County,0,16,-16
28,Mississippi,8,Colorado,101,Pueblo County,7,0,7
28,Mississippi,8,Colorado,109,Saguache County,15,0,15
28,Mississippi,8,Colorado,115,Sedgwick County,0,13,-13
28,Mississippi,8,Colorado,123,Weld County,20,46,-26
28,Mississippi,9,Connecticut,1,Fairfield County,0,24,-24
28,Mississippi,9,Connecticut,3,Hartford County,45,0,45
28,Mississippi,9,Connecticut,9,New Haven County,40,17,23
28,Mississippi,9,Connecticut,11,New London County,34,13,21
28,Mississippi,AFR,Africa,,-,214,0,0
28,Mississippi,ASI,Asia,,-,2721,0,0
28,Mississippi,CAM,Central America,,-,1336,0,0
28,Mississippi,CAR,Caribbean,,-,849,0,0
28,Mississippi,EUR,Europe,,-,728,0,0
28,Mississippi,ISL,U.S. Island Areas,,-,33,0,0
28,Mississippi,NAM,Northern America,,-,195,0,0
28,Mississippi,OCE,Oceania and At Sea,,-,144,0,0
28,Mississippi,SAM,South America,,-,421,0,0
30,Montana,1,Alabama,1,Autauga County,30,0,30
30,Montana,1,Alabama,31,Coffee County,1,0,1
30,Montana,1,Alabama,33,Colbert County,14,0,14
30,Montana,1,Alabama,43,Cullman County,4,0,4
30,Montana,1,Alabama,45,Dale County,3,0,3
30,Montana,1,Alabama,49,DeKalb County,10,0,10
30,Montana,1,Alabama,53,Escambia County,8,0,8
30,Montana,1,Alabama,73,Jefferson County,8,9,-1
30,Montana,1,Alabama,77,Lauderdale County,0,6,-6
30,Montana,1,Alabama,79,Lawrence County,0,7,-7
30,Montana,1,Alabama,83,Limestone County,0,40,-40
30,Montana,1,Alabama,97,Mobile County,12,153,-141
30,Montana,1,Alabama,101,Montgomery County,32,0,32
30,Montana,1,Alabama,103,Morgan County,0,14,-14
30,Montana,1,Alabama,113,Russell County,5,0,5
30,Montana,1,Alabama,115,St. Clair County,13,106,-93
30,Montana,10,Delaware,1,Kent County,0,29,-29
30,Montana,11,District of Columbia,1,District of Columbia,15,24,-9
30,Montana,12,Florida,1,Alachua County,15,11,4
30,Montana,12,Florida,9,Brevard County,150,197,-47
30,Montana,12,Florida,11,Broward County,10,0,10
30,Montana,12,Florida,17,Citrus County,0,15,-15
30,Montana,12,Florida,19,Clay County,24,0,24
30,Montana,12,Florida,21,Collier County,12,0,12
30,Montana,12,Florida,23,Columbia County,13,9,4
30,Montana,12,Florida,31,Duval County,0,17,-17
30,Montana,12,Florida,33,Escambia County,0,61,-61
30,Montana,12,Florida,37,Franklin County,6,0,6
30,Montana,12,Florida,53,Hernando County,4,0,4
30,Montana,12,Florida,57,Hillsborough County,3,102,-99
30,Montana,12,Florida,69,Lake County,0,10,-10
30,Montana,12,Florida,71,Lee County,40,0,40
30,Montana,12,Florida,73,Leon County,0,15,-15
30,Montana,12,Florida,81,Manatee County,0,80,-80
30,Montana,12,Florida,83,Marion County,0,19,-19
30,Montana,12,Florida,86,Miami-Dade County,141,0,141
30,Montana,12,Florida,89,Nassau County,32,0,32
30,Montana,12,Florida,91,Okaloosa County,15,0,15
30,Montana,12,Florida,95,Orange County,4,0,4
30,Montana,12,Florida,97,Osceola County,40,0,40
30,Montana,12,Florida,99,Palm Beach County,91,28,63
30,Montana,12,Florida,101,Pasco County,144,7,137
30,Montana,12,Florida,103,Pinellas County,18,9,9
30,Montana,12,Florida,105,Polk County,0,29,-29
30,Montana,12,Florida,109,St. Johns County,0,18,-18
30,Montana,12,Florida,113,Santa Rosa County,14,0,14
30,Montana,12,Florida,127,Volusia County,39,57,-18
30,Montana,13,Georgia,21,Bibb County,0,14,-14
30,Montana,13,Georgia,51,Chatham County,8,8,0
30,Montana,13,Georgia,59,Clarke County,27,52,-25
30,Montana,13,Georgia,67,Cobb County,24,24,0
30,Montana,13,Georgia,73,Columbia County,9,0,9
30,Montana,13,Georgia,79,Crawford County,7,0,7
30,Montana,13,Georgia,97,Douglas County,5,0,5
30,Montana,13,Georgia,111,Fannin County,0,13,-13
30,Montana,13,Georgia,117,Forsyth County,8,0,8
30,Montana,13,Georgia,121,Fulton County,8,0,8
30,Montana,13,Georgia,129,Gordon County,0,5,-5
30,Montana,13,Georgia,131,Grady County,0,12,-12
30,Montana,13,Georgia,153,Houston County,9,0,9
30,Montana,13,Georgia,185,Lowndes County,99,0,99
30,Montana,13,Georgia,209,Montgomery County,0,11,-11
30,Montana,13,Georgia,215,Muscogee County,9,5,4
30,Montana,13,Georgia,217,Newton County,0,41,-41
30,Montana,13,Georgia,223,Paulding County,15,0,15
30,Montana,13,Georgia,233,Polk County,14,0,14
30,Montana,13,Georgia,245,Richmond County,0,11,-11
30,Montana,13,Georgia,255,Spalding County,47,0,47
30,Montana,13,Georgia,261,Sumter County,4,0,4
30,Montana,13,Georgia,297,Walton County,14,0,14
30,Montana,15,Hawaii,1,Hawaii County,10,31,-21
30,Montana,15,Hawaii,3,Honolulu County,104,52,52
30,Montana,15,Hawaii,9,Maui County,9,14,-5
30,Montana,16,Idaho,1,Ada County,616,436,180
30,Montana,16,Idaho,3,Adams County,0,6,-6
30,Montana,16,Idaho,5,Bannock County,265,74,191
30,Montana,16,Idaho,7,Bear Lake County,5,0,5
30,Montana,16,Idaho,9,Benewah County,0,21,-21
30,Montana,16,Idaho,11,Bingham County,22,59,-37
30,Montana,16,Idaho,13,Blaine County,3,0,3
30,Montana,16,Idaho,15,Boise County,2,6,-4
30,Montana,16,Idaho,17,Bonner County,192,155,37
30,Montana,16,Idaho,19,Bonneville County,235,64,171
30,Montana,16,Idaho,21,Boundary County,26,4,22
30,Montana,16,Idaho,27,Canyon County,128,176,-48
30,Montana,16,Idaho,29,Caribou County,0,7,-7
30,Montana,16,Idaho,31,Cassia County,4,17,-13
30,Montana,16,Idaho,33,Clark County,0,13,-13
30,Montana,16,Idaho,35,Clearwater County,4,12,-8
30,Montana,16,Idaho,37,Custer County,9,0,9
30,Montana,16,Idaho,39,Elmore County,6,11,-5
30,Montana,16,Idaho,41,Franklin County,0,79,-79
30,Montana,16,Idaho,43,Fremont County,20,30,-10
30,Montana,16,Idaho,47,Gooding County,18,0,18
30,Montana,16,Idaho,49,Idaho County,54,42,12
30,Montana,16,Idaho,51,Jefferson County,5,0,5
30,Montana,16,Idaho,53,Jerome County,10,0,10
30,Montana,16,Idaho,55,Kootenai County,305,304,1
30,Montana,16,Idaho,57,Latah County,23,38,-15
30,Montana,16,Idaho,59,Lemhi County,27,44,-17
30,Montana,16,Idaho,61,Lewis County,13,9,4
30,Montana,16,Idaho,65,Madison County,72,90,-18
30,Montana,16,Idaho,67,Minidoka County,25,0,25
30,Montana,16,Idaho,69,Nez Perce County,68,99,-31
30,Montana,16,Idaho,73,Owyhee County,0,11,-11
30,Montana,16,Idaho,75,Payette County,25,12,13
30,Montana,16,Idaho,79,Shoshone County,27,42,-15
30,Montana,16,Idaho,81,Teton County,65,16,49
30,Montana,16,Idaho,83,Twin Falls County,16,48,-32
30,Montana,16,Idaho,85,Valley County,8,1,7
30,Montana,16,Idaho,87,Washington County,0,1,-1
30,Montana,17,Illinois,17,Cass County,4,0,4
30,Montana,17,Illinois,19,Champaign County,4,58,-54
30,Montana,17,Illinois,21,Christian County,0,2,-2
30,Montana,17,Illinois,23,Clark County,37,0,37
30,Montana,17,Illinois,31,Cook County,265,37,228
30,Montana,17,Illinois,37,DeKalb County,16,0,16
30,Montana,17,Illinois,43,DuPage County,69,48,21
30,Montana,17,Illinois,57,Fulton County,0,22,-22
30,Montana,17,Illinois,65,Hamilton County,0,19,-19
30,Montana,17,Illinois,67,Hancock County,19,0,19
30,Montana,17,Illinois,75,Iroquois County,77,0,77
30,Montana,17,Illinois,85,Jo Daviess County,24,0,24
30,Montana,17,Illinois,89,Kane County,30,29,1
30,Montana,17,Illinois,93,Kendall County,18,0,18
30,Montana,17,Illinois,97,Lake County,30,50,-20
30,Montana,17,Illinois,107,Logan County,3,0,3
30,Montana,17,Illinois,111,McHenry County,5,14,-9
30,Montana,17,Illinois,113,McLean County,47,165,-118
30,Montana,17,Illinois,115,Macon County,5,0,5
30,Montana,17,Illinois,117,Macoupin County,0,14,-14
30,Montana,17,Illinois,119,Madison County,0,30,-30
30,Montana,17,Illinois,129,Menard County,12,0,12
30,Montana,17,Illinois,143,Peoria County,38,9,29
30,Montana,17,Illinois,149,Pike County,0,3,-3
30,Montana,17,Illinois,161,Rock Island County,0,20,-20
30,Montana,17,Illinois,163,St. Clair County,9,0,9
30,Montana,17,Illinois,183,Vermilion County,4,0,4
30,Montana,17,Illinois,197,Will County,36,0,36
30,Montana,17,Illinois,199,Williamson County,25,0,25
30,Montana,17,Illinois,201,Winnebago County,0,25,-25
30,Montana,17,Illinois,203,Woodford County,91,0,91
30,Montana,18,Indiana,5,Bartholomew County,3,0,3
30,Montana,18,Indiana,39,Elkhart County,42,0,42
30,Montana,18,Indiana,57,Hamilton County,15,197,-182
30,Montana,18,Indiana,59,Hancock County,9,0,9
30,Montana,18,Indiana,63,Hendricks County,3,0,3
30,Montana,18,Indiana,77,Jefferson County,19,0,19
30,Montana,18,Indiana,81,Johnson County,0,50,-50
30,Montana,18,Indiana,83,Knox County,0,43,-43
30,Montana,18,Indiana,87,LaGrange County,0,62,-62
30,Montana,18,Indiana,89,Lake County,29,0,29
30,Montana,18,Indiana,97,Marion County,266,0,266
30,Montana,18,Indiana,105,Monroe County,10,26,-16
30,Montana,18,Indiana,109,Morgan County,2,0,2
30,Montana,18,Indiana,141,St. Joseph County,0,9,-9
30,Montana,18,Indiana,157,Tippecanoe County,8,0,8
30,Montana,18,Indiana,163,Vanderburgh County,51,0,51
30,Montana,18,Indiana,177,Wayne County,11,35,-24
30,Montana,18,Indiana,181,White County,15,0,15
30,Montana,18,Indiana,183,Whitley County,58,0,58
30,Montana,19,Iowa,13,Black Hawk County,82,0,82
30,Montana,19,Iowa,15,Boone County,0,7,-7
30,Montana,19,Iowa,21,Buena Vista County,10,0,10
30,Montana,19,Iowa,29,Cass County,39,0,39
30,Montana,19,Iowa,41,Clay County,0,56,-56
30,Montana,19,Iowa,43,Clayton County,0,4,-4
30,Montana,19,Iowa,103,Johnson County,27,23,4
30,Montana,19,Iowa,139,Muscatine County,0,4,-4
30,Montana,19,Iowa,141,O'Brien County,15,0,15
30,Montana,19,Iowa,153,Polk County,10,1,9
30,Montana,19,Iowa,155,Pottawattamie County,0,5,-5
30,Montana,19,Iowa,163,Scott County,38,0,38
30,Montana,19,Iowa,165,Shelby County,0,7,-7
30,Montana,19,Iowa,169,Story County,15,25,-10
30,Montana,19,Iowa,187,Webster County,0,9,-9
30,Montana,19,Iowa,191,Winneshiek County,18,6,12
30,Montana,19,Iowa,193,Woodbury County,0,21,-21
30,Montana,19,Iowa,197,Wright County,0,4,-4
30,Montana,2,Alaska,16,Aleutians West Census Area,0,2,-2
30,Montana,2,Alaska,20,Anchorage Municipality,140,221,-81
30,Montana,2,Alaska,68,Denali Borough,20,0,20
30,Montana,2,Alaska,90,Fairbanks North Star Borough,73,31,42
30,Montana,2,Alaska,100,Haines Borough,43,0,43
30,Montana,2,Alaska,110,Juneau City and Borough,110,130,-20
30,Montana,2,Alaska,122,Kenai Peninsula Borough,41,0,41
30,Montana,2,Alaska,130,Ketchikan Gateway Borough,4,11,-7
30,Montana,2,Alaska,150,Kodiak Island Borough,6,0,6
30,Montana,2,Alaska,170,Matanuska-Susitna Borough,360,30,330
30,Montana,2,Alaska,185,North Slope Borough,0,13,-13
30,Montana,2,Alaska,195,Petersburg Borough,0,6,-6
30,Montana,2,Alaska,198,Prince of Wales-Hyder Census Area,0,7,-7
30,Montana,2,Alaska,220,Sitka City and Borough,5,13,-8
30,Montana,2,Alaska,230,Skagway Municipality,0,1,-1
30,Montana,2,Alaska,240,Southeast Fairbanks Census Area,0,5,-5
30,Montana,2,Alaska,261,Valdez-Cordova Census Area,22,0,22
30,Montana,2,Alaska,282,Yakutat City and Borough,0,7,-7
30,Montana,2,Alaska,290,Yukon-Koyukuk Census Area,0,2,-2
30,Montana,20,Kansas,11,Bourbon County,0,7,-7
30,Montana,20,Kansas,15,Butler County,5,0,5
30,Montana,20,Kansas,27,Clay County,8,0,8
30,Montana,20,Kansas,53,Ellsworth County,0,6,-6
30,Montana,20,Kansas,55,Finney County,0,4,-4
30,Montana,20,Kansas,57,Ford County,0,13,-13
30,Montana,20,Kansas,61,Geary County,0,11,-11
30,Montana,20,Kansas,77,Harper County,0,8,-8
30,Montana,20,Kansas,79,Harvey County,24,0,24
30,Montana,20,Kansas,85,Jackson County,5,0,5
30,Montana,20,Kansas,91,Johnson County,2,72,-70
30,Montana,20,Kansas,99,Labette County,13,0,13
30,Montana,20,Kansas,107,Linn County,28,0,28
30,Montana,20,Kansas,113,McPherson County,0,15,-15
30,Montana,20,Kansas,115,Marion County,0,3,-3
30,Montana,20,Kansas,117,Marshall County,13,0,13
30,Montana,20,Kansas,119,Meade County,19,0,19
30,Montana,20,Kansas,141,Osborne County,0,2,-2
30,Montana,20,Kansas,149,Pottawatomie County,0,2,-2
30,Montana,20,Kansas,155,Reno County,4,38,-34
30,Montana,20,Kansas,161,Riley County,34,21,13
30,Montana,20,Kansas,173,Sedgwick County,165,55,110
30,Montana,20,Kansas,175,Seward County,0,39,-39
30,Montana,20,Kansas,177,Shawnee County,30,0,30
30,Montana,20,Kansas,197,Wabaunsee County,0,11,-11
30,Montana,21,Kentucky,59,Daviess County,18,0,18
30,Montana,21,Kentucky,67,Fayette County,10,7,3
30,Montana,21,Kentucky,93,Hardin County,0,25,-25
30,Montana,21,Kentucky,111,Jefferson County,23,5,18
30,Montana,21,Kentucky,147,McCreary County,4,0,4
30,Montana,21,Kentucky,151,Madison County,33,0,33
30,Montana,21,Kentucky,221,Trigg County,9,0,9
30,Montana,22,Louisiana,15,Bossier Parish,0,52,-52
30,Montana,22,Louisiana,17,Caddo Parish,12,0,12
30,Montana,22,Louisiana,19,Calcasieu Parish,0,77,-77
30,Montana,22,Louisiana,33,East Baton Rouge Parish,36,18,18
30,Montana,22,Louisiana,43,Grant Parish,0,2,-2
30,Montana,22,Louisiana,49,Jackson Parish,0,6,-6
30,Montana,22,Louisiana,51,Jefferson Parish,0,26,-26
30,Montana,22,Louisiana,55,Lafayette Parish,0,58,-58
30,Montana,22,Louisiana,61,Lincoln Parish,0,31,-31
30,Montana,22,Louisiana,65,Madison Parish,0,4,-4
30,Montana,22,Louisiana,71,Orleans Parish,53,27,26
30,Montana,22,Louisiana,103,St. Tammany Parish,30,0,30
30,Montana,22,Louisiana,109,Terrebonne Parish,65,0,65
30,Montana,23,Maine,1,Androscoggin County,0,30,-30
30,Montana,23,Maine,3,Aroostook County,0,20,-20
30,Montana,23,Maine,5,Cumberland County,12,22,-10
30,Montana,23,Maine,7,Franklin County,40,0,40
30,Montana,23,Maine,11,Kennebec County,1,0,1
30,Montana,23,Maine,15,Lincoln County,0,12,-12
30,Montana,23,Maine,19,Penobscot County,2,12,-10
30,Montana,23,Maine,21,Piscataquis County,0,2,-2
30,Montana,23,Maine,29,Washington County,23,0,23
30,Montana,23,Maine,31,York County,19,0,19
30,Montana,24,Maryland,3,Anne Arundel County,0,12,-12
30,Montana,24,Maryland,5,Baltimore County,0,4,-4
30,Montana,24,Maryland,21,Frederick County,0,11,-11
30,Montana,24,Maryland,23,Garrett County,2,0,2
30,Montana,24,Maryland,25,Harford County,36,15,21
30,Montana,24,Maryland,31,Montgomery County,130,27,103
30,Montana,24,Maryland,33,Prince George's County,27,0,27
30,Montana,24,Maryland,41,Talbot County,2,0,2
30,Montana,24,Maryland,43,Washington County,8,0,8
30,Montana,25,Massachusetts,1,Barnstable County,21,8,13
30,Montana,25,Massachusetts,3,Berkshire County,4,11,-7
30,Montana,25,Massachusetts,9,Essex County,134,0,134
30,Montana,25,Massachusetts,17,Middlesex County,5,39,-34
30,Montana,25,Massachusetts,23,Plymouth County,41,0,41
30,Montana,25,Massachusetts,25,Suffolk County,61,6,55
30,Montana,26,Michigan,5,Allegan County,19,0,19
30,Montana,26,Michigan,7,Alpena County,29,0,29
30,Montana,26,Michigan,15,Barry County,65,0,65
30,Montana,26,Michigan,33,Chippewa County,10,0,10
30,Montana,26,Michigan,37,Clinton County,9,0,9
30,Montana,26,Michigan,47,Emmet County,61,20,41
30,Montana,26,Michigan,49,Genesee County,54,4,50
30,Montana,26,Michigan,51,Gladwin County,12,0,12
30,Montana,26,Michigan,55,Grand Traverse County,14,0,14
30,Montana,26,Michigan,69,Iosco County,23,2,21
30,Montana,26,Michigan,73,Isabella County,21,8,13
30,Montana,26,Michigan,77,Kalamazoo County,46,22,24
30,Montana,26,Michigan,81,Kent County,25,0,25
30,Montana,26,Michigan,87,Lapeer County,0,179,-179
30,Montana,26,Michigan,89,Leelanau County,0,6,-6
30,Montana,26,Michigan,91,Lenawee County,0,6,-6
30,Montana,26,Michigan,93,Livingston County,33,0,33
30,Montana,26,Michigan,103,Marquette County,0,81,-81
30,Montana,26,Michigan,111,Midland County,0,1,-1
30,Montana,26,Michigan,113,Missaukee County,102,0,102
30,Montana,26,Michigan,117,Montcalm County,0,12,-12
30,Montana,26,Michigan,121,Muskegon County,7,0,7
30,Montana,26,Michigan,123,Newaygo County,20,0,20
30,Montana,26,Michigan,125,Oakland County,27,11,16
30,Montana,26,Michigan,127,Oceana County,10,0,10
30,Montana,26,Michigan,129,Ogemaw County,3,2,1
30,Montana,26,Michigan,151,Sanilac County,4,0,4
30,Montana,26,Michigan,161,Washtenaw County,0,115,-115
30,Montana,26,Michigan,163,Wayne County,28,31,-3
30,Montana,26,Michigan,165,Wexford County,6,0,6
30,Montana,27,Minnesota,1,Aitkin County,4,0,4
30,Montana,27,Minnesota,3,Anoka County,119,5,114
30,Montana,27,Minnesota,5,Becker County,13,0,13
30,Montana,27,Minnesota,7,Beltrami County,11,9,2
30,Montana,27,Minnesota,9,Benton County,0,32,-32
30,Montana,27,Minnesota,13,Blue Earth County,15,0,15
30,Montana,27,Minnesota,15,Brown County,0,13,-13
30,Montana,27,Minnesota,19,Carver County,29,0,29
30,Montana,27,Minnesota,21,Cass County,0,24,-24
30,Montana,27,Minnesota,25,Chisago County,17,10,7
30,Montana,27,Minnesota,27,Clay County,25,20,5
30,Montana,27,Minnesota,35,Crow Wing County,16,23,-7
30,Montana,27,Minnesota,37,Dakota County,11,37,-26
30,Montana,27,Minnesota,41,Douglas County,0,9,-9
30,Montana,27,Minnesota,53,Hennepin County,243,124,119
30,Montana,27,Minnesota,57,Hubbard County,0,12,-12
30,Montana,27,Minnesota,61,Itasca County,6,17,-11
30,Montana,27,Minnesota,67,Kandiyohi County,33,0,33
30,Montana,27,Minnesota,71,Koochiching County,53,13,40
30,Montana,27,Minnesota,75,Lake County,10,0,10
30,Montana,27,Minnesota,79,Le Sueur County,0,5,-5
30,Montana,27,Minnesota,85,McLeod County,4,2,2
30,Montana,27,Minnesota,93,Meeker County,11,0,11
30,Montana,27,Minnesota,99,Mower County,16,0,16
30,Montana,27,Minnesota,109,Olmsted County,0,11,-11
30,Montana,27,Minnesota,111,Otter Tail County,21,8,13
30,Montana,27,Minnesota,115,Pine County,14,31,-17
30,Montana,27,Minnesota,119,Polk County,95,31,64
30,Montana,27,Minnesota,123,Ramsey County,113,87,26
30,Montana,27,Minnesota,127,Redwood County,0,3,-3
30,Montana,27,Minnesota,129,Renville County,0,8,-8
30,Montana,27,Minnesota,131,Rice County,0,13,-13
30,Montana,27,Minnesota,137,St. Louis County,21,25,-4
30,Montana,27,Minnesota,139,Scott County,0,10,-10
30,Montana,27,Minnesota,141,Sherburne County,63,26,37
30,Montana,27,Minnesota,145,Stearns County,20,38,-18
30,Montana,27,Minnesota,163,Washington County,34,0,34
30,Montana,27,Minnesota,167,Wilkin County,0,5,-5
30,Montana,27,Minnesota,173,Yellow Medicine County,0,1,-1
30,Montana,28,Mississippi,7,Attala County,0,10,-10
30,Montana,28,Mississippi,33,DeSoto County,0,70,-70
30,Montana,28,Mississippi,47,Harrison County,47,43,4
30,Montana,28,Mississippi,49,Hinds County,0,9,-9
30,Montana,28,Mississippi,75,Lauderdale County,0,36,-36
30,Montana,28,Mississippi,87,Lowndes County,19,0,19
30,Montana,28,Mississippi,89,Madison County,24,0,24
30,Montana,28,Mississippi,103,Noxubee County,0,5,-5
30,Montana,28,Mississippi,115,Pontotoc County,21,0,21
30,Montana,28,Mississippi,121,Rankin County,70,0,70
30,Montana,28,Mississippi,131,Stone County,7,40,-33
30,Montana,28,Mississippi,149,Warren County,0,1,-1
30,Montana,28,Mississippi,163,Yazoo County,0,39,-39
30,Montana,29,Missouri,1,Adair County,0,12,-12
30,Montana,29,Missouri,23,Butler County,0,1,-1
30,Montana,29,Missouri,29,Camden County,0,22,-22
30,Montana,29,Missouri,31,Cape Girardeau County,4,0,4
30,Montana,29,Missouri,47,Clay County,0,3,-3
30,Montana,29,Missouri,77,Greene County,71,70,1
30,Montana,29,Missouri,91,Howell County,0,20,-20
30,Montana,29,Missouri,95,Jackson County,77,13,64
30,Montana,29,Missouri,97,Jasper County,0,39,-39
30,Montana,29,Missouri,99,Jefferson County,7,0,7
30,Montana,29,Missouri,121,Macon County,0,7,-7
30,Montana,29,Missouri,127,Marion County,0,6,-6
30,Montana,29,Missouri,149,Oregon County,6,0,6
30,Montana,29,Missouri,169,Pulaski County,171,41,130
30,Montana,29,Missouri,181,Ripley County,6,0,6
30,Montana,29,Missouri,183,St. Charles County,28,0,28
30,Montana,29,Missouri,185,St. Clair County,0,65,-65
30,Montana,29,Missouri,189,St. Louis County,45,0,45
30,Montana,29,Missouri,197,Schuyler County,0,2,-2
30,Montana,29,Missouri,203,Shannon County,0,2,-2
30,Montana,29,Missouri,213,Taney County,13,0,13
30,Montana,29,Missouri,215,Texas County,0,7,-7
30,Montana,29,Missouri,217,Vernon County,0,12,-12
30,Montana,29,Missouri,229,Wright County,3,0,3
30,Montana,29,Missouri,510,St. Louis city,39,0,39
30,Montana,30,Montana,1,Beaverhead County,988,623,365
30,Montana,30,Montana,3,Big Horn County,332,300,32
30,Montana,30,Montana,5,Blaine County,277,232,45
30,Montana,30,Montana,7,Broadwater County,251,279,-28
30,Montana,30,Montana,9,Carbon County,647,257,390
30,Montana,30,Montana,11,Carter County,138,8,130
30,Montana,30,Montana,13,Cascade County,2926,2655,271
30,Montana,30,Montana,15,Chouteau County,475,268,207
30,Montana,30,Montana,17,Custer County,418,411,7
30,Montana,30,Montana,19,Daniels County,3,12,-9
30,Montana,30,Montana,21,Dawson County,388,466,-78
30,Montana,30,Montana,23,Deer Lodge County,768,513,255
30,Montana,30,Montana,25,Fallon County,67,123,-56
30,Montana,30,Montana,27,Fergus County,830,452,378
30,Montana,30,Montana,29,Flathead County,1763,1914,-151
30,Montana,30,Montana,31,Gallatin County,2786,3495,-709
30,Montana,30,Montana,33,Garfield County,53,2,51
30,Montana,30,Montana,35,Glacier County,284,377,-93
30,Montana,30,Montana,37,Golden Valley County,26,60,-34
30,Montana,30,Montana,39,Granite County,102,191,-89
30,Montana,30,Montana,41,Hill County,835,571,264
30,Montana,30,Montana,43,Jefferson County,573,735,-162
30,Montana,30,Montana,45,Judith Basin County,124,78,46
30,Montana,30,Montana,47,Lake County,1080,1432,-352
30,Montana,30,Montana,49,Lewis and Clark County,2283,2077,206
30,Montana,30,Montana,51,Liberty County,40,49,-9
30,Montana,30,Montana,53,Lincoln County,554,285,269
30,Montana,30,Montana,55,McCone County,18,10,8
30,Montana,30,Montana,57,Madison County,332,348,-16
30,Montana,30,Montana,59,Meagher County,92,66,26
30,Montana,30,Montana,61,Mineral County,114,40,74
30,Montana,30,Montana,63,Missoula County,4222,4723,-501
30,Montana,30,Montana,65,Musselshell County,236,219,17
30,Montana,30,Montana,67,Park County,569,260,309
30,Montana,30,Montana,69,Petroleum County,6,54,-48
30,Montana,30,Montana,71,Phillips County,106,187,-81
30,Montana,30,Montana,73,Pondera County,315,174,141
30,Montana,30,Montana,75,Powder River County,99,34,65
30,Montana,30,Montana,77,Powell County,466,698,-232
30,Montana,30,Montana,79,Prairie County,2,5,-3
30,Montana,30,Montana,81,Ravalli County,1547,924,623
30,Montana,30,Montana,83,Richland County,350,301,49
30,Montana,30,Montana,85,Roosevelt County,494,171,323
30,Montana,30,Montana,87,Rosebud County,267,223,44
30,Montana,30,Montana,89,Sanders County,362,158,204
30,Montana,30,Montana,91,Sheridan County,142,96,46
30,Montana,30,Montana,93,Silver Bow County,1038,1796,-758
30,Montana,30,Montana,95,Stillwater County,283,384,-101
30,Montana,30,Montana,97,Sweet Grass County,140,152,-12
30,Montana,30,Montana,99,Teton County,116,310,-194
30,Montana,30,Montana,101,Toole County,399,525,-126
30,Montana,30,Montana,103,Treasure County,2,29,-27
30,Montana,30,Montana,105,Valley County,187,208,-21
30,Montana,30,Montana,107,Wheatland County,11,34,-23
30,Montana,30,Montana,109,Wibaux County,63,4,59
30,Montana,30,Montana,111,Yellowstone County,3435,4426,-991
30,Montana,31,Nebraska,13,Box Butte County,0,7,-7
30,Montana,31,Nebraska,19,Buffalo County,0,9,-9
30,Montana,31,Nebraska,31,Cherry County,0,1,-1
30,Montana,31,Nebraska,55,Douglas County,42,60,-18
30,Montana,31,Nebraska,65,Furnas County,0,15,-15
30,Montana,31,Nebraska,95,Jefferson County,0,4,-4
30,Montana,31,Nebraska,101,Keith County,0,6,-6
30,Montana,31,Nebraska,109,Lancaster County,102,0,102
30,Montana,31,Nebraska,111,Lincoln County,0,55,-55
30,Montana,31,Nebraska,123,Morrill County,0,19,-19
30,Montana,31,Nebraska,131,Otoe County,0,40,-40
30,Montana,31,Nebraska,153,Sarpy County,32,32,0
30,Montana,31,Nebraska,157,Scotts Bluff County,0,3,-3
30,Montana,31,Nebraska,159,Seward County,0,13,-13
30,Montana,31,Nebraska,169,Thayer County,0,27,-27
30,Montana,31,Nebraska,179,Wayne County,14,0,14
30,Montana,31,Nebraska,185,York County,0,3,-3
30,Montana,32,Nevada,1,Churchill County,8,0,8
30,Montana,32,Nevada,3,Clark County,548,586,-38
30,Montana,32,Nevada,5,Douglas County,5,46,-41
30,Montana,32,Nevada,7,Elko County,69,3,66
30,Montana,32,Nevada,13,Humboldt County,4,16,-12
30,Montana,32,Nevada,15,Lander County,0,3,-3
30,Montana,32,Nevada,19,Lyon County,9,52,-43
30,Montana,32,Nevada,23,Nye County,63,0,63
30,Montana,32,Nevada,31,Washoe County,87,25,62
30,Montana,32,Nevada,33,White Pine County,0,13,-13
30,Montana,32,Nevada,510,Carson City,4,112,-108
30,Montana,33,New Hampshire,3,Carroll County,0,86,-86
30,Montana,33,New Hampshire,9,Grafton County,0,6,-6
30,Montana,33,New Hampshire,11,Hillsborough County,13,0,13
30,Montana,33,New Hampshire,13,Merrimack County,77,0,77
30,Montana,33,New Hampshire,15,Rockingham County,35,0,35
30,Montana,33,New Hampshire,17,Strafford County,9,4,5
30,Montana,34,New Jersey,1,Atlantic County,24,72,-48
30,Montana,34,New Jersey,5,Burlington County,0,10,-10
30,Montana,34,New Jersey,7,Camden County,0,26,-26
30,Montana,34,New Jersey,9,Cape May County,0,21,-21
30,Montana,34,New Jersey,17,Hudson County,0,44,-44
30,Montana,34,New Jersey,21,Mercer County,35,9,26
30,Montana,34,New Jersey,27,Morris County,0,3,-3
30,Montana,34,New Jersey,29,Ocean County,11,0,11
30,Montana,34,New Jersey,31,Passaic County,13,7,6
30,Montana,35,New Mexico,1,Bernalillo County,22,255,-233
30,Montana,35,New Mexico,5,Chaves County,0,2,-2
30,Montana,35,New Mexico,9,Curry County,19,3,16
30,Montana,35,New Mexico,13,Doña Ana County,15,6,9
30,Montana,35,New Mexico,15,Eddy County,38,0,38
30,Montana,35,New Mexico,17,Grant County,5,0,5
30,Montana,35,New Mexico,19,Guadalupe County,0,2,-2
30,Montana,35,New Mexico,27,Lincoln County,47,0,47
30,Montana,35,New Mexico,31,McKinley County,2,16,-14
30,Montana,35,New Mexico,35,Otero County,10,14,-4
30,Montana,35,New Mexico,43,Sandoval County,0,14,-14
30,Montana,35,New Mexico,45,San Juan County,82,16,66
30,Montana,35,New Mexico,47,San Miguel County,39,0,39
30,Montana,35,New Mexico,49,Santa Fe County,43,11,32
30,Montana,35,New Mexico,53,Socorro County,0,22,-22
30,Montana,35,New Mexico,57,Torrance County,0,9,-9
30,Montana,35,New Mexico,61,Valencia County,6,0,6
30,Montana,36,New York,1,Albany County,31,0,31
30,Montana,36,New York,5,Bronx County,1,20,-19
30,Montana,36,New York,9,Cattaraugus County,30,12,18
30,Montana,36,New York,29,Erie County,58,0,58
30,Montana,36,New York,43,Herkimer County,0,5,-5
30,Montana,36,New York,45,Jefferson County,0,8,-8
30,Montana,36,New York,47,Kings County,0,21,-21
30,Montana,36,New York,49,Lewis County,0,5,-5
30,Montana,36,New York,53,Madison County,31,0,31
30,Montana,36,New York,59,Nassau County,34,0,34
30,Montana,36,New York,61,New York County,37,61,-24
30,Montana,36,New York,67,Onondaga County,5,0,5
30,Montana,36,New York,71,Orange County,0,14,-14
30,Montana,36,New York,75,Oswego County,0,2,-2
30,Montana,36,New York,89,St. Lawrence County,6,16,-10
30,Montana,36,New York,93,Schenectady County,0,48,-48
30,Montana,36,New York,103,Suffolk County,56,0,56
30,Montana,36,New York,109,Tompkins County,9,11,-2
30,Montana,36,New York,111,Ulster County,10,25,-15
30,Montana,36,New York,119,Westchester County,7,0,7
30,Montana,37,North Carolina,17,Bladen County,0,18,-18
30,Montana,37,North Carolina,19,Brunswick County,0,5,-5
30,Montana,37,North Carolina,21,Buncombe County,51,0,51
30,Montana,37,North Carolina,31,Carteret County,26,0,26
30,Montana,37,North Carolina,37,Chatham County,35,0,35
30,Montana,37,North Carolina,39,Cherokee County,114,0,114
30,Montana,37,North Carolina,51,Cumberland County,6,39,-33
30,Montana,37,North Carolina,63,Durham County,18,0,18
30,Montana,37,North Carolina,67,Forsyth County,85,0,85
30,Montana,37,North Carolina,69,Franklin County,12,0,12
30,Montana,37,North Carolina,81,Guilford County,11,0,11
30,Montana,37,North Carolina,97,Iredell County,30,49,-19
30,Montana,37,North Carolina,99,Jackson County,13,172,-159
30,Montana,37,North Carolina,101,Johnston County,0,14,-14
30,Montana,37,North Carolina,107,Lenoir County,13,0,13
30,Montana,37,North Carolina,119,Mecklenburg County,13,0,13
30,Montana,37,North Carolina,125,Moore County,6,0,6
30,Montana,37,North Carolina,129,New Hanover County,10,0,10
30,Montana,37,North Carolina,133,Onslow County,111,128,-17
30,Montana,37,North Carolina,135,Orange County,0,7,-7
30,Montana,37,North Carolina,147,Pitt County,0,10,-10
30,Montana,37,North Carolina,159,Rowan County,8,0,8
30,Montana,37,North Carolina,183,Wake County,25,0,25
30,Montana,37,North Carolina,189,Watauga County,53,16,37
30,Montana,37,North Carolina,191,Wayne County,28,18,10
30,Montana,38,North Dakota,3,Barnes County,0,90,-90
30,Montana,38,North Dakota,5,Benson County,25,0,25
30,Montana,38,North Dakota,9,Bottineau County,10,3,7
30,Montana,38,North Dakota,11,Bowman County,5,49,-44
30,Montana,38,North Dakota,15,Burleigh County,317,182,135
30,Montana,38,North Dakota,17,Cass County,58,72,-14
30,Montana,38,North Dakota,21,Dickey County,13,5,8
30,Montana,38,North Dakota,23,Divide County,3,3,0
30,Montana,38,North Dakota,25,Dunn County,0,36,-36
30,Montana,38,North Dakota,33,Golden Valley County,11,41,-30
30,Montana,38,North Dakota,35,Grand Forks County,36,47,-11
30,Montana,38,North Dakota,41,Hettinger County,18,0,18
30,Montana,38,North Dakota,43,Kidder County,1,3,-2
30,Montana,38,North Dakota,53,McKenzie County,90,169,-79
30,Montana,38,North Dakota,55,McLean County,0,2,-2
30,Montana,38,North Dakota,57,Mercer County,2,22,-20
30,Montana,38,North Dakota,59,Morton County,115,10,105
30,Montana,38,North Dakota,61,Mountrail County,31,32,-1
30,Montana,38,North Dakota,69,Pierce County,0,2,-2
30,Montana,38,North Dakota,71,Ramsey County,0,1,-1
30,Montana,38,North Dakota,73,Ransom County,4,0,4
30,Montana,38,North Dakota,75,Renville County,23,5,18
30,Montana,38,North Dakota,77,Richland County,0,59,-59
30,Montana,38,North Dakota,81,Sargent County,0,2,-2
30,Montana,38,North Dakota,85,Sioux County,10,12,-2
30,Montana,38,North Dakota,87,Slope County,32,11,21
30,Montana,38,North Dakota,89,Stark County,258,190,68
30,Montana,38,North Dakota,99,Walsh County,0,76,-76
30,Montana,38,North Dakota,101,Ward County,177,141,36
30,Montana,38,North Dakota,105,Williams County,476,200,276
30,Montana,39,Ohio,17,Butler County,3,86,-83
30,Montana,39,Ohio,25,Clermont County,6,9,-3
30,Montana,39,Ohio,35,Cuyahoga County,1,7,-6
30,Montana,39,Ohio,41,Delaware County,0,13,-13
30,Montana,39,Ohio,49,Franklin County,53,12,41
30,Montana,39,Ohio,57,Greene County,3,58,-55
30,Montana,39,Ohio,61,Hamilton County,21,5,16
30,Montana,39,Ohio,63,Hancock County,0,8,-8
30,Montana,39,Ohio,75,Holmes County,0,14,-14
30,Montana,39,Ohio,81,Jefferson County,4,0,4
30,Montana,39,Ohio,83,Knox County,0,8,-8
30,Montana,39,Ohio,93,Lorain County,2,0,2
30,Montana,39,Ohio,95,Lucas County,37,0,37
30,Montana,39,Ohio,103,Medina County,0,34,-34
30,Montana,39,Ohio,113,Montgomery County,9,28,-19
30,Montana,39,Ohio,125,Paulding County,0,19,-19
30,Montana,39,Ohio,139,Richland County,6,51,-45
30,Montana,39,Ohio,145,Scioto County,8,0,8
30,Montana,39,Ohio,153,Summit County,3,0,3
30,Montana,39,Ohio,155,Trumbull County,0,23,-23
30,Montana,39,Ohio,157,Tuscarawas County,38,0,38
30,Montana,39,Ohio,165,Warren County,23,0,23
30,Montana,39,Ohio,167,Washington County,2,0,2
30,Montana,39,Ohio,169,Wayne County,0,18,-18
30,Montana,39,Ohio,173,Wood County,0,40,-40
30,Montana,39,Ohio,175,Wyandot County,0,4,-4
30,Montana,4,Arizona,1,Apache County,52,0,52
30,Montana,4,Arizona,3,Cochise County,34,0,34
30,Montana,4,Arizona,5,Coconino County,44,68,-24
30,Montana,4,Arizona,7,Gila County,10,29,-19
30,Montana,4,Arizona,9,Graham County,0,2,-2
30,Montana,4,Arizona,11,Greenlee County,0,5,-5
30,Montana,4,Arizona,12,La Paz County,6,23,-17
30,Montana,4,Arizona,13,Maricopa County,691,903,-212
30,Montana,4,Arizona,15,Mohave County,49,369,-320
30,Montana,4,Arizona,17,Navajo County,100,0,100
30,Montana,4,Arizona,19,Pima County,89,283,-194
30,Montana,4,Arizona,21,Pinal County,29,133,-104
30,Montana,4,Arizona,25,Yavapai County,42,49,-7
30,Montana,4,Arizona,27,Yuma County,41,169,-128
30,Montana,40,Oklahoma,17,Canadian County,9,8,1
30,Montana,40,Oklahoma,27,Cleveland County,37,8,29
30,Montana,40,Oklahoma,31,Comanche County,33,43,-10
30,Montana,40,Oklahoma,47,Garfield County,0,73,-73
30,Montana,40,Oklahoma,55,Greer County,25,0,25
30,Montana,40,Oklahoma,71,Kay County,0,5,-5
30,Montana,40,Oklahoma,77,Latimer County,52,0,52
30,Montana,40,Oklahoma,89,McCurtain County,18,0,18
30,Montana,40,Oklahoma,109,Oklahoma County,23,145,-122
30,Montana,40,Oklahoma,113,Osage County,2,0,2
30,Montana,40,Oklahoma,119,Payne County,11,1,10
30,Montana,40,Oklahoma,121,Pittsburg County,0,3,-3
30,Montana,40,Oklahoma,131,Rogers County,0,1,-1
30,Montana,40,Oklahoma,143,Tulsa County,55,87,-32
30,Montana,40,Oklahoma,147,Washington County,36,0,36
30,Montana,41,Oregon,1,Baker County,3,72,-69
30,Montana,41,Oregon,3,Benton County,0,35,-35
30,Montana,41,Oregon,5,Clackamas County,56,75,-19
30,Montana,41,Oregon,7,Clatsop County,161,88,73
30,Montana,41,Oregon,9,Columbia County,24,34,-10
30,Montana,41,Oregon,11,Coos County,0,75,-75
30,Montana,41,Oregon,13,Crook County,0,7,-7
30,Montana,41,Oregon,15,Curry County,7,286,-279
30,Montana,41,Oregon,17,Deschutes County,215,107,108
30,Montana,41,Oregon,19,Douglas County,137,71,66
30,Montana,41,Oregon,23,Grant County,0,7,-7
30,Montana,41,Oregon,29,Jackson County,48,41,7
30,Montana,41,Oregon,31,Jefferson County,0,12,-12
30,Montana,41,Oregon,33,Josephine County,22,137,-115
30,Montana,41,Oregon,35,Klamath County,35,3,32
30,Montana,41,Oregon,39,Lane County,41,281,-240
30,Montana,41,Oregon,41,Lincoln County,69,0,69
30,Montana,41,Oregon,43,Linn County,29,28,1
30,Montana,41,Oregon,47,Marion County,88,133,-45
30,Montana,41,Oregon,49,Morrow County,10,0,10
30,Montana,41,Oregon,51,Multnomah County,190,329,-139
30,Montana,41,Oregon,53,Polk County,185,43,142
30,Montana,41,Oregon,57,Tillamook County,0,4,-4
30,Montana,41,Oregon,59,Umatilla County,40,69,-29
30,Montana,41,Oregon,61,Union County,32,29,3
30,Montana,41,Oregon,65,Wasco County,0,60,-60
30,Montana,41,Oregon,67,Washington County,177,141,36
30,Montana,41,Oregon,71,Yamhill County,43,150,-107
30,Montana,42,Pennsylvania,3,Allegheny County,101,89,12
30,Montana,42,Pennsylvania,17,Bucks County,5,0,5
30,Montana,42,Pennsylvania,21,Cambria County,0,12,-12
30,Montana,42,Pennsylvania,27,Centre County,24,0,24
30,Montana,42,Pennsylvania,29,Chester County,79,0,79
30,Montana,42,Pennsylvania,31,Clarion County,0,1,-1
30,Montana,42,Pennsylvania,39,Crawford County,44,2,42
30,Montana,42,Pennsylvania,41,Cumberland County,3,10,-7
30,Montana,42,Pennsylvania,49,Erie County,0,18,-18
30,Montana,42,Pennsylvania,71,Lancaster County,34,29,5
30,Montana,42,Pennsylvania,73,Lawrence County,8,0,8
30,Montana,42,Pennsylvania,77,Lehigh County,43,8,35
30,Montana,42,Pennsylvania,91,Montgomery County,17,51,-34
30,Montana,42,Pennsylvania,95,Northampton County,22,0,22
30,Montana,42,Pennsylvania,99,Perry County,44,0,44
30,Montana,42,Pennsylvania,101,Philadelphia County,11,7,4
30,Montana,42,Pennsylvania,107,Schuylkill County,0,4,-4
30,Montana,42,Pennsylvania,111,Somerset County,6,10,-4
30,Montana,42,Pennsylvania,125,Washington County,73,0,73
30,Montana,42,Pennsylvania,127,Wayne County,5,0,5
30,Montana,42,Pennsylvania,131,Wyoming County,0,11,-11
30,Montana,42,Pennsylvania,133,York County,24,20,4
30,Montana,44,Rhode Island,1,Bristol County,5,0,5
30,Montana,44,Rhode Island,5,Newport County,0,76,-76
30,Montana,44,Rhode Island,7,Providence County,10,0,10
30,Montana,44,Rhode Island,9,Washington County,0,47,-47
30,Montana,45,South Carolina,3,Aiken County,11,0,11
30,Montana,45,South Carolina,7,Anderson County,0,92,-92
30,Montana,45,South Carolina,13,Beaufort County,0,37,-37
30,Montana,45,South Carolina,15,Berkeley County,0,18,-18
30,Montana,45,South Carolina,19,Charleston County,13,49,-36
30,Montana,45,South Carolina,45,Greenville County,45,0,45
30,Montana,45,South Carolina,47,Greenwood County,9,0,9
30,Montana,45,South Carolina,49,Hampton County,0,5,-5
30,Montana,45,South Carolina,79,Richland County,4,43,-39
30,Montana,45,South Carolina,85,Sumter County,12,0,12
30,Montana,45,South Carolina,91,York County,14,0,14
30,Montana,46,South Dakota,5,Beadle County,0,53,-53
30,Montana,46,South Dakota,11,Brookings County,7,0,7
30,Montana,46,South Dakota,13,Brown County,5,43,-38
30,Montana,46,South Dakota,19,Butte County,45,0,45
30,Montana,46,South Dakota,27,Clay County,8,0,8
30,Montana,46,South Dakota,29,Codington County,8,0,8
30,Montana,46,South Dakota,33,Custer County,4,2,2
30,Montana,46,South Dakota,37,Day County,0,21,-21
30,Montana,46,South Dakota,47,Fall River County,31,44,-13
30,Montana,46,South Dakota,55,Haakon County,5,0,5
30,Montana,46,South Dakota,59,Hand County,0,5,-5
30,Montana,46,South Dakota,63,Harding County,0,1,-1
30,Montana,46,South Dakota,65,Hughes County,0,43,-43
30,Montana,46,South Dakota,71,Jackson County,0,3,-3
30,Montana,46,South Dakota,81,Lawrence County,38,22,16
30,Montana,46,South Dakota,83,Lincoln County,32,0,32
30,Montana,46,South Dakota,89,McPherson County,0,6,-6
30,Montana,46,South Dakota,93,Meade County,14,23,-9
30,Montana,46,South Dakota,99,Minnehaha County,17,32,-15
30,Montana,46,South Dakota,102,Oglala Lakota County,34,0,34
30,Montana,46,South Dakota,103,Pennington County,74,124,-50
30,Montana,46,South Dakota,105,Perkins County,0,3,-3
30,Montana,46,South Dakota,111,Sanborn County,0,4,-4
30,Montana,46,South Dakota,135,Yankton County,29,28,1
30,Montana,47,Tennessee,31,Coffee County,16,0,16
30,Montana,47,Tennessee,37,Davidson County,0,21,-21
30,Montana,47,Tennessee,51,Franklin County,3,0,3
30,Montana,47,Tennessee,65,Hamilton County,10,0,10
30,Montana,47,Tennessee,87,Jackson County,0,16,-16
30,Montana,47,Tennessee,89,Jefferson County,5,163,-158
30,Montana,47,Tennessee,93,Knox County,17,0,17
30,Montana,47,Tennessee,139,Polk County,0,16,-16
30,Montana,47,Tennessee,149,Rutherford County,0,8,-8
30,Montana,47,Tennessee,157,Shelby County,23,9,14
30,Montana,47,Tennessee,165,Sumner County,17,16,1
30,Montana,47,Tennessee,167,Tipton County,0,7,-7
30,Montana,47,Tennessee,179,Washington County,7,0,7
30,Montana,47,Tennessee,189,Wilson County,0,10,-10
30,Montana,48,Texas,1,Anderson County,0,26,-26
30,Montana,48,Texas,25,Bee County,0,9,-9
30,Montana,48,Texas,27,Bell County,401,11,390
30,Montana,48,Texas,29,Bexar County,204,111,93
30,Montana,48,Texas,37,Bowie County,15,0,15
30,Montana,48,Texas,39,Brazoria County,13,0,13
30,Montana,48,Texas,41,Brazos County,0,6,-6
30,Montana,48,Texas,43,Brewster County,0,25,-25
30,Montana,48,Texas,61,Cameron County,40,10,30
30,Montana,48,Texas,71,Chambers County,0,15,-15
30,Montana,48,Texas,85,Collin County,13,42,-29
30,Montana,48,Texas,91,Comal County,3,0,3
30,Montana,48,Texas,99,Coryell County,24,23,1
30,Montana,48,Texas,103,Crane County,0,7,-7
30,Montana,48,Texas,109,Culberson County,6,0,6
30,Montana,48,Texas,113,Dallas County,173,27,146
30,Montana,48,Texas,121,Denton County,28,15,13
30,Montana,48,Texas,129,Donley County,0,9,-9
30,Montana,48,Texas,135,Ector County,0,40,-40
30,Montana,48,Texas,139,Ellis County,14,0,14
30,Montana,48,Texas,141,El Paso County,125,36,89
30,Montana,48,Texas,143,Erath County,13,15,-2
30,Montana,48,Texas,157,Fort Bend County,27,0,27
30,Montana,48,Texas,165,Gaines County,3,0,3
30,Montana,48,Texas,167,Galveston County,25,12,13
30,Montana,48,Texas,181,Grayson County,102,0,102
30,Montana,48,Texas,185,Grimes County,8,0,8
30,Montana,48,Texas,201,Harris County,168,164,4
30,Montana,48,Texas,209,Hays County,20,35,-15
30,Montana,48,Texas,213,Henderson County,29,0,29
30,Montana,48,Texas,221,Hood County,34,0,34
30,Montana,48,Texas,231,Hunt County,1,0,1
30,Montana,48,Texas,245,Jefferson County,52,0,52
30,Montana,48,Texas,251,Johnson County,268,0,268
30,Montana,48,Texas,257,Kaufman County,0,48,-48
30,Montana,48,Texas,281,Lampasas County,0,31,-31
30,Montana,48,Texas,297,Live Oak County,16,0,16
30,Montana,48,Texas,303,Lubbock County,25,12,13
30,Montana,48,Texas,331,Milam County,0,5,-5
30,Montana,48,Texas,339,Montgomery County,12,36,-24
30,Montana,48,Texas,367,Parker County,14,0,14
30,Montana,48,Texas,375,Potter County,56,0,56
30,Montana,48,Texas,415,Scurry County,2,0,2
30,Montana,48,Texas,423,Smith County,13,0,13
30,Montana,48,Texas,439,Tarrant County,101,20,81
30,Montana,48,Texas,441,Taylor County,23,13,10
30,Montana,48,Texas,447,Throckmorton County,148,0,148
30,Montana,48,Texas,449,Titus County,8,0,8
30,Montana,48,Texas,451,Tom Green County,0,27,-27
30,Montana,48,Texas,453,Travis County,239,141,98
30,Montana,48,Texas,465,Val Verde County,0,21,-21
30,Montana,48,Texas,467,Van Zandt County,23,0,23
30,Montana,48,Texas,473,Waller County,0,19,-19
30,Montana,48,Texas,479,Webb County,3,39,-36
30,Montana,48,Texas,485,Wichita County,10,0,10
30,Montana,48,Texas,491,Williamson County,20,64,-44
30,Montana,48,Texas,493,Wilson County,18,0,18
30,Montana,48,Texas,497,Wise County,0,13,-13
30,Montana,48,Texas,499,Wood County,31,0,31
30,Montana,49,Utah,3,Box Elder County,0,27,-27
30,Montana,49,Utah,5,Cache County,95,82,13
30,Montana,49,Utah,7,Carbon County,4,0,4
30,Montana,49,Utah,11,Davis County,127,145,-18
30,Montana,49,Utah,15,Emery County,0,3,-3
30,Montana,49,Utah,19,Grand County,12,0,12
30,Montana,49,Utah,21,Iron County,0,9,-9
30,Montana,49,Utah,23,Juab County,0,12,-12
30,Montana,49,Utah,25,Kane County,17,0,17
30,Montana,49,Utah,35,Salt Lake County,386,646,-260
30,Montana,49,Utah,37,San Juan County,184,0,184
30,Montana,49,Utah,39,Sanpete County,2,0,2
30,Montana,49,Utah,41,Sevier County,0,88,-88
30,Montana,49,Utah,43,Summit County,89,20,69
30,Montana,49,Utah,45,Tooele County,14,14,0
30,Montana,49,Utah,47,Uintah County,41,78,-37
30,Montana,49,Utah,49,Utah County,265,320,-55
30,Montana,49,Utah,51,Wasatch County,0,56,-56
30,Montana,49,Utah,53,Washington County,109,118,-9
30,Montana,49,Utah,55,Wayne County,0,21,-21
30,Montana,49,Utah,57,Weber County,163,113,50
30,Montana,5,Arkansas,7,Benton County,0,29,-29
30,Montana,5,Arkansas,15,Carroll County,0,6,-6
30,Montana,5,Arkansas,33,Crawford County,137,0,137
30,Montana,5,Arkansas,39,Dallas County,0,19,-19
30,Montana,5,Arkansas,45,Faulkner County,47,9,38
30,Montana,5,Arkansas,71,Johnson County,85,0,85
30,Montana,5,Arkansas,85,Lonoke County,0,32,-32
30,Montana,5,Arkansas,89,Marion County,34,0,34
30,Montana,5,Arkansas,113,Polk County,0,23,-23
30,Montana,5,Arkansas,119,Pulaski County,34,16,18
30,Montana,5,Arkansas,131,Sebastian County,27,0,27
30,Montana,5,Arkansas,143,Washington County,16,0,16
30,Montana,5,Arkansas,145,White County,49,119,-70
30,Montana,50,Vermont,1,Addison County,24,3,21
30,Montana,50,Vermont,3,Bennington County,0,17,-17
30,Montana,50,Vermont,7,Chittenden County,71,52,19
30,Montana,50,Vermont,11,Franklin County,22,0,22
30,Montana,50,Vermont,15,Lamoille County,0,47,-47
30,Montana,50,Vermont,19,Orleans County,4,0,4
30,Montana,50,Vermont,21,Rutland County,6,0,6
30,Montana,50,Vermont,23,Washington County,0,4,-4
30,Montana,50,Vermont,27,Windsor County,0,43,-43
30,Montana,51,Virginia,1,Accomack County,9,4,5
30,Montana,51,Virginia,13,Arlington County,0,26,-26
30,Montana,51,Virginia,41,Chesterfield County,5,0,5
30,Montana,51,Virginia,59,Fairfax County,48,16,32
30,Montana,51,Virginia,71,Giles County,0,8,-8
30,Montana,51,Virginia,95,James City County,14,0,14
30,Montana,51,Virginia,107,Loudoun County,14,0,14
30,Montana,51,Virginia,149,Prince George County,0,7,-7
30,Montana,51,Virginia,153,Prince William County,34,32,2
30,Montana,51,Virginia,161,Roanoke County,0,10,-10
30,Montana,51,Virginia,165,Rockingham County,0,14,-14
30,Montana,51,Virginia,171,Shenandoah County,0,24,-24
30,Montana,51,Virginia,177,Spotsylvania County,8,0,8
30,Montana,51,Virginia,179,Stafford County,11,36,-25
30,Montana,51,Virginia,199,York County,55,0,55
30,Montana,51,Virginia,510,Alexandria city,32,17,15
30,Montana,51,Virginia,540,Charlottesville city,0,20,-20
30,Montana,51,Virginia,550,Chesapeake city,4,0,4
30,Montana,51,Virginia,650,Hampton city,23,25,-2
30,Montana,51,Virginia,680,Lynchburg city,6,0,6
30,Montana,51,Virginia,700,Newport News city,16,15,1
30,Montana,51,Virginia,710,Norfolk city,16,0,16
30,Montana,51,Virginia,735,Poquoson city,11,0,11
30,Montana,51,Virginia,760,Richmond city,10,0,10
30,Montana,51,Virginia,775,Salem city,27,0,27
30,Montana,51,Virginia,810,Virginia Beach city,23,0,23
30,Montana,51,Virginia,830,Williamsburg city,5,0,5
30,Montana,53,Washington,1,Adams County,4,8,-4
30,Montana,53,Washington,3,Asotin County,38,0,38
30,Montana,53,Washington,5,Benton County,232,202,30
30,Montana,53,Washington,7,Chelan County,86,47,39
30,Montana,53,Washington,9,Clallam County,8,59,-51
30,Montana,53,Washington,11,Clark County,246,157,89
30,Montana,53,Washington,15,Cowlitz County,244,27,217
30,Montana,53,Washington,17,Douglas County,4,22,-18
30,Montana,53,Washington,19,Ferry County,0,66,-66
30,Montana,53,Washington,21,Franklin County,4,31,-27
30,Montana,53,Washington,25,Grant County,180,4,176
30,Montana,53,Washington,27,Grays Harbor County,42,1,41
30,Montana,53,Washington,29,Island County,25,56,-31
30,Montana,53,Washington,31,Jefferson County,50,0,50
30,Montana,53,Washington,33,King County,889,914,-25
30,Montana,53,Washington,35,Kitsap County,207,230,-23
30,Montana,53,Washington,37,Kittitas County,73,30,43
30,Montana,53,Washington,39,Klickitat County,0,9,-9
30,Montana,53,Washington,41,Lewis County,10,48,-38
30,Montana,53,Washington,43,Lincoln County,0,24,-24
30,Montana,53,Washington,45,Mason County,5,66,-61
30,Montana,53,Washington,47,Okanogan County,22,8,14
30,Montana,53,Washington,51,Pend Oreille County,0,25,-25
30,Montana,53,Washington,53,Pierce County,630,421,209
30,Montana,53,Washington,55,San Juan County,8,20,-12
30,Montana,53,Washington,57,Skagit County,39,34,5
30,Montana,53,Washington,59,Skamania County,0,2,-2
30,Montana,53,Washington,61,Snohomish County,751,194,557
30,Montana,53,Washington,63,Spokane County,804,1006,-202
30,Montana,53,Washington,65,Stevens County,61,96,-35
30,Montana,53,Washington,67,Thurston County,92,31,61
30,Montana,53,Washington,71,Walla Walla County,6,129,-123
30,Montana,53,Washington,73,Whatcom County,95,89,6
30,Montana,53,Washington,75,Whitman County,7,213,-206
30,Montana,53,Washington,77,Yakima County,37,26,11
30,Montana,54,West Virginia,3,Berkeley County,0,11,-11
30,Montana,54,West Virginia,11,Cabell County,0,9,-9
30,Montana,54,West Virginia,25,Greenbrier County,0,23,-23
30,Montana,54,West Virginia,39,Kanawha County,17,0,17
30,Montana,54,West Virginia,47,McDowell County,1,0,1
30,Montana,54,West Virginia,49,Marion County,4,0,4
30,Montana,54,West Virginia,53,Mason County,13,36,-23
30,Montana,54,West Virginia,61,Monongalia County,26,0,26
30,Montana,54,West Virginia,65,Morgan County,0,10,-10
30,Montana,54,West Virginia,107,Wood County,1,0,1
30,Montana,55,Wisconsin,1,Adams County,0,11,-11
30,Montana,55,Wisconsin,7,Bayfield County,9,8,1
30,Montana,55,Wisconsin,9,Brown County,0,11,-11
30,Montana,55,Wisconsin,11,Buffalo County,0,7,-7
30,Montana,55,Wisconsin,17,Chippewa County,32,0,32
30,Montana,55,Wisconsin,21,Columbia County,39,0,39
30,Montana,55,Wisconsin,25,Dane County,89,65,24
30,Montana,55,Wisconsin,29,Door County,0,8,-8
30,Montana,55,Wisconsin,31,Douglas County,27,0,27
30,Montana,55,Wisconsin,35,Eau Claire County,18,0,18
30,Montana,55,Wisconsin,45,Green County,0,2,-2
30,Montana,55,Wisconsin,51,Iron County,0,6,-6
30,Montana,55,Wisconsin,55,Jefferson County,11,0,11
30,Montana,55,Wisconsin,59,Kenosha County,0,4,-4
30,Montana,55,Wisconsin,63,La Crosse County,29,4,25
30,Montana,55,Wisconsin,69,Lincoln County,0,1,-1
30,Montana,55,Wisconsin,79,Milwaukee County,71,19,52
30,Montana,55,Wisconsin,85,Oneida County,0,10,-10
30,Montana,55,Wisconsin,95,Polk County,0,18,-18
30,Montana,55,Wisconsin,97,Portage County,0,3,-3
30,Montana,55,Wisconsin,99,Price County,0,4,-4
30,Montana,55,Wisconsin,103,Richland County,0,24,-24
30,Montana,55,Wisconsin,105,Rock County,0,17,-17
30,Montana,55,Wisconsin,109,St. Croix County,11,0,11
30,Montana,55,Wisconsin,111,Sauk County,0,11,-11
30,Montana,55,Wisconsin,115,Shawano County,0,6,-6
30,Montana,55,Wisconsin,117,Sheboygan County,9,0,9
30,Montana,55,Wisconsin,127,Walworth County,14,0,14
30,Montana,55,Wisconsin,129,Washburn County,0,17,-17
30,Montana,55,Wisconsin,133,Waukesha County,58,82,-24
30,Montana,55,Wisconsin,135,Waupaca County,6,0,6
30,Montana,55,Wisconsin,139,Winnebago County,65,0,65
30,Montana,56,Wyoming,1,Albany County,129,62,67
30,Montana,56,Wyoming,3,Big Horn County,19,41,-22
30,Montana,56,Wyoming,5,Campbell County,69,80,-11
30,Montana,56,Wyoming,7,Carbon County,33,18,15
30,Montana,56,Wyoming,9,Converse County,47,1,46
30,Montana,56,Wyoming,11,Crook County,0,64,-64
30,Montana,56,Wyoming,13,Fremont County,95,78,17
30,Montana,56,Wyoming,15,Goshen County,0,15,-15
30,Montana,56,Wyoming,17,Hot Springs County,12,1,11
30,Montana,56,Wyoming,19,Johnson County,28,9,19
30,Montana,56,Wyoming,21,Laramie County,1,204,-203
30,Montana,56,Wyoming,23,Lincoln County,15,46,-31
30,Montana,56,Wyoming,25,Natrona County,247,41,206
30,Montana,56,Wyoming,27,Niobrara County,13,0,13
30,Montana,56,Wyoming,29,Park County,420,187,233
30,Montana,56,Wyoming,31,Platte County,3,0,3
30,Montana,56,Wyoming,33,Sheridan County,565,175,390
30,Montana,56,Wyoming,35,Sublette County,60,11,49
30,Montana,56,Wyoming,37,Sweetwater County,22,123,-101
30,Montana,56,Wyoming,39,Teton County,38,46,-8
30,Montana,56,Wyoming,41,Uinta County,42,3,39
30,Montana,56,Wyoming,43,Washakie County,25,5,20
30,Montana,56,Wyoming,45,Weston County,49,0,49
30,Montana,6,California,1,Alameda County,60,47,13
30,Montana,6,California,5,Amador County,0,13,-13
30,Montana,6,California,7,Butte County,38,3,35
30,Montana,6,California,9,Calaveras County,3,0,3
30,Montana,6,California,13,Contra Costa County,73,68,5
30,Montana,6,California,17,El Dorado County,75,0,75
30,Montana,6,California,19,Fresno County,30,175,-145
30,Montana,6,California,23,Humboldt County,19,11,8
30,Montana,6,California,25,Imperial County,7,0,7
30,Montana,6,California,27,Inyo County,15,4,11
30,Montana,6,California,29,Kern County,240,38,202
30,Montana,6,California,31,Kings County,0,15,-15
30,Montana,6,California,33,Lake County,17,0,17
30,Montana,6,California,35,Lassen County,0,6,-6
30,Montana,6,California,37,Los Angeles County,609,159,450
30,Montana,6,California,39,Madera County,3,15,-12
30,Montana,6,California,41,Marin County,9,31,-22
30,Montana,6,California,43,Mariposa County,14,0,14
30,Montana,6,California,45,Mendocino County,5,2,3
30,Montana,6,California,47,Merced County,4,57,-53
30,Montana,6,California,49,Modoc County,9,12,-3
30,Montana,6,California,51,Mono County,3,0,3
30,Montana,6,California,53,Monterey County,0,44,-44
30,Montana,6,California,57,Nevada County,15,51,-36
30,Montana,6,California,59,Orange County,299,261,38
30,Montana,6,California,61,Placer County,61,76,-15
30,Montana,6,California,63,Plumas County,15,0,15
30,Montana,6,California,65,Riverside County,738,252,486
30,Montana,6,California,67,Sacramento County,139,32,107
30,Montana,6,California,69,San Benito County,12,0,12
30,Montana,6,California,71,San Bernardino County,301,67,234
30,Montana,6,California,73,San Diego County,365,282,83
30,Montana,6,California,75,San Francisco County,95,17,78
30,Montana,6,California,77,San Joaquin County,24,0,24
30,Montana,6,California,79,San Luis Obispo County,114,58,56
30,Montana,6,California,81,San Mateo County,53,25,28
30,Montana,6,California,83,Santa Barbara County,206,199,7
30,Montana,6,California,85,Santa Clara County,352,30,322
30,Montana,6,California,87,Santa Cruz County,23,35,-12
30,Montana,6,California,89,Shasta County,34,11,23
30,Montana,6,California,91,Sierra County,55,0,55
30,Montana,6,California,93,Siskiyou County,123,7,116
30,Montana,6,California,95,Solano County,109,79,30
30,Montana,6,California,97,Sonoma County,138,29,109
30,Montana,6,California,99,Stanislaus County,3,0,3
30,Montana,6,California,101,Sutter County,6,0,6
30,Montana,6,California,105,Trinity County,0,98,-98
30,Montana,6,California,107,Tulare County,14,0,14
30,Montana,6,California,109,Tuolumne County,30,0,30
30,Montana,6,California,111,Ventura County,64,22,42
30,Montana,6,California,113,Yolo County,39,9,30
30,Montana,6,California,115,Yuba County,5,0,5
30,Montana,72,Puerto Rico,71,Isabela Municipio,8,0,8
30,Montana,72,Puerto Rico,117,Rincón Municipio,25,0,25
30,Montana,72,Puerto Rico,127,San Juan Municipio,3,0,3
30,Montana,8,Colorado,1,Adams County,59,47,12
30,Montana,8,Colorado,3,Alamosa County,0,12,-12
30,Montana,8,Colorado,5,Arapahoe County,152,199,-47
30,Montana,8,Colorado,7,Archuleta County,24,5,19
30,Montana,8,Colorado,11,Bent County,8,15,-7
30,Montana,8,Colorado,13,Boulder County,276,153,123
30,Montana,8,Colorado,14,Broomfield County,23,8,15
30,Montana,8,Colorado,19,Clear Creek County,20,0,20
30,Montana,8,Colorado,23,Costilla County,5,0,5
30,Montana,8,Colorado,27,Custer County,13,0,13
30,Montana,8,Colorado,29,Delta County,106,46,60
30,Montana,8,Colorado,31,Denver County,158,114,44
30,Montana,8,Colorado,35,Douglas County,47,29,18
30,Montana,8,Colorado,37,Eagle County,0,23,-23
30,Montana,8,Colorado,39,Elbert County,8,0,8
30,Montana,8,Colorado,41,El Paso County,226,236,-10
30,Montana,8,Colorado,43,Fremont County,8,49,-41
30,Montana,8,Colorado,45,Garfield County,8,20,-12
30,Montana,8,Colorado,47,Gilpin County,0,8,-8
30,Montana,8,Colorado,49,Grand County,7,81,-74
30,Montana,8,Colorado,57,Jackson County,4,0,4
30,Montana,8,Colorado,59,Jefferson County,319,349,-30
30,Montana,8,Colorado,67,La Plata County,72,10,62
30,Montana,8,Colorado,69,Larimer County,195,83,112
30,Montana,8,Colorado,71,Las Animas County,11,0,11
30,Montana,8,Colorado,77,Mesa County,53,0,53
30,Montana,8,Colorado,81,Moffat County,0,90,-90
30,Montana,8,Colorado,83,Montezuma County,23,13,10
30,Montana,8,Colorado,85,Montrose County,42,27,15
30,Montana,8,Colorado,87,Morgan County,33,0,33
30,Montana,8,Colorado,91,Ouray County,0,7,-7
30,Montana,8,Colorado,93,Park County,0,33,-33
30,Montana,8,Colorado,97,Pitkin County,24,0,24
30,Montana,8,Colorado,101,Pueblo County,44,15,29
30,Montana,8,Colorado,103,Rio Blanco County,6,8,-2
30,Montana,8,Colorado,107,Routt County,72,0,72
30,Montana,8,Colorado,113,San Miguel County,5,0,5
30,Montana,8,Colorado,117,Summit County,46,11,35
30,Montana,8,Colorado,119,Teller County,70,0,70
30,Montana,8,Colorado,123,Weld County,85,5,80
30,Montana,9,Connecticut,1,Fairfield County,10,0,10
30,Montana,9,Connecticut,3,Hartford County,0,11,-11
30,Montana,9,Connecticut,11,New London County,5,0,5
30,Montana,AFR,Africa,,-,163,0,0
30,Montana,ASI,Asia,,-,1181,0,0
30,Montana,CAM,Central America,,-,430,0,0
30,Montana,CAR,Caribbean,,-,123,0,0
30,Montana,EUR,Europe,,-,1085,0,0
30,Montana,ISL,U.S. Island Areas,,-,37,0,0
30,Montana,NAM,Northern America,,-,242,0,0
30,Montana,OCE,Oceania and At Sea,,-,186,0,0
30,Montana,SAM,South America,,-,144,0,0
31,Nebraska,1,Alabama,55,Etowah County,0,12,-12
31,Nebraska,1,Alabama,61,Geneva County,16,0,16
31,Nebraska,1,Alabama,69,Houston County,51,0,51
31,Nebraska,1,Alabama,73,Jefferson County,0,17,-17
31,Nebraska,1,Alabama,77,Lauderdale County,31,0,31
31,Nebraska,1,Alabama,81,Lee County,72,5,67
31,Nebraska,1,Alabama,89,Madison County,3,94,-91
31,Nebraska,1,Alabama,95,Marshall County,7,0,7
31,Nebraska,1,Alabama,97,Mobile County,128,0,128
31,Nebraska,1,Alabama,101,Montgomery County,0,42,-42
31,Nebraska,1,Alabama,119,Sumter County,12,0,12
31,Nebraska,1,Alabama,121,Talladega County,6,0,6
31,Nebraska,10,Delaware,1,Kent County,12,0,12
31,Nebraska,10,Delaware,5,Sussex County,8,40,-32
31,Nebraska,11,District of Columbia,1,District of Columbia,32,230,-198
31,Nebraska,12,Florida,1,Alachua County,66,46,20
31,Nebraska,12,Florida,5,Bay County,72,9,63
31,Nebraska,12,Florida,9,Brevard County,50,18,32
31,Nebraska,12,Florida,11,Broward County,70,53,17
31,Nebraska,12,Florida,19,Clay County,2,0,2
31,Nebraska,12,Florida,27,DeSoto County,70,0,70
31,Nebraska,12,Florida,31,Duval County,128,22,106
31,Nebraska,12,Florida,33,Escambia County,45,141,-96
31,Nebraska,12,Florida,53,Hernando County,114,0,114
31,Nebraska,12,Florida,57,Hillsborough County,377,105,272
31,Nebraska,12,Florida,61,Indian River County,0,17,-17
31,Nebraska,12,Florida,69,Lake County,2,0,2
31,Nebraska,12,Florida,71,Lee County,3,50,-47
31,Nebraska,12,Florida,73,Leon County,17,11,6
31,Nebraska,12,Florida,81,Manatee County,11,0,11
31,Nebraska,12,Florida,83,Marion County,64,0,64
31,Nebraska,12,Florida,85,Martin County,16,39,-23
31,Nebraska,12,Florida,86,Miami-Dade County,163,26,137
31,Nebraska,12,Florida,89,Nassau County,45,0,45
31,Nebraska,12,Florida,91,Okaloosa County,123,159,-36
31,Nebraska,12,Florida,95,Orange County,127,35,92
31,Nebraska,12,Florida,97,Osceola County,47,152,-105
31,Nebraska,12,Florida,99,Palm Beach County,107,134,-27
31,Nebraska,12,Florida,101,Pasco County,0,71,-71
31,Nebraska,12,Florida,103,Pinellas County,11,158,-147
31,Nebraska,12,Florida,105,Polk County,88,89,-1
31,Nebraska,12,Florida,109,St. Johns County,38,79,-41
31,Nebraska,12,Florida,111,St. Lucie County,20,0,20
31,Nebraska,12,Florida,113,Santa Rosa County,56,66,-10
31,Nebraska,12,Florida,115,Sarasota County,40,186,-146
31,Nebraska,12,Florida,117,Seminole County,23,0,23
31,Nebraska,12,Florida,127,Volusia County,45,0,45
31,Nebraska,12,Florida,131,Walton County,8,0,8
31,Nebraska,13,Georgia,21,Bibb County,0,4,-4
31,Nebraska,13,Georgia,29,Bryan County,0,7,-7
31,Nebraska,13,Georgia,39,Camden County,20,0,20
31,Nebraska,13,Georgia,45,Carroll County,33,0,33
31,Nebraska,13,Georgia,47,Catoosa County,0,20,-20
31,Nebraska,13,Georgia,51,Chatham County,74,5,69
31,Nebraska,13,Georgia,53,Chattahoochee County,97,14,83
31,Nebraska,13,Georgia,59,Clarke County,15,0,15
31,Nebraska,13,Georgia,63,Clayton County,17,4,13
31,Nebraska,13,Georgia,67,Cobb County,0,161,-161
31,Nebraska,13,Georgia,89,DeKalb County,63,11,52
31,Nebraska,13,Georgia,109,Evans County,9,0,9
31,Nebraska,13,Georgia,113,Fayette County,0,61,-61
31,Nebraska,13,Georgia,117,Forsyth County,0,181,-181
31,Nebraska,13,Georgia,121,Fulton County,296,65,231
31,Nebraska,13,Georgia,135,Gwinnett County,51,106,-55
31,Nebraska,13,Georgia,141,Hancock County,0,7,-7
31,Nebraska,13,Georgia,151,Henry County,31,0,31
31,Nebraska,13,Georgia,153,Houston County,24,0,24
31,Nebraska,13,Georgia,159,Jasper County,14,0,14
31,Nebraska,13,Georgia,177,Lee County,14,0,14
31,Nebraska,13,Georgia,185,Lowndes County,25,13,12
31,Nebraska,13,Georgia,215,Muscogee County,0,3,-3
31,Nebraska,13,Georgia,223,Paulding County,3,0,3
31,Nebraska,13,Georgia,231,Pike County,3,0,3
31,Nebraska,13,Georgia,245,Richmond County,59,11,48
31,Nebraska,13,Georgia,269,Taylor County,0,3,-3
31,Nebraska,13,Georgia,277,Tift County,19,0,19
31,Nebraska,13,Georgia,285,Troup County,9,0,9
31,Nebraska,13,Georgia,291,Union County,6,0,6
31,Nebraska,13,Georgia,313,Whitfield County,0,16,-16
31,Nebraska,15,Hawaii,1,Hawaii County,9,32,-23
31,Nebraska,15,Hawaii,3,Honolulu County,165,111,54
31,Nebraska,15,Hawaii,9,Maui County,0,19,-19
31,Nebraska,16,Idaho,1,Ada County,30,71,-41
31,Nebraska,16,Idaho,5,Bannock County,59,0,59
31,Nebraska,16,Idaho,11,Bingham County,140,0,140
31,Nebraska,16,Idaho,17,Bonner County,11,12,-1
31,Nebraska,16,Idaho,27,Canyon County,1,45,-44
31,Nebraska,16,Idaho,31,Cassia County,0,6,-6
31,Nebraska,16,Idaho,37,Custer County,0,1,-1
31,Nebraska,16,Idaho,39,Elmore County,34,0,34
31,Nebraska,16,Idaho,45,Gem County,9,0,9
31,Nebraska,16,Idaho,53,Jerome County,0,10,-10
31,Nebraska,16,Idaho,55,Kootenai County,16,5,11
31,Nebraska,16,Idaho,57,Latah County,6,0,6
31,Nebraska,16,Idaho,59,Lemhi County,0,1,-1
31,Nebraska,16,Idaho,61,Lewis County,21,0,21
31,Nebraska,16,Idaho,63,Lincoln County,7,0,7
31,Nebraska,16,Idaho,65,Madison County,59,66,-7
31,Nebraska,16,Idaho,69,Nez Perce County,13,6,7
31,Nebraska,17,Illinois,1,Adams County,0,14,-14
31,Nebraska,17,Illinois,7,Boone County,11,0,11
31,Nebraska,17,Illinois,19,Champaign County,11,0,11
31,Nebraska,17,Illinois,25,Clay County,5,0,5
31,Nebraska,17,Illinois,29,Coles County,12,119,-107
31,Nebraska,17,Illinois,31,Cook County,1008,598,410
31,Nebraska,17,Illinois,37,DeKalb County,110,0,110
31,Nebraska,17,Illinois,41,Douglas County,11,0,11
31,Nebraska,17,Illinois,43,DuPage County,81,178,-97
31,Nebraska,17,Illinois,49,Effingham County,6,0,6
31,Nebraska,17,Illinois,73,Henry County,11,0,11
31,Nebraska,17,Illinois,89,Kane County,10,25,-15
31,Nebraska,17,Illinois,93,Kendall County,41,0,41
31,Nebraska,17,Illinois,95,Knox County,7,0,7
31,Nebraska,17,Illinois,97,Lake County,82,16,66
31,Nebraska,17,Illinois,99,LaSalle County,35,0,35
31,Nebraska,17,Illinois,103,Lee County,0,16,-16
31,Nebraska,17,Illinois,109,McDonough County,42,0,42
31,Nebraska,17,Illinois,111,McHenry County,32,0,32
31,Nebraska,17,Illinois,113,McLean County,14,0,14
31,Nebraska,17,Illinois,115,Macon County,15,11,4
31,Nebraska,17,Illinois,119,Madison County,36,39,-3
31,Nebraska,17,Illinois,121,Marion County,37,0,37
31,Nebraska,17,Illinois,125,Mason County,16,16,0
31,Nebraska,17,Illinois,133,Monroe County,0,45,-45
31,Nebraska,17,Illinois,135,Montgomery County,53,0,53
31,Nebraska,17,Illinois,139,Moultrie County,3,0,3
31,Nebraska,17,Illinois,141,Ogle County,79,0,79
31,Nebraska,17,Illinois,143,Peoria County,15,24,-9
31,Nebraska,17,Illinois,149,Pike County,0,4,-4
31,Nebraska,17,Illinois,161,Rock Island County,24,53,-29
31,Nebraska,17,Illinois,163,St. Clair County,53,138,-85
31,Nebraska,17,Illinois,165,Saline County,7,0,7
31,Nebraska,17,Illinois,167,Sangamon County,42,8,34
31,Nebraska,17,Illinois,173,Shelby County,0,13,-13
31,Nebraska,17,Illinois,179,Tazewell County,197,34,163
31,Nebraska,17,Illinois,187,Warren County,0,7,-7
31,Nebraska,17,Illinois,195,Whiteside County,19,11,8
31,Nebraska,17,Illinois,197,Will County,146,75,71
31,Nebraska,17,Illinois,203,Woodford County,5,0,5
31,Nebraska,18,Indiana,3,Allen County,53,84,-31
31,Nebraska,18,Indiana,11,Boone County,0,10,-10
31,Nebraska,18,Indiana,21,Clay County,0,3,-3
31,Nebraska,18,Indiana,35,Delaware County,50,0,50
31,Nebraska,18,Indiana,43,Floyd County,0,19,-19
31,Nebraska,18,Indiana,45,Fountain County,9,0,9
31,Nebraska,18,Indiana,51,Gibson County,0,37,-37
31,Nebraska,18,Indiana,57,Hamilton County,72,14,58
31,Nebraska,18,Indiana,63,Hendricks County,0,108,-108
31,Nebraska,18,Indiana,67,Howard County,7,0,7
31,Nebraska,18,Indiana,73,Jasper County,44,0,44
31,Nebraska,18,Indiana,85,Kosciusko County,0,3,-3
31,Nebraska,18,Indiana,89,Lake County,8,4,4
31,Nebraska,18,Indiana,91,LaPorte County,3,0,3
31,Nebraska,18,Indiana,95,Madison County,3,0,3
31,Nebraska,18,Indiana,97,Marion County,37,11,26
31,Nebraska,18,Indiana,107,Montgomery County,10,6,4
31,Nebraska,18,Indiana,127,Porter County,60,12,48
31,Nebraska,18,Indiana,133,Putnam County,16,0,16
31,Nebraska,18,Indiana,151,Steuben County,5,0,5
31,Nebraska,18,Indiana,157,Tippecanoe County,0,9,-9
31,Nebraska,18,Indiana,163,Vanderburgh County,0,13,-13
31,Nebraska,18,Indiana,167,Vigo County,0,23,-23
31,Nebraska,19,Iowa,1,Adair County,7,0,7
31,Nebraska,19,Iowa,3,Adams County,38,4,34
31,Nebraska,19,Iowa,7,Appanoose County,0,8,-8
31,Nebraska,19,Iowa,9,Audubon County,30,5,25
31,Nebraska,19,Iowa,11,Benton County,0,79,-79
31,Nebraska,19,Iowa,13,Black Hawk County,118,112,6
31,Nebraska,19,Iowa,15,Boone County,7,100,-93
31,Nebraska,19,Iowa,19,Buchanan County,0,5,-5
31,Nebraska,19,Iowa,21,Buena Vista County,244,36,208
31,Nebraska,19,Iowa,23,Butler County,28,3,25
31,Nebraska,19,Iowa,25,Calhoun County,0,8,-8
31,Nebraska,19,Iowa,27,Carroll County,69,5,64
31,Nebraska,19,Iowa,29,Cass County,44,44,0
31,Nebraska,19,Iowa,31,Cedar County,4,0,4
31,Nebraska,19,Iowa,33,Cerro Gordo County,10,118,-108
31,Nebraska,19,Iowa,35,Cherokee County,16,66,-50
31,Nebraska,19,Iowa,39,Clarke County,0,12,-12
31,Nebraska,19,Iowa,41,Clay County,41,15,26
31,Nebraska,19,Iowa,47,Crawford County,96,32,64
31,Nebraska,19,Iowa,49,Dallas County,110,61,49
31,Nebraska,19,Iowa,51,Davis County,12,8,4
31,Nebraska,19,Iowa,53,Decatur County,0,14,-14
31,Nebraska,19,Iowa,59,Dickinson County,0,16,-16
31,Nebraska,19,Iowa,61,Dubuque County,17,34,-17
31,Nebraska,19,Iowa,63,Emmet County,0,14,-14
31,Nebraska,19,Iowa,65,Fayette County,1,0,1
31,Nebraska,19,Iowa,69,Franklin County,0,19,-19
31,Nebraska,19,Iowa,71,Fremont County,108,114,-6
31,Nebraska,19,Iowa,73,Greene County,8,49,-41
31,Nebraska,19,Iowa,75,Grundy County,0,4,-4
31,Nebraska,19,Iowa,77,Guthrie County,37,4,33
31,Nebraska,19,Iowa,79,Hamilton County,32,33,-1
31,Nebraska,19,Iowa,81,Hancock County,1,0,1
31,Nebraska,19,Iowa,83,Hardin County,9,11,-2
31,Nebraska,19,Iowa,85,Harrison County,296,126,170
31,Nebraska,19,Iowa,87,Henry County,0,6,-6
31,Nebraska,19,Iowa,93,Ida County,109,2,107
31,Nebraska,19,Iowa,95,Iowa County,8,27,-19
31,Nebraska,19,Iowa,99,Jasper County,18,10,8
31,Nebraska,19,Iowa,101,Jefferson County,0,9,-9
31,Nebraska,19,Iowa,103,Johnson County,215,159,56
31,Nebraska,19,Iowa,105,Jones County,0,14,-14
31,Nebraska,19,Iowa,107,Keokuk County,6,0,6
31,Nebraska,19,Iowa,109,Kossuth County,11,0,11
31,Nebraska,19,Iowa,111,Lee County,0,10,-10
31,Nebraska,19,Iowa,113,Linn County,53,181,-128
31,Nebraska,19,Iowa,117,Lucas County,0,7,-7
31,Nebraska,19,Iowa,119,Lyon County,33,0,33
31,Nebraska,19,Iowa,123,Mahaska County,12,0,12
31,Nebraska,19,Iowa,125,Marion County,23,14,9
31,Nebraska,19,Iowa,127,Marshall County,5,1,4
31,Nebraska,19,Iowa,129,Mills County,67,378,-311
31,Nebraska,19,Iowa,131,Mitchell County,8,4,4
31,Nebraska,19,Iowa,133,Monona County,76,13,63
31,Nebraska,19,Iowa,135,Monroe County,22,0,22
31,Nebraska,19,Iowa,137,Montgomery County,18,117,-99
31,Nebraska,19,Iowa,139,Muscatine County,34,13,21
31,Nebraska,19,Iowa,141,O'Brien County,75,13,62
31,Nebraska,19,Iowa,143,Osceola County,0,18,-18
31,Nebraska,19,Iowa,145,Page County,218,150,68
31,Nebraska,19,Iowa,147,Palo Alto County,104,11,93
31,Nebraska,19,Iowa,149,Plymouth County,75,72,3
31,Nebraska,19,Iowa,151,Pocahontas County,27,6,21
31,Nebraska,19,Iowa,153,Polk County,472,530,-58
31,Nebraska,19,Iowa,155,Pottawattamie County,2245,2152,93
31,Nebraska,19,Iowa,157,Poweshiek County,0,18,-18
31,Nebraska,19,Iowa,159,Ringgold County,0,4,-4
31,Nebraska,19,Iowa,161,Sac County,0,36,-36
31,Nebraska,19,Iowa,163,Scott County,44,45,-1
31,Nebraska,19,Iowa,165,Shelby County,70,118,-48
31,Nebraska,19,Iowa,167,Sioux County,57,122,-65
31,Nebraska,19,Iowa,169,Story County,296,424,-128
31,Nebraska,19,Iowa,171,Tama County,9,13,-4
31,Nebraska,19,Iowa,173,Taylor County,0,2,-2
31,Nebraska,19,Iowa,175,Union County,18,11,7
31,Nebraska,19,Iowa,179,Wapello County,0,18,-18
31,Nebraska,19,Iowa,181,Warren County,14,50,-36
31,Nebraska,19,Iowa,185,Wayne County,0,5,-5
31,Nebraska,19,Iowa,187,Webster County,53,90,-37
31,Nebraska,19,Iowa,189,Winnebago County,54,2,52
31,Nebraska,19,Iowa,191,Winneshiek County,49,0,49
31,Nebraska,19,Iowa,193,Woodbury County,1245,1028,217
31,Nebraska,2,Alaska,13,Aleutians East Borough,0,7,-7
31,Nebraska,2,Alaska,16,Aleutians West Census Area,0,3,-3
31,Nebraska,2,Alaska,20,Anchorage Municipality,205,40,165
31,Nebraska,2,Alaska,90,Fairbanks North Star Borough,124,16,108
31,Nebraska,2,Alaska,110,Juneau City and Borough,0,3,-3
31,Nebraska,2,Alaska,122,Kenai Peninsula Borough,20,0,20
31,Nebraska,2,Alaska,170,Matanuska-Susitna Borough,63,59,4
31,Nebraska,2,Alaska,290,Yukon-Koyukuk Census Area,3,0,3
31,Nebraska,20,Kansas,1,Allen County,0,8,-8
31,Nebraska,20,Kansas,5,Atchison County,75,35,40
31,Nebraska,20,Kansas,9,Barton County,0,23,-23
31,Nebraska,20,Kansas,11,Bourbon County,0,1,-1
31,Nebraska,20,Kansas,13,Brown County,4,40,-36
31,Nebraska,20,Kansas,15,Butler County,10,0,10
31,Nebraska,20,Kansas,21,Cherokee County,8,20,-12
31,Nebraska,20,Kansas,23,Cheyenne County,0,9,-9
31,Nebraska,20,Kansas,27,Clay County,29,49,-20
31,Nebraska,20,Kansas,29,Cloud County,7,29,-22
31,Nebraska,20,Kansas,31,Coffey County,0,8,-8
31,Nebraska,20,Kansas,35,Cowley County,0,8,-8
31,Nebraska,20,Kansas,37,Crawford County,3,63,-60
31,Nebraska,20,Kansas,39,Decatur County,0,22,-22
31,Nebraska,20,Kansas,41,Dickinson County,0,36,-36
31,Nebraska,20,Kansas,43,Doniphan County,0,31,-31
31,Nebraska,20,Kansas,45,Douglas County,85,143,-58
31,Nebraska,20,Kansas,51,Ellis County,66,74,-8
31,Nebraska,20,Kansas,53,Ellsworth County,20,0,20
31,Nebraska,20,Kansas,55,Finney County,3,19,-16
31,Nebraska,20,Kansas,57,Ford County,6,0,6
31,Nebraska,20,Kansas,59,Franklin County,4,2,2
31,Nebraska,20,Kansas,61,Geary County,26,56,-30
31,Nebraska,20,Kansas,63,Gove County,0,5,-5
31,Nebraska,20,Kansas,65,Graham County,8,0,8
31,Nebraska,20,Kansas,71,Greeley County,15,0,15
31,Nebraska,20,Kansas,77,Harper County,30,0,30
31,Nebraska,20,Kansas,79,Harvey County,42,31,11
31,Nebraska,20,Kansas,85,Jackson County,0,7,-7
31,Nebraska,20,Kansas,87,Jefferson County,21,0,21
31,Nebraska,20,Kansas,89,Jewell County,18,1,17
31,Nebraska,20,Kansas,91,Johnson County,678,850,-172
31,Nebraska,20,Kansas,93,Kearny County,24,52,-28
31,Nebraska,20,Kansas,95,Kingman County,11,5,6
31,Nebraska,20,Kansas,97,Kiowa County,0,1,-1
31,Nebraska,20,Kansas,103,Leavenworth County,19,163,-144
31,Nebraska,20,Kansas,109,Logan County,18,4,14
31,Nebraska,20,Kansas,111,Lyon County,25,2,23
31,Nebraska,20,Kansas,113,McPherson County,43,69,-26
31,Nebraska,20,Kansas,115,Marion County,0,8,-8
31,Nebraska,20,Kansas,117,Marshall County,142,18,124
31,Nebraska,20,Kansas,121,Miami County,9,31,-22
31,Nebraska,20,Kansas,123,Mitchell County,12,9,3
31,Nebraska,20,Kansas,125,Montgomery County,0,6,-6
31,Nebraska,20,Kansas,131,Nemaha County,5,52,-47
31,Nebraska,20,Kansas,137,Norton County,36,6,30
31,Nebraska,20,Kansas,139,Osage County,0,4,-4
31,Nebraska,20,Kansas,141,Osborne County,0,2,-2
31,Nebraska,20,Kansas,145,Pawnee County,0,4,-4
31,Nebraska,20,Kansas,147,Phillips County,7,7,0
31,Nebraska,20,Kansas,151,Pratt County,0,2,-2
31,Nebraska,20,Kansas,155,Reno County,46,37,9
31,Nebraska,20,Kansas,157,Republic County,1,34,-33
31,Nebraska,20,Kansas,161,Riley County,221,188,33
31,Nebraska,20,Kansas,165,Rush County,75,1,74
31,Nebraska,20,Kansas,167,Russell County,32,0,32
31,Nebraska,20,Kansas,169,Saline County,177,88,89
31,Nebraska,20,Kansas,171,Scott County,93,0,93
31,Nebraska,20,Kansas,173,Sedgwick County,251,100,151
31,Nebraska,20,Kansas,177,Shawnee County,75,127,-52
31,Nebraska,20,Kansas,181,Sherman County,189,23,166
31,Nebraska,20,Kansas,183,Smith County,43,8,35
31,Nebraska,20,Kansas,185,Stafford County,0,2,-2
31,Nebraska,20,Kansas,187,Stanton County,0,27,-27
31,Nebraska,20,Kansas,193,Thomas County,8,13,-5
31,Nebraska,20,Kansas,195,Trego County,0,4,-4
31,Nebraska,20,Kansas,197,Wabaunsee County,7,0,7
31,Nebraska,20,Kansas,201,Washington County,44,55,-11
31,Nebraska,20,Kansas,203,Wichita County,6,7,-1
31,Nebraska,20,Kansas,205,Wilson County,33,0,33
31,Nebraska,20,Kansas,209,Wyandotte County,37,181,-144
31,Nebraska,21,Kentucky,5,Anderson County,14,0,14
31,Nebraska,21,Kentucky,15,Boone County,0,36,-36
31,Nebraska,21,Kentucky,37,Campbell County,0,13,-13
31,Nebraska,21,Kentucky,45,Casey County,48,0,48
31,Nebraska,21,Kentucky,59,Daviess County,2,0,2
31,Nebraska,21,Kentucky,67,Fayette County,116,103,13
31,Nebraska,21,Kentucky,93,Hardin County,0,60,-60
31,Nebraska,21,Kentucky,101,Henderson County,0,16,-16
31,Nebraska,21,Kentucky,111,Jefferson County,48,165,-117
31,Nebraska,21,Kentucky,113,Jessamine County,2,0,2
31,Nebraska,21,Kentucky,115,Johnson County,43,0,43
31,Nebraska,21,Kentucky,117,Kenton County,3,9,-6
31,Nebraska,21,Kentucky,125,Laurel County,17,0,17
31,Nebraska,21,Kentucky,139,Livingston County,0,10,-10
31,Nebraska,21,Kentucky,141,Logan County,18,0,18
31,Nebraska,21,Kentucky,147,McCreary County,6,0,6
31,Nebraska,21,Kentucky,157,Marshall County,28,0,28
31,Nebraska,21,Kentucky,159,Martin County,0,33,-33
31,Nebraska,21,Kentucky,185,Oldham County,39,0,39
31,Nebraska,21,Kentucky,187,Owen County,0,9,-9
31,Nebraska,21,Kentucky,199,Pulaski County,0,87,-87
31,Nebraska,21,Kentucky,205,Rowan County,0,28,-28
31,Nebraska,21,Kentucky,225,Union County,11,0,11
31,Nebraska,21,Kentucky,227,Warren County,10,0,10
31,Nebraska,21,Kentucky,235,Whitley County,12,0,12
31,Nebraska,22,Louisiana,5,Ascension Parish,6,0,6
31,Nebraska,22,Louisiana,15,Bossier Parish,19,77,-58
31,Nebraska,22,Louisiana,19,Calcasieu Parish,3,0,3
31,Nebraska,22,Louisiana,23,Cameron Parish,0,2,-2
31,Nebraska,22,Louisiana,33,East Baton Rouge Parish,0,9,-9
31,Nebraska,22,Louisiana,45,Iberia Parish,0,25,-25
31,Nebraska,22,Louisiana,51,Jefferson Parish,0,18,-18
31,Nebraska,22,Louisiana,55,Lafayette Parish,46,0,46
31,Nebraska,22,Louisiana,59,LaSalle Parish,0,7,-7
31,Nebraska,22,Louisiana,71,Orleans Parish,0,33,-33
31,Nebraska,22,Louisiana,73,Ouachita Parish,7,0,7
31,Nebraska,22,Louisiana,79,Rapides Parish,0,12,-12
31,Nebraska,22,Louisiana,101,St. Mary Parish,140,0,140
31,Nebraska,22,Louisiana,103,St. Tammany Parish,5,0,5
31,Nebraska,22,Louisiana,105,Tangipahoa Parish,34,0,34
31,Nebraska,22,Louisiana,109,Terrebonne Parish,40,0,40
31,Nebraska,22,Louisiana,115,Vernon Parish,0,25,-25
31,Nebraska,23,Maine,5,Cumberland County,98,59,39
31,Nebraska,23,Maine,17,Oxford County,0,14,-14
31,Nebraska,23,Maine,19,Penobscot County,12,0,12
31,Nebraska,23,Maine,27,Waldo County,0,26,-26
31,Nebraska,23,Maine,31,York County,43,0,43
31,Nebraska,24,Maryland,3,Anne Arundel County,22,9,13
31,Nebraska,24,Maryland,5,Baltimore County,89,5,84
31,Nebraska,24,Maryland,9,Calvert County,5,0,5
31,Nebraska,24,Maryland,13,Carroll County,25,0,25
31,Nebraska,24,Maryland,15,Cecil County,6,0,6
31,Nebraska,24,Maryland,17,Charles County,24,0,24
31,Nebraska,24,Maryland,21,Frederick County,0,83,-83
31,Nebraska,24,Maryland,31,Montgomery County,204,129,75
31,Nebraska,24,Maryland,33,Prince George's County,126,29,97
31,Nebraska,24,Maryland,510,Baltimore city,20,19,1
31,Nebraska,25,Massachusetts,3,Berkshire County,0,12,-12
31,Nebraska,25,Massachusetts,5,Bristol County,0,161,-161
31,Nebraska,25,Massachusetts,9,Essex County,14,28,-14
31,Nebraska,25,Massachusetts,13,Hampden County,3,0,3
31,Nebraska,25,Massachusetts,15,Hampshire County,14,0,14
31,Nebraska,25,Massachusetts,17,Middlesex County,229,38,191
31,Nebraska,25,Massachusetts,21,Norfolk County,25,14,11
31,Nebraska,25,Massachusetts,25,Suffolk County,0,20,-20
31,Nebraska,25,Massachusetts,27,Worcester County,8,18,-10
31,Nebraska,26,Michigan,7,Alpena County,0,7,-7
31,Nebraska,26,Michigan,9,Antrim County,2,0,2
31,Nebraska,26,Michigan,15,Barry County,18,0,18
31,Nebraska,26,Michigan,19,Benzie County,4,0,4
31,Nebraska,26,Michigan,21,Berrien County,72,22,50
31,Nebraska,26,Michigan,25,Calhoun County,39,0,39
31,Nebraska,26,Michigan,29,Charlevoix County,0,10,-10
31,Nebraska,26,Michigan,33,Chippewa County,16,0,16
31,Nebraska,26,Michigan,35,Clare County,3,22,-19
31,Nebraska,26,Michigan,43,Dickinson County,28,0,28
31,Nebraska,26,Michigan,45,Eaton County,0,9,-9
31,Nebraska,26,Michigan,53,Gogebic County,24,0,24
31,Nebraska,26,Michigan,55,Grand Traverse County,29,0,29
31,Nebraska,26,Michigan,57,Gratiot County,0,7,-7
31,Nebraska,26,Michigan,59,Hillsdale County,17,20,-3
31,Nebraska,26,Michigan,61,Houghton County,30,0,30
31,Nebraska,26,Michigan,71,Iron County,0,2,-2
31,Nebraska,26,Michigan,73,Isabella County,111,0,111
31,Nebraska,26,Michigan,75,Jackson County,17,0,17
31,Nebraska,26,Michigan,77,Kalamazoo County,105,47,58
31,Nebraska,26,Michigan,81,Kent County,28,61,-33
31,Nebraska,26,Michigan,89,Leelanau County,0,95,-95
31,Nebraska,26,Michigan,91,Lenawee County,5,3,2
31,Nebraska,26,Michigan,101,Manistee County,0,13,-13
31,Nebraska,26,Michigan,107,Mecosta County,1,5,-4
31,Nebraska,26,Michigan,121,Muskegon County,0,7,-7
31,Nebraska,26,Michigan,125,Oakland County,28,89,-61
31,Nebraska,26,Michigan,129,Ogemaw County,0,4,-4
31,Nebraska,26,Michigan,139,Ottawa County,11,93,-82
31,Nebraska,26,Michigan,147,St. Clair County,0,34,-34
31,Nebraska,26,Michigan,151,Sanilac County,0,2,-2
31,Nebraska,26,Michigan,155,Shiawassee County,7,8,-1
31,Nebraska,26,Michigan,161,Washtenaw County,97,30,67
31,Nebraska,26,Michigan,163,Wayne County,81,55,26
31,Nebraska,26,Michigan,165,Wexford County,0,19,-19
31,Nebraska,27,Minnesota,1,Aitkin County,0,22,-22
31,Nebraska,27,Minnesota,3,Anoka County,91,0,91
31,Nebraska,27,Minnesota,5,Becker County,0,22,-22
31,Nebraska,27,Minnesota,7,Beltrami County,36,27,9
31,Nebraska,27,Minnesota,9,Benton County,1,0,1
31,Nebraska,27,Minnesota,11,Big Stone County,0,2,-2
31,Nebraska,27,Minnesota,13,Blue Earth County,19,83,-64
31,Nebraska,27,Minnesota,19,Carver County,13,4,9
31,Nebraska,27,Minnesota,21,Cass County,64,1,63
31,Nebraska,27,Minnesota,25,Chisago County,0,7,-7
31,Nebraska,27,Minnesota,27,Clay County,226,0,226
31,Nebraska,27,Minnesota,29,Clearwater County,0,1,-1
31,Nebraska,27,Minnesota,33,Cottonwood County,0,46,-46
31,Nebraska,27,Minnesota,35,Crow Wing County,44,11,33
31,Nebraska,27,Minnesota,37,Dakota County,203,117,86
31,Nebraska,27,Minnesota,41,Douglas County,30,46,-16
31,Nebraska,27,Minnesota,47,Freeborn County,26,8,18
31,Nebraska,27,Minnesota,49,Goodhue County,0,55,-55
31,Nebraska,27,Minnesota,53,Hennepin County,250,617,-367
31,Nebraska,27,Minnesota,57,Hubbard County,0,14,-14
31,Nebraska,27,Minnesota,61,Itasca County,0,4,-4
31,Nebraska,27,Minnesota,67,Kandiyohi County,28,30,-2
31,Nebraska,27,Minnesota,75,Lake County,0,10,-10
31,Nebraska,27,Minnesota,77,Lake of the Woods County,0,1,-1
31,Nebraska,27,Minnesota,79,Le Sueur County,36,0,36
31,Nebraska,27,Minnesota,81,Lincoln County,0,5,-5
31,Nebraska,27,Minnesota,83,Lyon County,8,17,-9
31,Nebraska,27,Minnesota,91,Martin County,0,7,-7
31,Nebraska,27,Minnesota,95,Mille Lacs County,3,0,3
31,Nebraska,27,Minnesota,97,Morrison County,0,19,-19
31,Nebraska,27,Minnesota,103,Nicollet County,21,49,-28
31,Nebraska,27,Minnesota,105,Nobles County,48,26,22
31,Nebraska,27,Minnesota,107,Norman County,16,0,16
31,Nebraska,27,Minnesota,109,Olmsted County,72,32,40
31,Nebraska,27,Minnesota,111,Otter Tail County,31,6,25
31,Nebraska,27,Minnesota,115,Pine County,12,0,12
31,Nebraska,27,Minnesota,119,Polk County,19,0,19
31,Nebraska,27,Minnesota,123,Ramsey County,103,152,-49
31,Nebraska,27,Minnesota,127,Redwood County,8,17,-9
31,Nebraska,27,Minnesota,129,Renville County,0,13,-13
31,Nebraska,27,Minnesota,131,Rice County,3,34,-31
31,Nebraska,27,Minnesota,133,Rock County,10,5,5
31,Nebraska,27,Minnesota,135,Roseau County,0,1,-1
31,Nebraska,27,Minnesota,137,St. Louis County,22,71,-49
31,Nebraska,27,Minnesota,139,Scott County,55,0,55
31,Nebraska,27,Minnesota,141,Sherburne County,26,0,26
31,Nebraska,27,Minnesota,143,Sibley County,0,57,-57
31,Nebraska,27,Minnesota,145,Stearns County,99,1,98
31,Nebraska,27,Minnesota,147,Steele County,27,1,26
31,Nebraska,27,Minnesota,149,Stevens County,34,0,34
31,Nebraska,27,Minnesota,155,Traverse County,0,22,-22
31,Nebraska,27,Minnesota,157,Wabasha County,0,1,-1
31,Nebraska,27,Minnesota,161,Waseca County,64,2,62
31,Nebraska,27,Minnesota,163,Washington County,140,31,109
31,Nebraska,27,Minnesota,165,Watonwan County,0,5,-5
31,Nebraska,27,Minnesota,167,Wilkin County,13,0,13
31,Nebraska,27,Minnesota,169,Winona County,0,6,-6
31,Nebraska,27,Minnesota,171,Wright County,24,0,24
31,Nebraska,28,Mississippi,33,DeSoto County,40,143,-103
31,Nebraska,28,Mississippi,35,Forrest County,0,29,-29
31,Nebraska,28,Mississippi,47,Harrison County,0,129,-129
31,Nebraska,28,Mississippi,59,Jackson County,0,9,-9
31,Nebraska,28,Mississippi,67,Jones County,0,19,-19
31,Nebraska,28,Mississippi,81,Lee County,38,0,38
31,Nebraska,28,Mississippi,83,Leflore County,17,0,17
31,Nebraska,28,Mississippi,85,Lincoln County,0,23,-23
31,Nebraska,28,Mississippi,87,Lowndes County,42,14,28
31,Nebraska,28,Mississippi,103,Noxubee County,0,90,-90
31,Nebraska,28,Mississippi,105,Oktibbeha County,0,12,-12
31,Nebraska,28,Mississippi,121,Rankin County,0,45,-45
31,Nebraska,28,Mississippi,151,Washington County,1,0,1
31,Nebraska,29,Missouri,1,Adair County,6,6,0
31,Nebraska,29,Missouri,3,Andrew County,4,48,-44
31,Nebraska,29,Missouri,5,Atchison County,11,28,-17
31,Nebraska,29,Missouri,7,Audrain County,1,3,-2
31,Nebraska,29,Missouri,15,Benton County,0,12,-12
31,Nebraska,29,Missouri,19,Boone County,38,1,37
31,Nebraska,29,Missouri,21,Buchanan County,93,112,-19
31,Nebraska,29,Missouri,23,Butler County,0,1,-1
31,Nebraska,29,Missouri,25,Caldwell County,0,1,-1
31,Nebraska,29,Missouri,27,Callaway County,0,48,-48
31,Nebraska,29,Missouri,29,Camden County,55,18,37
31,Nebraska,29,Missouri,31,Cape Girardeau County,0,36,-36
31,Nebraska,29,Missouri,33,Carroll County,4,0,4
31,Nebraska,29,Missouri,37,Cass County,58,39,19
31,Nebraska,29,Missouri,41,Chariton County,0,2,-2
31,Nebraska,29,Missouri,43,Christian County,34,51,-17
31,Nebraska,29,Missouri,47,Clay County,90,442,-352
31,Nebraska,29,Missouri,51,Cole County,108,7,101
31,Nebraska,29,Missouri,53,Cooper County,0,1,-1
31,Nebraska,29,Missouri,57,Dade County,0,36,-36
31,Nebraska,29,Missouri,61,Daviess County,0,2,-2
31,Nebraska,29,Missouri,63,DeKalb County,7,0,7
31,Nebraska,29,Missouri,69,Dunklin County,0,8,-8
31,Nebraska,29,Missouri,73,Gasconade County,0,1,-1
31,Nebraska,29,Missouri,77,Greene County,177,159,18
31,Nebraska,29,Missouri,81,Harrison County,2,6,-4
31,Nebraska,29,Missouri,83,Henry County,0,3,-3
31,Nebraska,29,Missouri,87,Holt County,16,21,-5
31,Nebraska,29,Missouri,95,Jackson County,339,921,-582
31,Nebraska,29,Missouri,97,Jasper County,17,14,3
31,Nebraska,29,Missouri,99,Jefferson County,3,13,-10
31,Nebraska,29,Missouri,101,Johnson County,0,22,-22
31,Nebraska,29,Missouri,107,Lafayette County,26,0,26
31,Nebraska,29,Missouri,113,Lincoln County,62,0,62
31,Nebraska,29,Missouri,115,Linn County,0,8,-8
31,Nebraska,29,Missouri,117,Livingston County,0,24,-24
31,Nebraska,29,Missouri,119,McDonald County,0,82,-82
31,Nebraska,29,Missouri,121,Macon County,28,0,28
31,Nebraska,29,Missouri,129,Mercer County,16,0,16
31,Nebraska,29,Missouri,141,Morgan County,0,1,-1
31,Nebraska,29,Missouri,145,Newton County,0,27,-27
31,Nebraska,29,Missouri,147,Nodaway County,160,321,-161
31,Nebraska,29,Missouri,155,Pemiscot County,38,36,2
31,Nebraska,29,Missouri,159,Pettis County,18,7,11
31,Nebraska,29,Missouri,161,Phelps County,17,0,17
31,Nebraska,29,Missouri,165,Platte County,69,90,-21
31,Nebraska,29,Missouri,167,Polk County,0,3,-3
31,Nebraska,29,Missouri,169,Pulaski County,6,139,-133
31,Nebraska,29,Missouri,177,Ray County,0,7,-7
31,Nebraska,29,Missouri,179,Reynolds County,0,35,-35
31,Nebraska,29,Missouri,183,St. Charles County,14,19,-5
31,Nebraska,29,Missouri,189,St. Louis County,89,256,-167
31,Nebraska,29,Missouri,195,Saline County,77,5,72
31,Nebraska,29,Missouri,201,Scott County,6,6,0
31,Nebraska,29,Missouri,209,Stone County,20,15,5
31,Nebraska,29,Missouri,213,Taney County,121,12,109
31,Nebraska,29,Missouri,217,Vernon County,3,24,-21
31,Nebraska,29,Missouri,219,Warren County,20,7,13
31,Nebraska,29,Missouri,225,Webster County,12,0,12
31,Nebraska,29,Missouri,510,St. Louis city,70,97,-27
31,Nebraska,30,Montana,13,Cascade County,27,30,-3
31,Nebraska,30,Montana,17,Custer County,34,0,34
31,Nebraska,30,Montana,23,Deer Lodge County,30,0,30
31,Nebraska,30,Montana,29,Flathead County,0,77,-77
31,Nebraska,30,Montana,31,Gallatin County,27,48,-21
31,Nebraska,30,Montana,45,Judith Basin County,0,1,-1
31,Nebraska,30,Montana,49,Lewis and Clark County,88,0,88
31,Nebraska,30,Montana,63,Missoula County,7,0,7
31,Nebraska,30,Montana,65,Musselshell County,0,2,-2
31,Nebraska,30,Montana,67,Park County,4,0,4
31,Nebraska,30,Montana,81,Ravalli County,0,1,-1
31,Nebraska,30,Montana,83,Richland County,17,0,17
31,Nebraska,30,Montana,111,Yellowstone County,60,31,29
31,Nebraska,31,Nebraska,1,Adams County,1972,1542,430
31,Nebraska,31,Nebraska,3,Antelope County,289,315,-26
31,Nebraska,31,Nebraska,5,Arthur County,30,46,-16
31,Nebraska,31,Nebraska,7,Banner County,125,3,122
31,Nebraska,31,Nebraska,9,Blaine County,69,57,12
31,Nebraska,31,Nebraska,11,Boone County,232,197,35
31,Nebraska,31,Nebraska,13,Box Butte County,348,137,211
31,Nebraska,31,Nebraska,15,Boyd County,95,51,44
31,Nebraska,31,Nebraska,17,Brown County,124,78,46
31,Nebraska,31,Nebraska,19,Buffalo County,1822,3320,-1498
31,Nebraska,31,Nebraska,21,Burt County,279,273,6
31,Nebraska,31,Nebraska,23,Butler County,445,257,188
31,Nebraska,31,Nebraska,25,Cass County,1584,1628,-44
31,Nebraska,31,Nebraska,27,Cedar County,214,302,-88
31,Nebraska,31,Nebraska,29,Chase County,301,66,235
31,Nebraska,31,Nebraska,31,Cherry County,127,220,-93
31,Nebraska,31,Nebraska,33,Cheyenne County,330,171,159
31,Nebraska,31,Nebraska,35,Clay County,333,319,14
31,Nebraska,31,Nebraska,37,Colfax County,456,297,159
31,Nebraska,31,Nebraska,39,Cuming County,234,346,-112
31,Nebraska,31,Nebraska,41,Custer County,325,183,142
31,Nebraska,31,Nebraska,43,Dakota County,488,263,225
31,Nebraska,31,Nebraska,45,Dawes County,262,557,-295
31,Nebraska,31,Nebraska,47,Dawson County,1107,946,161
31,Nebraska,31,Nebraska,49,Deuel County,27,100,-73
31,Nebraska,31,Nebraska,51,Dixon County,231,158,73
31,Nebraska,31,Nebraska,53,Dodge County,1881,1428,453
31,Nebraska,31,Nebraska,55,Douglas County,12868,12876,-8
31,Nebraska,31,Nebraska,57,Dundy County,89,105,-16
31,Nebraska,31,Nebraska,59,Fillmore County,462,342,120
31,Nebraska,31,Nebraska,61,Franklin County,334,106,228
31,Nebraska,31,Nebraska,63,Frontier County,108,209,-101
31,Nebraska,31,Nebraska,65,Furnas County,363,208,155
31,Nebraska,31,Nebraska,67,Gage County,1136,830,306
31,Nebraska,31,Nebraska,69,Garden County,158,31,127
31,Nebraska,31,Nebraska,71,Garfield County,86,109,-23
31,Nebraska,31,Nebraska,73,Gosper County,66,105,-39
31,Nebraska,31,Nebraska,75,Grant County,30,23,7
31,Nebraska,31,Nebraska,77,Greeley County,64,108,-44
31,Nebraska,31,Nebraska,79,Hall County,2819,2128,691
31,Nebraska,31,Nebraska,81,Hamilton County,482,396,86
31,Nebraska,31,Nebraska,83,Harlan County,202,113,89
31,Nebraska,31,Nebraska,85,Hayes County,97,44,53
31,Nebraska,31,Nebraska,87,Hitchcock County,125,62,63
31,Nebraska,31,Nebraska,89,Holt County,392,346,46
31,Nebraska,31,Nebraska,91,Hooker County,4,20,-16
31,Nebraska,31,Nebraska,93,Howard County,499,194,305
31,Nebraska,31,Nebraska,95,Jefferson County,246,403,-157
31,Nebraska,31,Nebraska,97,Johnson County,555,390,165
31,Nebraska,31,Nebraska,99,Kearney County,482,383,99
31,Nebraska,31,Nebraska,101,Keith County,200,329,-129
31,Nebraska,31,Nebraska,103,Keya Paha County,33,38,-5
31,Nebraska,31,Nebraska,105,Kimball County,90,51,39
31,Nebraska,31,Nebraska,107,Knox County,434,246,188
31,Nebraska,31,Nebraska,109,Lancaster County,7573,11398,-3825
31,Nebraska,31,Nebraska,111,Lincoln County,1176,1183,-7
31,Nebraska,31,Nebraska,113,Logan County,43,51,-8
31,Nebraska,31,Nebraska,115,Loup County,0,24,-24
31,Nebraska,31,Nebraska,117,McPherson County,0,7,-7
31,Nebraska,31,Nebraska,119,Madison County,1798,1969,-171
31,Nebraska,31,Nebraska,121,Merrick County,614,537,77
31,Nebraska,31,Nebraska,123,Morrill County,178,208,-30
31,Nebraska,31,Nebraska,125,Nance County,214,121,93
31,Nebraska,31,Nebraska,127,Nemaha County,338,419,-81
31,Nebraska,31,Nebraska,129,Nuckolls County,133,167,-34
31,Nebraska,31,Nebraska,131,Otoe County,579,694,-115
31,Nebraska,31,Nebraska,133,Pawnee County,50,61,-11
31,Nebraska,31,Nebraska,135,Perkins County,172,99,73
31,Nebraska,31,Nebraska,137,Phelps County,524,400,124
31,Nebraska,31,Nebraska,139,Pierce County,684,379,305
31,Nebraska,31,Nebraska,141,Platte County,992,755,237
31,Nebraska,31,Nebraska,143,Polk County,139,132,7
31,Nebraska,31,Nebraska,145,Red Willow County,516,331,185
31,Nebraska,31,Nebraska,147,Richardson County,117,80,37
31,Nebraska,31,Nebraska,149,Rock County,63,86,-23
31,Nebraska,31,Nebraska,151,Saline County,866,890,-24
31,Nebraska,31,Nebraska,153,Sarpy County,8641,8436,205
31,Nebraska,31,Nebraska,155,Saunders County,1159,1031,128
31,Nebraska,31,Nebraska,157,Scotts Bluff County,864,580,284
31,Nebraska,31,Nebraska,159,Seward County,844,1049,-205
31,Nebraska,31,Nebraska,161,Sheridan County,350,107,243
31,Nebraska,31,Nebraska,163,Sherman County,42,40,2
31,Nebraska,31,Nebraska,165,Sioux County,46,20,26
31,Nebraska,31,Nebraska,167,Stanton County,431,387,44
31,Nebraska,31,Nebraska,169,Thayer County,228,160,68
31,Nebraska,31,Nebraska,171,Thomas County,80,82,-2
31,Nebraska,31,Nebraska,173,Thurston County,244,176,68
31,Nebraska,31,Nebraska,175,Valley County,268,239,29
31,Nebraska,31,Nebraska,177,Washington County,1016,1031,-15
31,Nebraska,31,Nebraska,179,Wayne County,661,904,-243
31,Nebraska,31,Nebraska,181,Webster County,227,130,97
31,Nebraska,31,Nebraska,183,Wheeler County,33,32,1
31,Nebraska,31,Nebraska,185,York County,591,798,-207
31,Nebraska,32,Nevada,3,Clark County,433,410,23
31,Nebraska,32,Nevada,7,Elko County,6,0,6
31,Nebraska,32,Nevada,19,Lyon County,89,0,89
31,Nebraska,32,Nevada,23,Nye County,58,58,0
31,Nebraska,32,Nevada,31,Washoe County,23,177,-154
31,Nebraska,32,Nevada,33,White Pine County,5,0,5
31,Nebraska,32,Nevada,510,Carson City,12,0,12
31,Nebraska,33,New Hampshire,5,Cheshire County,11,0,11
31,Nebraska,33,New Hampshire,11,Hillsborough County,52,18,34
31,Nebraska,33,New Hampshire,13,Merrimack County,0,15,-15
31,Nebraska,33,New Hampshire,15,Rockingham County,21,0,21
31,Nebraska,33,New Hampshire,17,Strafford County,0,13,-13
31,Nebraska,34,New Jersey,3,Bergen County,83,0,83
31,Nebraska,34,New Jersey,5,Burlington County,39,51,-12
31,Nebraska,34,New Jersey,7,Camden County,8,0,8
31,Nebraska,34,New Jersey,13,Essex County,4,22,-18
31,Nebraska,34,New Jersey,15,Gloucester County,13,49,-36
31,Nebraska,34,New Jersey,17,Hudson County,28,41,-13
31,Nebraska,34,New Jersey,23,Middlesex County,0,37,-37
31,Nebraska,34,New Jersey,27,Morris County,30,12,18
31,Nebraska,34,New Jersey,31,Passaic County,7,0,7
31,Nebraska,34,New Jersey,39,Union County,33,0,33
31,Nebraska,35,New Mexico,1,Bernalillo County,148,150,-2
31,Nebraska,35,New Mexico,5,Chaves County,77,0,77
31,Nebraska,35,New Mexico,9,Curry County,52,0,52
31,Nebraska,35,New Mexico,13,Doña Ana County,67,10,57
31,Nebraska,35,New Mexico,15,Eddy County,2,0,2
31,Nebraska,35,New Mexico,25,Lea County,11,8,3
31,Nebraska,35,New Mexico,31,McKinley County,8,34,-26
31,Nebraska,35,New Mexico,35,Otero County,134,0,134
31,Nebraska,35,New Mexico,43,Sandoval County,110,0,110
31,Nebraska,35,New Mexico,45,San Juan County,0,21,-21
31,Nebraska,35,New Mexico,47,San Miguel County,0,4,-4
31,Nebraska,35,New Mexico,49,Santa Fe County,31,49,-18
31,Nebraska,36,New York,3,Allegany County,13,0,13
31,Nebraska,36,New York,5,Bronx County,9,0,9
31,Nebraska,36,New York,7,Broome County,23,0,23
31,Nebraska,36,New York,11,Cayuga County,21,0,21
31,Nebraska,36,New York,17,Chenango County,0,11,-11
31,Nebraska,36,New York,27,Dutchess County,0,18,-18
31,Nebraska,36,New York,29,Erie County,7,0,7
31,Nebraska,36,New York,45,Jefferson County,9,0,9
31,Nebraska,36,New York,47,Kings County,38,6,32
31,Nebraska,36,New York,55,Monroe County,42,11,31
31,Nebraska,36,New York,59,Nassau County,28,3,25
31,Nebraska,36,New York,61,New York County,28,38,-10
31,Nebraska,36,New York,65,Oneida County,33,5,28
31,Nebraska,36,New York,67,Onondaga County,108,14,94
31,Nebraska,36,New York,69,Ontario County,0,3,-3
31,Nebraska,36,New York,71,Orange County,30,18,12
31,Nebraska,36,New York,75,Oswego County,12,0,12
31,Nebraska,36,New York,81,Queens County,56,0,56
31,Nebraska,36,New York,89,St. Lawrence County,14,0,14
31,Nebraska,36,New York,103,Suffolk County,48,0,48
31,Nebraska,36,New York,109,Tompkins County,18,0,18
31,Nebraska,36,New York,113,Warren County,4,8,-4
31,Nebraska,36,New York,119,Westchester County,26,0,26
31,Nebraska,36,New York,121,Wyoming County,2,0,2
31,Nebraska,37,North Carolina,21,Buncombe County,0,37,-37
31,Nebraska,37,North Carolina,25,Cabarrus County,10,0,10
31,Nebraska,37,North Carolina,35,Catawba County,0,17,-17
31,Nebraska,37,North Carolina,51,Cumberland County,0,358,-358
31,Nebraska,37,North Carolina,55,Dare County,25,0,25
31,Nebraska,37,North Carolina,57,Davidson County,16,0,16
31,Nebraska,37,North Carolina,63,Durham County,0,6,-6
31,Nebraska,37,North Carolina,67,Forsyth County,26,14,12
31,Nebraska,37,North Carolina,71,Gaston County,39,15,24
31,Nebraska,37,North Carolina,81,Guilford County,0,13,-13
31,Nebraska,37,North Carolina,83,Halifax County,23,0,23
31,Nebraska,37,North Carolina,85,Harnett County,19,5,14
31,Nebraska,37,North Carolina,93,Hoke County,21,13,8
31,Nebraska,37,North Carolina,111,McDowell County,1,0,1
31,Nebraska,37,North Carolina,119,Mecklenburg County,51,101,-50
31,Nebraska,37,North Carolina,127,Nash County,2,0,2
31,Nebraska,37,North Carolina,133,Onslow County,89,152,-63
31,Nebraska,37,North Carolina,135,Orange County,14,18,-4
31,Nebraska,37,North Carolina,141,Pender County,25,0,25
31,Nebraska,37,North Carolina,147,Pitt County,52,9,43
31,Nebraska,37,North Carolina,159,Rowan County,0,27,-27
31,Nebraska,37,North Carolina,163,Sampson County,6,34,-28
31,Nebraska,37,North Carolina,179,Union County,15,0,15
31,Nebraska,37,North Carolina,183,Wake County,27,23,4
31,Nebraska,37,North Carolina,191,Wayne County,10,0,10
31,Nebraska,38,North Dakota,11,Bowman County,63,0,63
31,Nebraska,38,North Dakota,15,Burleigh County,67,2,65
31,Nebraska,38,North Dakota,17,Cass County,182,200,-18
31,Nebraska,38,North Dakota,25,Dunn County,5,6,-1
31,Nebraska,38,North Dakota,33,Golden Valley County,0,4,-4
31,Nebraska,38,North Dakota,35,Grand Forks County,27,75,-48
31,Nebraska,38,North Dakota,37,Grant County,31,0,31
31,Nebraska,38,North Dakota,47,Logan County,0,1,-1
31,Nebraska,38,North Dakota,49,McHenry County,0,6,-6
31,Nebraska,38,North Dakota,51,McIntosh County,0,2,-2
31,Nebraska,38,North Dakota,53,McKenzie County,0,5,-5
31,Nebraska,38,North Dakota,57,Mercer County,15,0,15
31,Nebraska,38,North Dakota,59,Morton County,3,13,-10
31,Nebraska,38,North Dakota,61,Mountrail County,14,0,14
31,Nebraska,38,North Dakota,63,Nelson County,0,7,-7
31,Nebraska,38,North Dakota,73,Ransom County,34,0,34
31,Nebraska,38,North Dakota,83,Sheridan County,0,11,-11
31,Nebraska,38,North Dakota,85,Sioux County,2,1,1
31,Nebraska,38,North Dakota,89,Stark County,43,18,25
31,Nebraska,38,North Dakota,97,Traill County,0,6,-6
31,Nebraska,38,North Dakota,101,Ward County,53,116,-63
31,Nebraska,38,North Dakota,105,Williams County,42,22,20
31,Nebraska,39,Ohio,3,Allen County,6,0,6
31,Nebraska,39,Ohio,9,Athens County,18,15,3
31,Nebraska,39,Ohio,11,Auglaize County,9,12,-3
31,Nebraska,39,Ohio,13,Belmont County,1,0,1
31,Nebraska,39,Ohio,25,Clermont County,0,64,-64
31,Nebraska,39,Ohio,27,Clinton County,6,0,6
31,Nebraska,39,Ohio,35,Cuyahoga County,61,204,-143
31,Nebraska,39,Ohio,37,Darke County,0,10,-10
31,Nebraska,39,Ohio,45,Fairfield County,26,0,26
31,Nebraska,39,Ohio,47,Fayette County,0,11,-11
31,Nebraska,39,Ohio,49,Franklin County,100,41,59
31,Nebraska,39,Ohio,57,Greene County,21,0,21
31,Nebraska,39,Ohio,61,Hamilton County,10,79,-69
31,Nebraska,39,Ohio,93,Lorain County,27,0,27
31,Nebraska,39,Ohio,99,Mahoning County,4,17,-13
31,Nebraska,39,Ohio,113,Montgomery County,39,105,-66
31,Nebraska,39,Ohio,119,Muskingum County,16,0,16
31,Nebraska,39,Ohio,135,Preble County,4,0,4
31,Nebraska,39,Ohio,145,Scioto County,16,0,16
31,Nebraska,39,Ohio,151,Stark County,10,0,10
31,Nebraska,39,Ohio,153,Summit County,1,20,-19
31,Nebraska,39,Ohio,165,Warren County,40,0,40
31,Nebraska,4,Arizona,1,Apache County,8,0,8
31,Nebraska,4,Arizona,3,Cochise County,0,108,-108
31,Nebraska,4,Arizona,5,Coconino County,36,9,27
31,Nebraska,4,Arizona,9,Graham County,0,29,-29
31,Nebraska,4,Arizona,13,Maricopa County,888,1156,-268
31,Nebraska,4,Arizona,15,Mohave County,6,211,-205
31,Nebraska,4,Arizona,17,Navajo County,19,0,19
31,Nebraska,4,Arizona,19,Pima County,208,217,-9
31,Nebraska,4,Arizona,21,Pinal County,175,6,169
31,Nebraska,4,Arizona,25,Yavapai County,17,15,2
31,Nebraska,4,Arizona,27,Yuma County,4,0,4
31,Nebraska,40,Oklahoma,1,Adair County,0,25,-25
31,Nebraska,40,Oklahoma,5,Atoka County,13,0,13
31,Nebraska,40,Oklahoma,11,Blaine County,0,6,-6
31,Nebraska,40,Oklahoma,15,Caddo County,0,18,-18
31,Nebraska,40,Oklahoma,17,Canadian County,52,0,52
31,Nebraska,40,Oklahoma,19,Carter County,81,0,81
31,Nebraska,40,Oklahoma,27,Cleveland County,9,130,-121
31,Nebraska,40,Oklahoma,31,Comanche County,16,9,7
31,Nebraska,40,Oklahoma,37,Creek County,99,0,99
31,Nebraska,40,Oklahoma,39,Custer County,23,0,23
31,Nebraska,40,Oklahoma,41,Delaware County,86,5,81
31,Nebraska,40,Oklahoma,47,Garfield County,33,0,33
31,Nebraska,40,Oklahoma,55,Greer County,0,7,-7
31,Nebraska,40,Oklahoma,71,Kay County,27,30,-3
31,Nebraska,40,Oklahoma,75,Kiowa County,0,16,-16
31,Nebraska,40,Oklahoma,81,Lincoln County,12,37,-25
31,Nebraska,40,Oklahoma,89,McCurtain County,20,0,20
31,Nebraska,40,Oklahoma,91,McIntosh County,11,0,11
31,Nebraska,40,Oklahoma,93,Major County,6,1,5
31,Nebraska,40,Oklahoma,95,Marshall County,14,0,14
31,Nebraska,40,Oklahoma,97,Mayes County,24,2,22
31,Nebraska,40,Oklahoma,101,Muskogee County,4,0,4
31,Nebraska,40,Oklahoma,109,Oklahoma County,136,228,-92
31,Nebraska,40,Oklahoma,119,Payne County,30,0,30
31,Nebraska,40,Oklahoma,125,Pottawatomie County,15,10,5
31,Nebraska,40,Oklahoma,131,Rogers County,25,0,25
31,Nebraska,40,Oklahoma,141,Tillman County,0,8,-8
31,Nebraska,40,Oklahoma,143,Tulsa County,184,106,78
31,Nebraska,40,Oklahoma,145,Wagoner County,0,13,-13
31,Nebraska,40,Oklahoma,147,Washington County,2,0,2
31,Nebraska,40,Oklahoma,153,Woodward County,20,0,20
31,Nebraska,41,Oregon,5,Clackamas County,0,40,-40
31,Nebraska,41,Oregon,15,Curry County,0,362,-362
31,Nebraska,41,Oregon,17,Deschutes County,31,28,3
31,Nebraska,41,Oregon,19,Douglas County,20,33,-13
31,Nebraska,41,Oregon,25,Harney County,0,4,-4
31,Nebraska,41,Oregon,27,Hood River County,12,0,12
31,Nebraska,41,Oregon,29,Jackson County,19,24,-5
31,Nebraska,41,Oregon,31,Jefferson County,0,19,-19
31,Nebraska,41,Oregon,33,Josephine County,0,38,-38
31,Nebraska,41,Oregon,35,Klamath County,0,53,-53
31,Nebraska,41,Oregon,39,Lane County,0,15,-15
31,Nebraska,41,Oregon,41,Lincoln County,0,9,-9
31,Nebraska,41,Oregon,43,Linn County,1,25,-24
31,Nebraska,41,Oregon,45,Malheur County,24,8,16
31,Nebraska,41,Oregon,47,Marion County,15,0,15
31,Nebraska,41,Oregon,51,Multnomah County,87,38,49
31,Nebraska,41,Oregon,57,Tillamook County,9,0,9
31,Nebraska,41,Oregon,61,Union County,0,1,-1
31,Nebraska,41,Oregon,65,Wasco County,0,36,-36
31,Nebraska,41,Oregon,67,Washington County,28,50,-22
31,Nebraska,41,Oregon,71,Yamhill County,77,0,77
31,Nebraska,42,Pennsylvania,3,Allegheny County,44,7,37
31,Nebraska,42,Pennsylvania,13,Blair County,16,0,16
31,Nebraska,42,Pennsylvania,15,Bradford County,16,0,16
31,Nebraska,42,Pennsylvania,17,Bucks County,0,6,-6
31,Nebraska,42,Pennsylvania,19,Butler County,96,3,93
31,Nebraska,42,Pennsylvania,21,Cambria County,0,12,-12
31,Nebraska,42,Pennsylvania,25,Carbon County,0,43,-43
31,Nebraska,42,Pennsylvania,27,Centre County,65,21,44
31,Nebraska,42,Pennsylvania,29,Chester County,0,6,-6
31,Nebraska,42,Pennsylvania,33,Clearfield County,0,15,-15
31,Nebraska,42,Pennsylvania,41,Cumberland County,34,0,34
31,Nebraska,42,Pennsylvania,45,Delaware County,75,0,75
31,Nebraska,42,Pennsylvania,49,Erie County,5,0,5
31,Nebraska,42,Pennsylvania,55,Franklin County,7,11,-4
31,Nebraska,42,Pennsylvania,59,Greene County,0,5,-5
31,Nebraska,42,Pennsylvania,65,Jefferson County,32,0,32
31,Nebraska,42,Pennsylvania,71,Lancaster County,8,63,-55
31,Nebraska,42,Pennsylvania,75,Lebanon County,23,3,20
31,Nebraska,42,Pennsylvania,77,Lehigh County,0,29,-29
31,Nebraska,42,Pennsylvania,85,Mercer County,0,27,-27
31,Nebraska,42,Pennsylvania,89,Monroe County,0,26,-26
31,Nebraska,42,Pennsylvania,91,Montgomery County,33,26,7
31,Nebraska,42,Pennsylvania,95,Northampton County,1,38,-37
31,Nebraska,42,Pennsylvania,101,Philadelphia County,108,6,102
31,Nebraska,42,Pennsylvania,103,Pike County,44,0,44
31,Nebraska,42,Pennsylvania,107,Schuylkill County,13,0,13
31,Nebraska,42,Pennsylvania,111,Somerset County,0,6,-6
31,Nebraska,42,Pennsylvania,115,Susquehanna County,0,3,-3
31,Nebraska,42,Pennsylvania,133,York County,2,0,2
31,Nebraska,44,Rhode Island,3,Kent County,0,138,-138
31,Nebraska,44,Rhode Island,5,Newport County,76,4,72
31,Nebraska,44,Rhode Island,7,Providence County,136,0,136
31,Nebraska,45,South Carolina,3,Aiken County,0,17,-17
31,Nebraska,45,South Carolina,13,Beaufort County,131,0,131
31,Nebraska,45,South Carolina,15,Berkeley County,22,75,-53
31,Nebraska,45,South Carolina,19,Charleston County,80,14,66
31,Nebraska,45,South Carolina,35,Dorchester County,0,14,-14
31,Nebraska,45,South Carolina,45,Greenville County,17,11,6
31,Nebraska,45,South Carolina,51,Horry County,18,19,-1
31,Nebraska,45,South Carolina,55,Kershaw County,0,25,-25
31,Nebraska,45,South Carolina,63,Lexington County,0,33,-33
31,Nebraska,45,South Carolina,73,Oconee County,2,0,2
31,Nebraska,45,South Carolina,79,Richland County,101,66,35
31,Nebraska,45,South Carolina,85,Sumter County,18,0,18
31,Nebraska,45,South Carolina,91,York County,0,25,-25
31,Nebraska,46,South Dakota,5,Beadle County,64,0,64
31,Nebraska,46,South Dakota,7,Bennett County,75,22,53
31,Nebraska,46,South Dakota,9,Bon Homme County,16,49,-33
31,Nebraska,46,South Dakota,11,Brookings County,187,152,35
31,Nebraska,46,South Dakota,13,Brown County,0,15,-15
31,Nebraska,46,South Dakota,15,Brule County,0,30,-30
31,Nebraska,46,South Dakota,23,Charles Mix County,4,15,-11
31,Nebraska,46,South Dakota,27,Clay County,79,185,-106
31,Nebraska,46,South Dakota,29,Codington County,0,19,-19
31,Nebraska,46,South Dakota,31,Corson County,0,1,-1
31,Nebraska,46,South Dakota,33,Custer County,22,24,-2
31,Nebraska,46,South Dakota,35,Davison County,28,137,-109
31,Nebraska,46,South Dakota,41,Dewey County,4,0,4
31,Nebraska,46,South Dakota,43,Douglas County,0,3,-3
31,Nebraska,46,South Dakota,47,Fall River County,12,23,-11
31,Nebraska,46,South Dakota,49,Faulk County,0,1,-1
31,Nebraska,46,South Dakota,51,Grant County,18,5,13
31,Nebraska,46,South Dakota,53,Gregory County,51,33,18
31,Nebraska,46,South Dakota,57,Hamlin County,0,1,-1
31,Nebraska,46,South Dakota,61,Hanson County,0,13,-13
31,Nebraska,46,South Dakota,63,Harding County,15,9,6
31,Nebraska,46,South Dakota,65,Hughes County,37,80,-43
31,Nebraska,46,South Dakota,67,Hutchinson County,11,7,4
31,Nebraska,46,South Dakota,71,Jackson County,55,35,20
31,Nebraska,46,South Dakota,79,Lake County,26,14,12
31,Nebraska,46,South Dakota,81,Lawrence County,67,104,-37
31,Nebraska,46,South Dakota,83,Lincoln County,116,100,16
31,Nebraska,46,South Dakota,85,Lyman County,9,26,-17
31,Nebraska,46,South Dakota,87,McCook County,11,5,6
31,Nebraska,46,South Dakota,93,Meade County,51,17,34
31,Nebraska,46,South Dakota,95,Mellette County,26,0,26
31,Nebraska,46,South Dakota,99,Minnehaha County,653,261,392
31,Nebraska,46,South Dakota,101,Moody County,0,1,-1
31,Nebraska,46,South Dakota,102,Oglala Lakota County,148,14,134
31,Nebraska,46,South Dakota,103,Pennington County,300,307,-7
31,Nebraska,46,South Dakota,109,Roberts County,0,5,-5
31,Nebraska,46,South Dakota,121,Todd County,16,47,-31
31,Nebraska,46,South Dakota,123,Tripp County,0,137,-137
31,Nebraska,46,South Dakota,125,Turner County,46,22,24
31,Nebraska,46,South Dakota,127,Union County,74,131,-57
31,Nebraska,46,South Dakota,129,Walworth County,0,6,-6
31,Nebraska,46,South Dakota,135,Yankton County,146,153,-7
31,Nebraska,46,South Dakota,137,Ziebach County,8,2,6
31,Nebraska,47,Tennessee,3,Bedford County,4,6,-2
31,Nebraska,47,Tennessee,9,Blount County,15,0,15
31,Nebraska,47,Tennessee,35,Cumberland County,0,7,-7
31,Nebraska,47,Tennessee,37,Davidson County,22,50,-28
31,Nebraska,47,Tennessee,63,Hamblen County,15,0,15
31,Nebraska,47,Tennessee,65,Hamilton County,2,26,-24
31,Nebraska,47,Tennessee,67,Hancock County,0,9,-9
31,Nebraska,47,Tennessee,75,Haywood County,36,0,36
31,Nebraska,47,Tennessee,85,Humphreys County,14,0,14
31,Nebraska,47,Tennessee,89,Jefferson County,12,0,12
31,Nebraska,47,Tennessee,93,Knox County,9,21,-12
31,Nebraska,47,Tennessee,113,Madison County,0,12,-12
31,Nebraska,47,Tennessee,119,Maury County,19,0,19
31,Nebraska,47,Tennessee,125,Montgomery County,26,5,21
31,Nebraska,47,Tennessee,141,Putnam County,0,35,-35
31,Nebraska,47,Tennessee,143,Rhea County,0,16,-16
31,Nebraska,47,Tennessee,149,Rutherford County,6,110,-104
31,Nebraska,47,Tennessee,157,Shelby County,160,33,127
31,Nebraska,47,Tennessee,161,Stewart County,1,0,1
31,Nebraska,47,Tennessee,163,Sullivan County,7,0,7
31,Nebraska,47,Tennessee,165,Sumner County,6,137,-131
31,Nebraska,47,Tennessee,187,Williamson County,37,29,8
31,Nebraska,47,Tennessee,189,Wilson County,0,11,-11
31,Nebraska,48,Texas,1,Anderson County,0,33,-33
31,Nebraska,48,Texas,5,Angelina County,5,0,5
31,Nebraska,48,Texas,13,Atascosa County,16,0,16
31,Nebraska,48,Texas,15,Austin County,0,3,-3
31,Nebraska,48,Texas,19,Bandera County,0,46,-46
31,Nebraska,48,Texas,21,Bastrop County,7,0,7
31,Nebraska,48,Texas,27,Bell County,13,9,4
31,Nebraska,48,Texas,29,Bexar County,361,390,-29
31,Nebraska,48,Texas,39,Brazoria County,17,59,-42
31,Nebraska,48,Texas,41,Brazos County,14,87,-73
31,Nebraska,48,Texas,43,Brewster County,18,0,18
31,Nebraska,48,Texas,61,Cameron County,0,13,-13
31,Nebraska,48,Texas,67,Cass County,0,18,-18
31,Nebraska,48,Texas,73,Cherokee County,4,0,4
31,Nebraska,48,Texas,75,Childress County,7,0,7
31,Nebraska,48,Texas,81,Coke County,0,9,-9
31,Nebraska,48,Texas,85,Collin County,49,221,-172
31,Nebraska,48,Texas,99,Coryell County,6,0,6
31,Nebraska,48,Texas,111,Dallam County,0,25,-25
31,Nebraska,48,Texas,113,Dallas County,164,454,-290
31,Nebraska,48,Texas,121,Denton County,104,236,-132
31,Nebraska,48,Texas,135,Ector County,45,0,45
31,Nebraska,48,Texas,139,Ellis County,7,9,-2
31,Nebraska,48,Texas,141,El Paso County,35,136,-101
31,Nebraska,48,Texas,143,Erath County,28,0,28
31,Nebraska,48,Texas,147,Fannin County,9,0,9
31,Nebraska,48,Texas,157,Fort Bend County,122,48,74
31,Nebraska,48,Texas,165,Gaines County,15,0,15
31,Nebraska,48,Texas,167,Galveston County,14,57,-43
31,Nebraska,48,Texas,181,Grayson County,0,6,-6
31,Nebraska,48,Texas,183,Gregg County,12,0,12
31,Nebraska,48,Texas,187,Guadalupe County,0,128,-128
31,Nebraska,48,Texas,189,Hale County,0,5,-5
31,Nebraska,48,Texas,193,Hamilton County,3,0,3
31,Nebraska,48,Texas,201,Harris County,582,495,87
31,Nebraska,48,Texas,205,Hartley County,39,0,39
31,Nebraska,48,Texas,209,Hays County,25,0,25
31,Nebraska,48,Texas,215,Hidalgo County,27,196,-169
31,Nebraska,48,Texas,221,Hood County,38,52,-14
31,Nebraska,48,Texas,231,Hunt County,0,26,-26
31,Nebraska,48,Texas,233,Hutchinson County,0,12,-12
31,Nebraska,48,Texas,241,Jasper County,14,0,14
31,Nebraska,48,Texas,245,Jefferson County,0,8,-8
31,Nebraska,48,Texas,251,Johnson County,321,0,321
31,Nebraska,48,Texas,257,Kaufman County,2,0,2
31,Nebraska,48,Texas,265,Kerr County,0,32,-32
31,Nebraska,48,Texas,271,Kinney County,0,8,-8
31,Nebraska,48,Texas,273,Kleberg County,0,57,-57
31,Nebraska,48,Texas,279,Lamb County,0,5,-5
31,Nebraska,48,Texas,291,Liberty County,53,0,53
31,Nebraska,48,Texas,299,Llano County,0,19,-19
31,Nebraska,48,Texas,303,Lubbock County,57,38,19
31,Nebraska,48,Texas,309,McLennan County,27,23,4
31,Nebraska,48,Texas,321,Matagorda County,37,0,37
31,Nebraska,48,Texas,323,Maverick County,0,10,-10
31,Nebraska,48,Texas,329,Midland County,18,0,18
31,Nebraska,48,Texas,337,Montague County,5,0,5
31,Nebraska,48,Texas,339,Montgomery County,7,129,-122
31,Nebraska,48,Texas,341,Moore County,39,0,39
31,Nebraska,48,Texas,355,Nueces County,60,45,15
31,Nebraska,48,Texas,367,Parker County,5,18,-13
31,Nebraska,48,Texas,373,Polk County,40,11,29
31,Nebraska,48,Texas,375,Potter County,37,19,18
31,Nebraska,48,Texas,381,Randall County,38,25,13
31,Nebraska,48,Texas,385,Real County,3,0,3
31,Nebraska,48,Texas,389,Reeves County,8,0,8
31,Nebraska,48,Texas,409,San Patricio County,2,0,2
31,Nebraska,48,Texas,423,Smith County,69,4,65
31,Nebraska,48,Texas,439,Tarrant County,503,224,279
31,Nebraska,48,Texas,441,Taylor County,31,184,-153
31,Nebraska,48,Texas,449,Titus County,0,1,-1
31,Nebraska,48,Texas,451,Tom Green County,30,21,9
31,Nebraska,48,Texas,453,Travis County,182,134,48
31,Nebraska,48,Texas,465,Val Verde County,13,0,13
31,Nebraska,48,Texas,473,Waller County,0,3,-3
31,Nebraska,48,Texas,479,Webb County,0,22,-22
31,Nebraska,48,Texas,485,Wichita County,68,0,68
31,Nebraska,48,Texas,487,Wilbarger County,13,0,13
31,Nebraska,48,Texas,491,Williamson County,85,123,-38
31,Nebraska,48,Texas,493,Wilson County,13,9,4
31,Nebraska,48,Texas,495,Winkler County,22,85,-63
31,Nebraska,48,Texas,497,Wise County,42,0,42
31,Nebraska,48,Texas,499,Wood County,0,31,-31
31,Nebraska,49,Utah,3,Box Elder County,0,41,-41
31,Nebraska,49,Utah,5,Cache County,135,120,15
31,Nebraska,49,Utah,7,Carbon County,11,0,11
31,Nebraska,49,Utah,11,Davis County,57,0,57
31,Nebraska,49,Utah,25,Kane County,1,0,1
31,Nebraska,49,Utah,29,Morgan County,0,11,-11
31,Nebraska,49,Utah,35,Salt Lake County,368,199,169
31,Nebraska,49,Utah,49,Utah County,197,67,130
31,Nebraska,49,Utah,53,Washington County,425,0,425
31,Nebraska,49,Utah,57,Weber County,38,58,-20
31,Nebraska,5,Arkansas,5,Baxter County,0,36,-36
31,Nebraska,5,Arkansas,7,Benton County,47,42,5
31,Nebraska,5,Arkansas,9,Boone County,20,19,1
31,Nebraska,5,Arkansas,15,Carroll County,13,0,13
31,Nebraska,5,Arkansas,19,Clark County,6,0,6
31,Nebraska,5,Arkansas,31,Craighead County,21,0,21
31,Nebraska,5,Arkansas,33,Crawford County,15,0,15
31,Nebraska,5,Arkansas,35,Crittenden County,8,0,8
31,Nebraska,5,Arkansas,43,Drew County,0,7,-7
31,Nebraska,5,Arkansas,45,Faulkner County,35,0,35
31,Nebraska,5,Arkansas,51,Garland County,8,0,8
31,Nebraska,5,Arkansas,63,Independence County,4,0,4
31,Nebraska,5,Arkansas,69,Jefferson County,31,0,31
31,Nebraska,5,Arkansas,83,Logan County,7,0,7
31,Nebraska,5,Arkansas,85,Lonoke County,7,18,-11
31,Nebraska,5,Arkansas,89,Marion County,0,29,-29
31,Nebraska,5,Arkansas,103,Ouachita County,13,0,13
31,Nebraska,5,Arkansas,119,Pulaski County,4,133,-129
31,Nebraska,5,Arkansas,121,Randolph County,41,0,41
31,Nebraska,5,Arkansas,123,St. Francis County,0,12,-12
31,Nebraska,5,Arkansas,125,Saline County,17,37,-20
31,Nebraska,5,Arkansas,129,Searcy County,16,0,16
31,Nebraska,5,Arkansas,131,Sebastian County,33,68,-35
31,Nebraska,5,Arkansas,143,Washington County,46,0,46
31,Nebraska,5,Arkansas,145,White County,15,0,15
31,Nebraska,50,Vermont,15,Lamoille County,5,0,5
31,Nebraska,50,Vermont,21,Rutland County,0,54,-54
31,Nebraska,50,Vermont,27,Windsor County,1,9,-8
31,Nebraska,51,Virginia,13,Arlington County,27,9,18
31,Nebraska,51,Virginia,15,Augusta County,23,0,23
31,Nebraska,51,Virginia,31,Campbell County,17,40,-23
31,Nebraska,51,Virginia,41,Chesterfield County,4,10,-6
31,Nebraska,51,Virginia,49,Cumberland County,4,0,4
31,Nebraska,51,Virginia,59,Fairfax County,81,221,-140
31,Nebraska,51,Virginia,65,Fluvanna County,0,71,-71
31,Nebraska,51,Virginia,69,Frederick County,143,52,91
31,Nebraska,51,Virginia,83,Halifax County,0,3,-3
31,Nebraska,51,Virginia,87,Henrico County,0,18,-18
31,Nebraska,51,Virginia,107,Loudoun County,24,32,-8
31,Nebraska,51,Virginia,121,Montgomery County,2,49,-47
31,Nebraska,51,Virginia,153,Prince William County,33,34,-1
31,Nebraska,51,Virginia,161,Roanoke County,0,36,-36
31,Nebraska,51,Virginia,165,Rockingham County,19,0,19
31,Nebraska,51,Virginia,171,Shenandoah County,0,32,-32
31,Nebraska,51,Virginia,179,Stafford County,54,65,-11
31,Nebraska,51,Virginia,199,York County,0,66,-66
31,Nebraska,51,Virginia,510,Alexandria city,0,50,-50
31,Nebraska,51,Virginia,520,Bristol city,0,7,-7
31,Nebraska,51,Virginia,550,Chesapeake city,73,0,73
31,Nebraska,51,Virginia,650,Hampton city,4,13,-9
31,Nebraska,51,Virginia,680,Lynchburg city,2,0,2
31,Nebraska,51,Virginia,700,Newport News city,0,15,-15
31,Nebraska,51,Virginia,710,Norfolk city,13,58,-45
31,Nebraska,51,Virginia,760,Richmond city,55,0,55
31,Nebraska,51,Virginia,770,Roanoke city,69,0,69
31,Nebraska,51,Virginia,800,Suffolk city,38,0,38
31,Nebraska,51,Virginia,810,Virginia Beach city,229,107,122
31,Nebraska,51,Virginia,830,Williamsburg city,17,0,17
31,Nebraska,53,Washington,5,Benton County,11,0,11
31,Nebraska,53,Washington,9,Clallam County,0,7,-7
31,Nebraska,53,Washington,11,Clark County,0,39,-39
31,Nebraska,53,Washington,15,Cowlitz County,0,14,-14
31,Nebraska,53,Washington,27,Grays Harbor County,11,20,-9
31,Nebraska,53,Washington,29,Island County,6,0,6
31,Nebraska,53,Washington,31,Jefferson County,0,37,-37
31,Nebraska,53,Washington,33,King County,121,240,-119
31,Nebraska,53,Washington,35,Kitsap County,66,53,13
31,Nebraska,53,Washington,37,Kittitas County,0,18,-18
31,Nebraska,53,Washington,41,Lewis County,0,10,-10
31,Nebraska,53,Washington,45,Mason County,20,10,10
31,Nebraska,53,Washington,49,Pacific County,10,0,10
31,Nebraska,53,Washington,51,Pend Oreille County,0,6,-6
31,Nebraska,53,Washington,53,Pierce County,65,155,-90
31,Nebraska,53,Washington,57,Skagit County,27,2,25
31,Nebraska,53,Washington,61,Snohomish County,54,69,-15
31,Nebraska,53,Washington,63,Spokane County,25,149,-124
31,Nebraska,53,Washington,67,Thurston County,37,0,37
31,Nebraska,53,Washington,69,Wahkiakum County,2,0,2
31,Nebraska,53,Washington,71,Walla Walla County,0,4,-4
31,Nebraska,53,Washington,75,Whitman County,27,15,12
31,Nebraska,54,West Virginia,25,Greenbrier County,0,55,-55
31,Nebraska,54,West Virginia,37,Jefferson County,6,42,-36
31,Nebraska,54,West Virginia,49,Marion County,20,0,20
31,Nebraska,54,West Virginia,55,Mercer County,9,0,9
31,Nebraska,54,West Virginia,61,Monongalia County,8,0,8
31,Nebraska,54,West Virginia,67,Nicholas County,5,0,5
31,Nebraska,55,Wisconsin,7,Bayfield County,0,20,-20
31,Nebraska,55,Wisconsin,9,Brown County,34,10,24
31,Nebraska,55,Wisconsin,19,Clark County,8,0,8
31,Nebraska,55,Wisconsin,21,Columbia County,6,0,6
31,Nebraska,55,Wisconsin,25,Dane County,58,51,7
31,Nebraska,55,Wisconsin,31,Douglas County,7,5,2
31,Nebraska,55,Wisconsin,35,Eau Claire County,106,7,99
31,Nebraska,55,Wisconsin,43,Grant County,0,60,-60
31,Nebraska,55,Wisconsin,45,Green County,0,5,-5
31,Nebraska,55,Wisconsin,47,Green Lake County,0,11,-11
31,Nebraska,55,Wisconsin,53,Jackson County,7,0,7
31,Nebraska,55,Wisconsin,59,Kenosha County,14,15,-1
31,Nebraska,55,Wisconsin,63,La Crosse County,52,0,52
31,Nebraska,55,Wisconsin,71,Manitowoc County,33,0,33
31,Nebraska,55,Wisconsin,73,Marathon County,6,0,6
31,Nebraska,55,Wisconsin,79,Milwaukee County,61,43,18
31,Nebraska,55,Wisconsin,81,Monroe County,0,8,-8
31,Nebraska,55,Wisconsin,83,Oconto County,0,17,-17
31,Nebraska,55,Wisconsin,85,Oneida County,9,0,9
31,Nebraska,55,Wisconsin,87,Outagamie County,36,0,36
31,Nebraska,55,Wisconsin,89,Ozaukee County,0,3,-3
31,Nebraska,55,Wisconsin,93,Pierce County,23,0,23
31,Nebraska,55,Wisconsin,95,Polk County,4,0,4
31,Nebraska,55,Wisconsin,97,Portage County,7,25,-18
31,Nebraska,55,Wisconsin,99,Price County,0,1,-1
31,Nebraska,55,Wisconsin,101,Racine County,17,42,-25
31,Nebraska,55,Wisconsin,105,Rock County,25,0,25
31,Nebraska,55,Wisconsin,109,St. Croix County,26,0,26
31,Nebraska,55,Wisconsin,111,Sauk County,3,0,3
31,Nebraska,55,Wisconsin,113,Sawyer County,15,20,-5
31,Nebraska,55,Wisconsin,115,Shawano County,0,3,-3
31,Nebraska,55,Wisconsin,117,Sheboygan County,8,0,8
31,Nebraska,55,Wisconsin,123,Vernon County,5,0,5
31,Nebraska,55,Wisconsin,127,Walworth County,2,21,-19
31,Nebraska,55,Wisconsin,129,Washburn County,0,3,-3
31,Nebraska,55,Wisconsin,133,Waukesha County,19,99,-80
31,Nebraska,55,Wisconsin,139,Winnebago County,5,52,-47
31,Nebraska,55,Wisconsin,141,Wood County,11,0,11
31,Nebraska,56,Wyoming,1,Albany County,33,74,-41
31,Nebraska,56,Wyoming,3,Big Horn County,0,30,-30
31,Nebraska,56,Wyoming,5,Campbell County,39,0,39
31,Nebraska,56,Wyoming,7,Carbon County,0,10,-10
31,Nebraska,56,Wyoming,9,Converse County,111,29,82
31,Nebraska,56,Wyoming,11,Crook County,17,0,17
31,Nebraska,56,Wyoming,13,Fremont County,81,21,60
31,Nebraska,56,Wyoming,15,Goshen County,117,113,4
31,Nebraska,56,Wyoming,17,Hot Springs County,8,0,8
31,Nebraska,56,Wyoming,21,Laramie County,201,262,-61
31,Nebraska,56,Wyoming,25,Natrona County,49,122,-73
31,Nebraska,56,Wyoming,27,Niobrara County,0,3,-3
31,Nebraska,56,Wyoming,29,Park County,2,33,-31
31,Nebraska,56,Wyoming,31,Platte County,49,34,15
31,Nebraska,56,Wyoming,33,Sheridan County,4,30,-26
31,Nebraska,56,Wyoming,35,Sublette County,4,0,4
31,Nebraska,56,Wyoming,37,Sweetwater County,14,10,4
31,Nebraska,56,Wyoming,39,Teton County,0,16,-16
31,Nebraska,56,Wyoming,41,Uinta County,58,0,58
31,Nebraska,56,Wyoming,45,Weston County,5,0,5
31,Nebraska,6,California,1,Alameda County,143,65,78
31,Nebraska,6,California,13,Contra Costa County,4,67,-63
31,Nebraska,6,California,19,Fresno County,55,107,-52
31,Nebraska,6,California,23,Humboldt County,0,194,-194
31,Nebraska,6,California,25,Imperial County,38,0,38
31,Nebraska,6,California,29,Kern County,24,100,-76
31,Nebraska,6,California,31,Kings County,21,42,-21
31,Nebraska,6,California,33,Lake County,0,21,-21
31,Nebraska,6,California,37,Los Angeles County,492,186,306
31,Nebraska,6,California,39,Madera County,0,29,-29
31,Nebraska,6,California,41,Marin County,11,0,11
31,Nebraska,6,California,45,Mendocino County,0,14,-14
31,Nebraska,6,California,47,Merced County,10,21,-11
31,Nebraska,6,California,49,Modoc County,0,33,-33
31,Nebraska,6,California,51,Mono County,5,0,5
31,Nebraska,6,California,53,Monterey County,110,4,106
31,Nebraska,6,California,55,Napa County,4,0,4
31,Nebraska,6,California,57,Nevada County,0,99,-99
31,Nebraska,6,California,59,Orange County,382,131,251
31,Nebraska,6,California,61,Placer County,25,14,11
31,Nebraska,6,California,65,Riverside County,159,163,-4
31,Nebraska,6,California,67,Sacramento County,176,140,36
31,Nebraska,6,California,71,San Bernardino County,233,85,148
31,Nebraska,6,California,73,San Diego County,846,555,291
31,Nebraska,6,California,75,San Francisco County,52,49,3
31,Nebraska,6,California,77,San Joaquin County,88,37,51
31,Nebraska,6,California,79,San Luis Obispo County,96,0,96
31,Nebraska,6,California,81,San Mateo County,23,84,-61
31,Nebraska,6,California,83,Santa Barbara County,11,0,11
31,Nebraska,6,California,85,Santa Clara County,99,26,73
31,Nebraska,6,California,87,Santa Cruz County,24,0,24
31,Nebraska,6,California,89,Shasta County,13,8,5
31,Nebraska,6,California,95,Solano County,66,51,15
31,Nebraska,6,California,97,Sonoma County,49,0,49
31,Nebraska,6,California,99,Stanislaus County,18,9,9
31,Nebraska,6,California,101,Sutter County,22,10,12
31,Nebraska,6,California,107,Tulare County,25,35,-10
31,Nebraska,6,California,111,Ventura County,119,153,-34
31,Nebraska,6,California,113,Yolo County,0,13,-13
31,Nebraska,72,Puerto Rico,21,Bayamón Municipio,0,30,-30
31,Nebraska,72,Puerto Rico,31,Carolina Municipio,0,22,-22
31,Nebraska,72,Puerto Rico,85,Las Piedras Municipio,47,0,47
31,Nebraska,72,Puerto Rico,127,San Juan Municipio,42,18,24
31,Nebraska,72,Puerto Rico,129,San Lorenzo Municipio,107,0,107
31,Nebraska,8,Colorado,1,Adams County,294,275,19
31,Nebraska,8,Colorado,3,Alamosa County,8,37,-29
31,Nebraska,8,Colorado,5,Arapahoe County,399,268,131
31,Nebraska,8,Colorado,9,Baca County,12,0,12
31,Nebraska,8,Colorado,13,Boulder County,106,154,-48
31,Nebraska,8,Colorado,14,Broomfield County,61,56,5
31,Nebraska,8,Colorado,15,Chaffee County,32,0,32
31,Nebraska,8,Colorado,21,Conejos County,13,0,13
31,Nebraska,8,Colorado,25,Crowley County,32,0,32
31,Nebraska,8,Colorado,27,Custer County,0,40,-40
31,Nebraska,8,Colorado,29,Delta County,8,0,8
31,Nebraska,8,Colorado,31,Denver County,301,304,-3
31,Nebraska,8,Colorado,35,Douglas County,291,35,256
31,Nebraska,8,Colorado,37,Eagle County,0,37,-37
31,Nebraska,8,Colorado,41,El Paso County,497,576,-79
31,Nebraska,8,Colorado,43,Fremont County,72,4,68
31,Nebraska,8,Colorado,45,Garfield County,35,0,35
31,Nebraska,8,Colorado,49,Grand County,39,0,39
31,Nebraska,8,Colorado,51,Gunnison County,11,49,-38
31,Nebraska,8,Colorado,55,Huerfano County,21,0,21
31,Nebraska,8,Colorado,57,Jackson County,4,0,4
31,Nebraska,8,Colorado,59,Jefferson County,402,416,-14
31,Nebraska,8,Colorado,63,Kit Carson County,5,6,-1
31,Nebraska,8,Colorado,67,La Plata County,0,6,-6
31,Nebraska,8,Colorado,69,Larimer County,519,511,8
31,Nebraska,8,Colorado,71,Las Animas County,0,38,-38
31,Nebraska,8,Colorado,73,Lincoln County,0,7,-7
31,Nebraska,8,Colorado,75,Logan County,134,144,-10
31,Nebraska,8,Colorado,77,Mesa County,102,31,71
31,Nebraska,8,Colorado,79,Mineral County,0,8,-8
31,Nebraska,8,Colorado,81,Moffat County,34,0,34
31,Nebraska,8,Colorado,85,Montrose County,13,62,-49
31,Nebraska,8,Colorado,87,Morgan County,126,131,-5
31,Nebraska,8,Colorado,89,Otero County,4,0,4
31,Nebraska,8,Colorado,93,Park County,6,17,-11
31,Nebraska,8,Colorado,95,Phillips County,16,0,16
31,Nebraska,8,Colorado,99,Prowers County,14,9,5
31,Nebraska,8,Colorado,101,Pueblo County,73,193,-120
31,Nebraska,8,Colorado,105,Rio Grande County,7,9,-2
31,Nebraska,8,Colorado,107,Routt County,43,0,43
31,Nebraska,8,Colorado,113,San Miguel County,17,0,17
31,Nebraska,8,Colorado,115,Sedgwick County,37,61,-24
31,Nebraska,8,Colorado,117,Summit County,10,0,10
31,Nebraska,8,Colorado,121,Washington County,4,0,4
31,Nebraska,8,Colorado,123,Weld County,436,199,237
31,Nebraska,8,Colorado,125,Yuma County,83,45,38
31,Nebraska,9,Connecticut,1,Fairfield County,11,0,11
31,Nebraska,9,Connecticut,3,Hartford County,45,0,45
31,Nebraska,9,Connecticut,5,Litchfield County,38,0,38
31,Nebraska,9,Connecticut,9,New Haven County,0,39,-39
31,Nebraska,9,Connecticut,11,New London County,159,0,159
31,Nebraska,AFR,Africa,,-,892,0,0
31,Nebraska,ASI,Asia,,-,4383,0,0
31,Nebraska,CAM,Central America,,-,999,0,0
31,Nebraska,CAR,Caribbean,,-,251,0,0
31,Nebraska,EUR,Europe,,-,1572,0,0
31,Nebraska,ISL,U.S. Island Areas,,-,40,0,0
31,Nebraska,NAM,Northern America,,-,297,0,0
31,Nebraska,OCE,Oceania and At Sea,,-,29,0,0
31,Nebraska,SAM,South America,,-,430,0,0
32,Nevada,1,Alabama,3,Baldwin County,30,31,-1
32,Nevada,1,Alabama,9,Blount County,0,33,-33
32,Nevada,1,Alabama,15,Calhoun County,0,30,-30
32,Nevada,1,Alabama,23,Choctaw County,0,5,-5
32,Nevada,1,Alabama,43,Cullman County,0,38,-38
32,Nevada,1,Alabama,45,Dale County,10,16,-6
32,Nevada,1,Alabama,47,Dallas County,31,113,-82
32,Nevada,1,Alabama,49,DeKalb County,0,12,-12
32,Nevada,1,Alabama,55,Etowah County,0,16,-16
32,Nevada,1,Alabama,71,Jackson County,0,60,-60
32,Nevada,1,Alabama,73,Jefferson County,74,75,-1
32,Nevada,1,Alabama,75,Lamar County,0,1,-1
32,Nevada,1,Alabama,77,Lauderdale County,0,8,-8
32,Nevada,1,Alabama,81,Lee County,208,0,208
32,Nevada,1,Alabama,83,Limestone County,0,42,-42
32,Nevada,1,Alabama,89,Madison County,36,5,31
32,Nevada,1,Alabama,95,Marshall County,0,2,-2
32,Nevada,1,Alabama,97,Mobile County,0,60,-60
32,Nevada,1,Alabama,101,Montgomery County,267,118,149
32,Nevada,1,Alabama,103,Morgan County,20,0,20
32,Nevada,1,Alabama,115,St. Clair County,0,14,-14
32,Nevada,1,Alabama,117,Shelby County,7,0,7
32,Nevada,1,Alabama,123,Tallapoosa County,10,0,10
32,Nevada,1,Alabama,125,Tuscaloosa County,12,0,12
32,Nevada,1,Alabama,127,Walker County,0,22,-22
32,Nevada,10,Delaware,1,Kent County,143,0,143
32,Nevada,10,Delaware,3,New Castle County,8,7,1
32,Nevada,10,Delaware,5,Sussex County,9,6,3
32,Nevada,11,District of Columbia,1,District of Columbia,212,210,2
32,Nevada,12,Florida,1,Alachua County,25,35,-10
32,Nevada,12,Florida,5,Bay County,18,473,-455
32,Nevada,12,Florida,9,Brevard County,123,285,-162
32,Nevada,12,Florida,11,Broward County,309,176,133
32,Nevada,12,Florida,15,Charlotte County,0,24,-24
32,Nevada,12,Florida,17,Citrus County,38,115,-77
32,Nevada,12,Florida,19,Clay County,25,0,25
32,Nevada,12,Florida,21,Collier County,11,206,-195
32,Nevada,12,Florida,23,Columbia County,28,0,28
32,Nevada,12,Florida,31,Duval County,139,210,-71
32,Nevada,12,Florida,33,Escambia County,176,75,101
32,Nevada,12,Florida,35,Flagler County,8,56,-48
32,Nevada,12,Florida,53,Hernando County,34,42,-8
32,Nevada,12,Florida,55,Highlands County,113,0,113
32,Nevada,12,Florida,57,Hillsborough County,519,320,199
32,Nevada,12,Florida,61,Indian River County,19,15,4
32,Nevada,12,Florida,63,Jackson County,10,22,-12
32,Nevada,12,Florida,69,Lake County,61,64,-3
32,Nevada,12,Florida,71,Lee County,59,119,-60
32,Nevada,12,Florida,73,Leon County,132,28,104
32,Nevada,12,Florida,81,Manatee County,21,166,-145
32,Nevada,12,Florida,83,Marion County,73,115,-42
32,Nevada,12,Florida,85,Martin County,23,27,-4
32,Nevada,12,Florida,86,Miami-Dade County,557,89,468
32,Nevada,12,Florida,87,Monroe County,10,58,-48
32,Nevada,12,Florida,91,Okaloosa County,360,28,332
32,Nevada,12,Florida,95,Orange County,459,292,167
32,Nevada,12,Florida,97,Osceola County,99,87,12
32,Nevada,12,Florida,99,Palm Beach County,338,170,168
32,Nevada,12,Florida,101,Pasco County,344,35,309
32,Nevada,12,Florida,103,Pinellas County,455,413,42
32,Nevada,12,Florida,105,Polk County,144,103,41
32,Nevada,12,Florida,107,Putnam County,11,0,11
32,Nevada,12,Florida,109,St. Johns County,221,8,213
32,Nevada,12,Florida,111,St. Lucie County,46,0,46
32,Nevada,12,Florida,113,Santa Rosa County,76,401,-325
32,Nevada,12,Florida,115,Sarasota County,0,208,-208
32,Nevada,12,Florida,117,Seminole County,131,111,20
32,Nevada,12,Florida,119,Sumter County,32,134,-102
32,Nevada,12,Florida,127,Volusia County,169,32,137
32,Nevada,12,Florida,129,Wakulla County,160,0,160
32,Nevada,12,Florida,131,Walton County,0,44,-44
32,Nevada,13,Georgia,1,Appling County,0,15,-15
32,Nevada,13,Georgia,9,Baldwin County,0,6,-6
32,Nevada,13,Georgia,15,Bartow County,0,8,-8
32,Nevada,13,Georgia,21,Bibb County,0,15,-15
32,Nevada,13,Georgia,39,Camden County,19,0,19
32,Nevada,13,Georgia,47,Catoosa County,2,0,2
32,Nevada,13,Georgia,51,Chatham County,19,223,-204
32,Nevada,13,Georgia,53,Chattahoochee County,0,30,-30
32,Nevada,13,Georgia,57,Cherokee County,4,46,-42
32,Nevada,13,Georgia,63,Clayton County,56,0,56
32,Nevada,13,Georgia,67,Cobb County,101,374,-273
32,Nevada,13,Georgia,69,Coffee County,0,15,-15
32,Nevada,13,Georgia,73,Columbia County,17,0,17
32,Nevada,13,Georgia,77,Coweta County,33,0,33
32,Nevada,13,Georgia,89,DeKalb County,211,77,134
32,Nevada,13,Georgia,95,Dougherty County,2,47,-45
32,Nevada,13,Georgia,97,Douglas County,0,8,-8
32,Nevada,13,Georgia,103,Effingham County,0,39,-39
32,Nevada,13,Georgia,113,Fayette County,0,73,-73
32,Nevada,13,Georgia,115,Floyd County,0,12,-12
32,Nevada,13,Georgia,121,Fulton County,422,53,369
32,Nevada,13,Georgia,135,Gwinnett County,124,64,60
32,Nevada,13,Georgia,139,Hall County,9,125,-116
32,Nevada,13,Georgia,151,Henry County,14,81,-67
32,Nevada,13,Georgia,153,Houston County,0,6,-6
32,Nevada,13,Georgia,167,Johnson County,0,14,-14
32,Nevada,13,Georgia,173,Lanier County,77,0,77
32,Nevada,13,Georgia,179,Liberty County,29,13,16
32,Nevada,13,Georgia,185,Lowndes County,195,77,118
32,Nevada,13,Georgia,209,Montgomery County,15,0,15
32,Nevada,13,Georgia,215,Muscogee County,68,25,43
32,Nevada,13,Georgia,217,Newton County,0,3,-3
32,Nevada,13,Georgia,245,Richmond County,0,28,-28
32,Nevada,13,Georgia,253,Seminole County,0,33,-33
32,Nevada,13,Georgia,285,Troup County,28,0,28
32,Nevada,13,Georgia,295,Walker County,6,1,5
32,Nevada,13,Georgia,297,Walton County,6,0,6
32,Nevada,13,Georgia,319,Wilkinson County,0,4,-4
32,Nevada,15,Hawaii,1,Hawaii County,352,174,178
32,Nevada,15,Hawaii,3,Honolulu County,2991,880,2111
32,Nevada,15,Hawaii,7,Kauai County,133,9,124
32,Nevada,15,Hawaii,9,Maui County,926,331,595
32,Nevada,16,Idaho,1,Ada County,217,931,-714
32,Nevada,16,Idaho,5,Bannock County,147,27,120
32,Nevada,16,Idaho,11,Bingham County,293,38,255
32,Nevada,16,Idaho,13,Blaine County,20,0,20
32,Nevada,16,Idaho,15,Boise County,0,20,-20
32,Nevada,16,Idaho,17,Bonner County,0,9,-9
32,Nevada,16,Idaho,19,Bonneville County,163,38,125
32,Nevada,16,Idaho,21,Boundary County,12,5,7
32,Nevada,16,Idaho,23,Butte County,0,15,-15
32,Nevada,16,Idaho,27,Canyon County,509,237,272
32,Nevada,16,Idaho,29,Caribou County,0,38,-38
32,Nevada,16,Idaho,31,Cassia County,0,51,-51
32,Nevada,16,Idaho,35,Clearwater County,0,3,-3
32,Nevada,16,Idaho,37,Custer County,0,13,-13
32,Nevada,16,Idaho,39,Elmore County,115,112,3
32,Nevada,16,Idaho,41,Franklin County,0,67,-67
32,Nevada,16,Idaho,45,Gem County,19,64,-45
32,Nevada,16,Idaho,47,Gooding County,6,0,6
32,Nevada,16,Idaho,49,Idaho County,0,9,-9
32,Nevada,16,Idaho,53,Jerome County,134,0,134
32,Nevada,16,Idaho,55,Kootenai County,34,116,-82
32,Nevada,16,Idaho,57,Latah County,0,66,-66
32,Nevada,16,Idaho,59,Lemhi County,18,0,18
32,Nevada,16,Idaho,63,Lincoln County,0,2,-2
32,Nevada,16,Idaho,65,Madison County,85,33,52
32,Nevada,16,Idaho,67,Minidoka County,12,112,-100
32,Nevada,16,Idaho,69,Nez Perce County,69,27,42
32,Nevada,16,Idaho,71,Oneida County,0,2,-2
32,Nevada,16,Idaho,73,Owyhee County,0,37,-37
32,Nevada,16,Idaho,75,Payette County,4,111,-107
32,Nevada,16,Idaho,79,Shoshone County,184,6,178
32,Nevada,16,Idaho,83,Twin Falls County,661,162,499
32,Nevada,16,Idaho,85,Valley County,0,25,-25
32,Nevada,17,Illinois,5,Bond County,0,10,-10
32,Nevada,17,Illinois,9,Brown County,0,1,-1
32,Nevada,17,Illinois,15,Carroll County,0,11,-11
32,Nevada,17,Illinois,19,Champaign County,55,84,-29
32,Nevada,17,Illinois,23,Clark County,0,12,-12
32,Nevada,17,Illinois,29,Coles County,0,96,-96
32,Nevada,17,Illinois,31,Cook County,1546,891,655
32,Nevada,17,Illinois,37,DeKalb County,16,0,16
32,Nevada,17,Illinois,43,DuPage County,192,122,70
32,Nevada,17,Illinois,49,Effingham County,0,26,-26
32,Nevada,17,Illinois,55,Franklin County,0,43,-43
32,Nevada,17,Illinois,63,Grundy County,0,7,-7
32,Nevada,17,Illinois,73,Henry County,0,32,-32
32,Nevada,17,Illinois,75,Iroquois County,0,1,-1
32,Nevada,17,Illinois,77,Jackson County,10,125,-115
32,Nevada,17,Illinois,81,Jefferson County,0,26,-26
32,Nevada,17,Illinois,83,Jersey County,153,0,153
32,Nevada,17,Illinois,85,Jo Daviess County,0,6,-6
32,Nevada,17,Illinois,89,Kane County,106,53,53
32,Nevada,17,Illinois,91,Kankakee County,35,0,35
32,Nevada,17,Illinois,93,Kendall County,41,0,41
32,Nevada,17,Illinois,95,Knox County,0,2,-2
32,Nevada,17,Illinois,97,Lake County,181,152,29
32,Nevada,17,Illinois,99,LaSalle County,53,47,6
32,Nevada,17,Illinois,101,Lawrence County,0,8,-8
32,Nevada,17,Illinois,103,Lee County,15,0,15
32,Nevada,17,Illinois,107,Logan County,0,2,-2
32,Nevada,17,Illinois,111,McHenry County,129,7,122
32,Nevada,17,Illinois,113,McLean County,0,41,-41
32,Nevada,17,Illinois,115,Macon County,15,0,15
32,Nevada,17,Illinois,119,Madison County,0,20,-20
32,Nevada,17,Illinois,121,Marion County,0,7,-7
32,Nevada,17,Illinois,127,Massac County,351,0,351
32,Nevada,17,Illinois,135,Montgomery County,0,25,-25
32,Nevada,17,Illinois,137,Morgan County,0,2,-2
32,Nevada,17,Illinois,141,Ogle County,14,121,-107
32,Nevada,17,Illinois,143,Peoria County,33,0,33
32,Nevada,17,Illinois,151,Pope County,0,8,-8
32,Nevada,17,Illinois,153,Pulaski County,0,4,-4
32,Nevada,17,Illinois,161,Rock Island County,59,9,50
32,Nevada,17,Illinois,163,St. Clair County,208,80,128
32,Nevada,17,Illinois,167,Sangamon County,0,2,-2
32,Nevada,17,Illinois,177,Stephenson County,0,5,-5
32,Nevada,17,Illinois,179,Tazewell County,0,9,-9
32,Nevada,17,Illinois,181,Union County,0,5,-5
32,Nevada,17,Illinois,185,Wabash County,15,0,15
32,Nevada,17,Illinois,193,White County,0,2,-2
32,Nevada,17,Illinois,197,Will County,292,120,172
32,Nevada,17,Illinois,199,Williamson County,3,0,3
32,Nevada,17,Illinois,201,Winnebago County,19,84,-65
32,Nevada,18,Indiana,3,Allen County,19,76,-57
32,Nevada,18,Indiana,23,Clinton County,0,9,-9
32,Nevada,18,Indiana,29,Dearborn County,51,0,51
32,Nevada,18,Indiana,33,DeKalb County,4,0,4
32,Nevada,18,Indiana,35,Delaware County,0,18,-18
32,Nevada,18,Indiana,39,Elkhart County,73,0,73
32,Nevada,18,Indiana,45,Fountain County,3,0,3
32,Nevada,18,Indiana,53,Grant County,0,171,-171
32,Nevada,18,Indiana,57,Hamilton County,45,298,-253
32,Nevada,18,Indiana,59,Hancock County,0,76,-76
32,Nevada,18,Indiana,63,Hendricks County,7,0,7
32,Nevada,18,Indiana,65,Henry County,61,12,49
32,Nevada,18,Indiana,67,Howard County,0,86,-86
32,Nevada,18,Indiana,81,Johnson County,57,19,38
32,Nevada,18,Indiana,85,Kosciusko County,0,18,-18
32,Nevada,18,Indiana,89,Lake County,168,149,19
32,Nevada,18,Indiana,91,LaPorte County,74,8,66
32,Nevada,18,Indiana,95,Madison County,0,29,-29
32,Nevada,18,Indiana,97,Marion County,159,311,-152
32,Nevada,18,Indiana,105,Monroe County,97,0,97
32,Nevada,18,Indiana,111,Newton County,0,3,-3
32,Nevada,18,Indiana,127,Porter County,96,23,73
32,Nevada,18,Indiana,151,Steuben County,10,0,10
32,Nevada,18,Indiana,157,Tippecanoe County,20,9,11
32,Nevada,18,Indiana,163,Vanderburgh County,3,91,-88
32,Nevada,18,Indiana,165,Vermillion County,0,7,-7
32,Nevada,18,Indiana,167,Vigo County,18,0,18
32,Nevada,18,Indiana,173,Warrick County,0,20,-20
32,Nevada,18,Indiana,177,Wayne County,0,9,-9
32,Nevada,18,Indiana,179,Wells County,0,6,-6
32,Nevada,19,Iowa,13,Black Hawk County,35,10,25
32,Nevada,19,Iowa,15,Boone County,0,17,-17
32,Nevada,19,Iowa,17,Bremer County,9,0,9
32,Nevada,19,Iowa,19,Buchanan County,0,2,-2
32,Nevada,19,Iowa,25,Calhoun County,0,8,-8
32,Nevada,19,Iowa,41,Clay County,0,2,-2
32,Nevada,19,Iowa,53,Decatur County,0,4,-4
32,Nevada,19,Iowa,57,Des Moines County,0,64,-64
32,Nevada,19,Iowa,61,Dubuque County,0,13,-13
32,Nevada,19,Iowa,67,Floyd County,38,0,38
32,Nevada,19,Iowa,71,Fremont County,6,0,6
32,Nevada,19,Iowa,83,Hardin County,0,6,-6
32,Nevada,19,Iowa,87,Henry County,0,3,-3
32,Nevada,19,Iowa,93,Ida County,0,8,-8
32,Nevada,19,Iowa,101,Jefferson County,22,0,22
32,Nevada,19,Iowa,103,Johnson County,5,0,5
32,Nevada,19,Iowa,105,Jones County,0,17,-17
32,Nevada,19,Iowa,111,Lee County,29,0,29
32,Nevada,19,Iowa,113,Linn County,70,90,-20
32,Nevada,19,Iowa,127,Marshall County,8,0,8
32,Nevada,19,Iowa,153,Polk County,234,238,-4
32,Nevada,19,Iowa,155,Pottawattamie County,0,8,-8
32,Nevada,19,Iowa,163,Scott County,111,17,94
32,Nevada,19,Iowa,169,Story County,0,7,-7
32,Nevada,19,Iowa,171,Tama County,0,21,-21
32,Nevada,19,Iowa,179,Wapello County,0,7,-7
32,Nevada,19,Iowa,181,Warren County,0,4,-4
32,Nevada,19,Iowa,187,Webster County,7,0,7
32,Nevada,19,Iowa,189,Winnebago County,0,47,-47
32,Nevada,19,Iowa,193,Woodbury County,75,0,75
32,Nevada,2,Alaska,16,Aleutians West Census Area,0,3,-3
32,Nevada,2,Alaska,20,Anchorage Municipality,889,461,428
32,Nevada,2,Alaska,60,Bristol Bay Borough,27,0,27
32,Nevada,2,Alaska,90,Fairbanks North Star Borough,20,92,-72
32,Nevada,2,Alaska,110,Juneau City and Borough,28,5,23
32,Nevada,2,Alaska,122,Kenai Peninsula Borough,75,67,8
32,Nevada,2,Alaska,130,Ketchikan Gateway Borough,0,19,-19
32,Nevada,2,Alaska,150,Kodiak Island Borough,79,0,79
32,Nevada,2,Alaska,170,Matanuska-Susitna Borough,118,84,34
32,Nevada,2,Alaska,180,Nome Census Area,0,3,-3
32,Nevada,2,Alaska,185,North Slope Borough,0,15,-15
32,Nevada,2,Alaska,195,Petersburg Borough,0,8,-8
32,Nevada,2,Alaska,198,Prince of Wales-Hyder Census Area,0,2,-2
32,Nevada,2,Alaska,220,Sitka City and Borough,0,2,-2
32,Nevada,2,Alaska,230,Skagway Municipality,0,25,-25
32,Nevada,2,Alaska,240,Southeast Fairbanks Census Area,0,4,-4
32,Nevada,2,Alaska,261,Valdez-Cordova Census Area,125,0,125
32,Nevada,2,Alaska,275,Wrangell City and Borough,0,4,-4
32,Nevada,20,Kansas,5,Atchison County,37,0,37
32,Nevada,20,Kansas,7,Barber County,0,5,-5
32,Nevada,20,Kansas,9,Barton County,0,18,-18
32,Nevada,20,Kansas,15,Butler County,16,32,-16
32,Nevada,20,Kansas,35,Cowley County,14,14,0
32,Nevada,20,Kansas,41,Dickinson County,0,28,-28
32,Nevada,20,Kansas,45,Douglas County,20,92,-72
32,Nevada,20,Kansas,57,Ford County,0,103,-103
32,Nevada,20,Kansas,61,Geary County,131,0,131
32,Nevada,20,Kansas,85,Jackson County,0,9,-9
32,Nevada,20,Kansas,87,Jefferson County,18,0,18
32,Nevada,20,Kansas,91,Johnson County,0,144,-144
32,Nevada,20,Kansas,99,Labette County,14,0,14
32,Nevada,20,Kansas,103,Leavenworth County,0,212,-212
32,Nevada,20,Kansas,115,Marion County,0,4,-4
32,Nevada,20,Kansas,117,Marshall County,14,0,14
32,Nevada,20,Kansas,127,Morris County,0,5,-5
32,Nevada,20,Kansas,131,Nemaha County,0,6,-6
32,Nevada,20,Kansas,133,Neosho County,34,0,34
32,Nevada,20,Kansas,137,Norton County,0,10,-10
32,Nevada,20,Kansas,155,Reno County,37,0,37
32,Nevada,20,Kansas,157,Republic County,0,34,-34
32,Nevada,20,Kansas,161,Riley County,86,0,86
32,Nevada,20,Kansas,173,Sedgwick County,137,29,108
32,Nevada,20,Kansas,177,Shawnee County,67,30,37
32,Nevada,20,Kansas,193,Thomas County,4,0,4
32,Nevada,20,Kansas,209,Wyandotte County,8,4,4
32,Nevada,21,Kentucky,3,Allen County,0,21,-21
32,Nevada,21,Kentucky,13,Bell County,84,0,84
32,Nevada,21,Kentucky,15,Boone County,55,0,55
32,Nevada,21,Kentucky,19,Boyd County,15,0,15
32,Nevada,21,Kentucky,29,Bullitt County,0,13,-13
32,Nevada,21,Kentucky,35,Calloway County,0,14,-14
32,Nevada,21,Kentucky,37,Campbell County,22,0,22
32,Nevada,21,Kentucky,47,Christian County,105,232,-127
32,Nevada,21,Kentucky,59,Daviess County,0,12,-12
32,Nevada,21,Kentucky,67,Fayette County,68,21,47
32,Nevada,21,Kentucky,85,Grayson County,79,0,79
32,Nevada,21,Kentucky,89,Greenup County,0,13,-13
32,Nevada,21,Kentucky,93,Hardin County,0,18,-18
32,Nevada,21,Kentucky,101,Henderson County,15,0,15
32,Nevada,21,Kentucky,103,Henry County,6,0,6
32,Nevada,21,Kentucky,111,Jefferson County,205,15,190
32,Nevada,21,Kentucky,147,McCreary County,160,0,160
32,Nevada,21,Kentucky,151,Madison County,16,22,-6
32,Nevada,21,Kentucky,157,Marshall County,0,34,-34
32,Nevada,21,Kentucky,161,Mason County,9,11,-2
32,Nevada,21,Kentucky,197,Powell County,0,41,-41
32,Nevada,21,Kentucky,211,Shelby County,36,0,36
32,Nevada,21,Kentucky,227,Warren County,14,0,14
32,Nevada,22,Louisiana,1,Acadia Parish,0,52,-52
32,Nevada,22,Louisiana,5,Ascension Parish,38,0,38
32,Nevada,22,Louisiana,15,Bossier Parish,0,21,-21
32,Nevada,22,Louisiana,17,Caddo Parish,38,13,25
32,Nevada,22,Louisiana,19,Calcasieu Parish,18,25,-7
32,Nevada,22,Louisiana,29,Concordia Parish,0,2,-2
32,Nevada,22,Louisiana,33,East Baton Rouge Parish,16,90,-74
32,Nevada,22,Louisiana,43,Grant Parish,9,0,9
32,Nevada,22,Louisiana,45,Iberia Parish,12,0,12
32,Nevada,22,Louisiana,51,Jefferson Parish,64,57,7
32,Nevada,22,Louisiana,55,Lafayette Parish,0,71,-71
32,Nevada,22,Louisiana,61,Lincoln Parish,9,0,9
32,Nevada,22,Louisiana,63,Livingston Parish,10,0,10
32,Nevada,22,Louisiana,67,Morehouse Parish,3,0,3
32,Nevada,22,Louisiana,69,Natchitoches Parish,0,34,-34
32,Nevada,22,Louisiana,71,Orleans Parish,72,93,-21
32,Nevada,22,Louisiana,73,Ouachita Parish,34,8,26
32,Nevada,22,Louisiana,97,St. Landry Parish,8,1,7
32,Nevada,22,Louisiana,103,St. Tammany Parish,0,3,-3
32,Nevada,22,Louisiana,115,Vernon Parish,27,14,13
32,Nevada,22,Louisiana,119,Webster Parish,0,8,-8
32,Nevada,23,Maine,1,Androscoggin County,17,0,17
32,Nevada,23,Maine,3,Aroostook County,0,7,-7
32,Nevada,23,Maine,5,Cumberland County,73,56,17
32,Nevada,23,Maine,7,Franklin County,0,23,-23
32,Nevada,23,Maine,9,Hancock County,4,2,2
32,Nevada,23,Maine,13,Knox County,0,4,-4
32,Nevada,23,Maine,17,Oxford County,0,11,-11
32,Nevada,23,Maine,19,Penobscot County,2,11,-9
32,Nevada,23,Maine,25,Somerset County,9,0,9
32,Nevada,23,Maine,29,Washington County,21,0,21
32,Nevada,23,Maine,31,York County,14,17,-3
32,Nevada,24,Maryland,3,Anne Arundel County,84,51,33
32,Nevada,24,Maryland,5,Baltimore County,0,212,-212
32,Nevada,24,Maryland,15,Cecil County,60,7,53
32,Nevada,24,Maryland,17,Charles County,38,31,7
32,Nevada,24,Maryland,21,Frederick County,165,40,125
32,Nevada,24,Maryland,23,Garrett County,0,140,-140
32,Nevada,24,Maryland,25,Harford County,39,0,39
32,Nevada,24,Maryland,27,Howard County,46,0,46
32,Nevada,24,Maryland,31,Montgomery County,246,216,30
32,Nevada,24,Maryland,33,Prince George's County,113,31,82
32,Nevada,24,Maryland,35,Queen Anne's County,0,22,-22
32,Nevada,24,Maryland,37,St. Mary's County,4,14,-10
32,Nevada,24,Maryland,43,Washington County,0,9,-9
32,Nevada,24,Maryland,45,Wicomico County,15,0,15
32,Nevada,24,Maryland,510,Baltimore city,115,12,103
32,Nevada,25,Massachusetts,1,Barnstable County,8,0,8
32,Nevada,25,Massachusetts,9,Essex County,35,12,23
32,Nevada,25,Massachusetts,13,Hampden County,34,0,34
32,Nevada,25,Massachusetts,15,Hampshire County,76,65,11
32,Nevada,25,Massachusetts,17,Middlesex County,219,184,35
32,Nevada,25,Massachusetts,21,Norfolk County,32,7,25
32,Nevada,25,Massachusetts,23,Plymouth County,174,178,-4
32,Nevada,25,Massachusetts,25,Suffolk County,53,128,-75
32,Nevada,25,Massachusetts,27,Worcester County,15,129,-114
32,Nevada,26,Michigan,15,Barry County,0,11,-11
32,Nevada,26,Michigan,19,Benzie County,8,2,6
32,Nevada,26,Michigan,21,Berrien County,0,31,-31
32,Nevada,26,Michigan,25,Calhoun County,35,23,12
32,Nevada,26,Michigan,27,Cass County,0,8,-8
32,Nevada,26,Michigan,35,Clare County,0,2,-2
32,Nevada,26,Michigan,39,Crawford County,45,0,45
32,Nevada,26,Michigan,41,Delta County,85,7,78
32,Nevada,26,Michigan,45,Eaton County,35,19,16
32,Nevada,26,Michigan,47,Emmet County,0,34,-34
32,Nevada,26,Michigan,49,Genesee County,191,158,33
32,Nevada,26,Michigan,55,Grand Traverse County,0,6,-6
32,Nevada,26,Michigan,59,Hillsdale County,0,3,-3
32,Nevada,26,Michigan,61,Houghton County,49,0,49
32,Nevada,26,Michigan,65,Ingham County,49,93,-44
32,Nevada,26,Michigan,67,Ionia County,38,0,38
32,Nevada,26,Michigan,69,Iosco County,0,32,-32
32,Nevada,26,Michigan,71,Iron County,0,12,-12
32,Nevada,26,Michigan,73,Isabella County,0,77,-77
32,Nevada,26,Michigan,75,Jackson County,37,0,37
32,Nevada,26,Michigan,77,Kalamazoo County,183,4,179
32,Nevada,26,Michigan,79,Kalkaska County,0,3,-3
32,Nevada,26,Michigan,81,Kent County,69,109,-40
32,Nevada,26,Michigan,87,Lapeer County,0,13,-13
32,Nevada,26,Michigan,89,Leelanau County,9,10,-1
32,Nevada,26,Michigan,93,Livingston County,0,9,-9
32,Nevada,26,Michigan,95,Luce County,0,5,-5
32,Nevada,26,Michigan,99,Macomb County,55,180,-125
32,Nevada,26,Michigan,101,Manistee County,0,4,-4
32,Nevada,26,Michigan,103,Marquette County,0,17,-17
32,Nevada,26,Michigan,107,Mecosta County,0,1,-1
32,Nevada,26,Michigan,109,Menominee County,0,11,-11
32,Nevada,26,Michigan,111,Midland County,0,20,-20
32,Nevada,26,Michigan,113,Missaukee County,0,12,-12
32,Nevada,26,Michigan,115,Monroe County,80,10,70
32,Nevada,26,Michigan,119,Montmorency County,0,4,-4
32,Nevada,26,Michigan,123,Newaygo County,0,23,-23
32,Nevada,26,Michigan,125,Oakland County,278,211,67
32,Nevada,26,Michigan,129,Ogemaw County,5,0,5
32,Nevada,26,Michigan,133,Osceola County,0,11,-11
32,Nevada,26,Michigan,141,Presque Isle County,0,2,-2
32,Nevada,26,Michigan,145,Saginaw County,26,21,5
32,Nevada,26,Michigan,147,St. Clair County,0,12,-12
32,Nevada,26,Michigan,159,Van Buren County,0,5,-5
32,Nevada,26,Michigan,161,Washtenaw County,10,87,-77
32,Nevada,26,Michigan,163,Wayne County,527,287,240
32,Nevada,27,Minnesota,3,Anoka County,0,79,-79
32,Nevada,27,Minnesota,5,Becker County,0,1,-1
32,Nevada,27,Minnesota,13,Blue Earth County,29,19,10
32,Nevada,27,Minnesota,19,Carver County,22,0,22
32,Nevada,27,Minnesota,21,Cass County,0,1,-1
32,Nevada,27,Minnesota,25,Chisago County,10,0,10
32,Nevada,27,Minnesota,27,Clay County,0,24,-24
32,Nevada,27,Minnesota,29,Clearwater County,16,0,16
32,Nevada,27,Minnesota,35,Crow Wing County,0,4,-4
32,Nevada,27,Minnesota,37,Dakota County,103,9,94
32,Nevada,27,Minnesota,49,Goodhue County,0,7,-7
32,Nevada,27,Minnesota,53,Hennepin County,669,216,453
32,Nevada,27,Minnesota,57,Hubbard County,0,29,-29
32,Nevada,27,Minnesota,59,Isanti County,28,0,28
32,Nevada,27,Minnesota,63,Jackson County,0,11,-11
32,Nevada,27,Minnesota,65,Kanabec County,0,9,-9
32,Nevada,27,Minnesota,67,Kandiyohi County,42,12,30
32,Nevada,27,Minnesota,71,Koochiching County,17,0,17
32,Nevada,27,Minnesota,75,Lake County,7,0,7
32,Nevada,27,Minnesota,79,Le Sueur County,0,42,-42
32,Nevada,27,Minnesota,103,Nicollet County,63,0,63
32,Nevada,27,Minnesota,109,Olmsted County,21,90,-69
32,Nevada,27,Minnesota,115,Pine County,54,0,54
32,Nevada,27,Minnesota,119,Polk County,0,6,-6
32,Nevada,27,Minnesota,123,Ramsey County,169,89,80
32,Nevada,27,Minnesota,131,Rice County,0,3,-3
32,Nevada,27,Minnesota,137,St. Louis County,0,9,-9
32,Nevada,27,Minnesota,139,Scott County,70,34,36
32,Nevada,27,Minnesota,141,Sherburne County,0,12,-12
32,Nevada,27,Minnesota,145,Stearns County,0,51,-51
32,Nevada,27,Minnesota,147,Steele County,21,0,21
32,Nevada,27,Minnesota,159,Wadena County,80,0,80
32,Nevada,27,Minnesota,163,Washington County,121,60,61
32,Nevada,27,Minnesota,169,Winona County,0,36,-36
32,Nevada,27,Minnesota,171,Wright County,90,0,90
32,Nevada,28,Mississippi,27,Coahoma County,0,52,-52
32,Nevada,28,Mississippi,47,Harrison County,106,118,-12
32,Nevada,28,Mississippi,49,Hinds County,30,41,-11
32,Nevada,28,Mississippi,59,Jackson County,26,0,26
32,Nevada,28,Mississippi,61,Jasper County,66,0,66
32,Nevada,28,Mississippi,65,Jefferson Davis County,26,0,26
32,Nevada,28,Mississippi,67,Jones County,0,23,-23
32,Nevada,28,Mississippi,75,Lauderdale County,20,26,-6
32,Nevada,28,Mississippi,81,Lee County,0,39,-39
32,Nevada,28,Mississippi,87,Lowndes County,89,0,89
32,Nevada,28,Mississippi,89,Madison County,6,18,-12
32,Nevada,28,Mississippi,107,Panola County,61,0,61
32,Nevada,28,Mississippi,117,Prentiss County,0,19,-19
32,Nevada,28,Mississippi,121,Rankin County,0,99,-99
32,Nevada,28,Mississippi,133,Sunflower County,4,0,4
32,Nevada,29,Missouri,15,Benton County,0,18,-18
32,Nevada,29,Missouri,19,Boone County,49,47,2
32,Nevada,29,Missouri,21,Buchanan County,16,10,6
32,Nevada,29,Missouri,23,Butler County,7,118,-111
32,Nevada,29,Missouri,29,Camden County,3,52,-49
32,Nevada,29,Missouri,31,Cape Girardeau County,0,30,-30
32,Nevada,29,Missouri,37,Cass County,111,3,108
32,Nevada,29,Missouri,43,Christian County,0,32,-32
32,Nevada,29,Missouri,47,Clay County,80,103,-23
32,Nevada,29,Missouri,49,Clinton County,15,0,15
32,Nevada,29,Missouri,51,Cole County,16,0,16
32,Nevada,29,Missouri,53,Cooper County,10,0,10
32,Nevada,29,Missouri,69,Dunklin County,0,38,-38
32,Nevada,29,Missouri,71,Franklin County,109,0,109
32,Nevada,29,Missouri,77,Greene County,55,39,16
32,Nevada,29,Missouri,81,Harrison County,0,2,-2
32,Nevada,29,Missouri,83,Henry County,18,0,18
32,Nevada,29,Missouri,89,Howard County,0,1,-1
32,Nevada,29,Missouri,95,Jackson County,12,216,-204
32,Nevada,29,Missouri,97,Jasper County,65,0,65
32,Nevada,29,Missouri,99,Jefferson County,54,0,54
32,Nevada,29,Missouri,101,Johnson County,116,0,116
32,Nevada,29,Missouri,105,Laclede County,9,0,9
32,Nevada,29,Missouri,107,Lafayette County,0,5,-5
32,Nevada,29,Missouri,111,Lewis County,0,6,-6
32,Nevada,29,Missouri,127,Marion County,0,6,-6
32,Nevada,29,Missouri,135,Moniteau County,0,24,-24
32,Nevada,29,Missouri,141,Morgan County,0,3,-3
32,Nevada,29,Missouri,145,Newton County,0,20,-20
32,Nevada,29,Missouri,147,Nodaway County,0,42,-42
32,Nevada,29,Missouri,161,Phelps County,7,0,7
32,Nevada,29,Missouri,165,Platte County,0,6,-6
32,Nevada,29,Missouri,167,Polk County,0,4,-4
32,Nevada,29,Missouri,169,Pulaski County,74,172,-98
32,Nevada,29,Missouri,175,Randolph County,0,9,-9
32,Nevada,29,Missouri,183,St. Charles County,30,19,11
32,Nevada,29,Missouri,185,St. Clair County,0,5,-5
32,Nevada,29,Missouri,187,St. Francois County,0,24,-24
32,Nevada,29,Missouri,189,St. Louis County,55,252,-197
32,Nevada,29,Missouri,199,Scotland County,0,18,-18
32,Nevada,29,Missouri,209,Stone County,0,20,-20
32,Nevada,29,Missouri,213,Taney County,35,0,35
32,Nevada,29,Missouri,217,Vernon County,0,3,-3
32,Nevada,29,Missouri,221,Washington County,19,0,19
32,Nevada,29,Missouri,510,St. Louis city,172,93,79
32,Nevada,30,Montana,1,Beaverhead County,0,25,-25
32,Nevada,30,Montana,3,Big Horn County,4,0,4
32,Nevada,30,Montana,9,Carbon County,0,9,-9
32,Nevada,30,Montana,13,Cascade County,78,158,-80
32,Nevada,30,Montana,17,Custer County,0,12,-12
32,Nevada,30,Montana,19,Daniels County,7,13,-6
32,Nevada,30,Montana,23,Deer Lodge County,0,3,-3
32,Nevada,30,Montana,25,Fallon County,0,8,-8
32,Nevada,30,Montana,29,Flathead County,8,7,1
32,Nevada,30,Montana,31,Gallatin County,128,219,-91
32,Nevada,30,Montana,39,Granite County,132,0,132
32,Nevada,30,Montana,41,Hill County,0,3,-3
32,Nevada,30,Montana,47,Lake County,0,1,-1
32,Nevada,30,Montana,49,Lewis and Clark County,82,48,34
32,Nevada,30,Montana,53,Lincoln County,1,4,-3
32,Nevada,30,Montana,63,Missoula County,174,91,83
32,Nevada,30,Montana,67,Park County,2,0,2
32,Nevada,30,Montana,81,Ravalli County,119,43,76
32,Nevada,30,Montana,83,Richland County,47,0,47
32,Nevada,30,Montana,89,Sanders County,0,4,-4
32,Nevada,30,Montana,91,Sheridan County,0,1,-1
32,Nevada,30,Montana,93,Silver Bow County,0,57,-57
32,Nevada,30,Montana,95,Stillwater County,0,26,-26
32,Nevada,30,Montana,97,Sweet Grass County,12,0,12
32,Nevada,30,Montana,99,Teton County,0,1,-1
32,Nevada,30,Montana,111,Yellowstone County,62,64,-2
32,Nevada,31,Nebraska,1,Adams County,0,36,-36
32,Nevada,31,Nebraska,19,Buffalo County,0,26,-26
32,Nevada,31,Nebraska,21,Burt County,16,0,16
32,Nevada,31,Nebraska,25,Cass County,79,0,79
32,Nevada,31,Nebraska,45,Dawes County,6,0,6
32,Nevada,31,Nebraska,51,Dixon County,7,0,7
32,Nevada,31,Nebraska,55,Douglas County,151,298,-147
32,Nevada,31,Nebraska,63,Frontier County,0,1,-1
32,Nevada,31,Nebraska,77,Greeley County,0,8,-8
32,Nevada,31,Nebraska,109,Lancaster County,72,132,-60
32,Nevada,31,Nebraska,111,Lincoln County,111,11,100
32,Nevada,31,Nebraska,121,Merrick County,0,16,-16
32,Nevada,31,Nebraska,127,Nemaha County,0,5,-5
32,Nevada,31,Nebraska,131,Otoe County,0,1,-1
32,Nevada,31,Nebraska,143,Polk County,0,1,-1
32,Nevada,31,Nebraska,151,Saline County,0,4,-4
32,Nevada,31,Nebraska,153,Sarpy County,112,41,71
32,Nevada,31,Nebraska,157,Scotts Bluff County,41,0,41
32,Nevada,31,Nebraska,159,Seward County,34,11,23
32,Nevada,31,Nebraska,173,Thurston County,0,9,-9
32,Nevada,31,Nebraska,177,Washington County,16,24,-8
32,Nevada,31,Nebraska,185,York County,0,2,-2
32,Nevada,32,Nevada,1,Churchill County,994,802,192
32,Nevada,32,Nevada,3,Clark County,6509,4613,1896
32,Nevada,32,Nevada,5,Douglas County,1405,1523,-118
32,Nevada,32,Nevada,7,Elko County,1306,1107,199
32,Nevada,32,Nevada,9,Esmeralda County,19,38,-19
32,Nevada,32,Nevada,11,Eureka County,76,37,39
32,Nevada,32,Nevada,13,Humboldt County,752,789,-37
32,Nevada,32,Nevada,15,Lander County,359,124,235
32,Nevada,32,Nevada,17,Lincoln County,261,513,-252
32,Nevada,32,Nevada,19,Lyon County,2784,2577,207
32,Nevada,32,Nevada,21,Mineral County,66,173,-107
32,Nevada,32,Nevada,23,Nye County,1714,1216,498
32,Nevada,32,Nevada,27,Pershing County,346,628,-282
32,Nevada,32,Nevada,29,Storey County,223,336,-113
32,Nevada,32,Nevada,31,Washoe County,5598,6689,-1091
32,Nevada,32,Nevada,33,White Pine County,454,642,-188
32,Nevada,32,Nevada,510,Carson City,2269,3328,-1059
32,Nevada,33,New Hampshire,5,Cheshire County,0,5,-5
32,Nevada,33,New Hampshire,7,Coos County,0,24,-24
32,Nevada,33,New Hampshire,9,Grafton County,7,17,-10
32,Nevada,33,New Hampshire,11,Hillsborough County,42,248,-206
32,Nevada,33,New Hampshire,13,Merrimack County,85,153,-68
32,Nevada,33,New Hampshire,15,Rockingham County,38,26,12
32,Nevada,33,New Hampshire,17,Strafford County,16,2,14
32,Nevada,33,New Hampshire,19,Sullivan County,0,4,-4
32,Nevada,34,New Jersey,1,Atlantic County,115,48,67
32,Nevada,34,New Jersey,3,Bergen County,134,36,98
32,Nevada,34,New Jersey,5,Burlington County,20,58,-38
32,Nevada,34,New Jersey,7,Camden County,110,57,53
32,Nevada,34,New Jersey,11,Cumberland County,9,0,9
32,Nevada,34,New Jersey,13,Essex County,90,59,31
32,Nevada,34,New Jersey,15,Gloucester County,101,0,101
32,Nevada,34,New Jersey,17,Hudson County,6,71,-65
32,Nevada,34,New Jersey,19,Hunterdon County,0,19,-19
32,Nevada,34,New Jersey,21,Mercer County,111,7,104
32,Nevada,34,New Jersey,23,Middlesex County,29,9,20
32,Nevada,34,New Jersey,25,Monmouth County,25,0,25
32,Nevada,34,New Jersey,27,Morris County,44,12,32
32,Nevada,34,New Jersey,29,Ocean County,31,0,31
32,Nevada,34,New Jersey,31,Passaic County,0,3,-3
32,Nevada,34,New Jersey,33,Salem County,0,18,-18
32,Nevada,34,New Jersey,35,Somerset County,37,53,-16
32,Nevada,34,New Jersey,37,Sussex County,4,12,-8
32,Nevada,34,New Jersey,39,Union County,173,0,173
32,Nevada,34,New Jersey,41,Warren County,3,0,3
32,Nevada,35,New Mexico,1,Bernalillo County,647,450,197
32,Nevada,35,New Mexico,3,Catron County,45,0,45
32,Nevada,35,New Mexico,7,Colfax County,0,55,-55
32,Nevada,35,New Mexico,9,Curry County,274,23,251
32,Nevada,35,New Mexico,13,Doña Ana County,271,53,218
32,Nevada,35,New Mexico,15,Eddy County,152,22,130
32,Nevada,35,New Mexico,17,Grant County,0,32,-32
32,Nevada,35,New Mexico,23,Hidalgo County,0,11,-11
32,Nevada,35,New Mexico,25,Lea County,14,0,14
32,Nevada,35,New Mexico,29,Luna County,52,39,13
32,Nevada,35,New Mexico,31,McKinley County,59,68,-9
32,Nevada,35,New Mexico,35,Otero County,119,165,-46
32,Nevada,35,New Mexico,39,Rio Arriba County,37,0,37
32,Nevada,35,New Mexico,41,Roosevelt County,0,2,-2
32,Nevada,35,New Mexico,43,Sandoval County,398,78,320
32,Nevada,35,New Mexico,45,San Juan County,102,5,97
32,Nevada,35,New Mexico,47,San Miguel County,0,6,-6
32,Nevada,35,New Mexico,49,Santa Fe County,66,50,16
32,Nevada,35,New Mexico,57,Torrance County,11,6,5
32,Nevada,35,New Mexico,61,Valencia County,0,28,-28
32,Nevada,36,New York,1,Albany County,22,11,11
32,Nevada,36,New York,5,Bronx County,250,37,213
32,Nevada,36,New York,9,Cattaraugus County,16,9,7
32,Nevada,36,New York,13,Chautauqua County,0,8,-8
32,Nevada,36,New York,15,Chemung County,0,17,-17
32,Nevada,36,New York,19,Clinton County,0,25,-25
32,Nevada,36,New York,21,Columbia County,0,14,-14
32,Nevada,36,New York,23,Cortland County,8,0,8
32,Nevada,36,New York,27,Dutchess County,12,9,3
32,Nevada,36,New York,29,Erie County,122,252,-130
32,Nevada,36,New York,35,Fulton County,0,8,-8
32,Nevada,36,New York,37,Genesee County,0,2,-2
32,Nevada,36,New York,43,Herkimer County,4,12,-8
32,Nevada,36,New York,45,Jefferson County,7,0,7
32,Nevada,36,New York,47,Kings County,199,141,58
32,Nevada,36,New York,55,Monroe County,106,35,71
32,Nevada,36,New York,59,Nassau County,279,42,237
32,Nevada,36,New York,61,New York County,258,202,56
32,Nevada,36,New York,63,Niagara County,29,52,-23
32,Nevada,36,New York,65,Oneida County,237,63,174
32,Nevada,36,New York,67,Onondaga County,19,139,-120
32,Nevada,36,New York,71,Orange County,192,10,182
32,Nevada,36,New York,75,Oswego County,9,29,-20
32,Nevada,36,New York,77,Otsego County,0,30,-30
32,Nevada,36,New York,79,Putnam County,42,0,42
32,Nevada,36,New York,81,Queens County,301,180,121
32,Nevada,36,New York,83,Rensselaer County,20,14,6
32,Nevada,36,New York,87,Rockland County,14,0,14
32,Nevada,36,New York,89,St. Lawrence County,15,0,15
32,Nevada,36,New York,91,Saratoga County,39,19,20
32,Nevada,36,New York,93,Schenectady County,17,0,17
32,Nevada,36,New York,99,Seneca County,0,25,-25
32,Nevada,36,New York,101,Steuben County,0,3,-3
32,Nevada,36,New York,103,Suffolk County,272,41,231
32,Nevada,36,New York,105,Sullivan County,0,57,-57
32,Nevada,36,New York,109,Tompkins County,0,9,-9
32,Nevada,36,New York,111,Ulster County,40,19,21
32,Nevada,36,New York,113,Warren County,16,0,16
32,Nevada,36,New York,117,Wayne County,0,9,-9
32,Nevada,36,New York,119,Westchester County,330,42,288
32,Nevada,36,New York,123,Yates County,15,158,-143
32,Nevada,37,North Carolina,1,Alamance County,0,2,-2
32,Nevada,37,North Carolina,21,Buncombe County,50,41,9
32,Nevada,37,North Carolina,25,Cabarrus County,47,137,-90
32,Nevada,37,North Carolina,27,Caldwell County,0,176,-176
32,Nevada,37,North Carolina,31,Carteret County,0,17,-17
32,Nevada,37,North Carolina,49,Craven County,49,33,16
32,Nevada,37,North Carolina,51,Cumberland County,101,104,-3
32,Nevada,37,North Carolina,55,Dare County,9,0,9
32,Nevada,37,North Carolina,63,Durham County,12,94,-82
32,Nevada,37,North Carolina,67,Forsyth County,40,18,22
32,Nevada,37,North Carolina,69,Franklin County,0,15,-15
32,Nevada,37,North Carolina,71,Gaston County,0,80,-80
32,Nevada,37,North Carolina,81,Guilford County,303,1,302
32,Nevada,37,North Carolina,85,Harnett County,100,18,82
32,Nevada,37,North Carolina,89,Henderson County,22,25,-3
32,Nevada,37,North Carolina,97,Iredell County,79,13,66
32,Nevada,37,North Carolina,101,Johnston County,9,1,8
32,Nevada,37,North Carolina,107,Lenoir County,10,0,10
32,Nevada,37,North Carolina,113,Macon County,0,29,-29
32,Nevada,37,North Carolina,119,Mecklenburg County,537,405,132
32,Nevada,37,North Carolina,121,Mitchell County,3,0,3
32,Nevada,37,North Carolina,127,Nash County,0,67,-67
32,Nevada,37,North Carolina,129,New Hanover County,8,17,-9
32,Nevada,37,North Carolina,133,Onslow County,0,62,-62
32,Nevada,37,North Carolina,135,Orange County,17,4,13
32,Nevada,37,North Carolina,139,Pasquotank County,0,48,-48
32,Nevada,37,North Carolina,155,Robeson County,0,68,-68
32,Nevada,37,North Carolina,159,Rowan County,0,9,-9
32,Nevada,37,North Carolina,161,Rutherford County,0,3,-3
32,Nevada,37,North Carolina,171,Surry County,0,4,-4
32,Nevada,37,North Carolina,179,Union County,38,0,38
32,Nevada,37,North Carolina,183,Wake County,184,251,-67
32,Nevada,37,North Carolina,185,Warren County,10,0,10
32,Nevada,37,North Carolina,191,Wayne County,252,6,246
32,Nevada,38,North Dakota,11,Bowman County,0,1,-1
32,Nevada,38,North Dakota,15,Burleigh County,7,20,-13
32,Nevada,38,North Dakota,17,Cass County,42,62,-20
32,Nevada,38,North Dakota,35,Grand Forks County,49,5,44
32,Nevada,38,North Dakota,59,Morton County,0,17,-17
32,Nevada,38,North Dakota,61,Mountrail County,0,21,-21
32,Nevada,38,North Dakota,63,Nelson County,0,1,-1
32,Nevada,38,North Dakota,71,Ramsey County,0,4,-4
32,Nevada,38,North Dakota,85,Sioux County,3,0,3
32,Nevada,38,North Dakota,89,Stark County,17,2,15
32,Nevada,38,North Dakota,93,Stutsman County,0,64,-64
32,Nevada,38,North Dakota,101,Ward County,26,54,-28
32,Nevada,38,North Dakota,103,Wells County,0,1,-1
32,Nevada,38,North Dakota,105,Williams County,38,0,38
32,Nevada,39,Ohio,9,Athens County,15,0,15
32,Nevada,39,Ohio,17,Butler County,127,28,99
32,Nevada,39,Ohio,25,Clermont County,54,0,54
32,Nevada,39,Ohio,27,Clinton County,0,8,-8
32,Nevada,39,Ohio,35,Cuyahoga County,599,243,356
32,Nevada,39,Ohio,39,Defiance County,0,19,-19
32,Nevada,39,Ohio,41,Delaware County,18,112,-94
32,Nevada,39,Ohio,43,Erie County,0,15,-15
32,Nevada,39,Ohio,49,Franklin County,74,178,-104
32,Nevada,39,Ohio,51,Fulton County,0,10,-10
32,Nevada,39,Ohio,55,Geauga County,21,12,9
32,Nevada,39,Ohio,57,Greene County,0,55,-55
32,Nevada,39,Ohio,61,Hamilton County,13,39,-26
32,Nevada,39,Ohio,69,Henry County,0,12,-12
32,Nevada,39,Ohio,75,Holmes County,0,2,-2
32,Nevada,39,Ohio,81,Jefferson County,0,23,-23
32,Nevada,39,Ohio,83,Knox County,0,5,-5
32,Nevada,39,Ohio,85,Lake County,65,0,65
32,Nevada,39,Ohio,89,Licking County,0,60,-60
32,Nevada,39,Ohio,93,Lorain County,39,71,-32
32,Nevada,39,Ohio,95,Lucas County,66,53,13
32,Nevada,39,Ohio,99,Mahoning County,84,37,47
32,Nevada,39,Ohio,101,Marion County,0,58,-58
32,Nevada,39,Ohio,113,Montgomery County,26,69,-43
32,Nevada,39,Ohio,119,Muskingum County,31,6,25
32,Nevada,39,Ohio,133,Portage County,0,31,-31
32,Nevada,39,Ohio,137,Putnam County,7,0,7
32,Nevada,39,Ohio,139,Richland County,0,67,-67
32,Nevada,39,Ohio,143,Sandusky County,57,0,57
32,Nevada,39,Ohio,151,Stark County,196,20,176
32,Nevada,39,Ohio,153,Summit County,71,59,12
32,Nevada,39,Ohio,155,Trumbull County,62,25,37
32,Nevada,39,Ohio,157,Tuscarawas County,0,10,-10
32,Nevada,39,Ohio,167,Washington County,0,40,-40
32,Nevada,39,Ohio,171,Williams County,0,7,-7
32,Nevada,39,Ohio,173,Wood County,0,91,-91
32,Nevada,4,Arizona,1,Apache County,20,5,15
32,Nevada,4,Arizona,3,Cochise County,185,70,115
32,Nevada,4,Arizona,5,Coconino County,159,199,-40
32,Nevada,4,Arizona,7,Gila County,0,160,-160
32,Nevada,4,Arizona,9,Graham County,18,68,-50
32,Nevada,4,Arizona,12,La Paz County,85,12,73
32,Nevada,4,Arizona,13,Maricopa County,2758,3537,-779
32,Nevada,4,Arizona,15,Mohave County,1173,1866,-693
32,Nevada,4,Arizona,17,Navajo County,183,62,121
32,Nevada,4,Arizona,19,Pima County,716,767,-51
32,Nevada,4,Arizona,21,Pinal County,113,267,-154
32,Nevada,4,Arizona,23,Santa Cruz County,0,3,-3
32,Nevada,4,Arizona,25,Yavapai County,273,314,-41
32,Nevada,4,Arizona,27,Yuma County,165,184,-19
32,Nevada,40,Oklahoma,19,Carter County,0,15,-15
32,Nevada,40,Oklahoma,21,Cherokee County,3,3,0
32,Nevada,40,Oklahoma,27,Cleveland County,58,57,1
32,Nevada,40,Oklahoma,31,Comanche County,0,70,-70
32,Nevada,40,Oklahoma,35,Craig County,0,4,-4
32,Nevada,40,Oklahoma,39,Custer County,4,9,-5
32,Nevada,40,Oklahoma,41,Delaware County,0,8,-8
32,Nevada,40,Oklahoma,47,Garfield County,0,13,-13
32,Nevada,40,Oklahoma,51,Grady County,9,5,4
32,Nevada,40,Oklahoma,65,Jackson County,0,24,-24
32,Nevada,40,Oklahoma,71,Kay County,0,22,-22
32,Nevada,40,Oklahoma,81,Lincoln County,17,24,-7
32,Nevada,40,Oklahoma,83,Logan County,6,82,-76
32,Nevada,40,Oklahoma,87,McClain County,47,4,43
32,Nevada,40,Oklahoma,109,Oklahoma County,169,209,-40
32,Nevada,40,Oklahoma,119,Payne County,34,3,31
32,Nevada,40,Oklahoma,131,Rogers County,9,13,-4
32,Nevada,40,Oklahoma,135,Sequoyah County,0,5,-5
32,Nevada,40,Oklahoma,139,Texas County,15,0,15
32,Nevada,40,Oklahoma,143,Tulsa County,103,229,-126
32,Nevada,40,Oklahoma,145,Wagoner County,0,11,-11
32,Nevada,40,Oklahoma,147,Washington County,15,0,15
32,Nevada,40,Oklahoma,149,Washita County,0,20,-20
32,Nevada,40,Oklahoma,153,Woodward County,15,0,15
32,Nevada,41,Oregon,1,Baker County,0,16,-16
32,Nevada,41,Oregon,3,Benton County,74,67,7
32,Nevada,41,Oregon,5,Clackamas County,167,85,82
32,Nevada,41,Oregon,7,Clatsop County,0,141,-141
32,Nevada,41,Oregon,9,Columbia County,0,3,-3
32,Nevada,41,Oregon,11,Coos County,11,101,-90
32,Nevada,41,Oregon,13,Crook County,10,0,10
32,Nevada,41,Oregon,15,Curry County,0,27,-27
32,Nevada,41,Oregon,17,Deschutes County,184,104,80
32,Nevada,41,Oregon,19,Douglas County,60,60,0
32,Nevada,41,Oregon,23,Grant County,0,18,-18
32,Nevada,41,Oregon,25,Harney County,16,7,9
32,Nevada,41,Oregon,27,Hood River County,4,9,-5
32,Nevada,41,Oregon,29,Jackson County,240,240,0
32,Nevada,41,Oregon,31,Jefferson County,4,0,4
32,Nevada,41,Oregon,33,Josephine County,100,9,91
32,Nevada,41,Oregon,35,Klamath County,50,22,28
32,Nevada,41,Oregon,37,Lake County,0,7,-7
32,Nevada,41,Oregon,39,Lane County,282,175,107
32,Nevada,41,Oregon,41,Lincoln County,0,93,-93
32,Nevada,41,Oregon,43,Linn County,42,61,-19
32,Nevada,41,Oregon,45,Malheur County,88,21,67
32,Nevada,41,Oregon,47,Marion County,212,58,154
32,Nevada,41,Oregon,49,Morrow County,7,0,7
32,Nevada,41,Oregon,51,Multnomah County,446,548,-102
32,Nevada,41,Oregon,53,Polk County,0,42,-42
32,Nevada,41,Oregon,57,Tillamook County,10,32,-22
32,Nevada,41,Oregon,59,Umatilla County,2,131,-129
32,Nevada,41,Oregon,61,Union County,72,12,60
32,Nevada,41,Oregon,63,Wallowa County,0,18,-18
32,Nevada,41,Oregon,65,Wasco County,0,35,-35
32,Nevada,41,Oregon,67,Washington County,322,401,-79
32,Nevada,41,Oregon,71,Yamhill County,101,68,33
32,Nevada,42,Pennsylvania,3,Allegheny County,321,91,230
32,Nevada,42,Pennsylvania,7,Beaver County,9,0,9
32,Nevada,42,Pennsylvania,9,Bedford County,12,0,12
32,Nevada,42,Pennsylvania,11,Berks County,38,60,-22
32,Nevada,42,Pennsylvania,17,Bucks County,0,44,-44
32,Nevada,42,Pennsylvania,19,Butler County,0,28,-28
32,Nevada,42,Pennsylvania,21,Cambria County,24,15,9
32,Nevada,42,Pennsylvania,27,Centre County,43,0,43
32,Nevada,42,Pennsylvania,29,Chester County,27,14,13
32,Nevada,42,Pennsylvania,41,Cumberland County,0,43,-43
32,Nevada,42,Pennsylvania,43,Dauphin County,53,28,25
32,Nevada,42,Pennsylvania,45,Delaware County,66,140,-74
32,Nevada,42,Pennsylvania,49,Erie County,168,67,101
32,Nevada,42,Pennsylvania,53,Forest County,29,0,29
32,Nevada,42,Pennsylvania,63,Indiana County,57,0,57
32,Nevada,42,Pennsylvania,71,Lancaster County,0,22,-22
32,Nevada,42,Pennsylvania,75,Lebanon County,0,14,-14
32,Nevada,42,Pennsylvania,77,Lehigh County,59,0,59
32,Nevada,42,Pennsylvania,79,Luzerne County,20,4,16
32,Nevada,42,Pennsylvania,89,Monroe County,9,0,9
32,Nevada,42,Pennsylvania,91,Montgomery County,151,76,75
32,Nevada,42,Pennsylvania,99,Perry County,0,3,-3
32,Nevada,42,Pennsylvania,101,Philadelphia County,207,235,-28
32,Nevada,42,Pennsylvania,103,Pike County,109,0,109
32,Nevada,42,Pennsylvania,107,Schuylkill County,13,0,13
32,Nevada,42,Pennsylvania,109,Snyder County,4,0,4
32,Nevada,42,Pennsylvania,111,Somerset County,32,3,29
32,Nevada,42,Pennsylvania,121,Venango County,0,8,-8
32,Nevada,42,Pennsylvania,127,Wayne County,38,7,31
32,Nevada,42,Pennsylvania,129,Westmoreland County,158,23,135
32,Nevada,42,Pennsylvania,133,York County,88,0,88
32,Nevada,44,Rhode Island,3,Kent County,9,46,-37
32,Nevada,44,Rhode Island,5,Newport County,0,3,-3
32,Nevada,44,Rhode Island,7,Providence County,99,10,89
32,Nevada,44,Rhode Island,9,Washington County,29,0,29
32,Nevada,45,South Carolina,3,Aiken County,0,33,-33
32,Nevada,45,South Carolina,7,Anderson County,17,45,-28
32,Nevada,45,South Carolina,13,Beaufort County,26,73,-47
32,Nevada,45,South Carolina,15,Berkeley County,12,122,-110
32,Nevada,45,South Carolina,19,Charleston County,129,0,129
32,Nevada,45,South Carolina,25,Chesterfield County,4,0,4
32,Nevada,45,South Carolina,35,Dorchester County,157,41,116
32,Nevada,45,South Carolina,39,Fairfield County,6,0,6
32,Nevada,45,South Carolina,45,Greenville County,22,104,-82
32,Nevada,45,South Carolina,49,Hampton County,5,0,5
32,Nevada,45,South Carolina,51,Horry County,132,15,117
32,Nevada,45,South Carolina,63,Lexington County,85,11,74
32,Nevada,45,South Carolina,77,Pickens County,10,10,0
32,Nevada,45,South Carolina,79,Richland County,307,145,162
32,Nevada,45,South Carolina,83,Spartanburg County,29,0,29
32,Nevada,45,South Carolina,85,Sumter County,36,34,2
32,Nevada,46,South Dakota,23,Charles Mix County,0,50,-50
32,Nevada,46,South Dakota,25,Clark County,0,21,-21
32,Nevada,46,South Dakota,27,Clay County,0,6,-6
32,Nevada,46,South Dakota,29,Codington County,0,7,-7
32,Nevada,46,South Dakota,33,Custer County,60,0,60
32,Nevada,46,South Dakota,41,Dewey County,0,3,-3
32,Nevada,46,South Dakota,65,Hughes County,0,11,-11
32,Nevada,46,South Dakota,77,Kingsbury County,0,1,-1
32,Nevada,46,South Dakota,79,Lake County,14,9,5
32,Nevada,46,South Dakota,81,Lawrence County,0,36,-36
32,Nevada,46,South Dakota,99,Minnehaha County,57,34,23
32,Nevada,46,South Dakota,102,Oglala Lakota County,0,12,-12
32,Nevada,46,South Dakota,103,Pennington County,411,142,269
32,Nevada,46,South Dakota,125,Turner County,0,32,-32
32,Nevada,46,South Dakota,127,Union County,15,0,15
32,Nevada,47,Tennessee,1,Anderson County,27,1,26
32,Nevada,47,Tennessee,3,Bedford County,0,5,-5
32,Nevada,47,Tennessee,9,Blount County,5,42,-37
32,Nevada,47,Tennessee,11,Bradley County,0,20,-20
32,Nevada,47,Tennessee,15,Cannon County,0,20,-20
32,Nevada,47,Tennessee,17,Carroll County,0,7,-7
32,Nevada,47,Tennessee,21,Cheatham County,24,0,24
32,Nevada,47,Tennessee,37,Davidson County,22,94,-72
32,Nevada,47,Tennessee,65,Hamilton County,158,8,150
32,Nevada,47,Tennessee,71,Hardin County,0,13,-13
32,Nevada,47,Tennessee,73,Hawkins County,0,14,-14
32,Nevada,47,Tennessee,79,Henry County,10,0,10
32,Nevada,47,Tennessee,93,Knox County,9,43,-34
32,Nevada,47,Tennessee,101,Lewis County,0,23,-23
32,Nevada,47,Tennessee,105,Loudon County,7,0,7
32,Nevada,47,Tennessee,119,Maury County,52,0,52
32,Nevada,47,Tennessee,125,Montgomery County,564,44,520
32,Nevada,47,Tennessee,141,Putnam County,0,20,-20
32,Nevada,47,Tennessee,143,Rhea County,12,0,12
32,Nevada,47,Tennessee,149,Rutherford County,52,12,40
32,Nevada,47,Tennessee,153,Sequatchie County,0,14,-14
32,Nevada,47,Tennessee,157,Shelby County,125,112,13
32,Nevada,47,Tennessee,165,Sumner County,22,0,22
32,Nevada,47,Tennessee,177,Warren County,0,81,-81
32,Nevada,47,Tennessee,179,Washington County,5,0,5
32,Nevada,47,Tennessee,187,Williamson County,0,72,-72
32,Nevada,47,Tennessee,189,Wilson County,0,8,-8
32,Nevada,48,Texas,1,Anderson County,24,0,24
32,Nevada,48,Texas,5,Angelina County,0,14,-14
32,Nevada,48,Texas,21,Bastrop County,19,3,16
32,Nevada,48,Texas,27,Bell County,177,166,11
32,Nevada,48,Texas,29,Bexar County,338,838,-500
32,Nevada,48,Texas,37,Bowie County,15,26,-11
32,Nevada,48,Texas,39,Brazoria County,55,34,21
32,Nevada,48,Texas,41,Brazos County,49,71,-22
32,Nevada,48,Texas,43,Brewster County,0,26,-26
32,Nevada,48,Texas,67,Cass County,0,51,-51
32,Nevada,48,Texas,71,Chambers County,15,0,15
32,Nevada,48,Texas,85,Collin County,174,243,-69
32,Nevada,48,Texas,89,Colorado County,16,0,16
32,Nevada,48,Texas,91,Comal County,68,50,18
32,Nevada,48,Texas,93,Comanche County,0,24,-24
32,Nevada,48,Texas,95,Concho County,0,36,-36
32,Nevada,48,Texas,97,Cooke County,0,7,-7
32,Nevada,48,Texas,99,Coryell County,48,0,48
32,Nevada,48,Texas,109,Culberson County,0,5,-5
32,Nevada,48,Texas,113,Dallas County,256,593,-337
32,Nevada,48,Texas,121,Denton County,251,373,-122
32,Nevada,48,Texas,135,Ector County,0,35,-35
32,Nevada,48,Texas,139,Ellis County,43,0,43
32,Nevada,48,Texas,141,El Paso County,388,559,-171
32,Nevada,48,Texas,153,Floyd County,0,9,-9
32,Nevada,48,Texas,157,Fort Bend County,130,444,-314
32,Nevada,48,Texas,165,Gaines County,2,0,2
32,Nevada,48,Texas,167,Galveston County,46,174,-128
32,Nevada,48,Texas,169,Garza County,0,7,-7
32,Nevada,48,Texas,181,Grayson County,0,25,-25
32,Nevada,48,Texas,183,Gregg County,12,0,12
32,Nevada,48,Texas,187,Guadalupe County,27,38,-11
32,Nevada,48,Texas,201,Harris County,771,760,11
32,Nevada,48,Texas,209,Hays County,28,19,9
32,Nevada,48,Texas,215,Hidalgo County,12,91,-79
32,Nevada,48,Texas,223,Hopkins County,0,2,-2
32,Nevada,48,Texas,225,Houston County,0,4,-4
32,Nevada,48,Texas,231,Hunt County,0,16,-16
32,Nevada,48,Texas,245,Jefferson County,0,2,-2
32,Nevada,48,Texas,251,Johnson County,91,77,14
32,Nevada,48,Texas,253,Jones County,0,5,-5
32,Nevada,48,Texas,257,Kaufman County,0,44,-44
32,Nevada,48,Texas,265,Kerr County,14,21,-7
32,Nevada,48,Texas,267,Kimble County,0,7,-7
32,Nevada,48,Texas,271,Kinney County,0,8,-8
32,Nevada,48,Texas,277,Lamar County,0,33,-33
32,Nevada,48,Texas,287,Lee County,22,0,22
32,Nevada,48,Texas,299,Llano County,0,8,-8
32,Nevada,48,Texas,303,Lubbock County,156,95,61
32,Nevada,48,Texas,309,McLennan County,59,52,7
32,Nevada,48,Texas,319,Mason County,0,80,-80
32,Nevada,48,Texas,329,Midland County,57,639,-582
32,Nevada,48,Texas,331,Milam County,26,0,26
32,Nevada,48,Texas,339,Montgomery County,149,33,116
32,Nevada,48,Texas,347,Nacogdoches County,0,12,-12
32,Nevada,48,Texas,355,Nueces County,85,88,-3
32,Nevada,48,Texas,361,Orange County,13,10,3
32,Nevada,48,Texas,367,Parker County,0,177,-177
32,Nevada,48,Texas,373,Polk County,0,7,-7
32,Nevada,48,Texas,375,Potter County,185,46,139
32,Nevada,48,Texas,379,Rains County,0,7,-7
32,Nevada,48,Texas,397,Rockwall County,0,191,-191
32,Nevada,48,Texas,423,Smith County,22,28,-6
32,Nevada,48,Texas,439,Tarrant County,101,584,-483
32,Nevada,48,Texas,441,Taylor County,0,26,-26
32,Nevada,48,Texas,445,Terry County,0,16,-16
32,Nevada,48,Texas,449,Titus County,9,0,9
32,Nevada,48,Texas,451,Tom Green County,62,60,2
32,Nevada,48,Texas,453,Travis County,307,187,120
32,Nevada,48,Texas,465,Val Verde County,10,67,-57
32,Nevada,48,Texas,467,Van Zandt County,46,75,-29
32,Nevada,48,Texas,471,Walker County,0,2,-2
32,Nevada,48,Texas,473,Waller County,82,0,82
32,Nevada,48,Texas,479,Webb County,15,18,-3
32,Nevada,48,Texas,485,Wichita County,54,102,-48
32,Nevada,48,Texas,491,Williamson County,147,252,-105
32,Nevada,48,Texas,493,Wilson County,0,33,-33
32,Nevada,48,Texas,497,Wise County,0,12,-12
32,Nevada,48,Texas,499,Wood County,0,16,-16
32,Nevada,49,Utah,3,Box Elder County,39,170,-131
32,Nevada,49,Utah,5,Cache County,134,79,55
32,Nevada,49,Utah,11,Davis County,355,246,109
32,Nevada,49,Utah,13,Duchesne County,0,12,-12
32,Nevada,49,Utah,15,Emery County,0,45,-45
32,Nevada,49,Utah,17,Garfield County,69,0,69
32,Nevada,49,Utah,19,Grand County,22,19,3
32,Nevada,49,Utah,21,Iron County,545,463,82
32,Nevada,49,Utah,23,Juab County,19,94,-75
32,Nevada,49,Utah,25,Kane County,108,29,79
32,Nevada,49,Utah,27,Millard County,0,11,-11
32,Nevada,49,Utah,33,Rich County,0,1,-1
32,Nevada,49,Utah,35,Salt Lake County,1264,1767,-503
32,Nevada,49,Utah,37,San Juan County,36,22,14
32,Nevada,49,Utah,39,Sanpete County,23,76,-53
32,Nevada,49,Utah,41,Sevier County,0,41,-41
32,Nevada,49,Utah,43,Summit County,20,30,-10
32,Nevada,49,Utah,45,Tooele County,261,171,90
32,Nevada,49,Utah,47,Uintah County,7,12,-5
32,Nevada,49,Utah,49,Utah County,942,874,68
32,Nevada,49,Utah,51,Wasatch County,28,37,-9
32,Nevada,49,Utah,53,Washington County,903,1318,-415
32,Nevada,49,Utah,57,Weber County,465,186,279
32,Nevada,5,Arkansas,5,Baxter County,176,0,176
32,Nevada,5,Arkansas,7,Benton County,9,27,-18
32,Nevada,5,Arkansas,35,Crittenden County,0,10,-10
32,Nevada,5,Arkansas,45,Faulkner County,0,50,-50
32,Nevada,5,Arkansas,51,Garland County,29,0,29
32,Nevada,5,Arkansas,53,Grant County,0,21,-21
32,Nevada,5,Arkansas,57,Hempstead County,10,0,10
32,Nevada,5,Arkansas,59,Hot Spring County,45,0,45
32,Nevada,5,Arkansas,85,Lonoke County,45,0,45
32,Nevada,5,Arkansas,89,Marion County,15,0,15
32,Nevada,5,Arkansas,93,Mississippi County,0,166,-166
32,Nevada,5,Arkansas,97,Montgomery County,65,0,65
32,Nevada,5,Arkansas,103,Ouachita County,9,0,9
32,Nevada,5,Arkansas,109,Pike County,0,8,-8
32,Nevada,5,Arkansas,115,Pope County,0,19,-19
32,Nevada,5,Arkansas,119,Pulaski County,89,41,48
32,Nevada,5,Arkansas,131,Sebastian County,0,6,-6
32,Nevada,5,Arkansas,143,Washington County,28,126,-98
32,Nevada,5,Arkansas,145,White County,6,0,6
32,Nevada,5,Arkansas,149,Yell County,0,32,-32
32,Nevada,50,Vermont,1,Addison County,6,73,-67
32,Nevada,50,Vermont,3,Bennington County,0,34,-34
32,Nevada,50,Vermont,5,Caledonia County,0,10,-10
32,Nevada,50,Vermont,7,Chittenden County,15,0,15
32,Nevada,50,Vermont,11,Franklin County,8,0,8
32,Nevada,50,Vermont,21,Rutland County,34,6,28
32,Nevada,50,Vermont,27,Windsor County,16,0,16
32,Nevada,51,Virginia,9,Amherst County,35,0,35
32,Nevada,51,Virginia,13,Arlington County,177,31,146
32,Nevada,51,Virginia,41,Chesterfield County,39,41,-2
32,Nevada,51,Virginia,59,Fairfax County,161,186,-25
32,Nevada,51,Virginia,69,Frederick County,0,32,-32
32,Nevada,51,Virginia,71,Giles County,25,0,25
32,Nevada,51,Virginia,87,Henrico County,77,0,77
32,Nevada,51,Virginia,93,Isle of Wight County,19,0,19
32,Nevada,51,Virginia,95,James City County,65,116,-51
32,Nevada,51,Virginia,107,Loudoun County,0,20,-20
32,Nevada,51,Virginia,117,Mecklenburg County,0,9,-9
32,Nevada,51,Virginia,139,Page County,62,0,62
32,Nevada,51,Virginia,143,Pittsylvania County,0,20,-20
32,Nevada,51,Virginia,149,Prince George County,0,4,-4
32,Nevada,51,Virginia,153,Prince William County,27,67,-40
32,Nevada,51,Virginia,161,Roanoke County,29,0,29
32,Nevada,51,Virginia,173,Smyth County,64,0,64
32,Nevada,51,Virginia,179,Stafford County,190,0,190
32,Nevada,51,Virginia,199,York County,37,203,-166
32,Nevada,51,Virginia,510,Alexandria city,73,92,-19
32,Nevada,51,Virginia,540,Charlottesville city,15,0,15
32,Nevada,51,Virginia,550,Chesapeake city,5,34,-29
32,Nevada,51,Virginia,590,Danville city,0,39,-39
32,Nevada,51,Virginia,630,Fredericksburg city,35,4,31
32,Nevada,51,Virginia,650,Hampton city,156,156,0
32,Nevada,51,Virginia,683,Manassas city,34,0,34
32,Nevada,51,Virginia,700,Newport News city,0,31,-31
32,Nevada,51,Virginia,710,Norfolk city,73,61,12
32,Nevada,51,Virginia,750,Radford city,28,0,28
32,Nevada,51,Virginia,760,Richmond city,11,0,11
32,Nevada,51,Virginia,800,Suffolk city,60,0,60
32,Nevada,51,Virginia,810,Virginia Beach city,109,155,-46
32,Nevada,51,Virginia,830,Williamsburg city,0,28,-28
32,Nevada,53,Washington,3,Asotin County,40,0,40
32,Nevada,53,Washington,5,Benton County,401,100,301
32,Nevada,53,Washington,7,Chelan County,27,7,20
32,Nevada,53,Washington,9,Clallam County,12,5,7
32,Nevada,53,Washington,11,Clark County,190,454,-264
32,Nevada,53,Washington,15,Cowlitz County,15,76,-61
32,Nevada,53,Washington,17,Douglas County,5,0,5
32,Nevada,53,Washington,19,Ferry County,68,30,38
32,Nevada,53,Washington,21,Franklin County,390,19,371
32,Nevada,53,Washington,25,Grant County,0,2,-2
32,Nevada,53,Washington,27,Grays Harbor County,0,47,-47
32,Nevada,53,Washington,29,Island County,56,60,-4
32,Nevada,53,Washington,31,Jefferson County,80,27,53
32,Nevada,53,Washington,33,King County,1583,1105,478
32,Nevada,53,Washington,35,Kitsap County,366,157,209
32,Nevada,53,Washington,37,Kittitas County,22,276,-254
32,Nevada,53,Washington,41,Lewis County,0,221,-221
32,Nevada,53,Washington,45,Mason County,45,12,33
32,Nevada,53,Washington,47,Okanogan County,16,0,16
32,Nevada,53,Washington,49,Pacific County,0,1,-1
32,Nevada,53,Washington,51,Pend Oreille County,0,11,-11
32,Nevada,53,Washington,53,Pierce County,558,385,173
32,Nevada,53,Washington,55,San Juan County,0,7,-7
32,Nevada,53,Washington,57,Skagit County,28,72,-44
32,Nevada,53,Washington,61,Snohomish County,784,427,357
32,Nevada,53,Washington,63,Spokane County,166,209,-43
32,Nevada,53,Washington,65,Stevens County,59,109,-50
32,Nevada,53,Washington,67,Thurston County,330,200,130
32,Nevada,53,Washington,71,Walla Walla County,21,9,12
32,Nevada,53,Washington,73,Whatcom County,144,159,-15
32,Nevada,53,Washington,75,Whitman County,98,38,60
32,Nevada,53,Washington,77,Yakima County,40,63,-23
32,Nevada,54,West Virginia,3,Berkeley County,0,4,-4
32,Nevada,54,West Virginia,15,Clay County,3,0,3
32,Nevada,54,West Virginia,23,Grant County,2,0,2
32,Nevada,54,West Virginia,25,Greenbrier County,26,0,26
32,Nevada,54,West Virginia,33,Harrison County,0,1,-1
32,Nevada,54,West Virginia,39,Kanawha County,34,36,-2
32,Nevada,54,West Virginia,47,McDowell County,6,0,6
32,Nevada,54,West Virginia,49,Marion County,2,0,2
32,Nevada,54,West Virginia,61,Monongalia County,62,0,62
32,Nevada,54,West Virginia,77,Preston County,0,2,-2
32,Nevada,54,West Virginia,79,Putnam County,16,0,16
32,Nevada,54,West Virginia,81,Raleigh County,30,8,22
32,Nevada,55,Wisconsin,1,Adams County,10,0,10
32,Nevada,55,Wisconsin,9,Brown County,0,2,-2
32,Nevada,55,Wisconsin,17,Chippewa County,14,6,8
32,Nevada,55,Wisconsin,25,Dane County,104,41,63
32,Nevada,55,Wisconsin,29,Door County,0,2,-2
32,Nevada,55,Wisconsin,35,Eau Claire County,189,0,189
32,Nevada,55,Wisconsin,39,Fond du Lac County,0,11,-11
32,Nevada,55,Wisconsin,43,Grant County,49,0,49
32,Nevada,55,Wisconsin,55,Jefferson County,52,0,52
32,Nevada,55,Wisconsin,57,Juneau County,0,27,-27
32,Nevada,55,Wisconsin,63,La Crosse County,25,54,-29
32,Nevada,55,Wisconsin,67,Langlade County,0,34,-34
32,Nevada,55,Wisconsin,71,Manitowoc County,0,78,-78
32,Nevada,55,Wisconsin,73,Marathon County,109,11,98
32,Nevada,55,Wisconsin,77,Marquette County,0,2,-2
32,Nevada,55,Wisconsin,79,Milwaukee County,81,78,3
32,Nevada,55,Wisconsin,81,Monroe County,0,46,-46
32,Nevada,55,Wisconsin,83,Oconto County,0,5,-5
32,Nevada,55,Wisconsin,85,Oneida County,0,9,-9
32,Nevada,55,Wisconsin,95,Polk County,0,4,-4
32,Nevada,55,Wisconsin,101,Racine County,28,46,-18
32,Nevada,55,Wisconsin,107,Rusk County,7,0,7
32,Nevada,55,Wisconsin,109,St. Croix County,11,77,-66
32,Nevada,55,Wisconsin,111,Sauk County,0,4,-4
32,Nevada,55,Wisconsin,113,Sawyer County,39,0,39
32,Nevada,55,Wisconsin,115,Shawano County,0,2,-2
32,Nevada,55,Wisconsin,117,Sheboygan County,55,43,12
32,Nevada,55,Wisconsin,119,Taylor County,0,1,-1
32,Nevada,55,Wisconsin,121,Trempealeau County,13,19,-6
32,Nevada,55,Wisconsin,125,Vilas County,0,2,-2
32,Nevada,55,Wisconsin,127,Walworth County,9,0,9
32,Nevada,55,Wisconsin,129,Washburn County,7,0,7
32,Nevada,55,Wisconsin,131,Washington County,0,11,-11
32,Nevada,55,Wisconsin,133,Waukesha County,92,159,-67
32,Nevada,55,Wisconsin,137,Waushara County,0,11,-11
32,Nevada,55,Wisconsin,139,Winnebago County,38,9,29
32,Nevada,55,Wisconsin,141,Wood County,0,12,-12
32,Nevada,56,Wyoming,1,Albany County,26,52,-26
32,Nevada,56,Wyoming,5,Campbell County,355,66,289
32,Nevada,56,Wyoming,7,Carbon County,0,11,-11
32,Nevada,56,Wyoming,9,Converse County,7,0,7
32,Nevada,56,Wyoming,13,Fremont County,8,25,-17
32,Nevada,56,Wyoming,17,Hot Springs County,30,0,30
32,Nevada,56,Wyoming,21,Laramie County,27,2,25
32,Nevada,56,Wyoming,23,Lincoln County,34,0,34
32,Nevada,56,Wyoming,25,Natrona County,81,27,54
32,Nevada,56,Wyoming,29,Park County,10,5,5
32,Nevada,56,Wyoming,31,Platte County,0,7,-7
32,Nevada,56,Wyoming,33,Sheridan County,0,13,-13
32,Nevada,56,Wyoming,35,Sublette County,39,0,39
32,Nevada,56,Wyoming,37,Sweetwater County,65,11,54
32,Nevada,56,Wyoming,39,Teton County,40,124,-84
32,Nevada,56,Wyoming,41,Uinta County,19,0,19
32,Nevada,56,Wyoming,45,Weston County,17,3,14
32,Nevada,6,California,1,Alameda County,1284,796,488
32,Nevada,6,California,3,Alpine County,5,16,-11
32,Nevada,6,California,5,Amador County,43,9,34
32,Nevada,6,California,7,Butte County,370,278,92
32,Nevada,6,California,9,Calaveras County,32,21,11
32,Nevada,6,California,13,Contra Costa County,1576,638,938
32,Nevada,6,California,15,Del Norte County,47,4,43
32,Nevada,6,California,17,El Dorado County,1089,803,286
32,Nevada,6,California,19,Fresno County,726,318,408
32,Nevada,6,California,21,Glenn County,0,14,-14
32,Nevada,6,California,23,Humboldt County,170,60,110
32,Nevada,6,California,25,Imperial County,0,227,-227
32,Nevada,6,California,27,Inyo County,152,79,73
32,Nevada,6,California,29,Kern County,1124,403,721
32,Nevada,6,California,31,Kings County,138,19,119
32,Nevada,6,California,33,Lake County,164,41,123
32,Nevada,6,California,35,Lassen County,220,114,106
32,Nevada,6,California,37,Los Angeles County,15369,5279,10090
32,Nevada,6,California,39,Madera County,101,0,101
32,Nevada,6,California,41,Marin County,180,101,79
32,Nevada,6,California,43,Mariposa County,96,54,42
32,Nevada,6,California,45,Mendocino County,36,761,-725
32,Nevada,6,California,47,Merced County,342,118,224
32,Nevada,6,California,49,Modoc County,71,16,55
32,Nevada,6,California,51,Mono County,245,35,210
32,Nevada,6,California,53,Monterey County,312,270,42
32,Nevada,6,California,55,Napa County,66,82,-16
32,Nevada,6,California,57,Nevada County,536,56,480
32,Nevada,6,California,59,Orange County,2582,1990,592
32,Nevada,6,California,61,Placer County,1032,613,419
32,Nevada,6,California,63,Plumas County,125,71,54
32,Nevada,6,California,65,Riverside County,2574,2379,195
32,Nevada,6,California,67,Sacramento County,1833,1433,400
32,Nevada,6,California,69,San Benito County,31,7,24
32,Nevada,6,California,71,San Bernardino County,3248,2160,1088
32,Nevada,6,California,73,San Diego County,4043,2539,1504
32,Nevada,6,California,75,San Francisco County,578,503,75
32,Nevada,6,California,77,San Joaquin County,983,462,521
32,Nevada,6,California,79,San Luis Obispo County,277,233,44
32,Nevada,6,California,81,San Mateo County,655,219,436
32,Nevada,6,California,83,Santa Barbara County,334,258,76
32,Nevada,6,California,85,Santa Clara County,1913,553,1360
32,Nevada,6,California,87,Santa Cruz County,163,48,115
32,Nevada,6,California,89,Shasta County,370,405,-35
32,Nevada,6,California,91,Sierra County,71,8,63
32,Nevada,6,California,93,Siskiyou County,3,35,-32
32,Nevada,6,California,95,Solano County,327,213,114
32,Nevada,6,California,97,Sonoma County,373,260,113
32,Nevada,6,California,99,Stanislaus County,544,491,53
32,Nevada,6,California,101,Sutter County,136,66,70
32,Nevada,6,California,103,Tehama County,100,22,78
32,Nevada,6,California,105,Trinity County,50,1,49
32,Nevada,6,California,107,Tulare County,433,434,-1
32,Nevada,6,California,109,Tuolumne County,125,68,57
32,Nevada,6,California,111,Ventura County,967,496,471
32,Nevada,6,California,113,Yolo County,73,304,-231
32,Nevada,6,California,115,Yuba County,180,294,-114
32,Nevada,72,Puerto Rico,5,Aguadilla Municipio,62,0,62
32,Nevada,72,Puerto Rico,21,Bayamón Municipio,13,0,13
32,Nevada,72,Puerto Rico,31,Carolina Municipio,55,0,55
32,Nevada,72,Puerto Rico,75,Juana Díaz Municipio,37,0,37
32,Nevada,72,Puerto Rico,119,Río Grande Municipio,168,0,168
32,Nevada,72,Puerto Rico,127,San Juan Municipio,65,0,65
32,Nevada,8,Colorado,1,Adams County,168,137,31
32,Nevada,8,Colorado,3,Alamosa County,21,17,4
32,Nevada,8,Colorado,5,Arapahoe County,565,291,274
32,Nevada,8,Colorado,9,Baca County,0,5,-5
32,Nevada,8,Colorado,13,Boulder County,49,29,20
32,Nevada,8,Colorado,14,Broomfield County,7,127,-120
32,Nevada,8,Colorado,15,Chaffee County,8,0,8
32,Nevada,8,Colorado,19,Clear Creek County,0,10,-10
32,Nevada,8,Colorado,25,Crowley County,19,0,19
32,Nevada,8,Colorado,31,Denver County,627,397,230
32,Nevada,8,Colorado,35,Douglas County,270,371,-101
32,Nevada,8,Colorado,37,Eagle County,0,22,-22
32,Nevada,8,Colorado,41,El Paso County,340,681,-341
32,Nevada,8,Colorado,43,Fremont County,2,22,-20
32,Nevada,8,Colorado,45,Garfield County,19,0,19
32,Nevada,8,Colorado,47,Gilpin County,91,0,91
32,Nevada,8,Colorado,55,Huerfano County,19,10,9
32,Nevada,8,Colorado,59,Jefferson County,569,308,261
32,Nevada,8,Colorado,65,Lake County,104,31,73
32,Nevada,8,Colorado,67,La Plata County,19,60,-41
32,Nevada,8,Colorado,69,Larimer County,136,141,-5
32,Nevada,8,Colorado,71,Las Animas County,11,0,11
32,Nevada,8,Colorado,77,Mesa County,228,219,9
32,Nevada,8,Colorado,81,Moffat County,13,0,13
32,Nevada,8,Colorado,83,Montezuma County,18,61,-43
32,Nevada,8,Colorado,85,Montrose County,4,47,-43
32,Nevada,8,Colorado,87,Morgan County,0,54,-54
32,Nevada,8,Colorado,89,Otero County,13,7,6
32,Nevada,8,Colorado,91,Ouray County,0,4,-4
32,Nevada,8,Colorado,93,Park County,0,10,-10
32,Nevada,8,Colorado,99,Prowers County,9,0,9
32,Nevada,8,Colorado,101,Pueblo County,171,194,-23
32,Nevada,8,Colorado,103,Rio Blanco County,0,6,-6
32,Nevada,8,Colorado,107,Routt County,77,42,35
32,Nevada,8,Colorado,113,San Miguel County,16,0,16
32,Nevada,8,Colorado,117,Summit County,16,0,16
32,Nevada,8,Colorado,119,Teller County,18,26,-8
32,Nevada,8,Colorado,123,Weld County,141,177,-36
32,Nevada,8,Colorado,125,Yuma County,0,3,-3
32,Nevada,9,Connecticut,1,Fairfield County,389,86,303
32,Nevada,9,Connecticut,3,Hartford County,136,65,71
32,Nevada,9,Connecticut,5,Litchfield County,43,0,43
32,Nevada,9,Connecticut,7,Middlesex County,14,6,8
32,Nevada,9,Connecticut,9,New Haven County,143,43,100
32,Nevada,9,Connecticut,11,New London County,15,28,-13
32,Nevada,9,Connecticut,13,Tolland County,16,0,16
32,Nevada,AFR,Africa,,-,757,0,0
32,Nevada,ASI,Asia,,-,6121,0,0
32,Nevada,CAM,Central America,,-,2589,0,0
32,Nevada,CAR,Caribbean,,-,1181,0,0
32,Nevada,EUR,Europe,,-,2430,0,0
32,Nevada,ISL,U.S. Island Areas,,-,519,0,0
32,Nevada,NAM,Northern America,,-,636,0,0
32,Nevada,OCE,Oceania and At Sea,,-,488,0,0
32,Nevada,SAM,South America,,-,1196,0,0
33,New Hampshire,1,Alabama,7,Bibb County,19,0,19
33,New Hampshire,1,Alabama,31,Coffee County,0,59,-59
33,New Hampshire,1,Alabama,43,Cullman County,0,11,-11
33,New Hampshire,1,Alabama,69,Houston County,0,3,-3
33,New Hampshire,1,Alabama,81,Lee County,16,0,16
33,New Hampshire,1,Alabama,89,Madison County,43,0,43
33,New Hampshire,1,Alabama,97,Mobile County,0,34,-34
33,New Hampshire,1,Alabama,103,Morgan County,0,9,-9
33,New Hampshire,1,Alabama,113,Russell County,0,12,-12
33,New Hampshire,1,Alabama,117,Shelby County,22,0,22
33,New Hampshire,1,Alabama,125,Tuscaloosa County,15,22,-7
33,New Hampshire,10,Delaware,1,Kent County,0,88,-88
33,New Hampshire,10,Delaware,3,New Castle County,42,9,33
33,New Hampshire,10,Delaware,5,Sussex County,0,12,-12
33,New Hampshire,11,District of Columbia,1,District of Columbia,149,82,67
33,New Hampshire,12,Florida,1,Alachua County,0,15,-15
33,New Hampshire,12,Florida,3,Baker County,0,12,-12
33,New Hampshire,12,Florida,5,Bay County,0,8,-8
33,New Hampshire,12,Florida,9,Brevard County,86,194,-108
33,New Hampshire,12,Florida,11,Broward County,253,162,91
33,New Hampshire,12,Florida,15,Charlotte County,109,180,-71
33,New Hampshire,12,Florida,17,Citrus County,106,159,-53
33,New Hampshire,12,Florida,19,Clay County,22,29,-7
33,New Hampshire,12,Florida,21,Collier County,139,452,-313
33,New Hampshire,12,Florida,27,DeSoto County,86,41,45
33,New Hampshire,12,Florida,31,Duval County,169,195,-26
33,New Hampshire,12,Florida,33,Escambia County,6,107,-101
33,New Hampshire,12,Florida,35,Flagler County,41,0,41
33,New Hampshire,12,Florida,37,Franklin County,0,65,-65
33,New Hampshire,12,Florida,53,Hernando County,83,149,-66
33,New Hampshire,12,Florida,55,Highlands County,11,9,2
33,New Hampshire,12,Florida,57,Hillsborough County,16,205,-189
33,New Hampshire,12,Florida,61,Indian River County,11,0,11
33,New Hampshire,12,Florida,63,Jackson County,0,16,-16
33,New Hampshire,12,Florida,67,Lafayette County,0,4,-4
33,New Hampshire,12,Florida,69,Lake County,2,215,-213
33,New Hampshire,12,Florida,71,Lee County,194,296,-102
33,New Hampshire,12,Florida,73,Leon County,18,0,18
33,New Hampshire,12,Florida,81,Manatee County,20,129,-109
33,New Hampshire,12,Florida,83,Marion County,28,58,-30
33,New Hampshire,12,Florida,85,Martin County,26,37,-11
33,New Hampshire,12,Florida,86,Miami-Dade County,47,54,-7
33,New Hampshire,12,Florida,87,Monroe County,6,0,6
33,New Hampshire,12,Florida,89,Nassau County,13,0,13
33,New Hampshire,12,Florida,91,Okaloosa County,0,65,-65
33,New Hampshire,12,Florida,95,Orange County,143,434,-291
33,New Hampshire,12,Florida,97,Osceola County,2,0,2
33,New Hampshire,12,Florida,99,Palm Beach County,90,446,-356
33,New Hampshire,12,Florida,101,Pasco County,17,227,-210
33,New Hampshire,12,Florida,103,Pinellas County,151,162,-11
33,New Hampshire,12,Florida,105,Polk County,43,315,-272
33,New Hampshire,12,Florida,107,Putnam County,0,31,-31
33,New Hampshire,12,Florida,111,St. Lucie County,133,111,22
33,New Hampshire,12,Florida,113,Santa Rosa County,22,0,22
33,New Hampshire,12,Florida,115,Sarasota County,134,178,-44
33,New Hampshire,12,Florida,117,Seminole County,25,17,8
33,New Hampshire,12,Florida,119,Sumter County,39,224,-185
33,New Hampshire,12,Florida,127,Volusia County,71,0,71
33,New Hampshire,12,Florida,131,Walton County,13,0,13
33,New Hampshire,13,Georgia,21,Bibb County,16,0,16
33,New Hampshire,13,Georgia,39,Camden County,25,25,0
33,New Hampshire,13,Georgia,51,Chatham County,33,223,-190
33,New Hampshire,13,Georgia,53,Chattahoochee County,45,3,42
33,New Hampshire,13,Georgia,57,Cherokee County,55,0,55
33,New Hampshire,13,Georgia,67,Cobb County,38,0,38
33,New Hampshire,13,Georgia,75,Cook County,0,16,-16
33,New Hampshire,13,Georgia,87,Decatur County,0,17,-17
33,New Hampshire,13,Georgia,89,DeKalb County,0,8,-8
33,New Hampshire,13,Georgia,97,Douglas County,2,0,2
33,New Hampshire,13,Georgia,115,Floyd County,0,18,-18
33,New Hampshire,13,Georgia,117,Forsyth County,0,54,-54
33,New Hampshire,13,Georgia,121,Fulton County,40,58,-18
33,New Hampshire,13,Georgia,135,Gwinnett County,14,0,14
33,New Hampshire,13,Georgia,139,Hall County,47,14,33
33,New Hampshire,13,Georgia,163,Jefferson County,0,30,-30
33,New Hampshire,13,Georgia,173,Lanier County,41,0,41
33,New Hampshire,13,Georgia,175,Laurens County,0,8,-8
33,New Hampshire,13,Georgia,179,Liberty County,20,0,20
33,New Hampshire,13,Georgia,185,Lowndes County,40,0,40
33,New Hampshire,13,Georgia,215,Muscogee County,0,7,-7
33,New Hampshire,13,Georgia,221,Oglethorpe County,0,15,-15
33,New Hampshire,13,Georgia,223,Paulding County,0,3,-3
33,New Hampshire,13,Georgia,231,Pike County,0,2,-2
33,New Hampshire,13,Georgia,245,Richmond County,0,56,-56
33,New Hampshire,13,Georgia,247,Rockdale County,0,8,-8
33,New Hampshire,13,Georgia,265,Taliaferro County,10,0,10
33,New Hampshire,13,Georgia,271,Telfair County,17,0,17
33,New Hampshire,13,Georgia,281,Towns County,0,7,-7
33,New Hampshire,13,Georgia,293,Upson County,0,8,-8
33,New Hampshire,15,Hawaii,1,Hawaii County,18,13,5
33,New Hampshire,15,Hawaii,3,Honolulu County,117,21,96
33,New Hampshire,16,Idaho,3,Adams County,0,8,-8
33,New Hampshire,16,Idaho,19,Bonneville County,28,0,28
33,New Hampshire,16,Idaho,37,Custer County,0,2,-2
33,New Hampshire,16,Idaho,83,Twin Falls County,0,35,-35
33,New Hampshire,17,Illinois,5,Bond County,2,0,2
33,New Hampshire,17,Illinois,19,Champaign County,0,6,-6
33,New Hampshire,17,Illinois,27,Clinton County,2,0,2
33,New Hampshire,17,Illinois,31,Cook County,309,179,130
33,New Hampshire,17,Illinois,41,Douglas County,0,10,-10
33,New Hampshire,17,Illinois,43,DuPage County,6,29,-23
33,New Hampshire,17,Illinois,77,Jackson County,0,11,-11
33,New Hampshire,17,Illinois,93,Kendall County,26,0,26
33,New Hampshire,17,Illinois,97,Lake County,138,0,138
33,New Hampshire,17,Illinois,105,Livingston County,34,0,34
33,New Hampshire,17,Illinois,111,McHenry County,25,9,16
33,New Hampshire,17,Illinois,113,McLean County,0,9,-9
33,New Hampshire,17,Illinois,119,Madison County,7,27,-20
33,New Hampshire,17,Illinois,161,Rock Island County,39,0,39
33,New Hampshire,17,Illinois,163,St. Clair County,0,29,-29
33,New Hampshire,17,Illinois,167,Sangamon County,0,13,-13
33,New Hampshire,17,Illinois,197,Will County,20,0,20
33,New Hampshire,18,Indiana,3,Allen County,0,13,-13
33,New Hampshire,18,Indiana,35,Delaware County,2,0,2
33,New Hampshire,18,Indiana,39,Elkhart County,33,20,13
33,New Hampshire,18,Indiana,43,Floyd County,20,0,20
33,New Hampshire,18,Indiana,57,Hamilton County,31,119,-88
33,New Hampshire,18,Indiana,59,Hancock County,12,0,12
33,New Hampshire,18,Indiana,63,Hendricks County,40,0,40
33,New Hampshire,18,Indiana,81,Johnson County,8,0,8
33,New Hampshire,18,Indiana,85,Kosciusko County,148,0,148
33,New Hampshire,18,Indiana,97,Marion County,29,31,-2
33,New Hampshire,18,Indiana,99,Marshall County,10,8,2
33,New Hampshire,18,Indiana,105,Monroe County,0,31,-31
33,New Hampshire,18,Indiana,141,St. Joseph County,0,60,-60
33,New Hampshire,18,Indiana,157,Tippecanoe County,13,0,13
33,New Hampshire,18,Indiana,163,Vanderburgh County,3,6,-3
33,New Hampshire,18,Indiana,167,Vigo County,0,11,-11
33,New Hampshire,18,Indiana,177,Wayne County,3,7,-4
33,New Hampshire,19,Iowa,13,Black Hawk County,6,0,6
33,New Hampshire,19,Iowa,61,Dubuque County,15,4,11
33,New Hampshire,19,Iowa,87,Henry County,0,3,-3
33,New Hampshire,19,Iowa,103,Johnson County,44,0,44
33,New Hampshire,19,Iowa,113,Linn County,0,24,-24
33,New Hampshire,19,Iowa,153,Polk County,19,34,-15
33,New Hampshire,19,Iowa,169,Story County,0,9,-9
33,New Hampshire,2,Alaska,16,Aleutians West Census Area,0,1,-1
33,New Hampshire,2,Alaska,20,Anchorage Municipality,137,7,130
33,New Hampshire,2,Alaska,90,Fairbanks North Star Borough,5,28,-23
33,New Hampshire,2,Alaska,110,Juneau City and Borough,46,9,37
33,New Hampshire,2,Alaska,122,Kenai Peninsula Borough,0,66,-66
33,New Hampshire,2,Alaska,170,Matanuska-Susitna Borough,77,0,77
33,New Hampshire,2,Alaska,261,Valdez-Cordova Census Area,21,0,21
33,New Hampshire,20,Kansas,11,Bourbon County,4,0,4
33,New Hampshire,20,Kansas,45,Douglas County,5,0,5
33,New Hampshire,20,Kansas,51,Ellis County,0,63,-63
33,New Hampshire,20,Kansas,61,Geary County,0,9,-9
33,New Hampshire,20,Kansas,135,Ness County,0,2,-2
33,New Hampshire,20,Kansas,157,Republic County,0,4,-4
33,New Hampshire,20,Kansas,173,Sedgwick County,118,73,45
33,New Hampshire,20,Kansas,177,Shawnee County,23,0,23
33,New Hampshire,21,Kentucky,19,Boyd County,0,3,-3
33,New Hampshire,21,Kentucky,21,Boyle County,0,18,-18
33,New Hampshire,21,Kentucky,47,Christian County,50,9,41
33,New Hampshire,21,Kentucky,67,Fayette County,33,0,33
33,New Hampshire,21,Kentucky,73,Franklin County,6,13,-7
33,New Hampshire,21,Kentucky,87,Green County,115,0,115
33,New Hampshire,21,Kentucky,93,Hardin County,0,43,-43
33,New Hampshire,21,Kentucky,111,Jefferson County,0,49,-49
33,New Hampshire,21,Kentucky,151,Madison County,0,1,-1
33,New Hampshire,21,Kentucky,211,Shelby County,0,82,-82
33,New Hampshire,21,Kentucky,215,Spencer County,0,114,-114
33,New Hampshire,21,Kentucky,227,Warren County,3,0,3
33,New Hampshire,22,Louisiana,3,Allen Parish,0,30,-30
33,New Hampshire,22,Louisiana,33,East Baton Rouge Parish,175,0,175
33,New Hampshire,22,Louisiana,51,Jefferson Parish,17,0,17
33,New Hampshire,22,Louisiana,63,Livingston Parish,5,0,5
33,New Hampshire,22,Louisiana,71,Orleans Parish,0,40,-40
33,New Hampshire,22,Louisiana,79,Rapides Parish,12,0,12
33,New Hampshire,22,Louisiana,87,St. Bernard Parish,0,55,-55
33,New Hampshire,22,Louisiana,103,St. Tammany Parish,0,22,-22
33,New Hampshire,22,Louisiana,115,Vernon Parish,0,46,-46
33,New Hampshire,23,Maine,1,Androscoggin County,227,165,62
33,New Hampshire,23,Maine,3,Aroostook County,42,54,-12
33,New Hampshire,23,Maine,5,Cumberland County,572,712,-140
33,New Hampshire,23,Maine,7,Franklin County,7,88,-81
33,New Hampshire,23,Maine,9,Hancock County,164,95,69
33,New Hampshire,23,Maine,11,Kennebec County,175,232,-57
33,New Hampshire,23,Maine,13,Knox County,63,36,27
33,New Hampshire,23,Maine,15,Lincoln County,0,77,-77
33,New Hampshire,23,Maine,17,Oxford County,249,358,-109
33,New Hampshire,23,Maine,19,Penobscot County,565,512,53
33,New Hampshire,23,Maine,21,Piscataquis County,102,17,85
33,New Hampshire,23,Maine,23,Sagadahoc County,37,74,-37
33,New Hampshire,23,Maine,25,Somerset County,2,40,-38
33,New Hampshire,23,Maine,27,Waldo County,6,44,-38
33,New Hampshire,23,Maine,29,Washington County,0,37,-37
33,New Hampshire,23,Maine,31,York County,1610,1888,-278
33,New Hampshire,24,Maryland,3,Anne Arundel County,100,40,60
33,New Hampshire,24,Maryland,5,Baltimore County,63,22,41
33,New Hampshire,24,Maryland,21,Frederick County,9,13,-4
33,New Hampshire,24,Maryland,25,Harford County,0,8,-8
33,New Hampshire,24,Maryland,27,Howard County,31,74,-43
33,New Hampshire,24,Maryland,31,Montgomery County,282,69,213
33,New Hampshire,24,Maryland,33,Prince George's County,60,13,47
33,New Hampshire,24,Maryland,37,St. Mary's County,16,0,16
33,New Hampshire,24,Maryland,41,Talbot County,6,0,6
33,New Hampshire,24,Maryland,510,Baltimore city,134,43,91
33,New Hampshire,25,Massachusetts,1,Barnstable County,158,127,31
33,New Hampshire,25,Massachusetts,3,Berkshire County,84,266,-182
33,New Hampshire,25,Massachusetts,5,Bristol County,299,293,6
33,New Hampshire,25,Massachusetts,7,Dukes County,9,0,9
33,New Hampshire,25,Massachusetts,9,Essex County,4925,2604,2321
33,New Hampshire,25,Massachusetts,11,Franklin County,113,117,-4
33,New Hampshire,25,Massachusetts,13,Hampden County,440,148,292
33,New Hampshire,25,Massachusetts,15,Hampshire County,248,274,-26
33,New Hampshire,25,Massachusetts,17,Middlesex County,7666,3833,3833
33,New Hampshire,25,Massachusetts,19,Nantucket County,0,48,-48
33,New Hampshire,25,Massachusetts,21,Norfolk County,1040,1022,18
33,New Hampshire,25,Massachusetts,23,Plymouth County,856,159,697
33,New Hampshire,25,Massachusetts,25,Suffolk County,1345,1134,211
33,New Hampshire,25,Massachusetts,27,Worcester County,1876,878,998
33,New Hampshire,26,Michigan,1,Alcona County,0,1,-1
33,New Hampshire,26,Michigan,9,Antrim County,0,11,-11
33,New Hampshire,26,Michigan,19,Benzie County,0,4,-4
33,New Hampshire,26,Michigan,21,Berrien County,25,0,25
33,New Hampshire,26,Michigan,57,Gratiot County,0,9,-9
33,New Hampshire,26,Michigan,65,Ingham County,7,22,-15
33,New Hampshire,26,Michigan,79,Kalkaska County,0,1,-1
33,New Hampshire,26,Michigan,81,Kent County,0,29,-29
33,New Hampshire,26,Michigan,91,Lenawee County,3,40,-37
33,New Hampshire,26,Michigan,99,Macomb County,22,33,-11
33,New Hampshire,26,Michigan,103,Marquette County,0,21,-21
33,New Hampshire,26,Michigan,121,Muskegon County,65,0,65
33,New Hampshire,26,Michigan,123,Newaygo County,0,13,-13
33,New Hampshire,26,Michigan,125,Oakland County,49,53,-4
33,New Hampshire,26,Michigan,127,Oceana County,18,0,18
33,New Hampshire,26,Michigan,147,St. Clair County,28,8,20
33,New Hampshire,26,Michigan,161,Washtenaw County,64,62,2
33,New Hampshire,26,Michigan,163,Wayne County,9,22,-13
33,New Hampshire,26,Michigan,165,Wexford County,6,0,6
33,New Hampshire,27,Minnesota,25,Chisago County,13,0,13
33,New Hampshire,27,Minnesota,31,Cook County,0,5,-5
33,New Hampshire,27,Minnesota,53,Hennepin County,8,110,-102
33,New Hampshire,27,Minnesota,107,Norman County,7,0,7
33,New Hampshire,27,Minnesota,109,Olmsted County,53,0,53
33,New Hampshire,27,Minnesota,123,Ramsey County,53,17,36
33,New Hampshire,27,Minnesota,131,Rice County,0,20,-20
33,New Hampshire,27,Minnesota,137,St. Louis County,0,2,-2
33,New Hampshire,27,Minnesota,163,Washington County,0,6,-6
33,New Hampshire,28,Mississippi,47,Harrison County,0,57,-57
33,New Hampshire,28,Mississippi,49,Hinds County,125,0,125
33,New Hampshire,28,Mississippi,83,Leflore County,0,10,-10
33,New Hampshire,28,Mississippi,149,Warren County,31,0,31
33,New Hampshire,29,Missouri,31,Cape Girardeau County,0,13,-13
33,New Hampshire,29,Missouri,51,Cole County,56,0,56
33,New Hampshire,29,Missouri,71,Franklin County,12,0,12
33,New Hampshire,29,Missouri,95,Jackson County,30,40,-10
33,New Hampshire,29,Missouri,165,Platte County,0,55,-55
33,New Hampshire,29,Missouri,169,Pulaski County,0,32,-32
33,New Hampshire,29,Missouri,183,St. Charles County,0,19,-19
33,New Hampshire,29,Missouri,189,St. Louis County,2,33,-31
33,New Hampshire,29,Missouri,225,Webster County,0,3,-3
33,New Hampshire,29,Missouri,510,St. Louis city,28,20,8
33,New Hampshire,30,Montana,31,Gallatin County,96,92,4
33,New Hampshire,30,Montana,39,Granite County,0,34,-34
33,New Hampshire,30,Montana,63,Missoula County,0,8,-8
33,New Hampshire,31,Nebraska,55,Douglas County,17,52,-35
33,New Hampshire,31,Nebraska,81,Hamilton County,0,11,-11
33,New Hampshire,31,Nebraska,109,Lancaster County,13,0,13
33,New Hampshire,31,Nebraska,119,Madison County,16,0,16
33,New Hampshire,31,Nebraska,141,Platte County,0,21,-21
33,New Hampshire,32,Nevada,3,Clark County,395,93,302
33,New Hampshire,32,Nevada,5,Douglas County,0,12,-12
33,New Hampshire,32,Nevada,23,Nye County,32,0,32
33,New Hampshire,32,Nevada,31,Washoe County,42,60,-18
33,New Hampshire,32,Nevada,510,Carson City,10,23,-13
33,New Hampshire,33,New Hampshire,1,Belknap County,2577,1696,881
33,New Hampshire,33,New Hampshire,3,Carroll County,1164,1419,-255
33,New Hampshire,33,New Hampshire,5,Cheshire County,1220,1808,-588
33,New Hampshire,33,New Hampshire,7,Coos County,731,903,-172
33,New Hampshire,33,New Hampshire,9,Grafton County,2119,2198,-79
33,New Hampshire,33,New Hampshire,11,Hillsborough County,6774,7622,-848
33,New Hampshire,33,New Hampshire,13,Merrimack County,4749,5478,-729
33,New Hampshire,33,New Hampshire,15,Rockingham County,8221,4626,3595
33,New Hampshire,33,New Hampshire,17,Strafford County,3637,5278,-1641
33,New Hampshire,33,New Hampshire,19,Sullivan County,917,1081,-164
33,New Hampshire,34,New Jersey,1,Atlantic County,73,14,59
33,New Hampshire,34,New Jersey,3,Bergen County,22,0,22
33,New Hampshire,34,New Jersey,5,Burlington County,67,131,-64
33,New Hampshire,34,New Jersey,7,Camden County,32,12,20
33,New Hampshire,34,New Jersey,9,Cape May County,8,24,-16
33,New Hampshire,34,New Jersey,13,Essex County,20,44,-24
33,New Hampshire,34,New Jersey,15,Gloucester County,7,0,7
33,New Hampshire,34,New Jersey,17,Hudson County,56,84,-28
33,New Hampshire,34,New Jersey,19,Hunterdon County,18,0,18
33,New Hampshire,34,New Jersey,21,Mercer County,73,3,70
33,New Hampshire,34,New Jersey,23,Middlesex County,74,4,70
33,New Hampshire,34,New Jersey,25,Monmouth County,14,24,-10
33,New Hampshire,34,New Jersey,27,Morris County,61,0,61
33,New Hampshire,34,New Jersey,29,Ocean County,20,20,0
33,New Hampshire,34,New Jersey,31,Passaic County,21,0,21
33,New Hampshire,34,New Jersey,35,Somerset County,91,0,91
33,New Hampshire,34,New Jersey,39,Union County,11,8,3
33,New Hampshire,35,New Mexico,1,Bernalillo County,6,121,-115
33,New Hampshire,35,New Mexico,5,Chaves County,0,6,-6
33,New Hampshire,35,New Mexico,6,Cibola County,7,0,7
33,New Hampshire,35,New Mexico,17,Grant County,12,0,12
33,New Hampshire,35,New Mexico,28,Los Alamos County,0,11,-11
33,New Hampshire,35,New Mexico,31,McKinley County,30,0,30
33,New Hampshire,35,New Mexico,43,Sandoval County,0,74,-74
33,New Hampshire,35,New Mexico,45,San Juan County,0,11,-11
33,New Hampshire,35,New Mexico,49,Santa Fe County,0,90,-90
33,New Hampshire,35,New Mexico,55,Taos County,0,2,-2
33,New Hampshire,36,New York,1,Albany County,101,111,-10
33,New Hampshire,36,New York,3,Allegany County,9,3,6
33,New Hampshire,36,New York,5,Bronx County,222,52,170
33,New Hampshire,36,New York,7,Broome County,77,22,55
33,New Hampshire,36,New York,11,Cayuga County,12,16,-4
33,New Hampshire,36,New York,13,Chautauqua County,0,25,-25
33,New Hampshire,36,New York,17,Chenango County,7,0,7
33,New Hampshire,36,New York,21,Columbia County,30,0,30
33,New Hampshire,36,New York,23,Cortland County,54,0,54
33,New Hampshire,36,New York,27,Dutchess County,0,89,-89
33,New Hampshire,36,New York,29,Erie County,60,104,-44
33,New Hampshire,36,New York,31,Essex County,70,67,3
33,New Hampshire,36,New York,33,Franklin County,65,16,49
33,New Hampshire,36,New York,35,Fulton County,13,3,10
33,New Hampshire,36,New York,39,Greene County,9,0,9
33,New Hampshire,36,New York,43,Herkimer County,34,9,25
33,New Hampshire,36,New York,45,Jefferson County,204,31,173
33,New Hampshire,36,New York,47,Kings County,130,165,-35
33,New Hampshire,36,New York,49,Lewis County,62,0,62
33,New Hampshire,36,New York,55,Monroe County,90,119,-29
33,New Hampshire,36,New York,57,Montgomery County,0,5,-5
33,New Hampshire,36,New York,59,Nassau County,168,31,137
33,New Hampshire,36,New York,61,New York County,293,102,191
33,New Hampshire,36,New York,63,Niagara County,38,0,38
33,New Hampshire,36,New York,65,Oneida County,55,47,8
33,New Hampshire,36,New York,67,Onondaga County,128,143,-15
33,New Hampshire,36,New York,69,Ontario County,12,14,-2
33,New Hampshire,36,New York,71,Orange County,61,75,-14
33,New Hampshire,36,New York,75,Oswego County,21,0,21
33,New Hampshire,36,New York,79,Putnam County,63,29,34
33,New Hampshire,36,New York,81,Queens County,247,116,131
33,New Hampshire,36,New York,83,Rensselaer County,93,38,55
33,New Hampshire,36,New York,85,Richmond County,0,8,-8
33,New Hampshire,36,New York,87,Rockland County,67,0,67
33,New Hampshire,36,New York,89,St. Lawrence County,69,76,-7
33,New Hampshire,36,New York,91,Saratoga County,115,26,89
33,New Hampshire,36,New York,93,Schenectady County,18,32,-14
33,New Hampshire,36,New York,95,Schoharie County,8,18,-10
33,New Hampshire,36,New York,101,Steuben County,0,17,-17
33,New Hampshire,36,New York,103,Suffolk County,219,20,199
33,New Hampshire,36,New York,107,Tioga County,12,0,12
33,New Hampshire,36,New York,109,Tompkins County,63,30,33
33,New Hampshire,36,New York,111,Ulster County,16,57,-41
33,New Hampshire,36,New York,113,Warren County,9,32,-23
33,New Hampshire,36,New York,115,Washington County,0,45,-45
33,New Hampshire,36,New York,119,Westchester County,113,82,31
33,New Hampshire,37,North Carolina,1,Alamance County,8,1,7
33,New Hampshire,37,North Carolina,19,Brunswick County,0,8,-8
33,New Hampshire,37,North Carolina,21,Buncombe County,88,26,62
33,New Hampshire,37,North Carolina,23,Burke County,0,15,-15
33,New Hampshire,37,North Carolina,25,Cabarrus County,21,7,14
33,New Hampshire,37,North Carolina,31,Carteret County,0,16,-16
33,New Hampshire,37,North Carolina,37,Chatham County,0,12,-12
33,New Hampshire,37,North Carolina,49,Craven County,42,44,-2
33,New Hampshire,37,North Carolina,51,Cumberland County,46,72,-26
33,New Hampshire,37,North Carolina,63,Durham County,1,36,-35
33,New Hampshire,37,North Carolina,67,Forsyth County,0,13,-13
33,New Hampshire,37,North Carolina,71,Gaston County,53,0,53
33,New Hampshire,37,North Carolina,81,Guilford County,16,5,11
33,New Hampshire,37,North Carolina,85,Harnett County,0,32,-32
33,New Hampshire,37,North Carolina,89,Henderson County,0,87,-87
33,New Hampshire,37,North Carolina,91,Hertford County,0,4,-4
33,New Hampshire,37,North Carolina,93,Hoke County,0,31,-31
33,New Hampshire,37,North Carolina,113,Macon County,0,10,-10
33,New Hampshire,37,North Carolina,119,Mecklenburg County,42,124,-82
33,New Hampshire,37,North Carolina,121,Mitchell County,0,6,-6
33,New Hampshire,37,North Carolina,123,Montgomery County,28,0,28
33,New Hampshire,37,North Carolina,125,Moore County,27,66,-39
33,New Hampshire,37,North Carolina,129,New Hanover County,0,34,-34
33,New Hampshire,37,North Carolina,133,Onslow County,32,57,-25
33,New Hampshire,37,North Carolina,135,Orange County,55,0,55
33,New Hampshire,37,North Carolina,147,Pitt County,66,69,-3
33,New Hampshire,37,North Carolina,155,Robeson County,8,0,8
33,New Hampshire,37,North Carolina,157,Rockingham County,0,100,-100
33,New Hampshire,37,North Carolina,167,Stanly County,0,42,-42
33,New Hampshire,37,North Carolina,171,Surry County,0,23,-23
33,New Hampshire,37,North Carolina,179,Union County,100,53,47
33,New Hampshire,37,North Carolina,181,Vance County,0,30,-30
33,New Hampshire,37,North Carolina,183,Wake County,106,166,-60
33,New Hampshire,37,North Carolina,189,Watauga County,0,7,-7
33,New Hampshire,37,North Carolina,191,Wayne County,0,32,-32
33,New Hampshire,38,North Dakota,15,Burleigh County,0,35,-35
33,New Hampshire,38,North Dakota,17,Cass County,0,2,-2
33,New Hampshire,38,North Dakota,49,McHenry County,0,5,-5
33,New Hampshire,38,North Dakota,71,Ramsey County,0,9,-9
33,New Hampshire,38,North Dakota,89,Stark County,0,47,-47
33,New Hampshire,38,North Dakota,101,Ward County,177,26,151
33,New Hampshire,39,Ohio,17,Butler County,6,21,-15
33,New Hampshire,39,Ohio,19,Carroll County,0,7,-7
33,New Hampshire,39,Ohio,23,Clark County,0,10,-10
33,New Hampshire,39,Ohio,35,Cuyahoga County,59,163,-104
33,New Hampshire,39,Ohio,45,Fairfield County,0,257,-257
33,New Hampshire,39,Ohio,49,Franklin County,6,156,-150
33,New Hampshire,39,Ohio,51,Fulton County,14,0,14
33,New Hampshire,39,Ohio,55,Geauga County,0,14,-14
33,New Hampshire,39,Ohio,57,Greene County,0,12,-12
33,New Hampshire,39,Ohio,61,Hamilton County,13,75,-62
33,New Hampshire,39,Ohio,71,Highland County,9,0,9
33,New Hampshire,39,Ohio,83,Knox County,66,31,35
33,New Hampshire,39,Ohio,85,Lake County,5,20,-15
33,New Hampshire,39,Ohio,89,Licking County,36,55,-19
33,New Hampshire,39,Ohio,93,Lorain County,10,0,10
33,New Hampshire,39,Ohio,95,Lucas County,0,50,-50
33,New Hampshire,39,Ohio,99,Mahoning County,35,14,21
33,New Hampshire,39,Ohio,109,Miami County,16,0,16
33,New Hampshire,39,Ohio,113,Montgomery County,31,17,14
33,New Hampshire,39,Ohio,129,Pickaway County,0,6,-6
33,New Hampshire,39,Ohio,133,Portage County,0,7,-7
33,New Hampshire,39,Ohio,139,Richland County,0,2,-2
33,New Hampshire,39,Ohio,151,Stark County,0,85,-85
33,New Hampshire,39,Ohio,153,Summit County,0,66,-66
33,New Hampshire,39,Ohio,159,Union County,10,0,10
33,New Hampshire,39,Ohio,165,Warren County,12,30,-18
33,New Hampshire,4,Arizona,3,Cochise County,97,0,97
33,New Hampshire,4,Arizona,5,Coconino County,7,8,-1
33,New Hampshire,4,Arizona,13,Maricopa County,119,394,-275
33,New Hampshire,4,Arizona,15,Mohave County,0,102,-102
33,New Hampshire,4,Arizona,17,Navajo County,5,15,-10
33,New Hampshire,4,Arizona,19,Pima County,80,35,45
33,New Hampshire,4,Arizona,21,Pinal County,14,22,-8
33,New Hampshire,4,Arizona,25,Yavapai County,5,4,1
33,New Hampshire,4,Arizona,27,Yuma County,11,0,11
33,New Hampshire,40,Oklahoma,17,Canadian County,0,10,-10
33,New Hampshire,40,Oklahoma,21,Cherokee County,11,0,11
33,New Hampshire,40,Oklahoma,27,Cleveland County,0,53,-53
33,New Hampshire,40,Oklahoma,31,Comanche County,0,15,-15
33,New Hampshire,40,Oklahoma,47,Garfield County,0,2,-2
33,New Hampshire,40,Oklahoma,77,Latimer County,0,5,-5
33,New Hampshire,40,Oklahoma,85,Love County,0,57,-57
33,New Hampshire,40,Oklahoma,87,McClain County,39,0,39
33,New Hampshire,40,Oklahoma,109,Oklahoma County,0,16,-16
33,New Hampshire,40,Oklahoma,143,Tulsa County,60,16,44
33,New Hampshire,41,Oregon,3,Benton County,30,0,30
33,New Hampshire,41,Oregon,19,Douglas County,5,0,5
33,New Hampshire,41,Oregon,39,Lane County,0,16,-16
33,New Hampshire,41,Oregon,43,Linn County,9,0,9
33,New Hampshire,41,Oregon,51,Multnomah County,92,165,-73
33,New Hampshire,41,Oregon,67,Washington County,8,124,-116
33,New Hampshire,41,Oregon,71,Yamhill County,23,0,23
33,New Hampshire,42,Pennsylvania,1,Adams County,0,38,-38
33,New Hampshire,42,Pennsylvania,3,Allegheny County,146,174,-28
33,New Hampshire,42,Pennsylvania,7,Beaver County,0,52,-52
33,New Hampshire,42,Pennsylvania,11,Berks County,46,9,37
33,New Hampshire,42,Pennsylvania,13,Blair County,0,27,-27
33,New Hampshire,42,Pennsylvania,17,Bucks County,26,0,26
33,New Hampshire,42,Pennsylvania,19,Butler County,8,0,8
33,New Hampshire,42,Pennsylvania,21,Cambria County,10,22,-12
33,New Hampshire,42,Pennsylvania,25,Carbon County,46,0,46
33,New Hampshire,42,Pennsylvania,27,Centre County,66,63,3
33,New Hampshire,42,Pennsylvania,29,Chester County,4,8,-4
33,New Hampshire,42,Pennsylvania,31,Clarion County,0,8,-8
33,New Hampshire,42,Pennsylvania,37,Columbia County,39,0,39
33,New Hampshire,42,Pennsylvania,39,Crawford County,0,22,-22
33,New Hampshire,42,Pennsylvania,41,Cumberland County,49,10,39
33,New Hampshire,42,Pennsylvania,43,Dauphin County,27,3,24
33,New Hampshire,42,Pennsylvania,45,Delaware County,43,5,38
33,New Hampshire,42,Pennsylvania,55,Franklin County,0,15,-15
33,New Hampshire,42,Pennsylvania,61,Huntingdon County,0,20,-20
33,New Hampshire,42,Pennsylvania,65,Jefferson County,0,3,-3
33,New Hampshire,42,Pennsylvania,69,Lackawanna County,20,0,20
33,New Hampshire,42,Pennsylvania,71,Lancaster County,11,69,-58
33,New Hampshire,42,Pennsylvania,75,Lebanon County,250,0,250
33,New Hampshire,42,Pennsylvania,77,Lehigh County,90,120,-30
33,New Hampshire,42,Pennsylvania,79,Luzerne County,101,0,101
33,New Hampshire,42,Pennsylvania,81,Lycoming County,0,76,-76
33,New Hampshire,42,Pennsylvania,83,McKean County,41,16,25
33,New Hampshire,42,Pennsylvania,85,Mercer County,0,21,-21
33,New Hampshire,42,Pennsylvania,91,Montgomery County,122,51,71
33,New Hampshire,42,Pennsylvania,93,Montour County,9,0,9
33,New Hampshire,42,Pennsylvania,95,Northampton County,62,9,53
33,New Hampshire,42,Pennsylvania,97,Northumberland County,0,7,-7
33,New Hampshire,42,Pennsylvania,101,Philadelphia County,123,138,-15
33,New Hampshire,42,Pennsylvania,103,Pike County,0,52,-52
33,New Hampshire,42,Pennsylvania,105,Potter County,0,5,-5
33,New Hampshire,42,Pennsylvania,107,Schuylkill County,0,57,-57
33,New Hampshire,42,Pennsylvania,109,Snyder County,0,9,-9
33,New Hampshire,42,Pennsylvania,115,Susquehanna County,28,0,28
33,New Hampshire,42,Pennsylvania,119,Union County,6,12,-6
33,New Hampshire,42,Pennsylvania,125,Washington County,0,1,-1
33,New Hampshire,42,Pennsylvania,127,Wayne County,3,0,3
33,New Hampshire,42,Pennsylvania,129,Westmoreland County,15,0,15
33,New Hampshire,42,Pennsylvania,131,Wyoming County,0,2,-2
33,New Hampshire,42,Pennsylvania,133,York County,5,112,-107
33,New Hampshire,44,Rhode Island,1,Bristol County,0,71,-71
33,New Hampshire,44,Rhode Island,3,Kent County,7,67,-60
33,New Hampshire,44,Rhode Island,5,Newport County,91,145,-54
33,New Hampshire,44,Rhode Island,7,Providence County,575,475,100
33,New Hampshire,44,Rhode Island,9,Washington County,199,87,112
33,New Hampshire,45,South Carolina,7,Anderson County,0,7,-7
33,New Hampshire,45,South Carolina,13,Beaufort County,0,176,-176
33,New Hampshire,45,South Carolina,15,Berkeley County,26,46,-20
33,New Hampshire,45,South Carolina,19,Charleston County,16,86,-70
33,New Hampshire,45,South Carolina,35,Dorchester County,12,0,12
33,New Hampshire,45,South Carolina,41,Florence County,0,28,-28
33,New Hampshire,45,South Carolina,43,Georgetown County,0,41,-41
33,New Hampshire,45,South Carolina,45,Greenville County,0,121,-121
33,New Hampshire,45,South Carolina,47,Greenwood County,16,0,16
33,New Hampshire,45,South Carolina,51,Horry County,23,118,-95
33,New Hampshire,45,South Carolina,53,Jasper County,0,44,-44
33,New Hampshire,45,South Carolina,63,Lexington County,0,10,-10
33,New Hampshire,45,South Carolina,77,Pickens County,0,13,-13
33,New Hampshire,45,South Carolina,79,Richland County,0,99,-99
33,New Hampshire,45,South Carolina,83,Spartanburg County,51,94,-43
33,New Hampshire,45,South Carolina,91,York County,0,49,-49
33,New Hampshire,46,South Dakota,27,Clay County,0,6,-6
33,New Hampshire,46,South Dakota,93,Meade County,0,14,-14
33,New Hampshire,46,South Dakota,99,Minnehaha County,0,4,-4
33,New Hampshire,46,South Dakota,102,Oglala Lakota County,0,1,-1
33,New Hampshire,46,South Dakota,103,Pennington County,31,0,31
33,New Hampshire,47,Tennessee,15,Cannon County,0,14,-14
33,New Hampshire,47,Tennessee,31,Coffee County,6,0,6
33,New Hampshire,47,Tennessee,35,Cumberland County,2,0,2
33,New Hampshire,47,Tennessee,37,Davidson County,41,66,-25
33,New Hampshire,47,Tennessee,49,Fentress County,0,11,-11
33,New Hampshire,47,Tennessee,63,Hamblen County,21,0,21
33,New Hampshire,47,Tennessee,65,Hamilton County,5,0,5
33,New Hampshire,47,Tennessee,73,Hawkins County,7,0,7
33,New Hampshire,47,Tennessee,93,Knox County,0,41,-41
33,New Hampshire,47,Tennessee,105,Loudon County,18,0,18
33,New Hampshire,47,Tennessee,125,Montgomery County,0,23,-23
33,New Hampshire,47,Tennessee,147,Robertson County,0,8,-8
33,New Hampshire,47,Tennessee,157,Shelby County,16,52,-36
33,New Hampshire,47,Tennessee,163,Sullivan County,29,0,29
33,New Hampshire,47,Tennessee,171,Unicoi County,0,33,-33
33,New Hampshire,47,Tennessee,187,Williamson County,13,0,13
33,New Hampshire,48,Texas,9,Archer County,0,4,-4
33,New Hampshire,48,Texas,15,Austin County,9,23,-14
33,New Hampshire,48,Texas,27,Bell County,0,11,-11
33,New Hampshire,48,Texas,29,Bexar County,45,216,-171
33,New Hampshire,48,Texas,61,Cameron County,119,0,119
33,New Hampshire,48,Texas,85,Collin County,48,0,48
33,New Hampshire,48,Texas,91,Comal County,26,0,26
33,New Hampshire,48,Texas,99,Coryell County,0,16,-16
33,New Hampshire,48,Texas,113,Dallas County,173,113,60
33,New Hampshire,48,Texas,121,Denton County,11,212,-201
33,New Hampshire,48,Texas,139,Ellis County,3,20,-17
33,New Hampshire,48,Texas,141,El Paso County,101,19,82
33,New Hampshire,48,Texas,157,Fort Bend County,26,0,26
33,New Hampshire,48,Texas,183,Gregg County,0,27,-27
33,New Hampshire,48,Texas,187,Guadalupe County,41,0,41
33,New Hampshire,48,Texas,201,Harris County,45,89,-44
33,New Hampshire,48,Texas,209,Hays County,3,0,3
33,New Hampshire,48,Texas,215,Hidalgo County,51,0,51
33,New Hampshire,48,Texas,251,Johnson County,4,0,4
33,New Hampshire,48,Texas,259,Kendall County,0,83,-83
33,New Hampshire,48,Texas,273,Kleberg County,0,89,-89
33,New Hampshire,48,Texas,329,Midland County,20,64,-44
33,New Hampshire,48,Texas,339,Montgomery County,34,0,34
33,New Hampshire,48,Texas,353,Nolan County,0,22,-22
33,New Hampshire,48,Texas,367,Parker County,0,17,-17
33,New Hampshire,48,Texas,381,Randall County,41,0,41
33,New Hampshire,48,Texas,439,Tarrant County,74,136,-62
33,New Hampshire,48,Texas,453,Travis County,67,50,17
33,New Hampshire,48,Texas,485,Wichita County,0,40,-40
33,New Hampshire,48,Texas,491,Williamson County,118,64,54
33,New Hampshire,49,Utah,35,Salt Lake County,198,25,173
33,New Hampshire,49,Utah,39,Sanpete County,0,6,-6
33,New Hampshire,49,Utah,43,Summit County,0,36,-36
33,New Hampshire,49,Utah,49,Utah County,51,7,44
33,New Hampshire,49,Utah,57,Weber County,0,11,-11
33,New Hampshire,5,Arkansas,7,Benton County,105,14,91
33,New Hampshire,5,Arkansas,33,Crawford County,23,0,23
33,New Hampshire,5,Arkansas,115,Pope County,34,0,34
33,New Hampshire,5,Arkansas,119,Pulaski County,16,0,16
33,New Hampshire,5,Arkansas,123,St. Francis County,25,0,25
33,New Hampshire,5,Arkansas,131,Sebastian County,59,0,59
33,New Hampshire,5,Arkansas,143,Washington County,0,65,-65
33,New Hampshire,50,Vermont,1,Addison County,29,48,-19
33,New Hampshire,50,Vermont,3,Bennington County,69,18,51
33,New Hampshire,50,Vermont,5,Caledonia County,139,237,-98
33,New Hampshire,50,Vermont,7,Chittenden County,197,607,-410
33,New Hampshire,50,Vermont,9,Essex County,46,89,-43
33,New Hampshire,50,Vermont,11,Franklin County,0,96,-96
33,New Hampshire,50,Vermont,13,Grand Isle County,18,2,16
33,New Hampshire,50,Vermont,15,Lamoille County,50,199,-149
33,New Hampshire,50,Vermont,17,Orange County,424,202,222
33,New Hampshire,50,Vermont,19,Orleans County,50,148,-98
33,New Hampshire,50,Vermont,21,Rutland County,137,138,-1
33,New Hampshire,50,Vermont,23,Washington County,227,102,125
33,New Hampshire,50,Vermont,25,Windham County,424,334,90
33,New Hampshire,50,Vermont,27,Windsor County,748,740,8
33,New Hampshire,51,Virginia,3,Albemarle County,3,11,-8
33,New Hampshire,51,Virginia,9,Amherst County,0,11,-11
33,New Hampshire,51,Virginia,13,Arlington County,69,52,17
33,New Hampshire,51,Virginia,41,Chesterfield County,2,44,-42
33,New Hampshire,51,Virginia,59,Fairfax County,97,111,-14
33,New Hampshire,51,Virginia,61,Fauquier County,0,8,-8
33,New Hampshire,51,Virginia,67,Franklin County,0,1,-1
33,New Hampshire,51,Virginia,87,Henrico County,9,0,9
33,New Hampshire,51,Virginia,93,Isle of Wight County,0,7,-7
33,New Hampshire,51,Virginia,99,King George County,0,9,-9
33,New Hampshire,51,Virginia,107,Loudoun County,142,10,132
33,New Hampshire,51,Virginia,121,Montgomery County,0,20,-20
33,New Hampshire,51,Virginia,153,Prince William County,37,152,-115
33,New Hampshire,51,Virginia,163,Rockbridge County,0,15,-15
33,New Hampshire,51,Virginia,179,Stafford County,7,0,7
33,New Hampshire,51,Virginia,187,Warren County,11,0,11
33,New Hampshire,51,Virginia,510,Alexandria city,29,53,-24
33,New Hampshire,51,Virginia,550,Chesapeake city,39,14,25
33,New Hampshire,51,Virginia,600,Fairfax city,15,0,15
33,New Hampshire,51,Virginia,610,Falls Church city,12,0,12
33,New Hampshire,51,Virginia,630,Fredericksburg city,0,10,-10
33,New Hampshire,51,Virginia,650,Hampton city,18,22,-4
33,New Hampshire,51,Virginia,660,Harrisonburg city,0,18,-18
33,New Hampshire,51,Virginia,680,Lynchburg city,0,26,-26
33,New Hampshire,51,Virginia,700,Newport News city,45,48,-3
33,New Hampshire,51,Virginia,710,Norfolk city,40,14,26
33,New Hampshire,51,Virginia,740,Portsmouth city,39,0,39
33,New Hampshire,51,Virginia,760,Richmond city,0,21,-21
33,New Hampshire,51,Virginia,770,Roanoke city,0,20,-20
33,New Hampshire,51,Virginia,810,Virginia Beach city,29,41,-12
33,New Hampshire,51,Virginia,830,Williamsburg city,33,0,33
33,New Hampshire,51,Virginia,840,Winchester city,0,4,-4
33,New Hampshire,53,Washington,7,Chelan County,0,10,-10
33,New Hampshire,53,Washington,9,Clallam County,10,0,10
33,New Hampshire,53,Washington,11,Clark County,18,24,-6
33,New Hampshire,53,Washington,27,Grays Harbor County,0,14,-14
33,New Hampshire,53,Washington,29,Island County,0,49,-49
33,New Hampshire,53,Washington,33,King County,64,230,-166
33,New Hampshire,53,Washington,35,Kitsap County,10,0,10
33,New Hampshire,53,Washington,53,Pierce County,90,3,87
33,New Hampshire,53,Washington,57,Skagit County,0,4,-4
33,New Hampshire,53,Washington,61,Snohomish County,0,43,-43
33,New Hampshire,53,Washington,63,Spokane County,6,48,-42
33,New Hampshire,53,Washington,77,Yakima County,0,14,-14
33,New Hampshire,54,West Virginia,37,Jefferson County,155,63,92
33,New Hampshire,54,West Virginia,47,McDowell County,81,0,81
33,New Hampshire,54,West Virginia,61,Monongalia County,6,27,-21
33,New Hampshire,54,West Virginia,71,Pendleton County,0,23,-23
33,New Hampshire,54,West Virginia,81,Raleigh County,7,0,7
33,New Hampshire,54,West Virginia,83,Randolph County,0,13,-13
33,New Hampshire,54,West Virginia,87,Roane County,0,18,-18
33,New Hampshire,54,West Virginia,89,Summers County,0,4,-4
33,New Hampshire,54,West Virginia,97,Upshur County,0,8,-8
33,New Hampshire,55,Wisconsin,25,Dane County,86,85,1
33,New Hampshire,55,Wisconsin,29,Door County,0,27,-27
33,New Hampshire,55,Wisconsin,33,Dunn County,9,0,9
33,New Hampshire,55,Wisconsin,43,Grant County,0,9,-9
33,New Hampshire,55,Wisconsin,45,Green County,0,11,-11
33,New Hampshire,55,Wisconsin,55,Jefferson County,0,14,-14
33,New Hampshire,55,Wisconsin,73,Marathon County,17,0,17
33,New Hampshire,55,Wisconsin,75,Marinette County,0,3,-3
33,New Hampshire,55,Wisconsin,79,Milwaukee County,44,40,4
33,New Hampshire,55,Wisconsin,85,Oneida County,0,5,-5
33,New Hampshire,55,Wisconsin,109,St. Croix County,0,9,-9
33,New Hampshire,55,Wisconsin,123,Vernon County,4,0,4
33,New Hampshire,55,Wisconsin,133,Waukesha County,37,5,32
33,New Hampshire,55,Wisconsin,139,Winnebago County,0,25,-25
33,New Hampshire,56,Wyoming,1,Albany County,0,2,-2
33,New Hampshire,6,California,1,Alameda County,111,3,108
33,New Hampshire,6,California,13,Contra Costa County,66,66,0
33,New Hampshire,6,California,19,Fresno County,23,0,23
33,New Hampshire,6,California,23,Humboldt County,6,159,-153
33,New Hampshire,6,California,29,Kern County,18,10,8
33,New Hampshire,6,California,31,Kings County,3,0,3
33,New Hampshire,6,California,35,Lassen County,0,8,-8
33,New Hampshire,6,California,37,Los Angeles County,507,216,291
33,New Hampshire,6,California,41,Marin County,0,40,-40
33,New Hampshire,6,California,43,Mariposa County,17,0,17
33,New Hampshire,6,California,45,Mendocino County,46,0,46
33,New Hampshire,6,California,53,Monterey County,0,18,-18
33,New Hampshire,6,California,57,Nevada County,3,0,3
33,New Hampshire,6,California,59,Orange County,77,145,-68
33,New Hampshire,6,California,65,Riverside County,18,28,-10
33,New Hampshire,6,California,67,Sacramento County,116,46,70
33,New Hampshire,6,California,71,San Bernardino County,56,57,-1
33,New Hampshire,6,California,73,San Diego County,257,92,165
33,New Hampshire,6,California,75,San Francisco County,35,24,11
33,New Hampshire,6,California,77,San Joaquin County,75,66,9
33,New Hampshire,6,California,81,San Mateo County,35,0,35
33,New Hampshire,6,California,83,Santa Barbara County,88,20,68
33,New Hampshire,6,California,85,Santa Clara County,108,73,35
33,New Hampshire,6,California,93,Siskiyou County,3,0,3
33,New Hampshire,6,California,97,Sonoma County,147,0,147
33,New Hampshire,6,California,99,Stanislaus County,5,0,5
33,New Hampshire,6,California,101,Sutter County,6,0,6
33,New Hampshire,6,California,107,Tulare County,0,19,-19
33,New Hampshire,6,California,111,Ventura County,0,29,-29
33,New Hampshire,72,Puerto Rico,3,Aguada Municipio,34,0,34
33,New Hampshire,72,Puerto Rico,5,Aguadilla Municipio,80,20,60
33,New Hampshire,72,Puerto Rico,31,Carolina Municipio,13,20,-7
33,New Hampshire,72,Puerto Rico,35,Cayey Municipio,1,0,1
33,New Hampshire,72,Puerto Rico,59,Guayanilla Municipio,0,22,-22
33,New Hampshire,72,Puerto Rico,75,Juana Díaz Municipio,0,10,-10
33,New Hampshire,72,Puerto Rico,97,Mayagüez Municipio,0,9,-9
33,New Hampshire,72,Puerto Rico,99,Moca Municipio,15,0,15
33,New Hampshire,72,Puerto Rico,127,San Juan Municipio,185,1,184
33,New Hampshire,72,Puerto Rico,137,Toa Baja Municipio,3,0,3
33,New Hampshire,72,Puerto Rico,141,Utuado Municipio,43,0,43
33,New Hampshire,72,Puerto Rico,149,Villalba Municipio,0,1,-1
33,New Hampshire,8,Colorado,1,Adams County,0,35,-35
33,New Hampshire,8,Colorado,5,Arapahoe County,82,14,68
33,New Hampshire,8,Colorado,13,Boulder County,41,123,-82
33,New Hampshire,8,Colorado,31,Denver County,118,57,61
33,New Hampshire,8,Colorado,35,Douglas County,0,150,-150
33,New Hampshire,8,Colorado,37,Eagle County,0,17,-17
33,New Hampshire,8,Colorado,41,El Paso County,152,89,63
33,New Hampshire,8,Colorado,45,Garfield County,5,17,-12
33,New Hampshire,8,Colorado,51,Gunnison County,9,0,9
33,New Hampshire,8,Colorado,59,Jefferson County,100,202,-102
33,New Hampshire,8,Colorado,69,Larimer County,21,22,-1
33,New Hampshire,8,Colorado,93,Park County,0,57,-57
33,New Hampshire,8,Colorado,101,Pueblo County,0,8,-8
33,New Hampshire,8,Colorado,107,Routt County,29,29,0
33,New Hampshire,8,Colorado,113,San Miguel County,0,8,-8
33,New Hampshire,8,Colorado,117,Summit County,4,0,4
33,New Hampshire,8,Colorado,123,Weld County,28,0,28
33,New Hampshire,9,Connecticut,1,Fairfield County,550,292,258
33,New Hampshire,9,Connecticut,3,Hartford County,475,251,224
33,New Hampshire,9,Connecticut,5,Litchfield County,88,147,-59
33,New Hampshire,9,Connecticut,7,Middlesex County,71,45,26
33,New Hampshire,9,Connecticut,9,New Haven County,677,158,519
33,New Hampshire,9,Connecticut,11,New London County,363,120,243
33,New Hampshire,9,Connecticut,13,Tolland County,41,147,-106
33,New Hampshire,9,Connecticut,15,Windham County,183,82,101
33,New Hampshire,AFR,Africa,,-,380,0,0
33,New Hampshire,ASI,Asia,,-,3368,0,0
33,New Hampshire,CAM,Central America,,-,275,0,0
33,New Hampshire,CAR,Caribbean,,-,302,0,0
33,New Hampshire,EUR,Europe,,-,1043,0,0
33,New Hampshire,ISL,U.S. Island Areas,,-,61,0,0
33,New Hampshire,NAM,Northern America,,-,378,0,0
33,New Hampshire,OCE,Oceania and At Sea,,-,93,0,0
33,New Hampshire,SAM,South America,,-,282,0,0
34,New Jersey,1,Alabama,3,Baldwin County,10,2,8
34,New Jersey,1,Alabama,45,Dale County,0,19,-19
34,New Jersey,1,Alabama,53,Escambia County,27,0,27
34,New Jersey,1,Alabama,61,Geneva County,13,0,13
34,New Jersey,1,Alabama,69,Houston County,0,15,-15
34,New Jersey,1,Alabama,73,Jefferson County,22,163,-141
34,New Jersey,1,Alabama,81,Lee County,3,68,-65
34,New Jersey,1,Alabama,87,Macon County,5,0,5
34,New Jersey,1,Alabama,89,Madison County,32,91,-59
34,New Jersey,1,Alabama,95,Marshall County,14,0,14
34,New Jersey,1,Alabama,97,Mobile County,74,144,-70
34,New Jersey,1,Alabama,101,Montgomery County,84,56,28
34,New Jersey,1,Alabama,109,Pike County,0,20,-20
34,New Jersey,1,Alabama,117,Shelby County,0,29,-29
34,New Jersey,1,Alabama,121,Talladega County,0,21,-21
34,New Jersey,1,Alabama,123,Tallapoosa County,8,23,-15
34,New Jersey,1,Alabama,125,Tuscaloosa County,13,80,-67
34,New Jersey,10,Delaware,1,Kent County,235,709,-474
34,New Jersey,10,Delaware,3,New Castle County,1235,3197,-1962
34,New Jersey,10,Delaware,5,Sussex County,130,586,-456
34,New Jersey,11,District of Columbia,1,District of Columbia,875,1994,-1119
34,New Jersey,12,Florida,1,Alachua County,110,137,-27
34,New Jersey,12,Florida,5,Bay County,39,17,22
34,New Jersey,12,Florida,9,Brevard County,91,481,-390
34,New Jersey,12,Florida,11,Broward County,1067,2699,-1632
34,New Jersey,12,Florida,15,Charlotte County,214,520,-306
34,New Jersey,12,Florida,17,Citrus County,48,236,-188
34,New Jersey,12,Florida,19,Clay County,77,113,-36
34,New Jersey,12,Florida,21,Collier County,399,1021,-622
34,New Jersey,12,Florida,23,Columbia County,46,0,46
34,New Jersey,12,Florida,27,DeSoto County,11,0,11
34,New Jersey,12,Florida,29,Dixie County,18,0,18
34,New Jersey,12,Florida,31,Duval County,265,628,-363
34,New Jersey,12,Florida,33,Escambia County,14,213,-199
34,New Jersey,12,Florida,35,Flagler County,82,347,-265
34,New Jersey,12,Florida,37,Franklin County,22,0,22
34,New Jersey,12,Florida,39,Gadsden County,0,14,-14
34,New Jersey,12,Florida,51,Hendry County,6,46,-40
34,New Jersey,12,Florida,53,Hernando County,104,779,-675
34,New Jersey,12,Florida,55,Highlands County,0,37,-37
34,New Jersey,12,Florida,57,Hillsborough County,814,2025,-1211
34,New Jersey,12,Florida,61,Indian River County,82,462,-380
34,New Jersey,12,Florida,69,Lake County,277,453,-176
34,New Jersey,12,Florida,71,Lee County,257,2024,-1767
34,New Jersey,12,Florida,73,Leon County,91,235,-144
34,New Jersey,12,Florida,75,Levy County,0,2,-2
34,New Jersey,12,Florida,81,Manatee County,127,604,-477
34,New Jersey,12,Florida,83,Marion County,259,200,59
34,New Jersey,12,Florida,85,Martin County,105,191,-86
34,New Jersey,12,Florida,86,Miami-Dade County,1348,1771,-423
34,New Jersey,12,Florida,87,Monroe County,50,243,-193
34,New Jersey,12,Florida,89,Nassau County,0,88,-88
34,New Jersey,12,Florida,91,Okaloosa County,88,222,-134
34,New Jersey,12,Florida,93,Okeechobee County,13,37,-24
34,New Jersey,12,Florida,95,Orange County,770,3096,-2326
34,New Jersey,12,Florida,97,Osceola County,303,908,-605
34,New Jersey,12,Florida,99,Palm Beach County,1138,3600,-2462
34,New Jersey,12,Florida,101,Pasco County,392,484,-92
34,New Jersey,12,Florida,103,Pinellas County,411,1457,-1046
34,New Jersey,12,Florida,105,Polk County,188,669,-481
34,New Jersey,12,Florida,107,Putnam County,0,5,-5
34,New Jersey,12,Florida,109,St. Johns County,183,422,-239
34,New Jersey,12,Florida,111,St. Lucie County,217,511,-294
34,New Jersey,12,Florida,113,Santa Rosa County,49,133,-84
34,New Jersey,12,Florida,115,Sarasota County,238,1069,-831
34,New Jersey,12,Florida,117,Seminole County,147,523,-376
34,New Jersey,12,Florida,119,Sumter County,83,349,-266
34,New Jersey,12,Florida,125,Union County,0,20,-20
34,New Jersey,12,Florida,127,Volusia County,183,685,-502
34,New Jersey,12,Florida,131,Walton County,14,0,14
34,New Jersey,12,Florida,133,Washington County,4,0,4
34,New Jersey,13,Georgia,9,Baldwin County,0,6,-6
34,New Jersey,13,Georgia,13,Barrow County,0,24,-24
34,New Jersey,13,Georgia,15,Bartow County,0,35,-35
34,New Jersey,13,Georgia,21,Bibb County,5,48,-43
34,New Jersey,13,Georgia,29,Bryan County,47,174,-127
34,New Jersey,13,Georgia,31,Bulloch County,0,9,-9
34,New Jersey,13,Georgia,33,Burke County,0,1,-1
34,New Jersey,13,Georgia,39,Camden County,95,14,81
34,New Jersey,13,Georgia,45,Carroll County,17,0,17
34,New Jersey,13,Georgia,49,Charlton County,0,31,-31
34,New Jersey,13,Georgia,51,Chatham County,58,197,-139
34,New Jersey,13,Georgia,53,Chattahoochee County,0,96,-96
34,New Jersey,13,Georgia,57,Cherokee County,0,188,-188
34,New Jersey,13,Georgia,59,Clarke County,34,132,-98
34,New Jersey,13,Georgia,63,Clayton County,32,124,-92
34,New Jersey,13,Georgia,67,Cobb County,212,501,-289
34,New Jersey,13,Georgia,69,Coffee County,0,8,-8
34,New Jersey,13,Georgia,71,Colquitt County,0,28,-28
34,New Jersey,13,Georgia,73,Columbia County,0,87,-87
34,New Jersey,13,Georgia,77,Coweta County,0,125,-125
34,New Jersey,13,Georgia,79,Crawford County,0,9,-9
34,New Jersey,13,Georgia,87,Decatur County,0,12,-12
34,New Jersey,13,Georgia,89,DeKalb County,688,756,-68
34,New Jersey,13,Georgia,95,Dougherty County,43,90,-47
34,New Jersey,13,Georgia,97,Douglas County,0,92,-92
34,New Jersey,13,Georgia,111,Fannin County,28,18,10
34,New Jersey,13,Georgia,113,Fayette County,26,32,-6
34,New Jersey,13,Georgia,117,Forsyth County,297,182,115
34,New Jersey,13,Georgia,121,Fulton County,554,774,-220
34,New Jersey,13,Georgia,127,Glynn County,22,58,-36
34,New Jersey,13,Georgia,135,Gwinnett County,447,530,-83
34,New Jersey,13,Georgia,137,Habersham County,0,5,-5
34,New Jersey,13,Georgia,139,Hall County,35,62,-27
34,New Jersey,13,Georgia,145,Harris County,0,16,-16
34,New Jersey,13,Georgia,151,Henry County,8,65,-57
34,New Jersey,13,Georgia,153,Houston County,0,176,-176
34,New Jersey,13,Georgia,157,Jackson County,0,23,-23
34,New Jersey,13,Georgia,175,Laurens County,0,31,-31
34,New Jersey,13,Georgia,179,Liberty County,60,63,-3
34,New Jersey,13,Georgia,185,Lowndes County,28,111,-83
34,New Jersey,13,Georgia,189,McDuffie County,0,64,-64
34,New Jersey,13,Georgia,193,Macon County,0,26,-26
34,New Jersey,13,Georgia,205,Mitchell County,5,0,5
34,New Jersey,13,Georgia,213,Murray County,123,0,123
34,New Jersey,13,Georgia,215,Muscogee County,136,339,-203
34,New Jersey,13,Georgia,217,Newton County,105,78,27
34,New Jersey,13,Georgia,219,Oconee County,14,10,4
34,New Jersey,13,Georgia,223,Paulding County,20,0,20
34,New Jersey,13,Georgia,225,Peach County,7,9,-2
34,New Jersey,13,Georgia,245,Richmond County,23,89,-66
34,New Jersey,13,Georgia,247,Rockdale County,73,321,-248
34,New Jersey,13,Georgia,255,Spalding County,0,25,-25
34,New Jersey,13,Georgia,261,Sumter County,0,24,-24
34,New Jersey,13,Georgia,279,Toombs County,5,0,5
34,New Jersey,13,Georgia,285,Troup County,0,80,-80
34,New Jersey,13,Georgia,317,Wilkes County,0,18,-18
34,New Jersey,15,Hawaii,1,Hawaii County,29,49,-20
34,New Jersey,15,Hawaii,3,Honolulu County,330,274,56
34,New Jersey,15,Hawaii,9,Maui County,0,12,-12
34,New Jersey,16,Idaho,1,Ada County,0,12,-12
34,New Jersey,16,Idaho,15,Boise County,0,1,-1
34,New Jersey,16,Idaho,17,Bonner County,0,1,-1
34,New Jersey,16,Idaho,49,Idaho County,0,2,-2
34,New Jersey,16,Idaho,55,Kootenai County,0,26,-26
34,New Jersey,16,Idaho,65,Madison County,54,20,34
34,New Jersey,16,Idaho,67,Minidoka County,0,5,-5
34,New Jersey,16,Idaho,71,Oneida County,0,4,-4
34,New Jersey,16,Idaho,79,Shoshone County,0,2,-2
34,New Jersey,17,Illinois,1,Adams County,0,18,-18
34,New Jersey,17,Illinois,19,Champaign County,51,91,-40
34,New Jersey,17,Illinois,29,Coles County,0,22,-22
34,New Jersey,17,Illinois,31,Cook County,1314,1541,-227
34,New Jersey,17,Illinois,37,DeKalb County,0,6,-6
34,New Jersey,17,Illinois,43,DuPage County,181,325,-144
34,New Jersey,17,Illinois,49,Effingham County,0,14,-14
34,New Jersey,17,Illinois,63,Grundy County,0,9,-9
34,New Jersey,17,Illinois,67,Hancock County,0,3,-3
34,New Jersey,17,Illinois,77,Jackson County,0,10,-10
34,New Jersey,17,Illinois,83,Jersey County,0,13,-13
34,New Jersey,17,Illinois,89,Kane County,42,110,-68
34,New Jersey,17,Illinois,93,Kendall County,0,4,-4
34,New Jersey,17,Illinois,97,Lake County,331,373,-42
34,New Jersey,17,Illinois,99,LaSalle County,0,15,-15
34,New Jersey,17,Illinois,111,McHenry County,0,30,-30
34,New Jersey,17,Illinois,113,McLean County,194,0,194
34,New Jersey,17,Illinois,115,Macon County,0,30,-30
34,New Jersey,17,Illinois,119,Madison County,6,0,6
34,New Jersey,17,Illinois,121,Marion County,0,16,-16
34,New Jersey,17,Illinois,137,Morgan County,24,5,19
34,New Jersey,17,Illinois,141,Ogle County,0,41,-41
34,New Jersey,17,Illinois,143,Peoria County,0,211,-211
34,New Jersey,17,Illinois,147,Piatt County,0,29,-29
34,New Jersey,17,Illinois,157,Randolph County,0,2,-2
34,New Jersey,17,Illinois,163,St. Clair County,20,115,-95
34,New Jersey,17,Illinois,167,Sangamon County,17,24,-7
34,New Jersey,17,Illinois,179,Tazewell County,25,0,25
34,New Jersey,17,Illinois,189,Washington County,0,3,-3
34,New Jersey,17,Illinois,197,Will County,10,24,-14
34,New Jersey,17,Illinois,201,Winnebago County,0,43,-43
34,New Jersey,17,Illinois,203,Woodford County,0,4,-4
34,New Jersey,18,Indiana,3,Allen County,52,0,52
34,New Jersey,18,Indiana,5,Bartholomew County,0,14,-14
34,New Jersey,18,Indiana,35,Delaware County,0,28,-28
34,New Jersey,18,Indiana,39,Elkhart County,10,231,-221
34,New Jersey,18,Indiana,49,Fulton County,3,0,3
34,New Jersey,18,Indiana,53,Grant County,11,0,11
34,New Jersey,18,Indiana,57,Hamilton County,15,87,-72
34,New Jersey,18,Indiana,63,Hendricks County,52,194,-142
34,New Jersey,18,Indiana,65,Henry County,0,30,-30
34,New Jersey,18,Indiana,67,Howard County,0,16,-16
34,New Jersey,18,Indiana,69,Huntington County,0,10,-10
34,New Jersey,18,Indiana,73,Jasper County,19,0,19
34,New Jersey,18,Indiana,77,Jefferson County,15,2,13
34,New Jersey,18,Indiana,81,Johnson County,149,315,-166
34,New Jersey,18,Indiana,85,Kosciusko County,39,169,-130
34,New Jersey,18,Indiana,89,Lake County,41,140,-99
34,New Jersey,18,Indiana,91,LaPorte County,16,0,16
34,New Jersey,18,Indiana,95,Madison County,3,0,3
34,New Jersey,18,Indiana,97,Marion County,241,280,-39
34,New Jersey,18,Indiana,103,Miami County,6,0,6
34,New Jersey,18,Indiana,105,Monroe County,75,178,-103
34,New Jersey,18,Indiana,109,Morgan County,14,0,14
34,New Jersey,18,Indiana,119,Owen County,4,0,4
34,New Jersey,18,Indiana,123,Perry County,8,0,8
34,New Jersey,18,Indiana,127,Porter County,38,159,-121
34,New Jersey,18,Indiana,137,Ripley County,0,9,-9
34,New Jersey,18,Indiana,141,St. Joseph County,185,258,-73
34,New Jersey,18,Indiana,151,Steuben County,0,2,-2
34,New Jersey,18,Indiana,157,Tippecanoe County,45,119,-74
34,New Jersey,18,Indiana,163,Vanderburgh County,10,0,10
34,New Jersey,18,Indiana,167,Vigo County,20,4,16
34,New Jersey,18,Indiana,169,Wabash County,0,26,-26
34,New Jersey,18,Indiana,177,Wayne County,3,10,-7
34,New Jersey,18,Indiana,181,White County,8,0,8
34,New Jersey,19,Iowa,13,Black Hawk County,16,9,7
34,New Jersey,19,Iowa,37,Chickasaw County,0,6,-6
34,New Jersey,19,Iowa,45,Clinton County,0,1,-1
34,New Jersey,19,Iowa,51,Davis County,2,0,2
34,New Jersey,19,Iowa,57,Des Moines County,0,25,-25
34,New Jersey,19,Iowa,59,Dickinson County,0,7,-7
34,New Jersey,19,Iowa,61,Dubuque County,0,5,-5
34,New Jersey,19,Iowa,67,Floyd County,0,51,-51
34,New Jersey,19,Iowa,71,Fremont County,0,1,-1
34,New Jersey,19,Iowa,83,Hardin County,0,10,-10
34,New Jersey,19,Iowa,89,Howard County,0,10,-10
34,New Jersey,19,Iowa,97,Jackson County,0,8,-8
34,New Jersey,19,Iowa,101,Jefferson County,0,30,-30
34,New Jersey,19,Iowa,103,Johnson County,10,88,-78
34,New Jersey,19,Iowa,105,Jones County,0,9,-9
34,New Jersey,19,Iowa,113,Linn County,9,34,-25
34,New Jersey,19,Iowa,127,Marshall County,0,5,-5
34,New Jersey,19,Iowa,153,Polk County,13,43,-30
34,New Jersey,19,Iowa,155,Pottawattamie County,0,57,-57
34,New Jersey,19,Iowa,157,Poweshiek County,0,10,-10
34,New Jersey,19,Iowa,163,Scott County,0,23,-23
34,New Jersey,19,Iowa,167,Sioux County,17,0,17
34,New Jersey,19,Iowa,169,Story County,0,47,-47
34,New Jersey,19,Iowa,193,Woodbury County,0,43,-43
34,New Jersey,2,Alaska,13,Aleutians East Borough,0,5,-5
34,New Jersey,2,Alaska,20,Anchorage Municipality,386,125,261
34,New Jersey,2,Alaska,90,Fairbanks North Star Borough,0,53,-53
34,New Jersey,2,Alaska,122,Kenai Peninsula Borough,66,0,66
34,New Jersey,2,Alaska,130,Ketchikan Gateway Borough,0,13,-13
34,New Jersey,2,Alaska,150,Kodiak Island Borough,0,8,-8
34,New Jersey,2,Alaska,170,Matanuska-Susitna Borough,109,6,103
34,New Jersey,2,Alaska,185,North Slope Borough,0,4,-4
34,New Jersey,2,Alaska,198,Prince of Wales-Hyder Census Area,0,2,-2
34,New Jersey,2,Alaska,220,Sitka City and Borough,0,7,-7
34,New Jersey,2,Alaska,261,Valdez-Cordova Census Area,14,0,14
34,New Jersey,20,Kansas,15,Butler County,79,0,79
34,New Jersey,20,Kansas,45,Douglas County,0,181,-181
34,New Jersey,20,Kansas,47,Edwards County,0,1,-1
34,New Jersey,20,Kansas,57,Ford County,24,0,24
34,New Jersey,20,Kansas,85,Jackson County,0,3,-3
34,New Jersey,20,Kansas,91,Johnson County,323,277,46
34,New Jersey,20,Kansas,95,Kingman County,0,1,-1
34,New Jersey,20,Kansas,103,Leavenworth County,0,13,-13
34,New Jersey,20,Kansas,113,McPherson County,0,1,-1
34,New Jersey,20,Kansas,161,Riley County,56,155,-99
34,New Jersey,20,Kansas,173,Sedgwick County,33,192,-159
34,New Jersey,20,Kansas,177,Shawnee County,0,11,-11
34,New Jersey,20,Kansas,181,Sherman County,0,12,-12
34,New Jersey,20,Kansas,183,Smith County,0,1,-1
34,New Jersey,20,Kansas,189,Stevens County,0,22,-22
34,New Jersey,20,Kansas,209,Wyandotte County,0,18,-18
34,New Jersey,21,Kentucky,1,Adair County,7,0,7
34,New Jersey,21,Kentucky,19,Boyd County,14,0,14
34,New Jersey,21,Kentucky,21,Boyle County,0,24,-24
34,New Jersey,21,Kentucky,37,Campbell County,0,24,-24
34,New Jersey,21,Kentucky,47,Christian County,11,36,-25
34,New Jersey,21,Kentucky,51,Clay County,0,6,-6
34,New Jersey,21,Kentucky,59,Daviess County,0,6,-6
34,New Jersey,21,Kentucky,67,Fayette County,92,61,31
34,New Jersey,21,Kentucky,77,Gallatin County,0,37,-37
34,New Jersey,21,Kentucky,81,Grant County,0,55,-55
34,New Jersey,21,Kentucky,93,Hardin County,3,0,3
34,New Jersey,21,Kentucky,101,Henderson County,48,20,28
34,New Jersey,21,Kentucky,111,Jefferson County,164,73,91
34,New Jersey,21,Kentucky,113,Jessamine County,0,4,-4
34,New Jersey,21,Kentucky,117,Kenton County,59,90,-31
34,New Jersey,21,Kentucky,151,Madison County,0,15,-15
34,New Jersey,21,Kentucky,163,Meade County,12,0,12
34,New Jersey,21,Kentucky,179,Nelson County,0,19,-19
34,New Jersey,21,Kentucky,183,Ohio County,0,10,-10
34,New Jersey,21,Kentucky,191,Pendleton County,0,2,-2
34,New Jersey,21,Kentucky,195,Pike County,0,16,-16
34,New Jersey,21,Kentucky,205,Rowan County,0,10,-10
34,New Jersey,22,Louisiana,15,Bossier Parish,0,43,-43
34,New Jersey,22,Louisiana,17,Caddo Parish,107,12,95
34,New Jersey,22,Louisiana,19,Calcasieu Parish,17,27,-10
34,New Jersey,22,Louisiana,21,Caldwell Parish,0,30,-30
34,New Jersey,22,Louisiana,33,East Baton Rouge Parish,67,64,3
34,New Jersey,22,Louisiana,37,East Feliciana Parish,26,0,26
34,New Jersey,22,Louisiana,51,Jefferson Parish,190,7,183
34,New Jersey,22,Louisiana,55,Lafayette Parish,12,21,-9
34,New Jersey,22,Louisiana,71,Orleans Parish,170,112,58
34,New Jersey,22,Louisiana,73,Ouachita Parish,9,8,1
34,New Jersey,22,Louisiana,75,Plaquemines Parish,0,13,-13
34,New Jersey,22,Louisiana,85,Sabine Parish,0,4,-4
34,New Jersey,22,Louisiana,89,St. Charles Parish,28,0,28
34,New Jersey,22,Louisiana,91,St. Helena Parish,0,94,-94
34,New Jersey,22,Louisiana,97,St. Landry Parish,11,0,11
34,New Jersey,22,Louisiana,101,St. Mary Parish,11,60,-49
34,New Jersey,22,Louisiana,103,St. Tammany Parish,132,82,50
34,New Jersey,22,Louisiana,109,Terrebonne Parish,0,44,-44
34,New Jersey,22,Louisiana,115,Vernon Parish,121,0,121
34,New Jersey,22,Louisiana,117,Washington Parish,0,88,-88
34,New Jersey,23,Maine,1,Androscoggin County,61,169,-108
34,New Jersey,23,Maine,3,Aroostook County,0,8,-8
34,New Jersey,23,Maine,5,Cumberland County,35,265,-230
34,New Jersey,23,Maine,9,Hancock County,110,74,36
34,New Jersey,23,Maine,11,Kennebec County,88,102,-14
34,New Jersey,23,Maine,13,Knox County,15,54,-39
34,New Jersey,23,Maine,15,Lincoln County,0,30,-30
34,New Jersey,23,Maine,17,Oxford County,10,4,6
34,New Jersey,23,Maine,19,Penobscot County,0,216,-216
34,New Jersey,23,Maine,21,Piscataquis County,11,7,4
34,New Jersey,23,Maine,23,Sagadahoc County,14,0,14
34,New Jersey,23,Maine,25,Somerset County,0,11,-11
34,New Jersey,23,Maine,27,Waldo County,0,26,-26
34,New Jersey,23,Maine,31,York County,31,59,-28
34,New Jersey,24,Maryland,1,Allegany County,0,24,-24
34,New Jersey,24,Maryland,3,Anne Arundel County,667,547,120
34,New Jersey,24,Maryland,5,Baltimore County,322,1179,-857
34,New Jersey,24,Maryland,9,Calvert County,116,130,-14
34,New Jersey,24,Maryland,13,Carroll County,0,54,-54
34,New Jersey,24,Maryland,15,Cecil County,209,220,-11
34,New Jersey,24,Maryland,17,Charles County,70,57,13
34,New Jersey,24,Maryland,21,Frederick County,46,258,-212
34,New Jersey,24,Maryland,25,Harford County,145,317,-172
34,New Jersey,24,Maryland,27,Howard County,250,663,-413
34,New Jersey,24,Maryland,29,Kent County,2,56,-54
34,New Jersey,24,Maryland,31,Montgomery County,709,1384,-675
34,New Jersey,24,Maryland,33,Prince George's County,384,1148,-764
34,New Jersey,24,Maryland,35,Queen Anne's County,0,61,-61
34,New Jersey,24,Maryland,37,St. Mary's County,0,21,-21
34,New Jersey,24,Maryland,39,Somerset County,0,18,-18
34,New Jersey,24,Maryland,41,Talbot County,0,42,-42
34,New Jersey,24,Maryland,43,Washington County,13,0,13
34,New Jersey,24,Maryland,45,Wicomico County,82,416,-334
34,New Jersey,24,Maryland,47,Worcester County,120,20,100
34,New Jersey,24,Maryland,510,Baltimore city,660,705,-45
34,New Jersey,25,Massachusetts,1,Barnstable County,130,162,-32
34,New Jersey,25,Massachusetts,3,Berkshire County,34,120,-86
34,New Jersey,25,Massachusetts,5,Bristol County,107,121,-14
34,New Jersey,25,Massachusetts,7,Dukes County,10,17,-7
34,New Jersey,25,Massachusetts,9,Essex County,334,373,-39
34,New Jersey,25,Massachusetts,11,Franklin County,0,133,-133
34,New Jersey,25,Massachusetts,13,Hampden County,95,197,-102
34,New Jersey,25,Massachusetts,15,Hampshire County,161,393,-232
34,New Jersey,25,Massachusetts,17,Middlesex County,1212,1985,-773
34,New Jersey,25,Massachusetts,19,Nantucket County,0,17,-17
34,New Jersey,25,Massachusetts,21,Norfolk County,445,678,-233
34,New Jersey,25,Massachusetts,23,Plymouth County,112,46,66
34,New Jersey,25,Massachusetts,25,Suffolk County,708,1865,-1157
34,New Jersey,25,Massachusetts,27,Worcester County,253,353,-100
34,New Jersey,26,Michigan,5,Allegan County,12,0,12
34,New Jersey,26,Michigan,7,Alpena County,0,7,-7
34,New Jersey,26,Michigan,9,Antrim County,0,3,-3
34,New Jersey,26,Michigan,19,Benzie County,4,0,4
34,New Jersey,26,Michigan,21,Berrien County,0,41,-41
34,New Jersey,26,Michigan,23,Branch County,0,30,-30
34,New Jersey,26,Michigan,25,Calhoun County,0,16,-16
34,New Jersey,26,Michigan,29,Charlevoix County,0,7,-7
34,New Jersey,26,Michigan,31,Cheboygan County,0,16,-16
34,New Jersey,26,Michigan,33,Chippewa County,40,0,40
34,New Jersey,26,Michigan,47,Emmet County,23,0,23
34,New Jersey,26,Michigan,49,Genesee County,17,12,5
34,New Jersey,26,Michigan,65,Ingham County,48,123,-75
34,New Jersey,26,Michigan,69,Iosco County,11,22,-11
34,New Jersey,26,Michigan,73,Isabella County,0,18,-18
34,New Jersey,26,Michigan,75,Jackson County,0,8,-8
34,New Jersey,26,Michigan,77,Kalamazoo County,159,19,140
34,New Jersey,26,Michigan,81,Kent County,51,81,-30
34,New Jersey,26,Michigan,93,Livingston County,36,7,29
34,New Jersey,26,Michigan,99,Macomb County,250,46,204
34,New Jersey,26,Michigan,103,Marquette County,0,5,-5
34,New Jersey,26,Michigan,105,Mason County,0,2,-2
34,New Jersey,26,Michigan,107,Mecosta County,38,0,38
34,New Jersey,26,Michigan,111,Midland County,14,0,14
34,New Jersey,26,Michigan,115,Monroe County,6,0,6
34,New Jersey,26,Michigan,125,Oakland County,638,308,330
34,New Jersey,26,Michigan,133,Osceola County,16,0,16
34,New Jersey,26,Michigan,139,Ottawa County,0,27,-27
34,New Jersey,26,Michigan,145,Saginaw County,0,15,-15
34,New Jersey,26,Michigan,147,St. Clair County,0,6,-6
34,New Jersey,26,Michigan,151,Sanilac County,0,4,-4
34,New Jersey,26,Michigan,155,Shiawassee County,22,0,22
34,New Jersey,26,Michigan,157,Tuscola County,0,3,-3
34,New Jersey,26,Michigan,159,Van Buren County,20,53,-33
34,New Jersey,26,Michigan,161,Washtenaw County,151,691,-540
34,New Jersey,26,Michigan,163,Wayne County,229,167,62
34,New Jersey,27,Minnesota,1,Aitkin County,0,4,-4
34,New Jersey,27,Minnesota,3,Anoka County,51,67,-16
34,New Jersey,27,Minnesota,7,Beltrami County,11,32,-21
34,New Jersey,27,Minnesota,13,Blue Earth County,0,54,-54
34,New Jersey,27,Minnesota,17,Carlton County,17,0,17
34,New Jersey,27,Minnesota,19,Carver County,29,0,29
34,New Jersey,27,Minnesota,27,Clay County,45,13,32
34,New Jersey,27,Minnesota,37,Dakota County,33,61,-28
34,New Jersey,27,Minnesota,51,Grant County,0,15,-15
34,New Jersey,27,Minnesota,53,Hennepin County,255,106,149
34,New Jersey,27,Minnesota,59,Isanti County,0,1,-1
34,New Jersey,27,Minnesota,77,Lake of the Woods County,0,4,-4
34,New Jersey,27,Minnesota,99,Mower County,0,25,-25
34,New Jersey,27,Minnesota,101,Murray County,0,28,-28
34,New Jersey,27,Minnesota,109,Olmsted County,80,0,80
34,New Jersey,27,Minnesota,123,Ramsey County,112,72,40
34,New Jersey,27,Minnesota,131,Rice County,0,8,-8
34,New Jersey,27,Minnesota,133,Rock County,0,64,-64
34,New Jersey,27,Minnesota,137,St. Louis County,21,0,21
34,New Jersey,27,Minnesota,139,Scott County,0,90,-90
34,New Jersey,27,Minnesota,141,Sherburne County,0,23,-23
34,New Jersey,27,Minnesota,145,Stearns County,0,126,-126
34,New Jersey,27,Minnesota,147,Steele County,42,0,42
34,New Jersey,27,Minnesota,163,Washington County,29,0,29
34,New Jersey,27,Minnesota,169,Winona County,25,4,21
34,New Jersey,28,Mississippi,5,Amite County,0,4,-4
34,New Jersey,28,Mississippi,33,DeSoto County,19,261,-242
34,New Jersey,28,Mississippi,35,Forrest County,15,22,-7
34,New Jersey,28,Mississippi,45,Hancock County,56,0,56
34,New Jersey,28,Mississippi,47,Harrison County,27,198,-171
34,New Jersey,28,Mississippi,49,Hinds County,17,14,3
34,New Jersey,28,Mississippi,59,Jackson County,0,31,-31
34,New Jersey,28,Mississippi,71,Lafayette County,22,39,-17
34,New Jersey,28,Mississippi,73,Lamar County,13,0,13
34,New Jersey,28,Mississippi,77,Lawrence County,0,7,-7
34,New Jersey,28,Mississippi,87,Lowndes County,10,0,10
34,New Jersey,28,Mississippi,89,Madison County,0,4,-4
34,New Jersey,28,Mississippi,103,Noxubee County,0,8,-8
34,New Jersey,28,Mississippi,133,Sunflower County,15,0,15
34,New Jersey,28,Mississippi,151,Washington County,12,19,-7
34,New Jersey,29,Missouri,1,Adair County,0,7,-7
34,New Jersey,29,Missouri,9,Barry County,88,0,88
34,New Jersey,29,Missouri,11,Barton County,0,3,-3
34,New Jersey,29,Missouri,19,Boone County,38,50,-12
34,New Jersey,29,Missouri,27,Callaway County,0,11,-11
34,New Jersey,29,Missouri,31,Cape Girardeau County,17,0,17
34,New Jersey,29,Missouri,37,Cass County,0,41,-41
34,New Jersey,29,Missouri,47,Clay County,11,15,-4
34,New Jersey,29,Missouri,51,Cole County,17,0,17
34,New Jersey,29,Missouri,77,Greene County,0,69,-69
34,New Jersey,29,Missouri,95,Jackson County,68,103,-35
34,New Jersey,29,Missouri,97,Jasper County,0,27,-27
34,New Jersey,29,Missouri,101,Johnson County,22,0,22
34,New Jersey,29,Missouri,115,Linn County,0,3,-3
34,New Jersey,29,Missouri,127,Marion County,0,4,-4
34,New Jersey,29,Missouri,141,Morgan County,59,3,56
34,New Jersey,29,Missouri,145,Newton County,4,0,4
34,New Jersey,29,Missouri,161,Phelps County,7,0,7
34,New Jersey,29,Missouri,163,Pike County,0,20,-20
34,New Jersey,29,Missouri,169,Pulaski County,0,245,-245
34,New Jersey,29,Missouri,183,St. Charles County,19,38,-19
34,New Jersey,29,Missouri,187,St. Francois County,31,7,24
34,New Jersey,29,Missouri,189,St. Louis County,234,470,-236
34,New Jersey,29,Missouri,215,Texas County,0,1,-1
34,New Jersey,29,Missouri,229,Wright County,0,8,-8
34,New Jersey,29,Missouri,510,St. Louis city,144,99,45
34,New Jersey,30,Montana,13,Cascade County,10,0,10
34,New Jersey,30,Montana,29,Flathead County,37,10,27
34,New Jersey,30,Montana,31,Gallatin County,13,50,-37
34,New Jersey,30,Montana,63,Missoula County,4,7,-3
34,New Jersey,30,Montana,81,Ravalli County,27,0,27
34,New Jersey,30,Montana,87,Rosebud County,7,0,7
34,New Jersey,30,Montana,93,Silver Bow County,40,10,30
34,New Jersey,30,Montana,97,Sweet Grass County,0,5,-5
34,New Jersey,30,Montana,107,Wheatland County,0,1,-1
34,New Jersey,30,Montana,111,Yellowstone County,54,0,54
34,New Jersey,31,Nebraska,19,Buffalo County,9,0,9
34,New Jersey,31,Nebraska,47,Dawson County,0,7,-7
34,New Jersey,31,Nebraska,55,Douglas County,169,76,93
34,New Jersey,31,Nebraska,79,Hall County,12,0,12
34,New Jersey,31,Nebraska,109,Lancaster County,0,67,-67
34,New Jersey,31,Nebraska,141,Platte County,0,56,-56
34,New Jersey,31,Nebraska,153,Sarpy County,22,39,-17
34,New Jersey,32,Nevada,3,Clark County,362,961,-599
34,New Jersey,32,Nevada,5,Douglas County,0,1,-1
34,New Jersey,32,Nevada,31,Washoe County,100,17,83
34,New Jersey,32,Nevada,510,Carson City,0,63,-63
34,New Jersey,33,New Hampshire,1,Belknap County,54,38,16
34,New Jersey,33,New Hampshire,3,Carroll County,0,18,-18
34,New Jersey,33,New Hampshire,5,Cheshire County,27,13,14
34,New Jersey,33,New Hampshire,7,Coos County,0,7,-7
34,New Jersey,33,New Hampshire,9,Grafton County,25,161,-136
34,New Jersey,33,New Hampshire,11,Hillsborough County,145,182,-37
34,New Jersey,33,New Hampshire,13,Merrimack County,31,8,23
34,New Jersey,33,New Hampshire,15,Rockingham County,3,107,-104
34,New Jersey,33,New Hampshire,17,Strafford County,45,134,-89
34,New Jersey,33,New Hampshire,19,Sullivan County,38,0,38
34,New Jersey,34,New Jersey,1,Atlantic County,6882,6541,341
34,New Jersey,34,New Jersey,3,Bergen County,15025,14391,634
34,New Jersey,34,New Jersey,5,Burlington County,10117,10769,-652
34,New Jersey,34,New Jersey,7,Camden County,12220,13450,-1230
34,New Jersey,34,New Jersey,9,Cape May County,2596,1970,626
34,New Jersey,34,New Jersey,11,Cumberland County,4543,5151,-608
34,New Jersey,34,New Jersey,13,Essex County,18426,14496,3930
34,New Jersey,34,New Jersey,15,Gloucester County,7961,9375,-1414
34,New Jersey,34,New Jersey,17,Hudson County,18715,10398,8317
34,New Jersey,34,New Jersey,19,Hunterdon County,3811,4792,-981
34,New Jersey,34,New Jersey,21,Mercer County,9363,12743,-3380
34,New Jersey,34,New Jersey,23,Middlesex County,22888,20250,2638
34,New Jersey,34,New Jersey,25,Monmouth County,11420,13009,-1589
34,New Jersey,34,New Jersey,27,Morris County,10662,11273,-611
34,New Jersey,34,New Jersey,29,Ocean County,9650,13471,-3821
34,New Jersey,34,New Jersey,31,Passaic County,10370,9561,809
34,New Jersey,34,New Jersey,33,Salem County,1962,1537,425
34,New Jersey,34,New Jersey,35,Somerset County,9820,10424,-604
34,New Jersey,34,New Jersey,37,Sussex County,2986,3749,-763
34,New Jersey,34,New Jersey,39,Union County,12466,12707,-241
34,New Jersey,34,New Jersey,41,Warren County,1652,3478,-1826
34,New Jersey,35,New Mexico,1,Bernalillo County,325,173,152
34,New Jersey,35,New Mexico,5,Chaves County,14,0,14
34,New Jersey,35,New Mexico,9,Curry County,0,17,-17
34,New Jersey,35,New Mexico,13,Doña Ana County,9,62,-53
34,New Jersey,35,New Mexico,23,Hidalgo County,0,13,-13
34,New Jersey,35,New Mexico,27,Lincoln County,10,0,10
34,New Jersey,35,New Mexico,31,McKinley County,0,4,-4
34,New Jersey,35,New Mexico,35,Otero County,0,51,-51
34,New Jersey,35,New Mexico,41,Roosevelt County,0,14,-14
34,New Jersey,35,New Mexico,43,Sandoval County,19,0,19
34,New Jersey,35,New Mexico,47,San Miguel County,0,7,-7
34,New Jersey,35,New Mexico,49,Santa Fe County,9,12,-3
34,New Jersey,35,New Mexico,53,Socorro County,0,9,-9
34,New Jersey,35,New Mexico,61,Valencia County,0,36,-36
34,New Jersey,36,New York,1,Albany County,255,512,-257
34,New Jersey,36,New York,3,Allegany County,14,50,-36
34,New Jersey,36,New York,5,Bronx County,5587,1915,3672
34,New Jersey,36,New York,7,Broome County,231,555,-324
34,New Jersey,36,New York,9,Cattaraugus County,3,49,-46
34,New Jersey,36,New York,11,Cayuga County,0,31,-31
34,New Jersey,36,New York,13,Chautauqua County,115,24,91
34,New Jersey,36,New York,15,Chemung County,62,83,-21
34,New Jersey,36,New York,17,Chenango County,10,4,6
34,New Jersey,36,New York,19,Clinton County,12,42,-30
34,New Jersey,36,New York,21,Columbia County,10,5,5
34,New Jersey,36,New York,23,Cortland County,6,3,3
34,New Jersey,36,New York,25,Delaware County,14,43,-29
34,New Jersey,36,New York,27,Dutchess County,187,651,-464
34,New Jersey,36,New York,29,Erie County,217,365,-148
34,New Jersey,36,New York,31,Essex County,0,45,-45
34,New Jersey,36,New York,33,Franklin County,8,26,-18
34,New Jersey,36,New York,37,Genesee County,0,7,-7
34,New Jersey,36,New York,39,Greene County,145,46,99
34,New Jersey,36,New York,43,Herkimer County,42,9,33
34,New Jersey,36,New York,45,Jefferson County,187,329,-142
34,New Jersey,36,New York,47,Kings County,10539,3963,6576
34,New Jersey,36,New York,49,Lewis County,13,5,8
34,New Jersey,36,New York,53,Madison County,21,35,-14
34,New Jersey,36,New York,55,Monroe County,261,801,-540
34,New Jersey,36,New York,57,Montgomery County,16,36,-20
34,New Jersey,36,New York,59,Nassau County,1582,702,880
34,New Jersey,36,New York,61,New York County,11730,10681,1049
34,New Jersey,36,New York,63,Niagara County,46,6,40
34,New Jersey,36,New York,65,Oneida County,72,193,-121
34,New Jersey,36,New York,67,Onondaga County,374,896,-522
34,New Jersey,36,New York,69,Ontario County,20,73,-53
34,New Jersey,36,New York,71,Orange County,1066,851,215
34,New Jersey,36,New York,73,Orleans County,0,37,-37
34,New Jersey,36,New York,75,Oswego County,3,80,-77
34,New Jersey,36,New York,77,Otsego County,44,85,-41
34,New Jersey,36,New York,79,Putnam County,48,34,14
34,New Jersey,36,New York,81,Queens County,7755,3272,4483
34,New Jersey,36,New York,83,Rensselaer County,47,282,-235
34,New Jersey,36,New York,85,Richmond County,3202,601,2601
34,New Jersey,36,New York,87,Rockland County,1637,1101,536
34,New Jersey,36,New York,89,St. Lawrence County,12,54,-42
34,New Jersey,36,New York,91,Saratoga County,92,161,-69
34,New Jersey,36,New York,93,Schenectady County,32,176,-144
34,New Jersey,36,New York,95,Schoharie County,0,15,-15
34,New Jersey,36,New York,97,Schuyler County,0,5,-5
34,New Jersey,36,New York,99,Seneca County,0,24,-24
34,New Jersey,36,New York,101,Steuben County,62,27,35
34,New Jersey,36,New York,103,Suffolk County,1567,924,643
34,New Jersey,36,New York,105,Sullivan County,15,228,-213
34,New Jersey,36,New York,107,Tioga County,38,73,-35
34,New Jersey,36,New York,109,Tompkins County,212,788,-576
34,New Jersey,36,New York,111,Ulster County,95,133,-38
34,New Jersey,36,New York,113,Warren County,29,14,15
34,New Jersey,36,New York,115,Washington County,8,47,-39
34,New Jersey,36,New York,117,Wayne County,6,50,-44
34,New Jersey,36,New York,119,Westchester County,1908,1675,233
34,New Jersey,36,New York,121,Wyoming County,220,0,220
34,New Jersey,36,New York,123,Yates County,0,18,-18
34,New Jersey,37,North Carolina,1,Alamance County,50,301,-251
34,New Jersey,37,North Carolina,5,Alleghany County,11,10,1
34,New Jersey,37,North Carolina,13,Beaufort County,0,52,-52
34,New Jersey,37,North Carolina,17,Bladen County,0,48,-48
34,New Jersey,37,North Carolina,19,Brunswick County,36,337,-301
34,New Jersey,37,North Carolina,21,Buncombe County,22,145,-123
34,New Jersey,37,North Carolina,25,Cabarrus County,75,462,-387
34,New Jersey,37,North Carolina,31,Carteret County,0,195,-195
34,New Jersey,37,North Carolina,33,Caswell County,0,15,-15
34,New Jersey,37,North Carolina,35,Catawba County,0,113,-113
34,New Jersey,37,North Carolina,37,Chatham County,0,24,-24
34,New Jersey,37,North Carolina,41,Chowan County,16,26,-10
34,New Jersey,37,North Carolina,43,Clay County,0,11,-11
34,New Jersey,37,North Carolina,45,Cleveland County,78,24,54
34,New Jersey,37,North Carolina,49,Craven County,0,90,-90
34,New Jersey,37,North Carolina,51,Cumberland County,146,184,-38
34,New Jersey,37,North Carolina,55,Dare County,21,9,12
34,New Jersey,37,North Carolina,57,Davidson County,0,8,-8
34,New Jersey,37,North Carolina,59,Davie County,0,4,-4
34,New Jersey,37,North Carolina,61,Duplin County,0,12,-12
34,New Jersey,37,North Carolina,63,Durham County,312,267,45
34,New Jersey,37,North Carolina,65,Edgecombe County,0,19,-19
34,New Jersey,37,North Carolina,67,Forsyth County,97,346,-249
34,New Jersey,37,North Carolina,69,Franklin County,16,56,-40
34,New Jersey,37,North Carolina,71,Gaston County,151,193,-42
34,New Jersey,37,North Carolina,77,Granville County,30,116,-86
34,New Jersey,37,North Carolina,79,Greene County,0,20,-20
34,New Jersey,37,North Carolina,81,Guilford County,171,517,-346
34,New Jersey,37,North Carolina,83,Halifax County,20,15,5
34,New Jersey,37,North Carolina,85,Harnett County,0,210,-210
34,New Jersey,37,North Carolina,87,Haywood County,59,0,59
34,New Jersey,37,North Carolina,89,Henderson County,26,36,-10
34,New Jersey,37,North Carolina,91,Hertford County,0,32,-32
34,New Jersey,37,North Carolina,93,Hoke County,0,31,-31
34,New Jersey,37,North Carolina,97,Iredell County,5,164,-159
34,New Jersey,37,North Carolina,99,Jackson County,0,15,-15
34,New Jersey,37,North Carolina,101,Johnston County,10,58,-48
34,New Jersey,37,North Carolina,105,Lee County,0,77,-77
34,New Jersey,37,North Carolina,107,Lenoir County,13,16,-3
34,New Jersey,37,North Carolina,109,Lincoln County,9,0,9
34,New Jersey,37,North Carolina,111,McDowell County,0,33,-33
34,New Jersey,37,North Carolina,113,Macon County,0,30,-30
34,New Jersey,37,North Carolina,119,Mecklenburg County,696,2440,-1744
34,New Jersey,37,North Carolina,123,Montgomery County,0,3,-3
34,New Jersey,37,North Carolina,125,Moore County,32,47,-15
34,New Jersey,37,North Carolina,127,Nash County,0,7,-7
34,New Jersey,37,North Carolina,129,New Hanover County,99,305,-206
34,New Jersey,37,North Carolina,131,Northampton County,0,29,-29
34,New Jersey,37,North Carolina,133,Onslow County,86,335,-249
34,New Jersey,37,North Carolina,135,Orange County,55,328,-273
34,New Jersey,37,North Carolina,139,Pasquotank County,83,166,-83
34,New Jersey,37,North Carolina,141,Pender County,57,14,43
34,New Jersey,37,North Carolina,143,Perquimans County,0,21,-21
34,New Jersey,37,North Carolina,145,Person County,0,4,-4
34,New Jersey,37,North Carolina,147,Pitt County,0,247,-247
34,New Jersey,37,North Carolina,149,Polk County,0,6,-6
34,New Jersey,37,North Carolina,151,Randolph County,9,76,-67
34,New Jersey,37,North Carolina,155,Robeson County,41,19,22
34,New Jersey,37,North Carolina,157,Rockingham County,0,86,-86
34,New Jersey,37,North Carolina,159,Rowan County,0,43,-43
34,New Jersey,37,North Carolina,161,Rutherford County,13,40,-27
34,New Jersey,37,North Carolina,163,Sampson County,0,10,-10
34,New Jersey,37,North Carolina,165,Scotland County,0,23,-23
34,New Jersey,37,North Carolina,167,Stanly County,0,5,-5
34,New Jersey,37,North Carolina,169,Stokes County,4,10,-6
34,New Jersey,37,North Carolina,171,Surry County,81,42,39
34,New Jersey,37,North Carolina,177,Tyrrell County,48,0,48
34,New Jersey,37,North Carolina,179,Union County,0,212,-212
34,New Jersey,37,North Carolina,181,Vance County,4,109,-105
34,New Jersey,37,North Carolina,183,Wake County,767,1938,-1171
34,New Jersey,37,North Carolina,189,Watauga County,38,18,20
34,New Jersey,37,North Carolina,191,Wayne County,173,38,135
34,New Jersey,37,North Carolina,195,Wilson County,0,198,-198
34,New Jersey,37,North Carolina,199,Yancey County,4,12,-8
34,New Jersey,38,North Dakota,15,Burleigh County,57,26,31
34,New Jersey,38,North Dakota,17,Cass County,0,168,-168
34,New Jersey,38,North Dakota,35,Grand Forks County,0,61,-61
34,New Jersey,38,North Dakota,59,Morton County,50,0,50
34,New Jersey,38,North Dakota,61,Mountrail County,20,0,20
34,New Jersey,38,North Dakota,101,Ward County,0,4,-4
34,New Jersey,38,North Dakota,103,Wells County,24,0,24
34,New Jersey,39,Ohio,1,Adams County,0,1,-1
34,New Jersey,39,Ohio,3,Allen County,13,2,11
34,New Jersey,39,Ohio,5,Ashland County,0,7,-7
34,New Jersey,39,Ohio,7,Ashtabula County,7,30,-23
34,New Jersey,39,Ohio,9,Athens County,106,73,33
34,New Jersey,39,Ohio,13,Belmont County,8,0,8
34,New Jersey,39,Ohio,17,Butler County,48,142,-94
34,New Jersey,39,Ohio,23,Clark County,0,43,-43
34,New Jersey,39,Ohio,25,Clermont County,0,161,-161
34,New Jersey,39,Ohio,27,Clinton County,0,9,-9
34,New Jersey,39,Ohio,29,Columbiana County,0,15,-15
34,New Jersey,39,Ohio,35,Cuyahoga County,177,409,-232
34,New Jersey,39,Ohio,41,Delaware County,0,23,-23
34,New Jersey,39,Ohio,45,Fairfield County,0,48,-48
34,New Jersey,39,Ohio,49,Franklin County,377,903,-526
34,New Jersey,39,Ohio,57,Greene County,13,35,-22
34,New Jersey,39,Ohio,59,Guernsey County,5,0,5
34,New Jersey,39,Ohio,61,Hamilton County,170,211,-41
34,New Jersey,39,Ohio,63,Hancock County,0,17,-17
34,New Jersey,39,Ohio,75,Holmes County,0,3,-3
34,New Jersey,39,Ohio,81,Jefferson County,0,21,-21
34,New Jersey,39,Ohio,83,Knox County,0,16,-16
34,New Jersey,39,Ohio,85,Lake County,11,45,-34
34,New Jersey,39,Ohio,89,Licking County,37,116,-79
34,New Jersey,39,Ohio,93,Lorain County,0,119,-119
34,New Jersey,39,Ohio,95,Lucas County,11,117,-106
34,New Jersey,39,Ohio,99,Mahoning County,26,22,4
34,New Jersey,39,Ohio,105,Meigs County,0,79,-79
34,New Jersey,39,Ohio,107,Mercer County,222,0,222
34,New Jersey,39,Ohio,109,Miami County,0,10,-10
34,New Jersey,39,Ohio,113,Montgomery County,33,103,-70
34,New Jersey,39,Ohio,119,Muskingum County,0,2,-2
34,New Jersey,39,Ohio,123,Ottawa County,0,10,-10
34,New Jersey,39,Ohio,133,Portage County,42,232,-190
34,New Jersey,39,Ohio,141,Ross County,0,5,-5
34,New Jersey,39,Ohio,143,Sandusky County,41,0,41
34,New Jersey,39,Ohio,145,Scioto County,0,23,-23
34,New Jersey,39,Ohio,151,Stark County,24,54,-30
34,New Jersey,39,Ohio,153,Summit County,13,167,-154
34,New Jersey,39,Ohio,155,Trumbull County,0,58,-58
34,New Jersey,39,Ohio,159,Union County,0,41,-41
34,New Jersey,39,Ohio,165,Warren County,74,123,-49
34,New Jersey,39,Ohio,169,Wayne County,10,34,-24
34,New Jersey,39,Ohio,173,Wood County,35,90,-55
34,New Jersey,4,Arizona,1,Apache County,0,6,-6
34,New Jersey,4,Arizona,3,Cochise County,32,36,-4
34,New Jersey,4,Arizona,5,Coconino County,6,12,-6
34,New Jersey,4,Arizona,13,Maricopa County,815,2541,-1726
34,New Jersey,4,Arizona,15,Mohave County,7,71,-64
34,New Jersey,4,Arizona,19,Pima County,190,485,-295
34,New Jersey,4,Arizona,21,Pinal County,0,216,-216
34,New Jersey,4,Arizona,25,Yavapai County,15,70,-55
34,New Jersey,4,Arizona,27,Yuma County,17,0,17
34,New Jersey,40,Oklahoma,17,Canadian County,0,40,-40
34,New Jersey,40,Oklahoma,25,Cimarron County,0,1,-1
34,New Jersey,40,Oklahoma,27,Cleveland County,17,82,-65
34,New Jersey,40,Oklahoma,31,Comanche County,13,109,-96
34,New Jersey,40,Oklahoma,39,Custer County,14,0,14
34,New Jersey,40,Oklahoma,47,Garfield County,3,0,3
34,New Jersey,40,Oklahoma,65,Jackson County,0,53,-53
34,New Jersey,40,Oklahoma,77,Latimer County,0,8,-8
34,New Jersey,40,Oklahoma,105,Nowata County,0,1,-1
34,New Jersey,40,Oklahoma,109,Oklahoma County,82,79,3
34,New Jersey,40,Oklahoma,111,Okmulgee County,11,0,11
34,New Jersey,40,Oklahoma,119,Payne County,49,7,42
34,New Jersey,40,Oklahoma,123,Pontotoc County,0,6,-6
34,New Jersey,40,Oklahoma,143,Tulsa County,19,149,-130
34,New Jersey,40,Oklahoma,147,Washington County,15,0,15
34,New Jersey,41,Oregon,3,Benton County,10,21,-11
34,New Jersey,41,Oregon,5,Clackamas County,60,31,29
34,New Jersey,41,Oregon,7,Clatsop County,94,1,93
34,New Jersey,41,Oregon,11,Coos County,30,1,29
34,New Jersey,41,Oregon,15,Curry County,0,1,-1
34,New Jersey,41,Oregon,17,Deschutes County,25,42,-17
34,New Jersey,41,Oregon,19,Douglas County,9,0,9
34,New Jersey,41,Oregon,27,Hood River County,0,3,-3
34,New Jersey,41,Oregon,33,Josephine County,27,0,27
34,New Jersey,41,Oregon,39,Lane County,0,91,-91
34,New Jersey,41,Oregon,41,Lincoln County,0,1,-1
34,New Jersey,41,Oregon,43,Linn County,0,4,-4
34,New Jersey,41,Oregon,47,Marion County,22,65,-43
34,New Jersey,41,Oregon,51,Multnomah County,105,339,-234
34,New Jersey,41,Oregon,61,Union County,0,8,-8
34,New Jersey,41,Oregon,67,Washington County,181,40,141
34,New Jersey,41,Oregon,71,Yamhill County,14,0,14
34,New Jersey,42,Pennsylvania,1,Adams County,37,333,-296
34,New Jersey,42,Pennsylvania,3,Allegheny County,568,1542,-974
34,New Jersey,42,Pennsylvania,5,Armstrong County,0,17,-17
34,New Jersey,42,Pennsylvania,7,Beaver County,22,3,19
34,New Jersey,42,Pennsylvania,9,Bedford County,0,9,-9
34,New Jersey,42,Pennsylvania,11,Berks County,567,981,-414
34,New Jersey,42,Pennsylvania,13,Blair County,70,224,-154
34,New Jersey,42,Pennsylvania,15,Bradford County,19,8,11
34,New Jersey,42,Pennsylvania,17,Bucks County,2797,4521,-1724
34,New Jersey,42,Pennsylvania,19,Butler County,25,91,-66
34,New Jersey,42,Pennsylvania,21,Cambria County,56,208,-152
34,New Jersey,42,Pennsylvania,25,Carbon County,125,212,-87
34,New Jersey,42,Pennsylvania,27,Centre County,362,1526,-1164
34,New Jersey,42,Pennsylvania,29,Chester County,614,1371,-757
34,New Jersey,42,Pennsylvania,31,Clarion County,0,24,-24
34,New Jersey,42,Pennsylvania,33,Clearfield County,0,196,-196
34,New Jersey,42,Pennsylvania,35,Clinton County,6,62,-56
34,New Jersey,42,Pennsylvania,37,Columbia County,276,196,80
34,New Jersey,42,Pennsylvania,39,Crawford County,0,12,-12
34,New Jersey,42,Pennsylvania,41,Cumberland County,170,603,-433
34,New Jersey,42,Pennsylvania,43,Dauphin County,154,503,-349
34,New Jersey,42,Pennsylvania,45,Delaware County,1523,2028,-505
34,New Jersey,42,Pennsylvania,47,Elk County,0,7,-7
34,New Jersey,42,Pennsylvania,49,Erie County,56,177,-121
34,New Jersey,42,Pennsylvania,51,Fayette County,3,3,0
34,New Jersey,42,Pennsylvania,55,Franklin County,11,145,-134
34,New Jersey,42,Pennsylvania,59,Greene County,0,20,-20
34,New Jersey,42,Pennsylvania,61,Huntingdon County,0,38,-38
34,New Jersey,42,Pennsylvania,63,Indiana County,60,92,-32
34,New Jersey,42,Pennsylvania,65,Jefferson County,0,11,-11
34,New Jersey,42,Pennsylvania,69,Lackawanna County,325,925,-600
34,New Jersey,42,Pennsylvania,71,Lancaster County,354,526,-172
34,New Jersey,42,Pennsylvania,73,Lawrence County,0,7,-7
34,New Jersey,42,Pennsylvania,75,Lebanon County,67,16,51
34,New Jersey,42,Pennsylvania,77,Lehigh County,567,1753,-1186
34,New Jersey,42,Pennsylvania,79,Luzerne County,218,1227,-1009
34,New Jersey,42,Pennsylvania,81,Lycoming County,88,228,-140
34,New Jersey,42,Pennsylvania,83,McKean County,37,21,16
34,New Jersey,42,Pennsylvania,85,Mercer County,23,32,-9
34,New Jersey,42,Pennsylvania,87,Mifflin County,11,0,11
34,New Jersey,42,Pennsylvania,89,Monroe County,666,1657,-991
34,New Jersey,42,Pennsylvania,91,Montgomery County,1649,2850,-1201
34,New Jersey,42,Pennsylvania,93,Montour County,37,45,-8
34,New Jersey,42,Pennsylvania,95,Northampton County,881,2750,-1869
34,New Jersey,42,Pennsylvania,97,Northumberland County,22,55,-33
34,New Jersey,42,Pennsylvania,99,Perry County,26,24,2
34,New Jersey,42,Pennsylvania,101,Philadelphia County,7432,9054,-1622
34,New Jersey,42,Pennsylvania,103,Pike County,588,818,-230
34,New Jersey,42,Pennsylvania,105,Potter County,4,11,-7
34,New Jersey,42,Pennsylvania,107,Schuylkill County,251,72,179
34,New Jersey,42,Pennsylvania,109,Snyder County,7,196,-189
34,New Jersey,42,Pennsylvania,111,Somerset County,46,6,40
34,New Jersey,42,Pennsylvania,113,Sullivan County,0,3,-3
34,New Jersey,42,Pennsylvania,115,Susquehanna County,66,47,19
34,New Jersey,42,Pennsylvania,117,Tioga County,24,13,11
34,New Jersey,42,Pennsylvania,119,Union County,120,301,-181
34,New Jersey,42,Pennsylvania,121,Venango County,20,0,20
34,New Jersey,42,Pennsylvania,125,Washington County,134,186,-52
34,New Jersey,42,Pennsylvania,127,Wayne County,16,231,-215
34,New Jersey,42,Pennsylvania,129,Westmoreland County,82,48,34
34,New Jersey,42,Pennsylvania,131,Wyoming County,0,74,-74
34,New Jersey,42,Pennsylvania,133,York County,304,474,-170
34,New Jersey,44,Rhode Island,1,Bristol County,8,59,-51
34,New Jersey,44,Rhode Island,3,Kent County,32,24,8
34,New Jersey,44,Rhode Island,5,Newport County,36,135,-99
34,New Jersey,44,Rhode Island,7,Providence County,266,934,-668
34,New Jersey,44,Rhode Island,9,Washington County,312,252,60
34,New Jersey,45,South Carolina,1,Abbeville County,0,3,-3
34,New Jersey,45,South Carolina,3,Aiken County,19,20,-1
34,New Jersey,45,South Carolina,7,Anderson County,62,12,50
34,New Jersey,45,South Carolina,11,Barnwell County,0,42,-42
34,New Jersey,45,South Carolina,13,Beaufort County,98,507,-409
34,New Jersey,45,South Carolina,15,Berkeley County,0,186,-186
34,New Jersey,45,South Carolina,19,Charleston County,227,607,-380
34,New Jersey,45,South Carolina,21,Cherokee County,0,8,-8
34,New Jersey,45,South Carolina,25,Chesterfield County,58,94,-36
34,New Jersey,45,South Carolina,31,Darlington County,0,128,-128
34,New Jersey,45,South Carolina,33,Dillon County,0,19,-19
34,New Jersey,45,South Carolina,35,Dorchester County,50,193,-143
34,New Jersey,45,South Carolina,37,Edgefield County,0,36,-36
34,New Jersey,45,South Carolina,39,Fairfield County,11,0,11
34,New Jersey,45,South Carolina,41,Florence County,25,110,-85
34,New Jersey,45,South Carolina,43,Georgetown County,34,51,-17
34,New Jersey,45,South Carolina,45,Greenville County,107,422,-315
34,New Jersey,45,South Carolina,51,Horry County,104,1174,-1070
34,New Jersey,45,South Carolina,53,Jasper County,44,25,19
34,New Jersey,45,South Carolina,55,Kershaw County,0,60,-60
34,New Jersey,45,South Carolina,63,Lexington County,37,202,-165
34,New Jersey,45,South Carolina,67,Marion County,6,0,6
34,New Jersey,45,South Carolina,73,Oconee County,18,42,-24
34,New Jersey,45,South Carolina,75,Orangeburg County,18,0,18
34,New Jersey,45,South Carolina,77,Pickens County,98,94,4
34,New Jersey,45,South Carolina,79,Richland County,174,672,-498
34,New Jersey,45,South Carolina,83,Spartanburg County,158,352,-194
34,New Jersey,45,South Carolina,85,Sumter County,91,7,84
34,New Jersey,45,South Carolina,91,York County,119,291,-172
34,New Jersey,46,South Dakota,11,Brookings County,6,3,3
34,New Jersey,46,South Dakota,13,Brown County,0,11,-11
34,New Jersey,46,South Dakota,79,Lake County,0,3,-3
34,New Jersey,46,South Dakota,93,Meade County,42,0,42
34,New Jersey,46,South Dakota,99,Minnehaha County,0,24,-24
34,New Jersey,46,South Dakota,103,Pennington County,13,0,13
34,New Jersey,46,South Dakota,121,Todd County,0,5,-5
34,New Jersey,47,Tennessee,1,Anderson County,0,4,-4
34,New Jersey,47,Tennessee,9,Blount County,35,55,-20
34,New Jersey,47,Tennessee,11,Bradley County,7,3,4
34,New Jersey,47,Tennessee,23,Chester County,0,12,-12
34,New Jersey,47,Tennessee,29,Cocke County,0,104,-104
34,New Jersey,47,Tennessee,35,Cumberland County,0,19,-19
34,New Jersey,47,Tennessee,37,Davidson County,225,317,-92
34,New Jersey,47,Tennessee,41,DeKalb County,0,9,-9
34,New Jersey,47,Tennessee,47,Fayette County,0,50,-50
34,New Jersey,47,Tennessee,53,Gibson County,0,20,-20
34,New Jersey,47,Tennessee,59,Greene County,0,33,-33
34,New Jersey,47,Tennessee,63,Hamblen County,56,0,56
34,New Jersey,47,Tennessee,65,Hamilton County,5,41,-36
34,New Jersey,47,Tennessee,71,Hardin County,0,16,-16
34,New Jersey,47,Tennessee,83,Houston County,0,19,-19
34,New Jersey,47,Tennessee,89,Jefferson County,0,19,-19
34,New Jersey,47,Tennessee,91,Johnson County,0,12,-12
34,New Jersey,47,Tennessee,93,Knox County,91,45,46
34,New Jersey,47,Tennessee,99,Lawrence County,0,4,-4
34,New Jersey,47,Tennessee,103,Lincoln County,0,6,-6
34,New Jersey,47,Tennessee,107,McMinn County,5,14,-9
34,New Jersey,47,Tennessee,113,Madison County,0,8,-8
34,New Jersey,47,Tennessee,119,Maury County,42,22,20
34,New Jersey,47,Tennessee,125,Montgomery County,277,48,229
34,New Jersey,47,Tennessee,137,Pickett County,0,11,-11
34,New Jersey,47,Tennessee,143,Rhea County,0,7,-7
34,New Jersey,47,Tennessee,147,Robertson County,0,4,-4
34,New Jersey,47,Tennessee,149,Rutherford County,11,128,-117
34,New Jersey,47,Tennessee,155,Sevier County,8,18,-10
34,New Jersey,47,Tennessee,157,Shelby County,182,64,118
34,New Jersey,47,Tennessee,165,Sumner County,32,28,4
34,New Jersey,47,Tennessee,167,Tipton County,0,33,-33
34,New Jersey,47,Tennessee,171,Unicoi County,13,14,-1
34,New Jersey,47,Tennessee,179,Washington County,0,19,-19
34,New Jersey,47,Tennessee,183,Weakley County,26,4,22
34,New Jersey,47,Tennessee,187,Williamson County,113,40,73
34,New Jersey,47,Tennessee,189,Wilson County,12,50,-38
34,New Jersey,48,Texas,1,Anderson County,0,19,-19
34,New Jersey,48,Texas,3,Andrews County,0,12,-12
34,New Jersey,48,Texas,27,Bell County,254,175,79
34,New Jersey,48,Texas,29,Bexar County,220,666,-446
34,New Jersey,48,Texas,37,Bowie County,10,5,5
34,New Jersey,48,Texas,39,Brazoria County,0,116,-116
34,New Jersey,48,Texas,41,Brazos County,13,77,-64
34,New Jersey,48,Texas,43,Brewster County,0,7,-7
34,New Jersey,48,Texas,49,Brown County,31,0,31
34,New Jersey,48,Texas,61,Cameron County,13,0,13
34,New Jersey,48,Texas,67,Cass County,0,1,-1
34,New Jersey,48,Texas,85,Collin County,678,946,-268
34,New Jersey,48,Texas,91,Comal County,16,0,16
34,New Jersey,48,Texas,99,Coryell County,0,24,-24
34,New Jersey,48,Texas,113,Dallas County,635,1108,-473
34,New Jersey,48,Texas,115,Dawson County,0,1,-1
34,New Jersey,48,Texas,121,Denton County,173,405,-232
34,New Jersey,48,Texas,139,Ellis County,0,30,-30
34,New Jersey,48,Texas,141,El Paso County,170,99,71
34,New Jersey,48,Texas,147,Fannin County,0,13,-13
34,New Jersey,48,Texas,157,Fort Bend County,136,509,-373
34,New Jersey,48,Texas,167,Galveston County,49,130,-81
34,New Jersey,48,Texas,187,Guadalupe County,49,11,38
34,New Jersey,48,Texas,201,Harris County,948,1789,-841
34,New Jersey,48,Texas,203,Harrison County,0,8,-8
34,New Jersey,48,Texas,209,Hays County,47,60,-13
34,New Jersey,48,Texas,215,Hidalgo County,63,45,18
34,New Jersey,48,Texas,217,Hill County,0,3,-3
34,New Jersey,48,Texas,227,Howard County,0,35,-35
34,New Jersey,48,Texas,231,Hunt County,29,0,29
34,New Jersey,48,Texas,245,Jefferson County,4,16,-12
34,New Jersey,48,Texas,251,Johnson County,38,10,28
34,New Jersey,48,Texas,253,Jones County,0,4,-4
34,New Jersey,48,Texas,303,Lubbock County,18,19,-1
34,New Jersey,48,Texas,309,McLennan County,16,21,-5
34,New Jersey,48,Texas,323,Maverick County,0,7,-7
34,New Jersey,48,Texas,331,Milam County,0,6,-6
34,New Jersey,48,Texas,339,Montgomery County,96,153,-57
34,New Jersey,48,Texas,343,Morris County,0,16,-16
34,New Jersey,48,Texas,355,Nueces County,11,72,-61
34,New Jersey,48,Texas,359,Oldham County,0,8,-8
34,New Jersey,48,Texas,373,Polk County,0,10,-10
34,New Jersey,48,Texas,389,Reeves County,0,1,-1
34,New Jersey,48,Texas,405,San Augustine County,0,2,-2
34,New Jersey,48,Texas,407,San Jacinto County,90,0,90
34,New Jersey,48,Texas,409,San Patricio County,0,1,-1
34,New Jersey,48,Texas,415,Scurry County,31,0,31
34,New Jersey,48,Texas,423,Smith County,17,8,9
34,New Jersey,48,Texas,439,Tarrant County,428,511,-83
34,New Jersey,48,Texas,441,Taylor County,124,36,88
34,New Jersey,48,Texas,453,Travis County,420,566,-146
34,New Jersey,48,Texas,465,Val Verde County,17,44,-27
34,New Jersey,48,Texas,469,Victoria County,13,136,-123
34,New Jersey,48,Texas,471,Walker County,0,7,-7
34,New Jersey,48,Texas,485,Wichita County,0,102,-102
34,New Jersey,48,Texas,491,Williamson County,11,453,-442
34,New Jersey,49,Utah,5,Cache County,0,24,-24
34,New Jersey,49,Utah,7,Carbon County,16,0,16
34,New Jersey,49,Utah,11,Davis County,16,48,-32
34,New Jersey,49,Utah,13,Duchesne County,0,1,-1
34,New Jersey,49,Utah,35,Salt Lake County,75,202,-127
34,New Jersey,49,Utah,39,Sanpete County,0,7,-7
34,New Jersey,49,Utah,41,Sevier County,0,2,-2
34,New Jersey,49,Utah,43,Summit County,9,34,-25
34,New Jersey,49,Utah,49,Utah County,70,309,-239
34,New Jersey,49,Utah,53,Washington County,0,37,-37
34,New Jersey,49,Utah,57,Weber County,0,87,-87
34,New Jersey,5,Arkansas,7,Benton County,80,33,47
34,New Jersey,5,Arkansas,9,Boone County,11,0,11
34,New Jersey,5,Arkansas,31,Craighead County,41,0,41
34,New Jersey,5,Arkansas,45,Faulkner County,0,12,-12
34,New Jersey,5,Arkansas,67,Jackson County,0,3,-3
34,New Jersey,5,Arkansas,71,Johnson County,0,1,-1
34,New Jersey,5,Arkansas,85,Lonoke County,3,35,-32
34,New Jersey,5,Arkansas,115,Pope County,0,20,-20
34,New Jersey,5,Arkansas,119,Pulaski County,76,98,-22
34,New Jersey,5,Arkansas,125,Saline County,5,6,-1
34,New Jersey,5,Arkansas,143,Washington County,0,59,-59
34,New Jersey,5,Arkansas,145,White County,8,0,8
34,New Jersey,50,Vermont,1,Addison County,0,35,-35
34,New Jersey,50,Vermont,3,Bennington County,30,45,-15
34,New Jersey,50,Vermont,5,Caledonia County,0,4,-4
34,New Jersey,50,Vermont,7,Chittenden County,150,617,-467
34,New Jersey,50,Vermont,11,Franklin County,0,3,-3
34,New Jersey,50,Vermont,15,Lamoille County,41,12,29
34,New Jersey,50,Vermont,17,Orange County,0,4,-4
34,New Jersey,50,Vermont,19,Orleans County,0,10,-10
34,New Jersey,50,Vermont,21,Rutland County,122,85,37
34,New Jersey,50,Vermont,23,Washington County,13,87,-74
34,New Jersey,50,Vermont,25,Windham County,8,70,-62
34,New Jersey,50,Vermont,27,Windsor County,0,34,-34
34,New Jersey,51,Virginia,1,Accomack County,14,38,-24
34,New Jersey,51,Virginia,3,Albemarle County,103,297,-194
34,New Jersey,51,Virginia,9,Amherst County,0,6,-6
34,New Jersey,51,Virginia,13,Arlington County,626,262,364
34,New Jersey,51,Virginia,19,Bedford County,81,83,-2
34,New Jersey,51,Virginia,23,Botetourt County,0,39,-39
34,New Jersey,51,Virginia,25,Brunswick County,0,5,-5
34,New Jersey,51,Virginia,27,Buchanan County,0,41,-41
34,New Jersey,51,Virginia,29,Buckingham County,9,24,-15
34,New Jersey,51,Virginia,31,Campbell County,20,0,20
34,New Jersey,51,Virginia,36,Charles City County,0,2,-2
34,New Jersey,51,Virginia,37,Charlotte County,0,13,-13
34,New Jersey,51,Virginia,41,Chesterfield County,20,180,-160
34,New Jersey,51,Virginia,47,Culpeper County,0,114,-114
34,New Jersey,51,Virginia,53,Dinwiddie County,0,5,-5
34,New Jersey,51,Virginia,59,Fairfax County,629,1378,-749
34,New Jersey,51,Virginia,61,Fauquier County,3,13,-10
34,New Jersey,51,Virginia,65,Fluvanna County,30,16,14
34,New Jersey,51,Virginia,67,Franklin County,0,18,-18
34,New Jersey,51,Virginia,69,Frederick County,0,32,-32
34,New Jersey,51,Virginia,73,Gloucester County,0,56,-56
34,New Jersey,51,Virginia,75,Goochland County,0,3,-3
34,New Jersey,51,Virginia,79,Greene County,0,76,-76
34,New Jersey,51,Virginia,83,Halifax County,57,0,57
34,New Jersey,51,Virginia,85,Hanover County,7,101,-94
34,New Jersey,51,Virginia,87,Henrico County,148,488,-340
34,New Jersey,51,Virginia,93,Isle of Wight County,67,12,55
34,New Jersey,51,Virginia,95,James City County,54,59,-5
34,New Jersey,51,Virginia,99,King George County,0,25,-25
34,New Jersey,51,Virginia,103,Lancaster County,14,0,14
34,New Jersey,51,Virginia,107,Loudoun County,133,369,-236
34,New Jersey,51,Virginia,117,Mecklenburg County,0,63,-63
34,New Jersey,51,Virginia,121,Montgomery County,50,351,-301
34,New Jersey,51,Virginia,127,New Kent County,0,14,-14
34,New Jersey,51,Virginia,131,Northampton County,12,0,12
34,New Jersey,51,Virginia,135,Nottoway County,0,25,-25
34,New Jersey,51,Virginia,137,Orange County,28,74,-46
34,New Jersey,51,Virginia,141,Patrick County,0,40,-40
34,New Jersey,51,Virginia,143,Pittsylvania County,0,63,-63
34,New Jersey,51,Virginia,145,Powhatan County,13,0,13
34,New Jersey,51,Virginia,147,Prince Edward County,0,44,-44
34,New Jersey,51,Virginia,149,Prince George County,0,49,-49
34,New Jersey,51,Virginia,153,Prince William County,440,382,58
34,New Jersey,51,Virginia,159,Richmond County,0,2,-2
34,New Jersey,51,Virginia,161,Roanoke County,51,29,22
34,New Jersey,51,Virginia,165,Rockingham County,0,38,-38
34,New Jersey,51,Virginia,169,Scott County,0,5,-5
34,New Jersey,51,Virginia,171,Shenandoah County,0,14,-14
34,New Jersey,51,Virginia,177,Spotsylvania County,20,116,-96
34,New Jersey,51,Virginia,179,Stafford County,18,76,-58
34,New Jersey,51,Virginia,183,Sussex County,0,3,-3
34,New Jersey,51,Virginia,185,Tazewell County,3,2,1
34,New Jersey,51,Virginia,199,York County,92,145,-53
34,New Jersey,51,Virginia,510,Alexandria city,128,77,51
34,New Jersey,51,Virginia,540,Charlottesville city,54,44,10
34,New Jersey,51,Virginia,550,Chesapeake city,86,277,-191
34,New Jersey,51,Virginia,590,Danville city,0,87,-87
34,New Jersey,51,Virginia,595,Emporia city,0,138,-138
34,New Jersey,51,Virginia,600,Fairfax city,11,0,11
34,New Jersey,51,Virginia,610,Falls Church city,0,37,-37
34,New Jersey,51,Virginia,630,Fredericksburg city,33,54,-21
34,New Jersey,51,Virginia,650,Hampton city,47,202,-155
34,New Jersey,51,Virginia,660,Harrisonburg city,44,294,-250
34,New Jersey,51,Virginia,678,Lexington city,26,51,-25
34,New Jersey,51,Virginia,680,Lynchburg city,310,173,137
34,New Jersey,51,Virginia,683,Manassas city,24,0,24
34,New Jersey,51,Virginia,700,Newport News city,253,142,111
34,New Jersey,51,Virginia,710,Norfolk city,347,396,-49
34,New Jersey,51,Virginia,730,Petersburg city,37,13,24
34,New Jersey,51,Virginia,740,Portsmouth city,0,178,-178
34,New Jersey,51,Virginia,750,Radford city,0,4,-4
34,New Jersey,51,Virginia,760,Richmond city,101,550,-449
34,New Jersey,51,Virginia,770,Roanoke city,68,222,-154
34,New Jersey,51,Virginia,775,Salem city,15,85,-70
34,New Jersey,51,Virginia,790,Staunton city,0,9,-9
34,New Jersey,51,Virginia,800,Suffolk city,25,106,-81
34,New Jersey,51,Virginia,810,Virginia Beach city,220,309,-89
34,New Jersey,51,Virginia,820,Waynesboro city,0,7,-7
34,New Jersey,51,Virginia,830,Williamsburg city,78,113,-35
34,New Jersey,51,Virginia,840,Winchester city,0,32,-32
34,New Jersey,53,Washington,5,Benton County,37,18,19
34,New Jersey,53,Washington,9,Clallam County,9,0,9
34,New Jersey,53,Washington,11,Clark County,49,151,-102
34,New Jersey,53,Washington,17,Douglas County,0,7,-7
34,New Jersey,53,Washington,27,Grays Harbor County,0,1,-1
34,New Jersey,53,Washington,31,Jefferson County,0,100,-100
34,New Jersey,53,Washington,33,King County,452,1734,-1282
34,New Jersey,53,Washington,35,Kitsap County,32,80,-48
34,New Jersey,53,Washington,41,Lewis County,0,1,-1
34,New Jersey,53,Washington,47,Okanogan County,0,2,-2
34,New Jersey,53,Washington,53,Pierce County,139,202,-63
34,New Jersey,53,Washington,57,Skagit County,0,10,-10
34,New Jersey,53,Washington,61,Snohomish County,87,135,-48
34,New Jersey,53,Washington,63,Spokane County,49,133,-84
34,New Jersey,53,Washington,65,Stevens County,0,2,-2
34,New Jersey,53,Washington,67,Thurston County,75,90,-15
34,New Jersey,53,Washington,73,Whatcom County,0,6,-6
34,New Jersey,53,Washington,75,Whitman County,7,0,7
34,New Jersey,53,Washington,77,Yakima County,12,16,-4
34,New Jersey,54,West Virginia,1,Barbour County,0,3,-3
34,New Jersey,54,West Virginia,3,Berkeley County,13,0,13
34,New Jersey,54,West Virginia,5,Boone County,11,0,11
34,New Jersey,54,West Virginia,11,Cabell County,69,11,58
34,New Jersey,54,West Virginia,21,Gilmer County,29,6,23
34,New Jersey,54,West Virginia,31,Hardy County,0,34,-34
34,New Jersey,54,West Virginia,33,Harrison County,15,3,12
34,New Jersey,54,West Virginia,37,Jefferson County,0,5,-5
34,New Jersey,54,West Virginia,39,Kanawha County,9,7,2
34,New Jersey,54,West Virginia,49,Marion County,11,49,-38
34,New Jersey,54,West Virginia,55,Mercer County,20,6,14
34,New Jersey,54,West Virginia,59,Mingo County,0,2,-2
34,New Jersey,54,West Virginia,61,Monongalia County,154,401,-247
34,New Jersey,54,West Virginia,69,Ohio County,29,39,-10
34,New Jersey,54,West Virginia,75,Pocahontas County,0,3,-3
34,New Jersey,54,West Virginia,77,Preston County,34,12,22
34,New Jersey,54,West Virginia,81,Raleigh County,13,39,-26
34,New Jersey,54,West Virginia,83,Randolph County,0,7,-7
34,New Jersey,54,West Virginia,89,Summers County,0,1,-1
34,New Jersey,54,West Virginia,97,Upshur County,0,106,-106
34,New Jersey,54,West Virginia,99,Wayne County,37,0,37
34,New Jersey,54,West Virginia,107,Wood County,0,5,-5
34,New Jersey,55,Wisconsin,3,Ashland County,18,0,18
34,New Jersey,55,Wisconsin,9,Brown County,39,33,6
34,New Jersey,55,Wisconsin,15,Calumet County,0,35,-35
34,New Jersey,55,Wisconsin,23,Crawford County,0,2,-2
34,New Jersey,55,Wisconsin,25,Dane County,266,225,41
34,New Jersey,55,Wisconsin,27,Dodge County,0,9,-9
34,New Jersey,55,Wisconsin,31,Douglas County,0,13,-13
34,New Jersey,55,Wisconsin,33,Dunn County,0,30,-30
34,New Jersey,55,Wisconsin,35,Eau Claire County,0,52,-52
34,New Jersey,55,Wisconsin,39,Fond du Lac County,8,0,8
34,New Jersey,55,Wisconsin,45,Green County,0,5,-5
34,New Jersey,55,Wisconsin,57,Juneau County,0,1,-1
34,New Jersey,55,Wisconsin,63,La Crosse County,26,0,26
34,New Jersey,55,Wisconsin,75,Marinette County,0,6,-6
34,New Jersey,55,Wisconsin,79,Milwaukee County,115,247,-132
34,New Jersey,55,Wisconsin,81,Monroe County,0,1,-1
34,New Jersey,55,Wisconsin,87,Outagamie County,25,22,3
34,New Jersey,55,Wisconsin,97,Portage County,24,0,24
34,New Jersey,55,Wisconsin,101,Racine County,0,18,-18
34,New Jersey,55,Wisconsin,105,Rock County,0,10,-10
34,New Jersey,55,Wisconsin,111,Sauk County,0,5,-5
34,New Jersey,55,Wisconsin,115,Shawano County,0,54,-54
34,New Jersey,55,Wisconsin,121,Trempealeau County,0,1,-1
34,New Jersey,55,Wisconsin,127,Walworth County,0,55,-55
34,New Jersey,55,Wisconsin,129,Washburn County,0,4,-4
34,New Jersey,55,Wisconsin,133,Waukesha County,0,35,-35
34,New Jersey,55,Wisconsin,137,Waushara County,101,0,101
34,New Jersey,55,Wisconsin,139,Winnebago County,0,6,-6
34,New Jersey,56,Wyoming,1,Albany County,0,42,-42
34,New Jersey,56,Wyoming,5,Campbell County,3,0,3
34,New Jersey,56,Wyoming,21,Laramie County,38,25,13
34,New Jersey,56,Wyoming,25,Natrona County,7,0,7
34,New Jersey,56,Wyoming,29,Park County,0,26,-26
34,New Jersey,56,Wyoming,39,Teton County,13,0,13
34,New Jersey,6,California,1,Alameda County,655,1354,-699
34,New Jersey,6,California,7,Butte County,27,11,16
34,New Jersey,6,California,13,Contra Costa County,167,588,-421
34,New Jersey,6,California,15,Del Norte County,18,0,18
34,New Jersey,6,California,17,El Dorado County,25,5,20
34,New Jersey,6,California,19,Fresno County,79,119,-40
34,New Jersey,6,California,23,Humboldt County,52,0,52
34,New Jersey,6,California,27,Inyo County,0,2,-2
34,New Jersey,6,California,29,Kern County,28,27,1
34,New Jersey,6,California,31,Kings County,0,69,-69
34,New Jersey,6,California,37,Los Angeles County,1370,2985,-1615
34,New Jersey,6,California,41,Marin County,21,34,-13
34,New Jersey,6,California,45,Mendocino County,0,20,-20
34,New Jersey,6,California,53,Monterey County,26,114,-88
34,New Jersey,6,California,55,Napa County,0,51,-51
34,New Jersey,6,California,57,Nevada County,119,0,119
34,New Jersey,6,California,59,Orange County,592,877,-285
34,New Jersey,6,California,61,Placer County,7,27,-20
34,New Jersey,6,California,65,Riverside County,244,420,-176
34,New Jersey,6,California,67,Sacramento County,409,271,138
34,New Jersey,6,California,71,San Bernardino County,104,606,-502
34,New Jersey,6,California,73,San Diego County,990,2023,-1033
34,New Jersey,6,California,75,San Francisco County,427,292,135
34,New Jersey,6,California,77,San Joaquin County,76,36,40
34,New Jersey,6,California,79,San Luis Obispo County,9,51,-42
34,New Jersey,6,California,81,San Mateo County,220,510,-290
34,New Jersey,6,California,83,Santa Barbara County,50,88,-38
34,New Jersey,6,California,85,Santa Clara County,257,1281,-1024
34,New Jersey,6,California,87,Santa Cruz County,0,12,-12
34,New Jersey,6,California,89,Shasta County,0,13,-13
34,New Jersey,6,California,95,Solano County,218,74,144
34,New Jersey,6,California,97,Sonoma County,55,96,-41
34,New Jersey,6,California,99,Stanislaus County,0,13,-13
34,New Jersey,6,California,109,Tuolumne County,13,0,13
34,New Jersey,6,California,111,Ventura County,113,213,-100
34,New Jersey,6,California,113,Yolo County,155,61,94
34,New Jersey,72,Puerto Rico,1,Adjuntas Municipio,0,9,-9
34,New Jersey,72,Puerto Rico,3,Aguada Municipio,340,37,303
34,New Jersey,72,Puerto Rico,5,Aguadilla Municipio,4,45,-41
34,New Jersey,72,Puerto Rico,13,Arecibo Municipio,7,104,-97
34,New Jersey,72,Puerto Rico,15,Arroyo Municipio,0,12,-12
34,New Jersey,72,Puerto Rico,21,Bayamón Municipio,255,24,231
34,New Jersey,72,Puerto Rico,23,Cabo Rojo Municipio,24,0,24
34,New Jersey,72,Puerto Rico,25,Caguas Municipio,286,22,264
34,New Jersey,72,Puerto Rico,31,Carolina Municipio,24,47,-23
34,New Jersey,72,Puerto Rico,33,Cataño Municipio,14,0,14
34,New Jersey,72,Puerto Rico,35,Cayey Municipio,99,18,81
34,New Jersey,72,Puerto Rico,39,Ciales Municipio,145,0,145
34,New Jersey,72,Puerto Rico,43,Coamo Municipio,11,66,-55
34,New Jersey,72,Puerto Rico,45,Comerío Municipio,0,21,-21
34,New Jersey,72,Puerto Rico,47,Corozal Municipio,11,0,11
34,New Jersey,72,Puerto Rico,53,Fajardo Municipio,379,79,300
34,New Jersey,72,Puerto Rico,55,Guánica Municipio,0,8,-8
34,New Jersey,72,Puerto Rico,57,Guayama Municipio,54,34,20
34,New Jersey,72,Puerto Rico,59,Guayanilla Municipio,118,0,118
34,New Jersey,72,Puerto Rico,61,Guaynabo Municipio,52,24,28
34,New Jersey,72,Puerto Rico,67,Hormigueros Municipio,30,0,30
34,New Jersey,72,Puerto Rico,69,Humacao Municipio,8,16,-8
34,New Jersey,72,Puerto Rico,71,Isabela Municipio,41,0,41
34,New Jersey,72,Puerto Rico,75,Juana Díaz Municipio,0,88,-88
34,New Jersey,72,Puerto Rico,77,Juncos Municipio,40,0,40
34,New Jersey,72,Puerto Rico,79,Lajas Municipio,47,0,47
34,New Jersey,72,Puerto Rico,81,Lares Municipio,53,0,53
34,New Jersey,72,Puerto Rico,85,Las Piedras Municipio,188,0,188
34,New Jersey,72,Puerto Rico,89,Luquillo Municipio,0,76,-76
34,New Jersey,72,Puerto Rico,91,Manatí Municipio,13,18,-5
34,New Jersey,72,Puerto Rico,95,Maunabo Municipio,14,0,14
34,New Jersey,72,Puerto Rico,97,Mayagüez Municipio,113,0,113
34,New Jersey,72,Puerto Rico,99,Moca Municipio,67,75,-8
34,New Jersey,72,Puerto Rico,101,Morovis Municipio,26,44,-18
34,New Jersey,72,Puerto Rico,103,Naguabo Municipio,30,0,30
34,New Jersey,72,Puerto Rico,109,Patillas Municipio,0,24,-24
34,New Jersey,72,Puerto Rico,113,Ponce Municipio,91,42,49
34,New Jersey,72,Puerto Rico,115,Quebradillas Municipio,46,0,46
34,New Jersey,72,Puerto Rico,119,Río Grande Municipio,0,82,-82
34,New Jersey,72,Puerto Rico,121,Sabana Grande Municipio,86,0,86
34,New Jersey,72,Puerto Rico,125,San Germán Municipio,0,68,-68
34,New Jersey,72,Puerto Rico,127,San Juan Municipio,483,63,420
34,New Jersey,72,Puerto Rico,129,San Lorenzo Municipio,9,20,-11
34,New Jersey,72,Puerto Rico,131,San Sebastián Municipio,8,0,8
34,New Jersey,72,Puerto Rico,133,Santa Isabel Municipio,0,15,-15
34,New Jersey,72,Puerto Rico,135,Toa Alta Municipio,89,16,73
34,New Jersey,72,Puerto Rico,137,Toa Baja Municipio,134,0,134
34,New Jersey,72,Puerto Rico,139,Trujillo Alto Municipio,106,23,83
34,New Jersey,72,Puerto Rico,141,Utuado Municipio,228,175,53
34,New Jersey,72,Puerto Rico,143,Vega Alta Municipio,26,26,0
34,New Jersey,72,Puerto Rico,145,Vega Baja Municipio,131,0,131
34,New Jersey,72,Puerto Rico,149,Villalba Municipio,37,0,37
34,New Jersey,72,Puerto Rico,153,Yauco Municipio,94,0,94
34,New Jersey,8,Colorado,1,Adams County,81,186,-105
34,New Jersey,8,Colorado,3,Alamosa County,0,14,-14
34,New Jersey,8,Colorado,5,Arapahoe County,161,185,-24
34,New Jersey,8,Colorado,13,Boulder County,104,602,-498
34,New Jersey,8,Colorado,14,Broomfield County,0,116,-116
34,New Jersey,8,Colorado,31,Denver County,164,301,-137
34,New Jersey,8,Colorado,35,Douglas County,85,422,-337
34,New Jersey,8,Colorado,37,Eagle County,0,22,-22
34,New Jersey,8,Colorado,41,El Paso County,290,521,-231
34,New Jersey,8,Colorado,45,Garfield County,5,1,4
34,New Jersey,8,Colorado,47,Gilpin County,0,5,-5
34,New Jersey,8,Colorado,49,Grand County,20,0,20
34,New Jersey,8,Colorado,59,Jefferson County,71,95,-24
34,New Jersey,8,Colorado,69,Larimer County,70,212,-142
34,New Jersey,8,Colorado,77,Mesa County,3,17,-14
34,New Jersey,8,Colorado,83,Montezuma County,0,10,-10
34,New Jersey,8,Colorado,89,Otero County,0,1,-1
34,New Jersey,8,Colorado,97,Pitkin County,17,0,17
34,New Jersey,8,Colorado,101,Pueblo County,0,13,-13
34,New Jersey,8,Colorado,107,Routt County,2,0,2
34,New Jersey,8,Colorado,113,San Miguel County,10,0,10
34,New Jersey,8,Colorado,117,Summit County,0,24,-24
34,New Jersey,8,Colorado,119,Teller County,0,13,-13
34,New Jersey,8,Colorado,123,Weld County,21,51,-30
34,New Jersey,9,Connecticut,1,Fairfield County,1195,2294,-1099
34,New Jersey,9,Connecticut,3,Hartford County,662,840,-178
34,New Jersey,9,Connecticut,5,Litchfield County,225,26,199
34,New Jersey,9,Connecticut,7,Middlesex County,35,244,-209
34,New Jersey,9,Connecticut,9,New Haven County,1005,963,42
34,New Jersey,9,Connecticut,11,New London County,55,277,-222
34,New Jersey,9,Connecticut,13,Tolland County,19,224,-205
34,New Jersey,9,Connecticut,15,Windham County,9,23,-14
34,New Jersey,AFR,Africa,,-,4767,0,0
34,New Jersey,ASI,Asia,,-,29099,0,0
34,New Jersey,CAM,Central America,,-,4909,0,0
34,New Jersey,CAR,Caribbean,,-,6889,0,0
34,New Jersey,EUR,Europe,,-,9185,0,0
34,New Jersey,ISL,U.S. Island Areas,,-,225,0,0
34,New Jersey,NAM,Northern America,,-,1903,0,0
34,New Jersey,OCE,Oceania and At Sea,,-,443,0,0
34,New Jersey,SAM,South America,,-,5791,0,0
35,New Mexico,1,Alabama,1,Autauga County,0,321,-321
35,New Mexico,1,Alabama,17,Chambers County,0,24,-24
35,New Mexico,1,Alabama,19,Cherokee County,33,0,33
35,New Mexico,1,Alabama,25,Clarke County,0,5,-5
35,New Mexico,1,Alabama,31,Coffee County,40,0,40
35,New Mexico,1,Alabama,45,Dale County,0,54,-54
35,New Mexico,1,Alabama,51,Elmore County,0,11,-11
35,New Mexico,1,Alabama,71,Jackson County,0,12,-12
35,New Mexico,1,Alabama,73,Jefferson County,39,0,39
35,New Mexico,1,Alabama,89,Madison County,103,195,-92
35,New Mexico,1,Alabama,95,Marshall County,5,1,4
35,New Mexico,1,Alabama,97,Mobile County,0,14,-14
35,New Mexico,1,Alabama,101,Montgomery County,52,273,-221
35,New Mexico,1,Alabama,125,Tuscaloosa County,0,78,-78
35,New Mexico,1,Alabama,127,Walker County,17,4,13
35,New Mexico,10,Delaware,1,Kent County,88,0,88
35,New Mexico,10,Delaware,3,New Castle County,9,27,-18
35,New Mexico,10,Delaware,5,Sussex County,7,142,-135
35,New Mexico,11,District of Columbia,1,District of Columbia,82,182,-100
35,New Mexico,12,Florida,1,Alachua County,40,35,5
35,New Mexico,12,Florida,5,Bay County,11,185,-174
35,New Mexico,12,Florida,9,Brevard County,158,144,14
35,New Mexico,12,Florida,11,Broward County,31,164,-133
35,New Mexico,12,Florida,19,Clay County,20,17,3
35,New Mexico,12,Florida,21,Collier County,29,62,-33
35,New Mexico,12,Florida,27,DeSoto County,0,19,-19
35,New Mexico,12,Florida,31,Duval County,26,15,11
35,New Mexico,12,Florida,33,Escambia County,0,153,-153
35,New Mexico,12,Florida,35,Flagler County,143,0,143
35,New Mexico,12,Florida,53,Hernando County,0,22,-22
35,New Mexico,12,Florida,55,Highlands County,16,0,16
35,New Mexico,12,Florida,57,Hillsborough County,33,263,-230
35,New Mexico,12,Florida,69,Lake County,28,16,12
35,New Mexico,12,Florida,71,Lee County,49,23,26
35,New Mexico,12,Florida,75,Levy County,8,0,8
35,New Mexico,12,Florida,81,Manatee County,0,12,-12
35,New Mexico,12,Florida,83,Marion County,85,0,85
35,New Mexico,12,Florida,86,Miami-Dade County,54,135,-81
35,New Mexico,12,Florida,87,Monroe County,53,8,45
35,New Mexico,12,Florida,91,Okaloosa County,341,236,105
35,New Mexico,12,Florida,93,Okeechobee County,0,25,-25
35,New Mexico,12,Florida,95,Orange County,114,332,-218
35,New Mexico,12,Florida,97,Osceola County,17,0,17
35,New Mexico,12,Florida,99,Palm Beach County,60,61,-1
35,New Mexico,12,Florida,101,Pasco County,9,201,-192
35,New Mexico,12,Florida,103,Pinellas County,101,111,-10
35,New Mexico,12,Florida,105,Polk County,25,0,25
35,New Mexico,12,Florida,109,St. Johns County,150,16,134
35,New Mexico,12,Florida,111,St. Lucie County,2,22,-20
35,New Mexico,12,Florida,113,Santa Rosa County,279,276,3
35,New Mexico,12,Florida,115,Sarasota County,83,108,-25
35,New Mexico,12,Florida,119,Sumter County,14,0,14
35,New Mexico,12,Florida,127,Volusia County,16,35,-19
35,New Mexico,12,Florida,131,Walton County,0,19,-19
35,New Mexico,12,Florida,133,Washington County,0,18,-18
35,New Mexico,13,Georgia,31,Bulloch County,0,30,-30
35,New Mexico,13,Georgia,39,Camden County,29,0,29
35,New Mexico,13,Georgia,45,Carroll County,2,0,2
35,New Mexico,13,Georgia,47,Catoosa County,0,19,-19
35,New Mexico,13,Georgia,51,Chatham County,0,50,-50
35,New Mexico,13,Georgia,57,Cherokee County,25,0,25
35,New Mexico,13,Georgia,59,Clarke County,0,18,-18
35,New Mexico,13,Georgia,67,Cobb County,13,34,-21
35,New Mexico,13,Georgia,73,Columbia County,130,0,130
35,New Mexico,13,Georgia,75,Cook County,36,0,36
35,New Mexico,13,Georgia,77,Coweta County,15,0,15
35,New Mexico,13,Georgia,81,Crisp County,0,21,-21
35,New Mexico,13,Georgia,89,DeKalb County,24,116,-92
35,New Mexico,13,Georgia,91,Dodge County,31,0,31
35,New Mexico,13,Georgia,97,Douglas County,0,35,-35
35,New Mexico,13,Georgia,103,Effingham County,0,17,-17
35,New Mexico,13,Georgia,115,Floyd County,0,18,-18
35,New Mexico,13,Georgia,117,Forsyth County,0,87,-87
35,New Mexico,13,Georgia,121,Fulton County,95,30,65
35,New Mexico,13,Georgia,123,Gilmer County,0,16,-16
35,New Mexico,13,Georgia,127,Glynn County,18,21,-3
35,New Mexico,13,Georgia,135,Gwinnett County,40,10,30
35,New Mexico,13,Georgia,151,Henry County,20,0,20
35,New Mexico,13,Georgia,153,Houston County,0,122,-122
35,New Mexico,13,Georgia,179,Liberty County,55,8,47
35,New Mexico,13,Georgia,185,Lowndes County,152,410,-258
35,New Mexico,13,Georgia,189,McDuffie County,0,3,-3
35,New Mexico,13,Georgia,215,Muscogee County,0,61,-61
35,New Mexico,13,Georgia,223,Paulding County,0,105,-105
35,New Mexico,13,Georgia,229,Pierce County,22,0,22
35,New Mexico,13,Georgia,245,Richmond County,3,27,-24
35,New Mexico,13,Georgia,247,Rockdale County,20,21,-1
35,New Mexico,13,Georgia,261,Sumter County,0,8,-8
35,New Mexico,13,Georgia,267,Tattnall County,0,96,-96
35,New Mexico,13,Georgia,299,Ware County,52,0,52
35,New Mexico,15,Hawaii,1,Hawaii County,86,14,72
35,New Mexico,15,Hawaii,3,Honolulu County,251,276,-25
35,New Mexico,15,Hawaii,7,Kauai County,14,0,14
35,New Mexico,15,Hawaii,9,Maui County,75,128,-53
35,New Mexico,16,Idaho,1,Ada County,14,163,-149
35,New Mexico,16,Idaho,5,Bannock County,126,7,119
35,New Mexico,16,Idaho,9,Benewah County,0,1,-1
35,New Mexico,16,Idaho,11,Bingham County,48,20,28
35,New Mexico,16,Idaho,15,Boise County,16,8,8
35,New Mexico,16,Idaho,17,Bonner County,0,34,-34
35,New Mexico,16,Idaho,19,Bonneville County,1,27,-26
35,New Mexico,16,Idaho,23,Butte County,0,9,-9
35,New Mexico,16,Idaho,27,Canyon County,0,19,-19
35,New Mexico,16,Idaho,31,Cassia County,14,0,14
35,New Mexico,16,Idaho,39,Elmore County,0,4,-4
35,New Mexico,16,Idaho,43,Fremont County,0,28,-28
35,New Mexico,16,Idaho,45,Gem County,2,0,2
35,New Mexico,16,Idaho,47,Gooding County,8,12,-4
35,New Mexico,16,Idaho,51,Jefferson County,0,3,-3
35,New Mexico,16,Idaho,53,Jerome County,16,0,16
35,New Mexico,16,Idaho,55,Kootenai County,19,177,-158
35,New Mexico,16,Idaho,57,Latah County,0,17,-17
35,New Mexico,16,Idaho,63,Lincoln County,0,3,-3
35,New Mexico,16,Idaho,65,Madison County,69,6,63
35,New Mexico,16,Idaho,69,Nez Perce County,0,2,-2
35,New Mexico,16,Idaho,81,Teton County,31,12,19
35,New Mexico,16,Idaho,83,Twin Falls County,0,61,-61
35,New Mexico,16,Idaho,85,Valley County,0,55,-55
35,New Mexico,16,Idaho,87,Washington County,0,3,-3
35,New Mexico,17,Illinois,11,Bureau County,0,2,-2
35,New Mexico,17,Illinois,13,Calhoun County,0,10,-10
35,New Mexico,17,Illinois,15,Carroll County,15,0,15
35,New Mexico,17,Illinois,19,Champaign County,0,92,-92
35,New Mexico,17,Illinois,31,Cook County,503,262,241
35,New Mexico,17,Illinois,43,DuPage County,24,14,10
35,New Mexico,17,Illinois,89,Kane County,10,66,-56
35,New Mexico,17,Illinois,97,Lake County,102,87,15
35,New Mexico,17,Illinois,99,LaSalle County,47,38,9
35,New Mexico,17,Illinois,105,Livingston County,0,3,-3
35,New Mexico,17,Illinois,111,McHenry County,0,60,-60
35,New Mexico,17,Illinois,113,McLean County,0,100,-100
35,New Mexico,17,Illinois,115,Macon County,16,0,16
35,New Mexico,17,Illinois,119,Madison County,24,0,24
35,New Mexico,17,Illinois,121,Marion County,0,13,-13
35,New Mexico,17,Illinois,129,Menard County,121,0,121
35,New Mexico,17,Illinois,137,Morgan County,0,16,-16
35,New Mexico,17,Illinois,143,Peoria County,102,0,102
35,New Mexico,17,Illinois,157,Randolph County,18,0,18
35,New Mexico,17,Illinois,159,Richland County,0,6,-6
35,New Mexico,17,Illinois,163,St. Clair County,101,18,83
35,New Mexico,17,Illinois,167,Sangamon County,47,7,40
35,New Mexico,17,Illinois,183,Vermilion County,10,0,10
35,New Mexico,17,Illinois,195,Whiteside County,0,20,-20
35,New Mexico,17,Illinois,197,Will County,61,34,27
35,New Mexico,17,Illinois,199,Williamson County,19,0,19
35,New Mexico,17,Illinois,201,Winnebago County,12,0,12
35,New Mexico,18,Indiana,3,Allen County,0,19,-19
35,New Mexico,18,Indiana,13,Brown County,0,21,-21
35,New Mexico,18,Indiana,39,Elkhart County,0,26,-26
35,New Mexico,18,Indiana,59,Hancock County,6,0,6
35,New Mexico,18,Indiana,61,Harrison County,15,0,15
35,New Mexico,18,Indiana,63,Hendricks County,0,21,-21
35,New Mexico,18,Indiana,81,Johnson County,25,20,5
35,New Mexico,18,Indiana,89,Lake County,11,0,11
35,New Mexico,18,Indiana,91,LaPorte County,13,11,2
35,New Mexico,18,Indiana,93,Lawrence County,13,0,13
35,New Mexico,18,Indiana,97,Marion County,95,40,55
35,New Mexico,18,Indiana,99,Marshall County,0,54,-54
35,New Mexico,18,Indiana,105,Monroe County,33,58,-25
35,New Mexico,18,Indiana,107,Montgomery County,49,0,49
35,New Mexico,18,Indiana,127,Porter County,136,0,136
35,New Mexico,18,Indiana,133,Putnam County,0,2,-2
35,New Mexico,18,Indiana,141,St. Joseph County,15,28,-13
35,New Mexico,18,Indiana,151,Steuben County,31,0,31
35,New Mexico,18,Indiana,157,Tippecanoe County,4,0,4
35,New Mexico,18,Indiana,163,Vanderburgh County,0,22,-22
35,New Mexico,18,Indiana,167,Vigo County,0,9,-9
35,New Mexico,18,Indiana,169,Wabash County,0,156,-156
35,New Mexico,18,Indiana,181,White County,27,0,27
35,New Mexico,18,Indiana,183,Whitley County,86,3,83
35,New Mexico,19,Iowa,13,Black Hawk County,0,20,-20
35,New Mexico,19,Iowa,25,Calhoun County,0,16,-16
35,New Mexico,19,Iowa,33,Cerro Gordo County,0,15,-15
35,New Mexico,19,Iowa,45,Clinton County,18,0,18
35,New Mexico,19,Iowa,49,Dallas County,34,0,34
35,New Mexico,19,Iowa,53,Decatur County,15,0,15
35,New Mexico,19,Iowa,69,Franklin County,11,0,11
35,New Mexico,19,Iowa,77,Guthrie County,14,21,-7
35,New Mexico,19,Iowa,79,Hamilton County,0,11,-11
35,New Mexico,19,Iowa,85,Harrison County,0,5,-5
35,New Mexico,19,Iowa,89,Howard County,0,12,-12
35,New Mexico,19,Iowa,91,Humboldt County,0,12,-12
35,New Mexico,19,Iowa,103,Johnson County,9,64,-55
35,New Mexico,19,Iowa,107,Keokuk County,0,6,-6
35,New Mexico,19,Iowa,113,Linn County,0,38,-38
35,New Mexico,19,Iowa,133,Monona County,0,4,-4
35,New Mexico,19,Iowa,145,Page County,12,6,6
35,New Mexico,19,Iowa,153,Polk County,29,63,-34
35,New Mexico,19,Iowa,157,Poweshiek County,8,0,8
35,New Mexico,19,Iowa,167,Sioux County,9,0,9
35,New Mexico,19,Iowa,169,Story County,0,7,-7
35,New Mexico,19,Iowa,177,Van Buren County,0,19,-19
35,New Mexico,19,Iowa,183,Washington County,0,2,-2
35,New Mexico,19,Iowa,187,Webster County,75,32,43
35,New Mexico,19,Iowa,189,Winnebago County,0,9,-9
35,New Mexico,19,Iowa,197,Wright County,0,7,-7
35,New Mexico,2,Alaska,20,Anchorage Municipality,582,266,316
35,New Mexico,2,Alaska,70,Dillingham Census Area,0,10,-10
35,New Mexico,2,Alaska,90,Fairbanks North Star Borough,142,50,92
35,New Mexico,2,Alaska,100,Haines Borough,18,0,18
35,New Mexico,2,Alaska,105,Hoonah-Angoon Census Area,0,1,-1
35,New Mexico,2,Alaska,110,Juneau City and Borough,0,5,-5
35,New Mexico,2,Alaska,150,Kodiak Island Borough,12,0,12
35,New Mexico,2,Alaska,158,Kusilvak Census Area,0,1,-1
35,New Mexico,2,Alaska,170,Matanuska-Susitna Borough,181,16,165
35,New Mexico,2,Alaska,180,Nome Census Area,4,0,4
35,New Mexico,2,Alaska,188,Northwest Arctic Borough,0,4,-4
35,New Mexico,2,Alaska,220,Sitka City and Borough,9,0,9
35,New Mexico,2,Alaska,261,Valdez-Cordova Census Area,0,8,-8
35,New Mexico,2,Alaska,290,Yukon-Koyukuk Census Area,0,5,-5
35,New Mexico,20,Kansas,9,Barton County,11,0,11
35,New Mexico,20,Kansas,15,Butler County,0,4,-4
35,New Mexico,20,Kansas,17,Chase County,0,6,-6
35,New Mexico,20,Kansas,35,Cowley County,0,45,-45
35,New Mexico,20,Kansas,41,Dickinson County,0,59,-59
35,New Mexico,20,Kansas,45,Douglas County,50,32,18
35,New Mexico,20,Kansas,49,Elk County,0,28,-28
35,New Mexico,20,Kansas,51,Ellis County,17,49,-32
35,New Mexico,20,Kansas,55,Finney County,0,101,-101
35,New Mexico,20,Kansas,57,Ford County,109,0,109
35,New Mexico,20,Kansas,59,Franklin County,0,23,-23
35,New Mexico,20,Kansas,61,Geary County,0,96,-96
35,New Mexico,20,Kansas,69,Gray County,0,96,-96
35,New Mexico,20,Kansas,75,Hamilton County,0,21,-21
35,New Mexico,20,Kansas,91,Johnson County,57,70,-13
35,New Mexico,20,Kansas,101,Lane County,0,10,-10
35,New Mexico,20,Kansas,125,Montgomery County,14,20,-6
35,New Mexico,20,Kansas,133,Neosho County,0,8,-8
35,New Mexico,20,Kansas,151,Pratt County,0,2,-2
35,New Mexico,20,Kansas,155,Reno County,0,19,-19
35,New Mexico,20,Kansas,157,Republic County,0,4,-4
35,New Mexico,20,Kansas,161,Riley County,8,0,8
35,New Mexico,20,Kansas,167,Russell County,0,2,-2
35,New Mexico,20,Kansas,169,Saline County,35,0,35
35,New Mexico,20,Kansas,173,Sedgwick County,22,68,-46
35,New Mexico,20,Kansas,175,Seward County,2,0,2
35,New Mexico,20,Kansas,177,Shawnee County,4,17,-13
35,New Mexico,20,Kansas,187,Stanton County,0,5,-5
35,New Mexico,20,Kansas,209,Wyandotte County,15,0,15
35,New Mexico,21,Kentucky,19,Boyd County,28,0,28
35,New Mexico,21,Kentucky,21,Boyle County,7,0,7
35,New Mexico,21,Kentucky,47,Christian County,67,33,34
35,New Mexico,21,Kentucky,49,Clark County,34,0,34
35,New Mexico,21,Kentucky,59,Daviess County,0,11,-11
35,New Mexico,21,Kentucky,67,Fayette County,0,121,-121
35,New Mexico,21,Kentucky,87,Green County,0,16,-16
35,New Mexico,21,Kentucky,89,Greenup County,6,0,6
35,New Mexico,21,Kentucky,93,Hardin County,0,39,-39
35,New Mexico,21,Kentucky,111,Jefferson County,77,210,-133
35,New Mexico,21,Kentucky,117,Kenton County,4,0,4
35,New Mexico,21,Kentucky,123,Larue County,0,21,-21
35,New Mexico,21,Kentucky,179,Nelson County,18,0,18
35,New Mexico,21,Kentucky,209,Scott County,15,0,15
35,New Mexico,21,Kentucky,221,Trigg County,1,0,1
35,New Mexico,21,Kentucky,227,Warren County,0,163,-163
35,New Mexico,22,Louisiana,3,Allen Parish,37,0,37
35,New Mexico,22,Louisiana,5,Ascension Parish,0,8,-8
35,New Mexico,22,Louisiana,15,Bossier Parish,107,34,73
35,New Mexico,22,Louisiana,17,Caddo Parish,57,7,50
35,New Mexico,22,Louisiana,19,Calcasieu Parish,15,7,8
35,New Mexico,22,Louisiana,33,East Baton Rouge Parish,17,4,13
35,New Mexico,22,Louisiana,51,Jefferson Parish,0,33,-33
35,New Mexico,22,Louisiana,55,Lafayette Parish,93,62,31
35,New Mexico,22,Louisiana,63,Livingston Parish,15,40,-25
35,New Mexico,22,Louisiana,71,Orleans Parish,44,31,13
35,New Mexico,22,Louisiana,73,Ouachita Parish,18,0,18
35,New Mexico,22,Louisiana,77,Pointe Coupee Parish,0,11,-11
35,New Mexico,22,Louisiana,99,St. Martin Parish,35,24,11
35,New Mexico,22,Louisiana,101,St. Mary Parish,48,0,48
35,New Mexico,22,Louisiana,103,St. Tammany Parish,33,0,33
35,New Mexico,22,Louisiana,109,Terrebonne Parish,7,43,-36
35,New Mexico,22,Louisiana,113,Vermilion Parish,41,0,41
35,New Mexico,22,Louisiana,115,Vernon Parish,0,36,-36
35,New Mexico,22,Louisiana,117,Washington Parish,52,0,52
35,New Mexico,23,Maine,1,Androscoggin County,69,5,64
35,New Mexico,23,Maine,5,Cumberland County,120,116,4
35,New Mexico,23,Maine,11,Kennebec County,16,0,16
35,New Mexico,23,Maine,19,Penobscot County,63,37,26
35,New Mexico,23,Maine,21,Piscataquis County,19,11,8
35,New Mexico,23,Maine,23,Sagadahoc County,9,0,9
35,New Mexico,23,Maine,27,Waldo County,0,23,-23
35,New Mexico,23,Maine,29,Washington County,0,36,-36
35,New Mexico,24,Maryland,3,Anne Arundel County,76,291,-215
35,New Mexico,24,Maryland,5,Baltimore County,45,0,45
35,New Mexico,24,Maryland,9,Calvert County,119,14,105
35,New Mexico,24,Maryland,11,Caroline County,4,0,4
35,New Mexico,24,Maryland,17,Charles County,15,0,15
35,New Mexico,24,Maryland,19,Dorchester County,183,0,183
35,New Mexico,24,Maryland,21,Frederick County,10,19,-9
35,New Mexico,24,Maryland,25,Harford County,26,86,-60
35,New Mexico,24,Maryland,27,Howard County,13,44,-31
35,New Mexico,24,Maryland,29,Kent County,4,0,4
35,New Mexico,24,Maryland,31,Montgomery County,276,106,170
35,New Mexico,24,Maryland,33,Prince George's County,139,92,47
35,New Mexico,24,Maryland,37,St. Mary's County,11,49,-38
35,New Mexico,24,Maryland,43,Washington County,0,22,-22
35,New Mexico,24,Maryland,45,Wicomico County,14,0,14
35,New Mexico,24,Maryland,47,Worcester County,12,0,12
35,New Mexico,24,Maryland,510,Baltimore city,53,39,14
35,New Mexico,25,Massachusetts,3,Berkshire County,0,10,-10
35,New Mexico,25,Massachusetts,5,Bristol County,96,0,96
35,New Mexico,25,Massachusetts,9,Essex County,3,0,3
35,New Mexico,25,Massachusetts,11,Franklin County,28,0,28
35,New Mexico,25,Massachusetts,13,Hampden County,70,0,70
35,New Mexico,25,Massachusetts,15,Hampshire County,10,57,-47
35,New Mexico,25,Massachusetts,17,Middlesex County,170,88,82
35,New Mexico,25,Massachusetts,21,Norfolk County,0,18,-18
35,New Mexico,25,Massachusetts,23,Plymouth County,99,0,99
35,New Mexico,25,Massachusetts,25,Suffolk County,11,180,-169
35,New Mexico,25,Massachusetts,27,Worcester County,34,120,-86
35,New Mexico,26,Michigan,1,Alcona County,0,4,-4
35,New Mexico,26,Michigan,17,Bay County,0,26,-26
35,New Mexico,26,Michigan,25,Calhoun County,11,40,-29
35,New Mexico,26,Michigan,33,Chippewa County,11,0,11
35,New Mexico,26,Michigan,43,Dickinson County,0,52,-52
35,New Mexico,26,Michigan,45,Eaton County,0,16,-16
35,New Mexico,26,Michigan,47,Emmet County,0,40,-40
35,New Mexico,26,Michigan,49,Genesee County,0,9,-9
35,New Mexico,26,Michigan,53,Gogebic County,0,2,-2
35,New Mexico,26,Michigan,55,Grand Traverse County,21,27,-6
35,New Mexico,26,Michigan,59,Hillsdale County,9,3,6
35,New Mexico,26,Michigan,65,Ingham County,0,4,-4
35,New Mexico,26,Michigan,75,Jackson County,45,55,-10
35,New Mexico,26,Michigan,77,Kalamazoo County,0,19,-19
35,New Mexico,26,Michigan,79,Kalkaska County,24,0,24
35,New Mexico,26,Michigan,81,Kent County,131,88,43
35,New Mexico,26,Michigan,91,Lenawee County,58,4,54
35,New Mexico,26,Michigan,93,Livingston County,33,0,33
35,New Mexico,26,Michigan,99,Macomb County,7,19,-12
35,New Mexico,26,Michigan,101,Manistee County,0,17,-17
35,New Mexico,26,Michigan,103,Marquette County,96,0,96
35,New Mexico,26,Michigan,111,Midland County,0,8,-8
35,New Mexico,26,Michigan,113,Missaukee County,10,0,10
35,New Mexico,26,Michigan,121,Muskegon County,0,8,-8
35,New Mexico,26,Michigan,125,Oakland County,0,28,-28
35,New Mexico,26,Michigan,139,Ottawa County,0,19,-19
35,New Mexico,26,Michigan,147,St. Clair County,0,8,-8
35,New Mexico,26,Michigan,149,St. Joseph County,37,0,37
35,New Mexico,26,Michigan,151,Sanilac County,0,4,-4
35,New Mexico,26,Michigan,157,Tuscola County,11,6,5
35,New Mexico,26,Michigan,161,Washtenaw County,99,27,72
35,New Mexico,26,Michigan,163,Wayne County,231,128,103
35,New Mexico,27,Minnesota,3,Anoka County,3,64,-61
35,New Mexico,27,Minnesota,7,Beltrami County,8,4,4
35,New Mexico,27,Minnesota,19,Carver County,0,7,-7
35,New Mexico,27,Minnesota,21,Cass County,0,1,-1
35,New Mexico,27,Minnesota,25,Chisago County,0,2,-2
35,New Mexico,27,Minnesota,27,Clay County,9,0,9
35,New Mexico,27,Minnesota,33,Cottonwood County,0,1,-1
35,New Mexico,27,Minnesota,37,Dakota County,33,133,-100
35,New Mexico,27,Minnesota,41,Douglas County,36,0,36
35,New Mexico,27,Minnesota,53,Hennepin County,122,101,21
35,New Mexico,27,Minnesota,57,Hubbard County,8,0,8
35,New Mexico,27,Minnesota,67,Kandiyohi County,8,13,-5
35,New Mexico,27,Minnesota,69,Kittson County,0,3,-3
35,New Mexico,27,Minnesota,83,Lyon County,5,0,5
35,New Mexico,27,Minnesota,89,Marshall County,0,2,-2
35,New Mexico,27,Minnesota,91,Martin County,0,2,-2
35,New Mexico,27,Minnesota,93,Meeker County,4,0,4
35,New Mexico,27,Minnesota,95,Mille Lacs County,0,3,-3
35,New Mexico,27,Minnesota,109,Olmsted County,2,152,-150
35,New Mexico,27,Minnesota,115,Pine County,8,2,6
35,New Mexico,27,Minnesota,123,Ramsey County,81,23,58
35,New Mexico,27,Minnesota,125,Red Lake County,14,0,14
35,New Mexico,27,Minnesota,131,Rice County,37,11,26
35,New Mexico,27,Minnesota,137,St. Louis County,27,30,-3
35,New Mexico,27,Minnesota,145,Stearns County,17,4,13
35,New Mexico,27,Minnesota,147,Steele County,25,16,9
35,New Mexico,28,Mississippi,1,Adams County,5,0,5
35,New Mexico,28,Mississippi,29,Copiah County,0,10,-10
35,New Mexico,28,Mississippi,33,DeSoto County,0,50,-50
35,New Mexico,28,Mississippi,47,Harrison County,58,98,-40
35,New Mexico,28,Mississippi,49,Hinds County,13,0,13
35,New Mexico,28,Mississippi,75,Lauderdale County,0,34,-34
35,New Mexico,28,Mississippi,87,Lowndes County,136,1,135
35,New Mexico,28,Mississippi,99,Neshoba County,7,17,-10
35,New Mexico,28,Mississippi,105,Oktibbeha County,45,0,45
35,New Mexico,28,Mississippi,107,Panola County,52,0,52
35,New Mexico,28,Mississippi,111,Perry County,12,0,12
35,New Mexico,28,Mississippi,115,Pontotoc County,41,0,41
35,New Mexico,28,Mississippi,121,Rankin County,7,0,7
35,New Mexico,28,Mississippi,131,Stone County,0,19,-19
35,New Mexico,28,Mississippi,145,Union County,28,0,28
35,New Mexico,28,Mississippi,161,Yalobusha County,0,25,-25
35,New Mexico,29,Missouri,19,Boone County,0,24,-24
35,New Mexico,29,Missouri,23,Butler County,0,37,-37
35,New Mexico,29,Missouri,27,Callaway County,0,26,-26
35,New Mexico,29,Missouri,29,Camden County,16,44,-28
35,New Mexico,29,Missouri,37,Cass County,0,14,-14
35,New Mexico,29,Missouri,39,Cedar County,25,0,25
35,New Mexico,29,Missouri,47,Clay County,0,65,-65
35,New Mexico,29,Missouri,49,Clinton County,30,0,30
35,New Mexico,29,Missouri,51,Cole County,8,0,8
35,New Mexico,29,Missouri,77,Greene County,35,43,-8
35,New Mexico,29,Missouri,87,Holt County,25,0,25
35,New Mexico,29,Missouri,95,Jackson County,340,63,277
35,New Mexico,29,Missouri,99,Jefferson County,0,138,-138
35,New Mexico,29,Missouri,101,Johnson County,3,47,-44
35,New Mexico,29,Missouri,105,Laclede County,9,0,9
35,New Mexico,29,Missouri,107,Lafayette County,0,50,-50
35,New Mexico,29,Missouri,113,Lincoln County,0,2,-2
35,New Mexico,29,Missouri,117,Livingston County,0,6,-6
35,New Mexico,29,Missouri,119,McDonald County,41,82,-41
35,New Mexico,29,Missouri,131,Miller County,18,0,18
35,New Mexico,29,Missouri,145,Newton County,2,0,2
35,New Mexico,29,Missouri,149,Oregon County,86,0,86
35,New Mexico,29,Missouri,161,Phelps County,33,28,5
35,New Mexico,29,Missouri,167,Polk County,0,25,-25
35,New Mexico,29,Missouri,169,Pulaski County,42,135,-93
35,New Mexico,29,Missouri,183,St. Charles County,16,18,-2
35,New Mexico,29,Missouri,189,St. Louis County,282,203,79
35,New Mexico,29,Missouri,207,Stoddard County,0,2,-2
35,New Mexico,29,Missouri,213,Taney County,3,9,-6
35,New Mexico,29,Missouri,510,St. Louis city,39,42,-3
35,New Mexico,30,Montana,1,Beaverhead County,0,2,-2
35,New Mexico,30,Montana,9,Carbon County,14,3,11
35,New Mexico,30,Montana,13,Cascade County,79,3,76
35,New Mexico,30,Montana,23,Deer Lodge County,0,3,-3
35,New Mexico,30,Montana,29,Flathead County,78,38,40
35,New Mexico,30,Montana,31,Gallatin County,14,92,-78
35,New Mexico,30,Montana,35,Glacier County,22,0,22
35,New Mexico,30,Montana,47,Lake County,0,11,-11
35,New Mexico,30,Montana,49,Lewis and Clark County,70,7,63
35,New Mexico,30,Montana,53,Lincoln County,0,1,-1
35,New Mexico,30,Montana,61,Mineral County,0,10,-10
35,New Mexico,30,Montana,63,Missoula County,68,63,5
35,New Mexico,30,Montana,93,Silver Bow County,0,47,-47
35,New Mexico,30,Montana,105,Valley County,0,1,-1
35,New Mexico,30,Montana,111,Yellowstone County,25,47,-22
35,New Mexico,31,Nebraska,1,Adams County,0,35,-35
35,New Mexico,31,Nebraska,25,Cass County,55,0,55
35,New Mexico,31,Nebraska,49,Deuel County,0,10,-10
35,New Mexico,31,Nebraska,55,Douglas County,51,187,-136
35,New Mexico,31,Nebraska,77,Greeley County,0,2,-2
35,New Mexico,31,Nebraska,79,Hall County,8,0,8
35,New Mexico,31,Nebraska,109,Lancaster County,114,132,-18
35,New Mexico,31,Nebraska,153,Sarpy County,0,189,-189
35,New Mexico,31,Nebraska,159,Seward County,37,7,30
35,New Mexico,31,Nebraska,169,Thayer County,11,0,11
35,New Mexico,31,Nebraska,179,Wayne County,0,75,-75
35,New Mexico,31,Nebraska,185,York County,0,3,-3
35,New Mexico,32,Nevada,3,Clark County,877,1761,-884
35,New Mexico,32,Nevada,7,Elko County,19,52,-33
35,New Mexico,32,Nevada,13,Humboldt County,0,1,-1
35,New Mexico,32,Nevada,23,Nye County,73,48,25
35,New Mexico,32,Nevada,31,Washoe County,124,349,-225
35,New Mexico,32,Nevada,33,White Pine County,0,4,-4
35,New Mexico,32,Nevada,510,Carson City,0,32,-32
35,New Mexico,33,New Hampshire,3,Carroll County,74,0,74
35,New Mexico,33,New Hampshire,5,Cheshire County,81,0,81
35,New Mexico,33,New Hampshire,9,Grafton County,18,0,18
35,New Mexico,33,New Hampshire,11,Hillsborough County,103,37,66
35,New Mexico,33,New Hampshire,13,Merrimack County,16,0,16
35,New Mexico,33,New Hampshire,15,Rockingham County,22,12,10
35,New Mexico,33,New Hampshire,17,Strafford County,0,6,-6
35,New Mexico,33,New Hampshire,19,Sullivan County,1,0,1
35,New Mexico,34,New Jersey,1,Atlantic County,4,70,-66
35,New Mexico,34,New Jersey,3,Bergen County,49,0,49
35,New Mexico,34,New Jersey,5,Burlington County,22,151,-129
35,New Mexico,34,New Jersey,7,Camden County,0,5,-5
35,New Mexico,34,New Jersey,9,Cape May County,0,16,-16
35,New Mexico,34,New Jersey,13,Essex County,37,19,18
35,New Mexico,34,New Jersey,15,Gloucester County,0,56,-56
35,New Mexico,34,New Jersey,17,Hudson County,38,0,38
35,New Mexico,34,New Jersey,19,Hunterdon County,18,0,18
35,New Mexico,34,New Jersey,21,Mercer County,69,9,60
35,New Mexico,34,New Jersey,23,Middlesex County,37,13,24
35,New Mexico,34,New Jersey,25,Monmouth County,13,14,-1
35,New Mexico,34,New Jersey,27,Morris County,17,33,-16
35,New Mexico,34,New Jersey,29,Ocean County,36,0,36
35,New Mexico,34,New Jersey,37,Sussex County,58,0,58
35,New Mexico,35,New Mexico,1,Bernalillo County,11937,12777,-840
35,New Mexico,35,New Mexico,3,Catron County,34,3,31
35,New Mexico,35,New Mexico,5,Chaves County,1306,1758,-452
35,New Mexico,35,New Mexico,6,Cibola County,1177,1377,-200
35,New Mexico,35,New Mexico,7,Colfax County,274,618,-344
35,New Mexico,35,New Mexico,9,Curry County,1258,1357,-99
35,New Mexico,35,New Mexico,11,De Baca County,264,88,176
35,New Mexico,35,New Mexico,13,Doña Ana County,4011,5140,-1129
35,New Mexico,35,New Mexico,15,Eddy County,1433,1049,384
35,New Mexico,35,New Mexico,17,Grant County,453,391,62
35,New Mexico,35,New Mexico,19,Guadalupe County,372,281,91
35,New Mexico,35,New Mexico,21,Harding County,35,6,29
35,New Mexico,35,New Mexico,23,Hidalgo County,131,54,77
35,New Mexico,35,New Mexico,25,Lea County,2154,877,1277
35,New Mexico,35,New Mexico,27,Lincoln County,690,564,126
35,New Mexico,35,New Mexico,28,Los Alamos County,360,455,-95
35,New Mexico,35,New Mexico,29,Luna County,789,891,-102
35,New Mexico,35,New Mexico,31,McKinley County,1516,841,675
35,New Mexico,35,New Mexico,33,Mora County,109,152,-43
35,New Mexico,35,New Mexico,35,Otero County,1912,992,920
35,New Mexico,35,New Mexico,37,Quay County,310,76,234
35,New Mexico,35,New Mexico,39,Rio Arriba County,1112,751,361
35,New Mexico,35,New Mexico,41,Roosevelt County,911,1385,-474
35,New Mexico,35,New Mexico,43,Sandoval County,3842,4720,-878
35,New Mexico,35,New Mexico,45,San Juan County,1734,1254,480
35,New Mexico,35,New Mexico,47,San Miguel County,920,768,152
35,New Mexico,35,New Mexico,49,Santa Fe County,3595,3393,202
35,New Mexico,35,New Mexico,51,Sierra County,486,318,168
35,New Mexico,35,New Mexico,53,Socorro County,538,348,190
35,New Mexico,35,New Mexico,55,Taos County,747,771,-24
35,New Mexico,35,New Mexico,57,Torrance County,709,814,-105
35,New Mexico,35,New Mexico,59,Union County,227,311,-84
35,New Mexico,35,New Mexico,61,Valencia County,2112,2878,-766
35,New Mexico,36,New York,3,Allegany County,14,0,14
35,New Mexico,36,New York,5,Bronx County,0,27,-27
35,New Mexico,36,New York,7,Broome County,17,0,17
35,New Mexico,36,New York,9,Cattaraugus County,86,0,86
35,New Mexico,36,New York,15,Chemung County,24,0,24
35,New Mexico,36,New York,17,Chenango County,0,3,-3
35,New Mexico,36,New York,27,Dutchess County,14,16,-2
35,New Mexico,36,New York,29,Erie County,62,0,62
35,New Mexico,36,New York,43,Herkimer County,15,3,12
35,New Mexico,36,New York,45,Jefferson County,0,56,-56
35,New Mexico,36,New York,47,Kings County,267,196,71
35,New Mexico,36,New York,51,Livingston County,0,6,-6
35,New Mexico,36,New York,53,Madison County,0,6,-6
35,New Mexico,36,New York,55,Monroe County,132,139,-7
35,New Mexico,36,New York,59,Nassau County,0,12,-12
35,New Mexico,36,New York,61,New York County,71,251,-180
35,New Mexico,36,New York,65,Oneida County,17,48,-31
35,New Mexico,36,New York,67,Onondaga County,8,5,3
35,New Mexico,36,New York,71,Orange County,43,0,43
35,New Mexico,36,New York,75,Oswego County,8,0,8
35,New Mexico,36,New York,77,Otsego County,0,18,-18
35,New Mexico,36,New York,81,Queens County,29,37,-8
35,New Mexico,36,New York,83,Rensselaer County,18,5,13
35,New Mexico,36,New York,85,Richmond County,39,0,39
35,New Mexico,36,New York,87,Rockland County,6,24,-18
35,New Mexico,36,New York,89,St. Lawrence County,73,0,73
35,New Mexico,36,New York,91,Saratoga County,20,13,7
35,New Mexico,36,New York,93,Schenectady County,7,0,7
35,New Mexico,36,New York,99,Seneca County,18,0,18
35,New Mexico,36,New York,101,Steuben County,26,0,26
35,New Mexico,36,New York,103,Suffolk County,9,68,-59
35,New Mexico,36,New York,109,Tompkins County,24,0,24
35,New Mexico,36,New York,117,Wayne County,0,9,-9
35,New Mexico,36,New York,119,Westchester County,36,51,-15
35,New Mexico,37,North Carolina,9,Ashe County,15,0,15
35,New Mexico,37,North Carolina,11,Avery County,0,1,-1
35,New Mexico,37,North Carolina,19,Brunswick County,28,0,28
35,New Mexico,37,North Carolina,21,Buncombe County,6,5,1
35,New Mexico,37,North Carolina,25,Cabarrus County,0,30,-30
35,New Mexico,37,North Carolina,31,Carteret County,18,0,18
35,New Mexico,37,North Carolina,49,Craven County,20,41,-21
35,New Mexico,37,North Carolina,51,Cumberland County,76,42,34
35,New Mexico,37,North Carolina,63,Durham County,0,88,-88
35,New Mexico,37,North Carolina,67,Forsyth County,18,35,-17
35,New Mexico,37,North Carolina,71,Gaston County,0,8,-8
35,New Mexico,37,North Carolina,81,Guilford County,0,94,-94
35,New Mexico,37,North Carolina,85,Harnett County,61,13,48
35,New Mexico,37,North Carolina,93,Hoke County,0,108,-108
35,New Mexico,37,North Carolina,97,Iredell County,23,15,8
35,New Mexico,37,North Carolina,101,Johnston County,0,94,-94
35,New Mexico,37,North Carolina,105,Lee County,9,0,9
35,New Mexico,37,North Carolina,109,Lincoln County,0,23,-23
35,New Mexico,37,North Carolina,119,Mecklenburg County,120,143,-23
35,New Mexico,37,North Carolina,129,New Hanover County,48,0,48
35,New Mexico,37,North Carolina,133,Onslow County,18,94,-76
35,New Mexico,37,North Carolina,135,Orange County,0,127,-127
35,New Mexico,37,North Carolina,159,Rowan County,0,6,-6
35,New Mexico,37,North Carolina,161,Rutherford County,0,24,-24
35,New Mexico,37,North Carolina,167,Stanly County,11,0,11
35,New Mexico,37,North Carolina,171,Surry County,3,0,3
35,New Mexico,37,North Carolina,175,Transylvania County,0,8,-8
35,New Mexico,37,North Carolina,183,Wake County,0,91,-91
35,New Mexico,37,North Carolina,189,Watauga County,16,0,16
35,New Mexico,37,North Carolina,191,Wayne County,199,10,189
35,New Mexico,38,North Dakota,5,Benson County,0,10,-10
35,New Mexico,38,North Dakota,11,Bowman County,8,0,8
35,New Mexico,38,North Dakota,13,Burke County,0,12,-12
35,New Mexico,38,North Dakota,17,Cass County,0,21,-21
35,New Mexico,38,North Dakota,21,Dickey County,0,3,-3
35,New Mexico,38,North Dakota,25,Dunn County,0,9,-9
35,New Mexico,38,North Dakota,35,Grand Forks County,0,20,-20
35,New Mexico,38,North Dakota,45,LaMoure County,0,4,-4
35,New Mexico,38,North Dakota,59,Morton County,0,8,-8
35,New Mexico,38,North Dakota,89,Stark County,20,0,20
35,New Mexico,38,North Dakota,101,Ward County,8,44,-36
35,New Mexico,38,North Dakota,105,Williams County,3,7,-4
35,New Mexico,39,Ohio,7,Ashtabula County,8,0,8
35,New Mexico,39,Ohio,9,Athens County,0,6,-6
35,New Mexico,39,Ohio,13,Belmont County,43,0,43
35,New Mexico,39,Ohio,23,Clark County,0,9,-9
35,New Mexico,39,Ohio,25,Clermont County,57,23,34
35,New Mexico,39,Ohio,35,Cuyahoga County,37,39,-2
35,New Mexico,39,Ohio,49,Franklin County,178,199,-21
35,New Mexico,39,Ohio,57,Greene County,32,78,-46
35,New Mexico,39,Ohio,61,Hamilton County,37,33,4
35,New Mexico,39,Ohio,67,Harrison County,0,26,-26
35,New Mexico,39,Ohio,89,Licking County,18,0,18
35,New Mexico,39,Ohio,91,Logan County,17,0,17
35,New Mexico,39,Ohio,93,Lorain County,81,33,48
35,New Mexico,39,Ohio,95,Lucas County,12,28,-16
35,New Mexico,39,Ohio,99,Mahoning County,13,56,-43
35,New Mexico,39,Ohio,101,Marion County,4,0,4
35,New Mexico,39,Ohio,103,Medina County,18,29,-11
35,New Mexico,39,Ohio,109,Miami County,14,0,14
35,New Mexico,39,Ohio,113,Montgomery County,0,21,-21
35,New Mexico,39,Ohio,119,Muskingum County,0,6,-6
35,New Mexico,39,Ohio,133,Portage County,32,4,28
35,New Mexico,39,Ohio,139,Richland County,6,0,6
35,New Mexico,39,Ohio,145,Scioto County,0,19,-19
35,New Mexico,39,Ohio,147,Seneca County,0,4,-4
35,New Mexico,39,Ohio,151,Stark County,19,7,12
35,New Mexico,39,Ohio,153,Summit County,43,0,43
35,New Mexico,39,Ohio,155,Trumbull County,0,6,-6
35,New Mexico,39,Ohio,165,Warren County,11,0,11
35,New Mexico,39,Ohio,169,Wayne County,40,0,40
35,New Mexico,39,Ohio,173,Wood County,28,160,-132
35,New Mexico,4,Arizona,1,Apache County,574,178,396
35,New Mexico,4,Arizona,3,Cochise County,190,291,-101
35,New Mexico,4,Arizona,5,Coconino County,123,79,44
35,New Mexico,4,Arizona,7,Gila County,77,30,47
35,New Mexico,4,Arizona,9,Graham County,171,250,-79
35,New Mexico,4,Arizona,11,Greenlee County,26,124,-98
35,New Mexico,4,Arizona,12,La Paz County,0,10,-10
35,New Mexico,4,Arizona,13,Maricopa County,3401,4139,-738
35,New Mexico,4,Arizona,15,Mohave County,269,403,-134
35,New Mexico,4,Arizona,17,Navajo County,194,287,-93
35,New Mexico,4,Arizona,19,Pima County,1164,1253,-89
35,New Mexico,4,Arizona,21,Pinal County,233,741,-508
35,New Mexico,4,Arizona,23,Santa Cruz County,0,21,-21
35,New Mexico,4,Arizona,25,Yavapai County,59,77,-18
35,New Mexico,4,Arizona,27,Yuma County,56,45,11
35,New Mexico,40,Oklahoma,3,Alfalfa County,0,2,-2
35,New Mexico,40,Oklahoma,5,Atoka County,0,6,-6
35,New Mexico,40,Oklahoma,7,Beaver County,0,4,-4
35,New Mexico,40,Oklahoma,9,Beckham County,14,0,14
35,New Mexico,40,Oklahoma,11,Blaine County,0,2,-2
35,New Mexico,40,Oklahoma,13,Bryan County,0,3,-3
35,New Mexico,40,Oklahoma,15,Caddo County,17,12,5
35,New Mexico,40,Oklahoma,17,Canadian County,0,66,-66
35,New Mexico,40,Oklahoma,19,Carter County,0,16,-16
35,New Mexico,40,Oklahoma,21,Cherokee County,5,0,5
35,New Mexico,40,Oklahoma,25,Cimarron County,14,0,14
35,New Mexico,40,Oklahoma,27,Cleveland County,111,87,24
35,New Mexico,40,Oklahoma,31,Comanche County,63,77,-14
35,New Mexico,40,Oklahoma,37,Creek County,0,4,-4
35,New Mexico,40,Oklahoma,39,Custer County,146,0,146
35,New Mexico,40,Oklahoma,41,Delaware County,11,4,7
35,New Mexico,40,Oklahoma,47,Garfield County,28,15,13
35,New Mexico,40,Oklahoma,49,Garvin County,0,4,-4
35,New Mexico,40,Oklahoma,51,Grady County,0,36,-36
35,New Mexico,40,Oklahoma,63,Hughes County,0,4,-4
35,New Mexico,40,Oklahoma,71,Kay County,51,41,10
35,New Mexico,40,Oklahoma,73,Kingfisher County,26,7,19
35,New Mexico,40,Oklahoma,75,Kiowa County,50,14,36
35,New Mexico,40,Oklahoma,77,Latimer County,0,7,-7
35,New Mexico,40,Oklahoma,79,Le Flore County,15,0,15
35,New Mexico,40,Oklahoma,81,Lincoln County,0,8,-8
35,New Mexico,40,Oklahoma,83,Logan County,2,0,2
35,New Mexico,40,Oklahoma,85,Love County,0,1,-1
35,New Mexico,40,Oklahoma,87,McClain County,30,0,30
35,New Mexico,40,Oklahoma,99,Murray County,0,14,-14
35,New Mexico,40,Oklahoma,101,Muskogee County,0,18,-18
35,New Mexico,40,Oklahoma,103,Noble County,0,34,-34
35,New Mexico,40,Oklahoma,107,Okfuskee County,0,2,-2
35,New Mexico,40,Oklahoma,109,Oklahoma County,515,431,84
35,New Mexico,40,Oklahoma,111,Okmulgee County,0,4,-4
35,New Mexico,40,Oklahoma,117,Pawnee County,0,2,-2
35,New Mexico,40,Oklahoma,119,Payne County,16,40,-24
35,New Mexico,40,Oklahoma,121,Pittsburg County,0,24,-24
35,New Mexico,40,Oklahoma,123,Pontotoc County,0,11,-11
35,New Mexico,40,Oklahoma,125,Pottawatomie County,5,3,2
35,New Mexico,40,Oklahoma,127,Pushmataha County,0,6,-6
35,New Mexico,40,Oklahoma,129,Roger Mills County,0,6,-6
35,New Mexico,40,Oklahoma,133,Seminole County,0,13,-13
35,New Mexico,40,Oklahoma,135,Sequoyah County,5,9,-4
35,New Mexico,40,Oklahoma,137,Stephens County,0,33,-33
35,New Mexico,40,Oklahoma,139,Texas County,26,12,14
35,New Mexico,40,Oklahoma,143,Tulsa County,270,318,-48
35,New Mexico,40,Oklahoma,145,Wagoner County,40,11,29
35,New Mexico,40,Oklahoma,147,Washington County,104,0,104
35,New Mexico,40,Oklahoma,153,Woodward County,55,0,55
35,New Mexico,41,Oregon,3,Benton County,55,19,36
35,New Mexico,41,Oregon,5,Clackamas County,104,8,96
35,New Mexico,41,Oregon,9,Columbia County,0,1,-1
35,New Mexico,41,Oregon,11,Coos County,0,49,-49
35,New Mexico,41,Oregon,13,Crook County,25,0,25
35,New Mexico,41,Oregon,17,Deschutes County,13,75,-62
35,New Mexico,41,Oregon,19,Douglas County,7,123,-116
35,New Mexico,41,Oregon,27,Hood River County,0,8,-8
35,New Mexico,41,Oregon,29,Jackson County,97,54,43
35,New Mexico,41,Oregon,31,Jefferson County,0,42,-42
35,New Mexico,41,Oregon,33,Josephine County,0,17,-17
35,New Mexico,41,Oregon,35,Klamath County,24,22,2
35,New Mexico,41,Oregon,39,Lane County,14,194,-180
35,New Mexico,41,Oregon,41,Lincoln County,0,20,-20
35,New Mexico,41,Oregon,43,Linn County,0,4,-4
35,New Mexico,41,Oregon,45,Malheur County,9,0,9
35,New Mexico,41,Oregon,47,Marion County,66,94,-28
35,New Mexico,41,Oregon,51,Multnomah County,379,305,74
35,New Mexico,41,Oregon,53,Polk County,0,13,-13
35,New Mexico,41,Oregon,59,Umatilla County,1,8,-7
35,New Mexico,41,Oregon,61,Union County,0,3,-3
35,New Mexico,41,Oregon,65,Wasco County,0,19,-19
35,New Mexico,41,Oregon,67,Washington County,134,407,-273
35,New Mexico,41,Oregon,71,Yamhill County,51,61,-10
35,New Mexico,42,Pennsylvania,1,Adams County,0,14,-14
35,New Mexico,42,Pennsylvania,3,Allegheny County,72,60,12
35,New Mexico,42,Pennsylvania,11,Berks County,14,0,14
35,New Mexico,42,Pennsylvania,13,Blair County,0,17,-17
35,New Mexico,42,Pennsylvania,17,Bucks County,0,41,-41
35,New Mexico,42,Pennsylvania,19,Butler County,6,0,6
35,New Mexico,42,Pennsylvania,21,Cambria County,11,0,11
35,New Mexico,42,Pennsylvania,29,Chester County,0,32,-32
35,New Mexico,42,Pennsylvania,37,Columbia County,48,0,48
35,New Mexico,42,Pennsylvania,39,Crawford County,0,13,-13
35,New Mexico,42,Pennsylvania,41,Cumberland County,70,11,59
35,New Mexico,42,Pennsylvania,43,Dauphin County,75,31,44
35,New Mexico,42,Pennsylvania,45,Delaware County,64,0,64
35,New Mexico,42,Pennsylvania,47,Elk County,11,0,11
35,New Mexico,42,Pennsylvania,49,Erie County,0,15,-15
35,New Mexico,42,Pennsylvania,61,Huntingdon County,0,2,-2
35,New Mexico,42,Pennsylvania,63,Indiana County,26,0,26
35,New Mexico,42,Pennsylvania,69,Lackawanna County,0,57,-57
35,New Mexico,42,Pennsylvania,71,Lancaster County,26,12,14
35,New Mexico,42,Pennsylvania,73,Lawrence County,0,22,-22
35,New Mexico,42,Pennsylvania,77,Lehigh County,0,8,-8
35,New Mexico,42,Pennsylvania,83,McKean County,5,3,2
35,New Mexico,42,Pennsylvania,85,Mercer County,0,13,-13
35,New Mexico,42,Pennsylvania,89,Monroe County,13,0,13
35,New Mexico,42,Pennsylvania,91,Montgomery County,7,22,-15
35,New Mexico,42,Pennsylvania,95,Northampton County,0,42,-42
35,New Mexico,42,Pennsylvania,101,Philadelphia County,118,60,58
35,New Mexico,42,Pennsylvania,107,Schuylkill County,8,0,8
35,New Mexico,42,Pennsylvania,115,Susquehanna County,0,4,-4
35,New Mexico,42,Pennsylvania,117,Tioga County,29,0,29
35,New Mexico,42,Pennsylvania,125,Washington County,0,12,-12
35,New Mexico,42,Pennsylvania,127,Wayne County,0,5,-5
35,New Mexico,42,Pennsylvania,131,Wyoming County,0,10,-10
35,New Mexico,42,Pennsylvania,133,York County,71,0,71
35,New Mexico,44,Rhode Island,5,Newport County,2,0,2
35,New Mexico,44,Rhode Island,7,Providence County,57,11,46
35,New Mexico,45,South Carolina,3,Aiken County,124,4,120
35,New Mexico,45,South Carolina,13,Beaufort County,137,0,137
35,New Mexico,45,South Carolina,15,Berkeley County,0,24,-24
35,New Mexico,45,South Carolina,19,Charleston County,69,94,-25
35,New Mexico,45,South Carolina,21,Cherokee County,27,0,27
35,New Mexico,45,South Carolina,27,Clarendon County,0,10,-10
35,New Mexico,45,South Carolina,35,Dorchester County,72,21,51
35,New Mexico,45,South Carolina,45,Greenville County,21,24,-3
35,New Mexico,45,South Carolina,51,Horry County,71,0,71
35,New Mexico,45,South Carolina,57,Lancaster County,16,0,16
35,New Mexico,45,South Carolina,73,Oconee County,0,8,-8
35,New Mexico,45,South Carolina,79,Richland County,29,246,-217
35,New Mexico,45,South Carolina,85,Sumter County,224,0,224
35,New Mexico,45,South Carolina,91,York County,0,89,-89
35,New Mexico,46,South Dakota,9,Bon Homme County,0,4,-4
35,New Mexico,46,South Dakota,27,Clay County,0,26,-26
35,New Mexico,46,South Dakota,33,Custer County,113,8,105
35,New Mexico,46,South Dakota,39,Deuel County,0,2,-2
35,New Mexico,46,South Dakota,47,Fall River County,0,27,-27
35,New Mexico,46,South Dakota,65,Hughes County,0,21,-21
35,New Mexico,46,South Dakota,79,Lake County,8,0,8
35,New Mexico,46,South Dakota,81,Lawrence County,0,16,-16
35,New Mexico,46,South Dakota,85,Lyman County,0,6,-6
35,New Mexico,46,South Dakota,99,Minnehaha County,0,35,-35
35,New Mexico,46,South Dakota,103,Pennington County,41,56,-15
35,New Mexico,46,South Dakota,121,Todd County,0,10,-10
35,New Mexico,46,South Dakota,135,Yankton County,10,0,10
35,New Mexico,47,Tennessee,1,Anderson County,0,26,-26
35,New Mexico,47,Tennessee,7,Bledsoe County,12,0,12
35,New Mexico,47,Tennessee,9,Blount County,2,0,2
35,New Mexico,47,Tennessee,29,Cocke County,0,48,-48
35,New Mexico,47,Tennessee,37,Davidson County,41,24,17
35,New Mexico,47,Tennessee,53,Gibson County,8,0,8
35,New Mexico,47,Tennessee,65,Hamilton County,0,29,-29
35,New Mexico,47,Tennessee,75,Haywood County,39,0,39
35,New Mexico,47,Tennessee,93,Knox County,96,87,9
35,New Mexico,47,Tennessee,95,Lake County,94,0,94
35,New Mexico,47,Tennessee,99,Lawrence County,0,14,-14
35,New Mexico,47,Tennessee,107,McMinn County,87,0,87
35,New Mexico,47,Tennessee,109,McNairy County,0,4,-4
35,New Mexico,47,Tennessee,113,Madison County,0,4,-4
35,New Mexico,47,Tennessee,119,Maury County,0,15,-15
35,New Mexico,47,Tennessee,123,Monroe County,4,0,4
35,New Mexico,47,Tennessee,125,Montgomery County,108,67,41
35,New Mexico,47,Tennessee,145,Roane County,0,11,-11
35,New Mexico,47,Tennessee,147,Robertson County,0,14,-14
35,New Mexico,47,Tennessee,149,Rutherford County,28,0,28
35,New Mexico,47,Tennessee,155,Sevier County,10,0,10
35,New Mexico,47,Tennessee,157,Shelby County,67,8,59
35,New Mexico,47,Tennessee,165,Sumner County,67,0,67
35,New Mexico,47,Tennessee,177,Warren County,0,14,-14
35,New Mexico,47,Tennessee,187,Williamson County,7,15,-8
35,New Mexico,48,Texas,3,Andrews County,88,15,73
35,New Mexico,48,Texas,15,Austin County,56,19,37
35,New Mexico,48,Texas,17,Bailey County,267,63,204
35,New Mexico,48,Texas,21,Bastrop County,48,0,48
35,New Mexico,48,Texas,25,Bee County,0,17,-17
35,New Mexico,48,Texas,27,Bell County,151,76,75
35,New Mexico,48,Texas,29,Bexar County,685,1047,-362
35,New Mexico,48,Texas,31,Blanco County,8,0,8
35,New Mexico,48,Texas,35,Bosque County,19,12,7
35,New Mexico,48,Texas,37,Bowie County,17,0,17
35,New Mexico,48,Texas,39,Brazoria County,72,113,-41
35,New Mexico,48,Texas,41,Brazos County,102,169,-67
35,New Mexico,48,Texas,43,Brewster County,17,0,17
35,New Mexico,48,Texas,45,Briscoe County,0,14,-14
35,New Mexico,48,Texas,49,Brown County,9,1,8
35,New Mexico,48,Texas,53,Burnet County,0,3,-3
35,New Mexico,48,Texas,61,Cameron County,123,19,104
35,New Mexico,48,Texas,63,Camp County,0,29,-29
35,New Mexico,48,Texas,65,Carson County,0,1,-1
35,New Mexico,48,Texas,69,Castro County,50,0,50
35,New Mexico,48,Texas,73,Cherokee County,34,10,24
35,New Mexico,48,Texas,75,Childress County,18,0,18
35,New Mexico,48,Texas,79,Cochran County,1,23,-22
35,New Mexico,48,Texas,85,Collin County,207,304,-97
35,New Mexico,48,Texas,91,Comal County,51,67,-16
35,New Mexico,48,Texas,93,Comanche County,30,0,30
35,New Mexico,48,Texas,97,Cooke County,0,165,-165
35,New Mexico,48,Texas,99,Coryell County,8,70,-62
35,New Mexico,48,Texas,103,Crane County,0,19,-19
35,New Mexico,48,Texas,105,Crockett County,0,2,-2
35,New Mexico,48,Texas,107,Crosby County,48,0,48
35,New Mexico,48,Texas,109,Culberson County,41,5,36
35,New Mexico,48,Texas,111,Dallam County,172,77,95
35,New Mexico,48,Texas,113,Dallas County,978,465,513
35,New Mexico,48,Texas,115,Dawson County,0,165,-165
35,New Mexico,48,Texas,117,Deaf Smith County,170,36,134
35,New Mexico,48,Texas,121,Denton County,200,560,-360
35,New Mexico,48,Texas,129,Donley County,0,6,-6
35,New Mexico,48,Texas,133,Eastland County,0,5,-5
35,New Mexico,48,Texas,135,Ector County,173,854,-681
35,New Mexico,48,Texas,139,Ellis County,101,4,97
35,New Mexico,48,Texas,141,El Paso County,4823,3497,1326
35,New Mexico,48,Texas,143,Erath County,26,28,-2
35,New Mexico,48,Texas,145,Falls County,0,20,-20
35,New Mexico,48,Texas,149,Fayette County,0,1,-1
35,New Mexico,48,Texas,153,Floyd County,51,38,13
35,New Mexico,48,Texas,157,Fort Bend County,74,76,-2
35,New Mexico,48,Texas,159,Franklin County,0,19,-19
35,New Mexico,48,Texas,165,Gaines County,113,111,2
35,New Mexico,48,Texas,167,Galveston County,52,100,-48
35,New Mexico,48,Texas,169,Garza County,49,57,-8
35,New Mexico,48,Texas,177,Gonzales County,0,10,-10
35,New Mexico,48,Texas,179,Gray County,57,41,16
35,New Mexico,48,Texas,181,Grayson County,39,23,16
35,New Mexico,48,Texas,183,Gregg County,66,0,66
35,New Mexico,48,Texas,185,Grimes County,0,17,-17
35,New Mexico,48,Texas,187,Guadalupe County,22,70,-48
35,New Mexico,48,Texas,189,Hale County,68,58,10
35,New Mexico,48,Texas,191,Hall County,0,8,-8
35,New Mexico,48,Texas,197,Hardeman County,0,4,-4
35,New Mexico,48,Texas,201,Harris County,788,1721,-933
35,New Mexico,48,Texas,203,Harrison County,0,2,-2
35,New Mexico,48,Texas,209,Hays County,21,192,-171
35,New Mexico,48,Texas,213,Henderson County,124,11,113
35,New Mexico,48,Texas,215,Hidalgo County,57,14,43
35,New Mexico,48,Texas,217,Hill County,0,26,-26
35,New Mexico,48,Texas,219,Hockley County,0,106,-106
35,New Mexico,48,Texas,223,Hopkins County,0,1,-1
35,New Mexico,48,Texas,227,Howard County,108,106,2
35,New Mexico,48,Texas,229,Hudspeth County,14,12,2
35,New Mexico,48,Texas,231,Hunt County,67,27,40
35,New Mexico,48,Texas,243,Jeff Davis County,0,36,-36
35,New Mexico,48,Texas,249,Jim Wells County,8,1,7
35,New Mexico,48,Texas,251,Johnson County,40,0,40
35,New Mexico,48,Texas,257,Kaufman County,7,23,-16
35,New Mexico,48,Texas,259,Kendall County,20,0,20
35,New Mexico,48,Texas,265,Kerr County,0,69,-69
35,New Mexico,48,Texas,267,Kimble County,0,2,-2
35,New Mexico,48,Texas,275,Knox County,0,12,-12
35,New Mexico,48,Texas,277,Lamar County,0,30,-30
35,New Mexico,48,Texas,279,Lamb County,18,233,-215
35,New Mexico,48,Texas,281,Lampasas County,0,34,-34
35,New Mexico,48,Texas,287,Lee County,28,0,28
35,New Mexico,48,Texas,291,Liberty County,34,0,34
35,New Mexico,48,Texas,293,Limestone County,42,0,42
35,New Mexico,48,Texas,297,Live Oak County,0,44,-44
35,New Mexico,48,Texas,299,Llano County,83,0,83
35,New Mexico,48,Texas,303,Lubbock County,897,1128,-231
35,New Mexico,48,Texas,305,Lynn County,58,1,57
35,New Mexico,48,Texas,309,McLennan County,44,45,-1
35,New Mexico,48,Texas,323,Maverick County,4,0,4
35,New Mexico,48,Texas,325,Medina County,0,42,-42
35,New Mexico,48,Texas,327,Menard County,0,42,-42
35,New Mexico,48,Texas,329,Midland County,508,473,35
35,New Mexico,48,Texas,331,Milam County,0,30,-30
35,New Mexico,48,Texas,337,Montague County,0,16,-16
35,New Mexico,48,Texas,339,Montgomery County,52,121,-69
35,New Mexico,48,Texas,341,Moore County,19,37,-18
35,New Mexico,48,Texas,345,Motley County,0,9,-9
35,New Mexico,48,Texas,347,Nacogdoches County,0,3,-3
35,New Mexico,48,Texas,349,Navarro County,23,1,22
35,New Mexico,48,Texas,353,Nolan County,19,0,19
35,New Mexico,48,Texas,355,Nueces County,134,191,-57
35,New Mexico,48,Texas,357,Ochiltree County,30,0,30
35,New Mexico,48,Texas,359,Oldham County,0,11,-11
35,New Mexico,48,Texas,361,Orange County,0,51,-51
35,New Mexico,48,Texas,367,Parker County,3,58,-55
35,New Mexico,48,Texas,369,Parmer County,176,54,122
35,New Mexico,48,Texas,371,Pecos County,0,8,-8
35,New Mexico,48,Texas,373,Polk County,0,85,-85
35,New Mexico,48,Texas,375,Potter County,190,315,-125
35,New Mexico,48,Texas,377,Presidio County,0,30,-30
35,New Mexico,48,Texas,379,Rains County,0,5,-5
35,New Mexico,48,Texas,381,Randall County,148,652,-504
35,New Mexico,48,Texas,383,Reagan County,11,0,11
35,New Mexico,48,Texas,385,Real County,0,33,-33
35,New Mexico,48,Texas,387,Red River County,0,3,-3
35,New Mexico,48,Texas,389,Reeves County,87,110,-23
35,New Mexico,48,Texas,397,Rockwall County,7,16,-9
35,New Mexico,48,Texas,407,San Jacinto County,22,0,22
35,New Mexico,48,Texas,409,San Patricio County,14,25,-11
35,New Mexico,48,Texas,415,Scurry County,1,12,-11
35,New Mexico,48,Texas,417,Shackelford County,0,4,-4
35,New Mexico,48,Texas,419,Shelby County,0,102,-102
35,New Mexico,48,Texas,423,Smith County,0,97,-97
35,New Mexico,48,Texas,427,Starr County,5,0,5
35,New Mexico,48,Texas,429,Stephens County,0,7,-7
35,New Mexico,48,Texas,433,Stonewall County,0,1,-1
35,New Mexico,48,Texas,437,Swisher County,0,14,-14
35,New Mexico,48,Texas,439,Tarrant County,635,609,26
35,New Mexico,48,Texas,441,Taylor County,11,32,-21
35,New Mexico,48,Texas,445,Terry County,0,80,-80
35,New Mexico,48,Texas,451,Tom Green County,202,92,110
35,New Mexico,48,Texas,453,Travis County,287,1030,-743
35,New Mexico,48,Texas,457,Tyler County,5,6,-1
35,New Mexico,48,Texas,459,Upshur County,0,32,-32
35,New Mexico,48,Texas,461,Upton County,0,8,-8
35,New Mexico,48,Texas,463,Uvalde County,13,0,13
35,New Mexico,48,Texas,465,Val Verde County,129,0,129
35,New Mexico,48,Texas,467,Van Zandt County,0,5,-5
35,New Mexico,48,Texas,471,Walker County,79,0,79
35,New Mexico,48,Texas,473,Waller County,65,0,65
35,New Mexico,48,Texas,475,Ward County,29,0,29
35,New Mexico,48,Texas,479,Webb County,0,1,-1
35,New Mexico,48,Texas,485,Wichita County,132,14,118
35,New Mexico,48,Texas,491,Williamson County,135,428,-293
35,New Mexico,48,Texas,497,Wise County,34,13,21
35,New Mexico,48,Texas,499,Wood County,63,21,42
35,New Mexico,48,Texas,501,Yoakum County,21,0,21
35,New Mexico,49,Utah,3,Box Elder County,0,41,-41
35,New Mexico,49,Utah,5,Cache County,15,32,-17
35,New Mexico,49,Utah,11,Davis County,262,264,-2
35,New Mexico,49,Utah,13,Duchesne County,0,19,-19
35,New Mexico,49,Utah,15,Emery County,0,25,-25
35,New Mexico,49,Utah,17,Garfield County,0,2,-2
35,New Mexico,49,Utah,23,Juab County,0,2,-2
35,New Mexico,49,Utah,25,Kane County,0,16,-16
35,New Mexico,49,Utah,35,Salt Lake County,399,508,-109
35,New Mexico,49,Utah,37,San Juan County,4,57,-53
35,New Mexico,49,Utah,39,Sanpete County,23,0,23
35,New Mexico,49,Utah,41,Sevier County,0,8,-8
35,New Mexico,49,Utah,43,Summit County,0,12,-12
35,New Mexico,49,Utah,45,Tooele County,0,247,-247
35,New Mexico,49,Utah,47,Uintah County,42,20,22
35,New Mexico,49,Utah,49,Utah County,293,121,172
35,New Mexico,49,Utah,53,Washington County,8,0,8
35,New Mexico,49,Utah,55,Wayne County,20,5,15
35,New Mexico,49,Utah,57,Weber County,15,25,-10
35,New Mexico,5,Arkansas,5,Baxter County,5,43,-38
35,New Mexico,5,Arkansas,7,Benton County,18,69,-51
35,New Mexico,5,Arkansas,9,Boone County,0,4,-4
35,New Mexico,5,Arkansas,27,Columbia County,0,4,-4
35,New Mexico,5,Arkansas,31,Craighead County,0,11,-11
35,New Mexico,5,Arkansas,45,Faulkner County,0,25,-25
35,New Mexico,5,Arkansas,51,Garland County,0,21,-21
35,New Mexico,5,Arkansas,59,Hot Spring County,0,7,-7
35,New Mexico,5,Arkansas,69,Jefferson County,0,7,-7
35,New Mexico,5,Arkansas,75,Lawrence County,0,6,-6
35,New Mexico,5,Arkansas,81,Little River County,20,0,20
35,New Mexico,5,Arkansas,85,Lonoke County,0,19,-19
35,New Mexico,5,Arkansas,89,Marion County,0,16,-16
35,New Mexico,5,Arkansas,91,Miller County,0,20,-20
35,New Mexico,5,Arkansas,97,Montgomery County,0,5,-5
35,New Mexico,5,Arkansas,103,Ouachita County,17,0,17
35,New Mexico,5,Arkansas,107,Phillips County,25,0,25
35,New Mexico,5,Arkansas,113,Polk County,0,13,-13
35,New Mexico,5,Arkansas,119,Pulaski County,107,46,61
35,New Mexico,5,Arkansas,131,Sebastian County,0,32,-32
35,New Mexico,5,Arkansas,135,Sharp County,0,2,-2
35,New Mexico,5,Arkansas,139,Union County,0,14,-14
35,New Mexico,5,Arkansas,143,Washington County,29,30,-1
35,New Mexico,5,Arkansas,145,White County,0,5,-5
35,New Mexico,50,Vermont,3,Bennington County,0,11,-11
35,New Mexico,50,Vermont,5,Caledonia County,1,0,1
35,New Mexico,50,Vermont,7,Chittenden County,58,30,28
35,New Mexico,50,Vermont,21,Rutland County,0,9,-9
35,New Mexico,50,Vermont,23,Washington County,7,4,3
35,New Mexico,50,Vermont,27,Windsor County,9,16,-7
35,New Mexico,51,Virginia,13,Arlington County,32,143,-111
35,New Mexico,51,Virginia,15,Augusta County,0,11,-11
35,New Mexico,51,Virginia,21,Bland County,0,46,-46
35,New Mexico,51,Virginia,41,Chesterfield County,0,25,-25
35,New Mexico,51,Virginia,59,Fairfax County,384,192,192
35,New Mexico,51,Virginia,83,Halifax County,0,31,-31
35,New Mexico,51,Virginia,85,Hanover County,10,0,10
35,New Mexico,51,Virginia,87,Henrico County,75,0,75
35,New Mexico,51,Virginia,95,James City County,17,13,4
35,New Mexico,51,Virginia,107,Loudoun County,34,109,-75
35,New Mexico,51,Virginia,109,Louisa County,28,0,28
35,New Mexico,51,Virginia,139,Page County,0,7,-7
35,New Mexico,51,Virginia,147,Prince Edward County,25,0,25
35,New Mexico,51,Virginia,149,Prince George County,3,0,3
35,New Mexico,51,Virginia,153,Prince William County,53,180,-127
35,New Mexico,51,Virginia,161,Roanoke County,6,15,-9
35,New Mexico,51,Virginia,165,Rockingham County,0,30,-30
35,New Mexico,51,Virginia,171,Shenandoah County,13,0,13
35,New Mexico,51,Virginia,179,Stafford County,16,5,11
35,New Mexico,51,Virginia,181,Surry County,21,0,21
35,New Mexico,51,Virginia,187,Warren County,18,0,18
35,New Mexico,51,Virginia,199,York County,38,0,38
35,New Mexico,51,Virginia,510,Alexandria city,68,33,35
35,New Mexico,51,Virginia,550,Chesapeake city,55,71,-16
35,New Mexico,51,Virginia,590,Danville city,70,0,70
35,New Mexico,51,Virginia,600,Fairfax city,0,4,-4
35,New Mexico,51,Virginia,610,Falls Church city,0,33,-33
35,New Mexico,51,Virginia,650,Hampton city,9,106,-97
35,New Mexico,51,Virginia,660,Harrisonburg city,0,1,-1
35,New Mexico,51,Virginia,680,Lynchburg city,9,0,9
35,New Mexico,51,Virginia,683,Manassas city,0,43,-43
35,New Mexico,51,Virginia,700,Newport News city,85,59,26
35,New Mexico,51,Virginia,710,Norfolk city,110,27,83
35,New Mexico,51,Virginia,740,Portsmouth city,30,0,30
35,New Mexico,51,Virginia,760,Richmond city,54,0,54
35,New Mexico,51,Virginia,770,Roanoke city,6,0,6
35,New Mexico,51,Virginia,790,Staunton city,10,0,10
35,New Mexico,51,Virginia,800,Suffolk city,52,9,43
35,New Mexico,51,Virginia,810,Virginia Beach city,79,95,-16
35,New Mexico,53,Washington,5,Benton County,0,24,-24
35,New Mexico,53,Washington,7,Chelan County,39,0,39
35,New Mexico,53,Washington,9,Clallam County,0,12,-12
35,New Mexico,53,Washington,11,Clark County,41,166,-125
35,New Mexico,53,Washington,17,Douglas County,0,45,-45
35,New Mexico,53,Washington,21,Franklin County,8,0,8
35,New Mexico,53,Washington,25,Grant County,33,0,33
35,New Mexico,53,Washington,27,Grays Harbor County,0,10,-10
35,New Mexico,53,Washington,29,Island County,193,22,171
35,New Mexico,53,Washington,33,King County,400,516,-116
35,New Mexico,53,Washington,35,Kitsap County,27,224,-197
35,New Mexico,53,Washington,37,Kittitas County,36,62,-26
35,New Mexico,53,Washington,41,Lewis County,0,31,-31
35,New Mexico,53,Washington,47,Okanogan County,24,0,24
35,New Mexico,53,Washington,51,Pend Oreille County,0,8,-8
35,New Mexico,53,Washington,53,Pierce County,35,69,-34
35,New Mexico,53,Washington,55,San Juan County,16,11,5
35,New Mexico,53,Washington,57,Skagit County,8,8,0
35,New Mexico,53,Washington,61,Snohomish County,87,281,-194
35,New Mexico,53,Washington,63,Spokane County,35,285,-250
35,New Mexico,53,Washington,65,Stevens County,13,0,13
35,New Mexico,53,Washington,67,Thurston County,194,19,175
35,New Mexico,53,Washington,71,Walla Walla County,32,65,-33
35,New Mexico,53,Washington,73,Whatcom County,66,23,43
35,New Mexico,53,Washington,77,Yakima County,18,26,-8
35,New Mexico,54,West Virginia,3,Berkeley County,28,0,28
35,New Mexico,54,West Virginia,49,Marion County,13,0,13
35,New Mexico,54,West Virginia,61,Monongalia County,0,68,-68
35,New Mexico,54,West Virginia,69,Ohio County,0,11,-11
35,New Mexico,54,West Virginia,75,Pocahontas County,0,22,-22
35,New Mexico,54,West Virginia,77,Preston County,7,0,7
35,New Mexico,54,West Virginia,85,Ritchie County,1,0,1
35,New Mexico,54,West Virginia,89,Summers County,14,0,14
35,New Mexico,54,West Virginia,107,Wood County,16,14,2
35,New Mexico,55,Wisconsin,5,Barron County,28,7,21
35,New Mexico,55,Wisconsin,7,Bayfield County,0,6,-6
35,New Mexico,55,Wisconsin,9,Brown County,0,4,-4
35,New Mexico,55,Wisconsin,11,Buffalo County,2,0,2
35,New Mexico,55,Wisconsin,19,Clark County,0,18,-18
35,New Mexico,55,Wisconsin,25,Dane County,32,143,-111
35,New Mexico,55,Wisconsin,27,Dodge County,0,6,-6
35,New Mexico,55,Wisconsin,33,Dunn County,4,0,4
35,New Mexico,55,Wisconsin,35,Eau Claire County,0,36,-36
35,New Mexico,55,Wisconsin,43,Grant County,0,6,-6
35,New Mexico,55,Wisconsin,55,Jefferson County,101,0,101
35,New Mexico,55,Wisconsin,59,Kenosha County,27,7,20
35,New Mexico,55,Wisconsin,63,La Crosse County,10,19,-9
35,New Mexico,55,Wisconsin,77,Marquette County,0,4,-4
35,New Mexico,55,Wisconsin,79,Milwaukee County,100,113,-13
35,New Mexico,55,Wisconsin,83,Oconto County,6,0,6
35,New Mexico,55,Wisconsin,85,Oneida County,0,11,-11
35,New Mexico,55,Wisconsin,87,Outagamie County,0,18,-18
35,New Mexico,55,Wisconsin,89,Ozaukee County,14,4,10
35,New Mexico,55,Wisconsin,95,Polk County,0,44,-44
35,New Mexico,55,Wisconsin,97,Portage County,0,13,-13
35,New Mexico,55,Wisconsin,101,Racine County,10,0,10
35,New Mexico,55,Wisconsin,105,Rock County,0,3,-3
35,New Mexico,55,Wisconsin,109,St. Croix County,0,6,-6
35,New Mexico,55,Wisconsin,119,Taylor County,0,7,-7
35,New Mexico,55,Wisconsin,123,Vernon County,0,4,-4
35,New Mexico,55,Wisconsin,129,Washburn County,0,1,-1
35,New Mexico,55,Wisconsin,131,Washington County,41,17,24
35,New Mexico,55,Wisconsin,133,Waukesha County,53,7,46
35,New Mexico,55,Wisconsin,139,Winnebago County,26,0,26
35,New Mexico,56,Wyoming,1,Albany County,47,39,8
35,New Mexico,56,Wyoming,5,Campbell County,50,0,50
35,New Mexico,56,Wyoming,7,Carbon County,0,17,-17
35,New Mexico,56,Wyoming,13,Fremont County,12,16,-4
35,New Mexico,56,Wyoming,15,Goshen County,0,9,-9
35,New Mexico,56,Wyoming,17,Hot Springs County,0,11,-11
35,New Mexico,56,Wyoming,21,Laramie County,166,177,-11
35,New Mexico,56,Wyoming,23,Lincoln County,0,65,-65
35,New Mexico,56,Wyoming,25,Natrona County,22,102,-80
35,New Mexico,56,Wyoming,29,Park County,2,2,0
35,New Mexico,56,Wyoming,37,Sweetwater County,4,34,-30
35,New Mexico,56,Wyoming,39,Teton County,8,0,8
35,New Mexico,56,Wyoming,41,Uinta County,17,0,17
35,New Mexico,56,Wyoming,45,Weston County,0,2,-2
35,New Mexico,6,California,1,Alameda County,198,254,-56
35,New Mexico,6,California,7,Butte County,86,0,86
35,New Mexico,6,California,9,Calaveras County,34,0,34
35,New Mexico,6,California,11,Colusa County,0,11,-11
35,New Mexico,6,California,13,Contra Costa County,89,252,-163
35,New Mexico,6,California,15,Del Norte County,7,0,7
35,New Mexico,6,California,17,El Dorado County,0,38,-38
35,New Mexico,6,California,19,Fresno County,109,97,12
35,New Mexico,6,California,27,Inyo County,0,15,-15
35,New Mexico,6,California,29,Kern County,506,167,339
35,New Mexico,6,California,31,Kings County,0,22,-22
35,New Mexico,6,California,33,Lake County,6,21,-15
35,New Mexico,6,California,35,Lassen County,0,6,-6
35,New Mexico,6,California,37,Los Angeles County,1328,1111,217
35,New Mexico,6,California,39,Madera County,3,0,3
35,New Mexico,6,California,41,Marin County,43,32,11
35,New Mexico,6,California,45,Mendocino County,0,118,-118
35,New Mexico,6,California,47,Merced County,0,19,-19
35,New Mexico,6,California,53,Monterey County,174,117,57
35,New Mexico,6,California,55,Napa County,8,0,8
35,New Mexico,6,California,57,Nevada County,54,12,42
35,New Mexico,6,California,59,Orange County,202,271,-69
35,New Mexico,6,California,61,Placer County,17,77,-60
35,New Mexico,6,California,63,Plumas County,0,51,-51
35,New Mexico,6,California,65,Riverside County,388,360,28
35,New Mexico,6,California,67,Sacramento County,84,152,-68
35,New Mexico,6,California,71,San Bernardino County,278,553,-275
35,New Mexico,6,California,73,San Diego County,924,799,125
35,New Mexico,6,California,75,San Francisco County,24,121,-97
35,New Mexico,6,California,77,San Joaquin County,99,31,68
35,New Mexico,6,California,79,San Luis Obispo County,26,166,-140
35,New Mexico,6,California,81,San Mateo County,0,29,-29
35,New Mexico,6,California,83,Santa Barbara County,15,107,-92
35,New Mexico,6,California,85,Santa Clara County,443,111,332
35,New Mexico,6,California,87,Santa Cruz County,25,28,-3
35,New Mexico,6,California,89,Shasta County,21,0,21
35,New Mexico,6,California,93,Siskiyou County,69,0,69
35,New Mexico,6,California,95,Solano County,81,244,-163
35,New Mexico,6,California,97,Sonoma County,18,84,-66
35,New Mexico,6,California,99,Stanislaus County,68,30,38
35,New Mexico,6,California,101,Sutter County,9,124,-115
35,New Mexico,6,California,107,Tulare County,24,95,-71
35,New Mexico,6,California,109,Tuolumne County,6,0,6
35,New Mexico,6,California,111,Ventura County,77,154,-77
35,New Mexico,6,California,113,Yolo County,30,64,-34
35,New Mexico,6,California,115,Yuba County,0,46,-46
35,New Mexico,72,Puerto Rico,31,Carolina Municipio,28,0,28
35,New Mexico,72,Puerto Rico,47,Corozal Municipio,31,0,31
35,New Mexico,72,Puerto Rico,127,San Juan Municipio,116,0,116
35,New Mexico,72,Puerto Rico,151,Yabucoa Municipio,20,0,20
35,New Mexico,8,Colorado,1,Adams County,54,269,-215
35,New Mexico,8,Colorado,3,Alamosa County,0,171,-171
35,New Mexico,8,Colorado,5,Arapahoe County,529,532,-3
35,New Mexico,8,Colorado,7,Archuleta County,28,97,-69
35,New Mexico,8,Colorado,13,Boulder County,140,342,-202
35,New Mexico,8,Colorado,14,Broomfield County,35,40,-5
35,New Mexico,8,Colorado,15,Chaffee County,18,14,4
35,New Mexico,8,Colorado,25,Crowley County,0,55,-55
35,New Mexico,8,Colorado,29,Delta County,42,8,34
35,New Mexico,8,Colorado,31,Denver County,540,616,-76
35,New Mexico,8,Colorado,35,Douglas County,160,265,-105
35,New Mexico,8,Colorado,37,Eagle County,25,37,-12
35,New Mexico,8,Colorado,41,El Paso County,1205,999,206
35,New Mexico,8,Colorado,43,Fremont County,70,42,28
35,New Mexico,8,Colorado,45,Garfield County,0,39,-39
35,New Mexico,8,Colorado,49,Grand County,16,0,16
35,New Mexico,8,Colorado,51,Gunnison County,1,23,-22
35,New Mexico,8,Colorado,53,Hinsdale County,0,6,-6
35,New Mexico,8,Colorado,55,Huerfano County,81,8,73
35,New Mexico,8,Colorado,59,Jefferson County,306,257,49
35,New Mexico,8,Colorado,63,Kit Carson County,0,31,-31
35,New Mexico,8,Colorado,67,La Plata County,273,634,-361
35,New Mexico,8,Colorado,69,Larimer County,359,271,88
35,New Mexico,8,Colorado,71,Las Animas County,152,57,95
35,New Mexico,8,Colorado,73,Lincoln County,0,1,-1
35,New Mexico,8,Colorado,77,Mesa County,114,230,-116
35,New Mexico,8,Colorado,81,Moffat County,0,25,-25
35,New Mexico,8,Colorado,83,Montezuma County,28,78,-50
35,New Mexico,8,Colorado,85,Montrose County,0,32,-32
35,New Mexico,8,Colorado,87,Morgan County,100,7,93
35,New Mexico,8,Colorado,89,Otero County,0,93,-93
35,New Mexico,8,Colorado,97,Pitkin County,3,0,3
35,New Mexico,8,Colorado,99,Prowers County,6,5,1
35,New Mexico,8,Colorado,101,Pueblo County,122,396,-274
35,New Mexico,8,Colorado,103,Rio Blanco County,0,69,-69
35,New Mexico,8,Colorado,105,Rio Grande County,31,14,17
35,New Mexico,8,Colorado,107,Routt County,0,16,-16
35,New Mexico,8,Colorado,109,Saguache County,11,0,11
35,New Mexico,8,Colorado,113,San Miguel County,0,18,-18
35,New Mexico,8,Colorado,115,Sedgwick County,55,0,55
35,New Mexico,8,Colorado,117,Summit County,0,24,-24
35,New Mexico,8,Colorado,119,Teller County,20,0,20
35,New Mexico,8,Colorado,123,Weld County,108,158,-50
35,New Mexico,9,Connecticut,1,Fairfield County,73,11,62
35,New Mexico,9,Connecticut,3,Hartford County,52,8,44
35,New Mexico,9,Connecticut,5,Litchfield County,27,0,27
35,New Mexico,9,Connecticut,9,New Haven County,82,110,-28
35,New Mexico,9,Connecticut,11,New London County,45,88,-43
35,New Mexico,AFR,Africa,,-,264,0,0
35,New Mexico,ASI,Asia,,-,3011,0,0
35,New Mexico,CAM,Central America,,-,4371,0,0
35,New Mexico,CAR,Caribbean,,-,36,0,0
35,New Mexico,EUR,Europe,,-,2206,0,0
35,New Mexico,ISL,U.S. Island Areas,,-,55,0,0
35,New Mexico,NAM,Northern America,,-,286,0,0
35,New Mexico,OCE,Oceania and At Sea,,-,208,0,0
35,New Mexico,SAM,South America,,-,352,0,0
36,New York,1,Alabama,1,Autauga County,22,0,22
36,New York,1,Alabama,3,Baldwin County,76,143,-67
36,New York,1,Alabama,7,Bibb County,0,8,-8
36,New York,1,Alabama,15,Calhoun County,2,77,-75
36,New York,1,Alabama,17,Chambers County,0,14,-14
36,New York,1,Alabama,23,Choctaw County,18,3,15
36,New York,1,Alabama,29,Cleburne County,0,14,-14
36,New York,1,Alabama,31,Coffee County,75,222,-147
36,New York,1,Alabama,33,Colbert County,11,72,-61
36,New York,1,Alabama,35,Conecuh County,0,3,-3
36,New York,1,Alabama,39,Covington County,14,2,12
36,New York,1,Alabama,45,Dale County,143,188,-45
36,New York,1,Alabama,47,Dallas County,37,51,-14
36,New York,1,Alabama,49,DeKalb County,0,7,-7
36,New York,1,Alabama,53,Escambia County,8,0,8
36,New York,1,Alabama,55,Etowah County,0,66,-66
36,New York,1,Alabama,59,Franklin County,0,8,-8
36,New York,1,Alabama,61,Geneva County,0,14,-14
36,New York,1,Alabama,65,Hale County,0,9,-9
36,New York,1,Alabama,67,Henry County,0,3,-3
36,New York,1,Alabama,69,Houston County,40,40,0
36,New York,1,Alabama,73,Jefferson County,156,419,-263
36,New York,1,Alabama,81,Lee County,128,18,110
36,New York,1,Alabama,85,Lowndes County,0,1,-1
36,New York,1,Alabama,87,Macon County,4,5,-1
36,New York,1,Alabama,89,Madison County,134,279,-145
36,New York,1,Alabama,91,Marengo County,0,15,-15
36,New York,1,Alabama,93,Marion County,8,0,8
36,New York,1,Alabama,95,Marshall County,0,57,-57
36,New York,1,Alabama,97,Mobile County,7,105,-98
36,New York,1,Alabama,101,Montgomery County,102,175,-73
36,New York,1,Alabama,103,Morgan County,0,28,-28
36,New York,1,Alabama,105,Perry County,26,0,26
36,New York,1,Alabama,107,Pickens County,7,0,7
36,New York,1,Alabama,109,Pike County,18,0,18
36,New York,1,Alabama,113,Russell County,48,126,-78
36,New York,1,Alabama,115,St. Clair County,19,0,19
36,New York,1,Alabama,117,Shelby County,7,78,-71
36,New York,1,Alabama,121,Talladega County,0,63,-63
36,New York,1,Alabama,125,Tuscaloosa County,88,152,-64
36,New York,1,Alabama,127,Walker County,0,8,-8
36,New York,1,Alabama,131,Wilcox County,0,4,-4
36,New York,10,Delaware,1,Kent County,238,523,-285
36,New York,10,Delaware,3,New Castle County,920,2252,-1332
36,New York,10,Delaware,5,Sussex County,96,553,-457
36,New York,11,District of Columbia,1,District of Columbia,3870,4339,-469
36,New York,12,Florida,1,Alachua County,424,504,-80
36,New York,12,Florida,3,Baker County,9,5,4
36,New York,12,Florida,5,Bay County,88,236,-148
36,New York,12,Florida,9,Brevard County,475,1560,-1085
36,New York,12,Florida,11,Broward County,2423,6943,-4520
36,New York,12,Florida,15,Charlotte County,221,783,-562
36,New York,12,Florida,17,Citrus County,168,541,-373
36,New York,12,Florida,19,Clay County,150,494,-344
36,New York,12,Florida,21,Collier County,292,1307,-1015
36,New York,12,Florida,23,Columbia County,24,24,0
36,New York,12,Florida,27,DeSoto County,0,39,-39
36,New York,12,Florida,29,Dixie County,10,0,10
36,New York,12,Florida,31,Duval County,834,1468,-634
36,New York,12,Florida,33,Escambia County,67,281,-214
36,New York,12,Florida,35,Flagler County,199,764,-565
36,New York,12,Florida,37,Franklin County,0,4,-4
36,New York,12,Florida,39,Gadsden County,33,0,33
36,New York,12,Florida,41,Gilchrist County,9,0,9
36,New York,12,Florida,43,Glades County,13,19,-6
36,New York,12,Florida,47,Hamilton County,0,6,-6
36,New York,12,Florida,51,Hendry County,0,138,-138
36,New York,12,Florida,53,Hernando County,368,910,-542
36,New York,12,Florida,55,Highlands County,8,182,-174
36,New York,12,Florida,57,Hillsborough County,1794,4451,-2657
36,New York,12,Florida,59,Holmes County,0,37,-37
36,New York,12,Florida,61,Indian River County,71,511,-440
36,New York,12,Florida,63,Jackson County,18,76,-58
36,New York,12,Florida,69,Lake County,262,967,-705
36,New York,12,Florida,71,Lee County,1383,2639,-1256
36,New York,12,Florida,73,Leon County,283,390,-107
36,New York,12,Florida,75,Levy County,0,25,-25
36,New York,12,Florida,77,Liberty County,40,11,29
36,New York,12,Florida,81,Manatee County,337,1018,-681
36,New York,12,Florida,83,Marion County,310,1435,-1125
36,New York,12,Florida,85,Martin County,218,688,-470
36,New York,12,Florida,86,Miami-Dade County,3500,4797,-1297
36,New York,12,Florida,87,Monroe County,93,240,-147
36,New York,12,Florida,89,Nassau County,32,9,23
36,New York,12,Florida,91,Okaloosa County,210,408,-198
36,New York,12,Florida,93,Okeechobee County,47,5,42
36,New York,12,Florida,95,Orange County,2543,4070,-1527
36,New York,12,Florida,97,Osceola County,842,1399,-557
36,New York,12,Florida,99,Palm Beach County,2842,7991,-5149
36,New York,12,Florida,101,Pasco County,757,1595,-838
36,New York,12,Florida,103,Pinellas County,983,2789,-1806
36,New York,12,Florida,105,Polk County,703,2429,-1726
36,New York,12,Florida,107,Putnam County,38,105,-67
36,New York,12,Florida,109,St. Johns County,290,1124,-834
36,New York,12,Florida,111,St. Lucie County,501,1158,-657
36,New York,12,Florida,113,Santa Rosa County,142,61,81
36,New York,12,Florida,115,Sarasota County,611,1251,-640
36,New York,12,Florida,117,Seminole County,505,1800,-1295
36,New York,12,Florida,119,Sumter County,185,501,-316
36,New York,12,Florida,121,Suwannee County,0,23,-23
36,New York,12,Florida,123,Taylor County,33,12,21
36,New York,12,Florida,125,Union County,23,0,23
36,New York,12,Florida,127,Volusia County,848,1448,-600
36,New York,12,Florida,131,Walton County,15,96,-81
36,New York,13,Georgia,5,Bacon County,0,11,-11
36,New York,13,Georgia,9,Baldwin County,17,0,17
36,New York,13,Georgia,13,Barrow County,0,44,-44
36,New York,13,Georgia,15,Bartow County,0,13,-13
36,New York,13,Georgia,21,Bibb County,25,86,-61
36,New York,13,Georgia,29,Bryan County,12,0,12
36,New York,13,Georgia,31,Bulloch County,6,0,6
36,New York,13,Georgia,33,Burke County,0,4,-4
36,New York,13,Georgia,39,Camden County,132,259,-127
36,New York,13,Georgia,43,Candler County,0,9,-9
36,New York,13,Georgia,45,Carroll County,13,64,-51
36,New York,13,Georgia,47,Catoosa County,0,54,-54
36,New York,13,Georgia,51,Chatham County,334,733,-399
36,New York,13,Georgia,53,Chattahoochee County,280,496,-216
36,New York,13,Georgia,55,Chattooga County,0,4,-4
36,New York,13,Georgia,57,Cherokee County,173,50,123
36,New York,13,Georgia,59,Clarke County,233,193,40
36,New York,13,Georgia,63,Clayton County,69,348,-279
36,New York,13,Georgia,67,Cobb County,664,1771,-1107
36,New York,13,Georgia,71,Colquitt County,0,1,-1
36,New York,13,Georgia,73,Columbia County,127,228,-101
36,New York,13,Georgia,77,Coweta County,16,87,-71
36,New York,13,Georgia,79,Crawford County,4,0,4
36,New York,13,Georgia,83,Dade County,0,19,-19
36,New York,13,Georgia,89,DeKalb County,876,1645,-769
36,New York,13,Georgia,91,Dodge County,0,6,-6
36,New York,13,Georgia,95,Dougherty County,67,90,-23
36,New York,13,Georgia,97,Douglas County,70,93,-23
36,New York,13,Georgia,101,Echols County,0,8,-8
36,New York,13,Georgia,103,Effingham County,43,44,-1
36,New York,13,Georgia,107,Emanuel County,19,0,19
36,New York,13,Georgia,111,Fannin County,0,4,-4
36,New York,13,Georgia,113,Fayette County,64,244,-180
36,New York,13,Georgia,115,Floyd County,0,26,-26
36,New York,13,Georgia,117,Forsyth County,30,448,-418
36,New York,13,Georgia,121,Fulton County,1989,2601,-612
36,New York,13,Georgia,127,Glynn County,29,107,-78
36,New York,13,Georgia,133,Greene County,51,28,23
36,New York,13,Georgia,135,Gwinnett County,794,3019,-2225
36,New York,13,Georgia,139,Hall County,38,107,-69
36,New York,13,Georgia,141,Hancock County,0,10,-10
36,New York,13,Georgia,145,Harris County,0,7,-7
36,New York,13,Georgia,147,Hart County,0,61,-61
36,New York,13,Georgia,151,Henry County,66,451,-385
36,New York,13,Georgia,153,Houston County,82,189,-107
36,New York,13,Georgia,157,Jackson County,20,0,20
36,New York,13,Georgia,163,Jefferson County,0,2,-2
36,New York,13,Georgia,173,Lanier County,0,32,-32
36,New York,13,Georgia,175,Laurens County,189,14,175
36,New York,13,Georgia,177,Lee County,0,8,-8
36,New York,13,Georgia,179,Liberty County,196,354,-158
36,New York,13,Georgia,183,Long County,19,0,19
36,New York,13,Georgia,185,Lowndes County,7,67,-60
36,New York,13,Georgia,187,Lumpkin County,0,89,-89
36,New York,13,Georgia,189,McDuffie County,60,0,60
36,New York,13,Georgia,191,McIntosh County,0,6,-6
36,New York,13,Georgia,193,Macon County,0,6,-6
36,New York,13,Georgia,205,Mitchell County,38,10,28
36,New York,13,Georgia,207,Monroe County,10,0,10
36,New York,13,Georgia,213,Murray County,15,0,15
36,New York,13,Georgia,215,Muscogee County,243,721,-478
36,New York,13,Georgia,217,Newton County,12,133,-121
36,New York,13,Georgia,219,Oconee County,17,0,17
36,New York,13,Georgia,221,Oglethorpe County,0,17,-17
36,New York,13,Georgia,223,Paulding County,0,264,-264
36,New York,13,Georgia,237,Putnam County,0,26,-26
36,New York,13,Georgia,245,Richmond County,266,246,20
36,New York,13,Georgia,247,Rockdale County,31,382,-351
36,New York,13,Georgia,261,Sumter County,0,3,-3
36,New York,13,Georgia,267,Tattnall County,0,3,-3
36,New York,13,Georgia,269,Taylor County,0,13,-13
36,New York,13,Georgia,271,Telfair County,0,8,-8
36,New York,13,Georgia,275,Thomas County,0,27,-27
36,New York,13,Georgia,277,Tift County,0,6,-6
36,New York,13,Georgia,285,Troup County,0,29,-29
36,New York,13,Georgia,293,Upson County,0,9,-9
36,New York,13,Georgia,297,Walton County,26,329,-303
36,New York,13,Georgia,299,Ware County,0,14,-14
36,New York,13,Georgia,301,Warren County,0,1,-1
36,New York,13,Georgia,305,Wayne County,17,32,-15
36,New York,13,Georgia,307,Webster County,0,7,-7
36,New York,13,Georgia,313,Whitfield County,9,215,-206
36,New York,13,Georgia,317,Wilkes County,0,14,-14
36,New York,15,Hawaii,1,Hawaii County,94,23,71
36,New York,15,Hawaii,3,Honolulu County,1062,1606,-544
36,New York,15,Hawaii,7,Kauai County,14,32,-18
36,New York,15,Hawaii,9,Maui County,63,78,-15
36,New York,16,Idaho,1,Ada County,114,276,-162
36,New York,16,Idaho,5,Bannock County,22,0,22
36,New York,16,Idaho,11,Bingham County,54,21,33
36,New York,16,Idaho,13,Blaine County,0,12,-12
36,New York,16,Idaho,15,Boise County,0,2,-2
36,New York,16,Idaho,17,Bonner County,0,12,-12
36,New York,16,Idaho,19,Bonneville County,101,43,58
36,New York,16,Idaho,31,Cassia County,13,0,13
36,New York,16,Idaho,39,Elmore County,16,11,5
36,New York,16,Idaho,47,Gooding County,9,10,-1
36,New York,16,Idaho,51,Jefferson County,0,69,-69
36,New York,16,Idaho,55,Kootenai County,0,108,-108
36,New York,16,Idaho,65,Madison County,0,12,-12
36,New York,16,Idaho,69,Nez Perce County,46,0,46
36,New York,16,Idaho,79,Shoshone County,0,13,-13
36,New York,16,Idaho,83,Twin Falls County,73,0,73
36,New York,17,Illinois,1,Adams County,0,11,-11
36,New York,17,Illinois,5,Bond County,5,0,5
36,New York,17,Illinois,9,Brown County,0,4,-4
36,New York,17,Illinois,11,Bureau County,0,8,-8
36,New York,17,Illinois,19,Champaign County,243,283,-40
36,New York,17,Illinois,29,Coles County,13,85,-72
36,New York,17,Illinois,31,Cook County,4826,4585,241
36,New York,17,Illinois,37,DeKalb County,22,34,-12
36,New York,17,Illinois,43,DuPage County,303,575,-272
36,New York,17,Illinois,51,Fayette County,9,0,9
36,New York,17,Illinois,63,Grundy County,28,0,28
36,New York,17,Illinois,71,Henderson County,0,8,-8
36,New York,17,Illinois,73,Henry County,0,35,-35
36,New York,17,Illinois,75,Iroquois County,33,1,32
36,New York,17,Illinois,77,Jackson County,103,37,66
36,New York,17,Illinois,85,Jo Daviess County,0,12,-12
36,New York,17,Illinois,89,Kane County,273,163,110
36,New York,17,Illinois,91,Kankakee County,39,0,39
36,New York,17,Illinois,93,Kendall County,22,0,22
36,New York,17,Illinois,97,Lake County,346,642,-296
36,New York,17,Illinois,99,LaSalle County,6,28,-22
36,New York,17,Illinois,101,Lawrence County,0,1,-1
36,New York,17,Illinois,103,Lee County,0,2,-2
36,New York,17,Illinois,111,McHenry County,68,90,-22
36,New York,17,Illinois,113,McLean County,255,29,226
36,New York,17,Illinois,115,Macon County,27,6,21
36,New York,17,Illinois,119,Madison County,0,182,-182
36,New York,17,Illinois,137,Morgan County,17,0,17
36,New York,17,Illinois,141,Ogle County,23,0,23
36,New York,17,Illinois,143,Peoria County,43,101,-58
36,New York,17,Illinois,145,Perry County,0,5,-5
36,New York,17,Illinois,147,Piatt County,27,0,27
36,New York,17,Illinois,159,Richland County,0,18,-18
36,New York,17,Illinois,161,Rock Island County,53,20,33
36,New York,17,Illinois,163,St. Clair County,115,75,40
36,New York,17,Illinois,165,Saline County,13,0,13
36,New York,17,Illinois,167,Sangamon County,15,167,-152
36,New York,17,Illinois,173,Shelby County,0,3,-3
36,New York,17,Illinois,177,Stephenson County,0,66,-66
36,New York,17,Illinois,195,Whiteside County,0,4,-4
36,New York,17,Illinois,197,Will County,297,99,198
36,New York,17,Illinois,199,Williamson County,0,10,-10
36,New York,17,Illinois,201,Winnebago County,107,229,-122
36,New York,17,Illinois,203,Woodford County,0,25,-25
36,New York,18,Indiana,3,Allen County,174,77,97
36,New York,18,Indiana,5,Bartholomew County,49,34,15
36,New York,18,Indiana,11,Boone County,36,0,36
36,New York,18,Indiana,17,Cass County,11,16,-5
36,New York,18,Indiana,19,Clark County,56,0,56
36,New York,18,Indiana,21,Clay County,0,3,-3
36,New York,18,Indiana,23,Clinton County,0,7,-7
36,New York,18,Indiana,29,Dearborn County,9,3,6
36,New York,18,Indiana,35,Delaware County,16,63,-47
36,New York,18,Indiana,37,Dubois County,0,109,-109
36,New York,18,Indiana,39,Elkhart County,7,39,-32
36,New York,18,Indiana,45,Fountain County,0,7,-7
36,New York,18,Indiana,49,Fulton County,0,33,-33
36,New York,18,Indiana,51,Gibson County,0,12,-12
36,New York,18,Indiana,55,Greene County,0,29,-29
36,New York,18,Indiana,57,Hamilton County,66,208,-142
36,New York,18,Indiana,63,Hendricks County,71,87,-16
36,New York,18,Indiana,71,Jackson County,31,9,22
36,New York,18,Indiana,73,Jasper County,0,8,-8
36,New York,18,Indiana,77,Jefferson County,38,18,20
36,New York,18,Indiana,81,Johnson County,82,18,64
36,New York,18,Indiana,83,Knox County,0,17,-17
36,New York,18,Indiana,85,Kosciusko County,86,57,29
36,New York,18,Indiana,89,Lake County,63,20,43
36,New York,18,Indiana,91,LaPorte County,14,0,14
36,New York,18,Indiana,93,Lawrence County,6,0,6
36,New York,18,Indiana,95,Madison County,57,0,57
36,New York,18,Indiana,97,Marion County,290,389,-99
36,New York,18,Indiana,99,Marshall County,25,4,21
36,New York,18,Indiana,103,Miami County,0,28,-28
36,New York,18,Indiana,105,Monroe County,256,221,35
36,New York,18,Indiana,107,Montgomery County,0,5,-5
36,New York,18,Indiana,109,Morgan County,4,0,4
36,New York,18,Indiana,117,Orange County,19,4,15
36,New York,18,Indiana,119,Owen County,0,17,-17
36,New York,18,Indiana,123,Perry County,0,4,-4
36,New York,18,Indiana,127,Porter County,86,49,37
36,New York,18,Indiana,133,Putnam County,0,1,-1
36,New York,18,Indiana,141,St. Joseph County,185,172,13
36,New York,18,Indiana,145,Shelby County,0,10,-10
36,New York,18,Indiana,147,Spencer County,0,4,-4
36,New York,18,Indiana,151,Steuben County,9,69,-60
36,New York,18,Indiana,157,Tippecanoe County,84,270,-186
36,New York,18,Indiana,163,Vanderburgh County,12,75,-63
36,New York,18,Indiana,167,Vigo County,0,68,-68
36,New York,18,Indiana,173,Warrick County,16,0,16
36,New York,18,Indiana,177,Wayne County,0,91,-91
36,New York,18,Indiana,179,Wells County,0,5,-5
36,New York,18,Indiana,183,Whitley County,0,11,-11
36,New York,19,Iowa,7,Appanoose County,7,0,7
36,New York,19,Iowa,11,Benton County,4,4,0
36,New York,19,Iowa,13,Black Hawk County,9,48,-39
36,New York,19,Iowa,15,Boone County,17,0,17
36,New York,19,Iowa,17,Bremer County,15,6,9
36,New York,19,Iowa,21,Buena Vista County,11,0,11
36,New York,19,Iowa,23,Butler County,14,0,14
36,New York,19,Iowa,33,Cerro Gordo County,0,7,-7
36,New York,19,Iowa,49,Dallas County,0,25,-25
36,New York,19,Iowa,53,Decatur County,0,11,-11
36,New York,19,Iowa,61,Dubuque County,17,77,-60
36,New York,19,Iowa,71,Fremont County,0,5,-5
36,New York,19,Iowa,83,Hardin County,0,6,-6
36,New York,19,Iowa,85,Harrison County,0,2,-2
36,New York,19,Iowa,93,Ida County,0,1,-1
36,New York,19,Iowa,97,Jackson County,20,0,20
36,New York,19,Iowa,99,Jasper County,8,0,8
36,New York,19,Iowa,101,Jefferson County,28,0,28
36,New York,19,Iowa,103,Johnson County,298,74,224
36,New York,19,Iowa,109,Kossuth County,2,0,2
36,New York,19,Iowa,111,Lee County,46,0,46
36,New York,19,Iowa,113,Linn County,7,0,7
36,New York,19,Iowa,127,Marshall County,0,2,-2
36,New York,19,Iowa,141,O'Brien County,4,0,4
36,New York,19,Iowa,151,Pocahontas County,0,9,-9
36,New York,19,Iowa,153,Polk County,227,107,120
36,New York,19,Iowa,155,Pottawattamie County,0,10,-10
36,New York,19,Iowa,157,Poweshiek County,4,96,-92
36,New York,19,Iowa,163,Scott County,42,26,16
36,New York,19,Iowa,165,Shelby County,0,3,-3
36,New York,19,Iowa,167,Sioux County,8,0,8
36,New York,19,Iowa,169,Story County,50,25,25
36,New York,19,Iowa,179,Wapello County,0,18,-18
36,New York,19,Iowa,181,Warren County,30,0,30
36,New York,19,Iowa,187,Webster County,8,0,8
36,New York,2,Alaska,20,Anchorage Municipality,1866,199,1667
36,New York,2,Alaska,90,Fairbanks North Star Borough,300,380,-80
36,New York,2,Alaska,105,Hoonah-Angoon Census Area,0,8,-8
36,New York,2,Alaska,110,Juneau City and Borough,31,54,-23
36,New York,2,Alaska,122,Kenai Peninsula Borough,0,27,-27
36,New York,2,Alaska,150,Kodiak Island Borough,1,15,-14
36,New York,2,Alaska,170,Matanuska-Susitna Borough,249,58,191
36,New York,2,Alaska,185,North Slope Borough,24,0,24
36,New York,2,Alaska,188,Northwest Arctic Borough,26,0,26
36,New York,2,Alaska,220,Sitka City and Borough,0,5,-5
36,New York,2,Alaska,230,Skagway Municipality,0,1,-1
36,New York,2,Alaska,240,Southeast Fairbanks Census Area,0,5,-5
36,New York,20,Kansas,11,Bourbon County,156,0,156
36,New York,20,Kansas,13,Brown County,0,5,-5
36,New York,20,Kansas,21,Cherokee County,9,0,9
36,New York,20,Kansas,35,Cowley County,22,0,22
36,New York,20,Kansas,37,Crawford County,5,6,-1
36,New York,20,Kansas,41,Dickinson County,28,0,28
36,New York,20,Kansas,43,Doniphan County,0,11,-11
36,New York,20,Kansas,45,Douglas County,60,113,-53
36,New York,20,Kansas,55,Finney County,0,5,-5
36,New York,20,Kansas,57,Ford County,24,0,24
36,New York,20,Kansas,61,Geary County,89,0,89
36,New York,20,Kansas,91,Johnson County,225,345,-120
36,New York,20,Kansas,101,Lane County,53,0,53
36,New York,20,Kansas,103,Leavenworth County,138,230,-92
36,New York,20,Kansas,107,Linn County,0,14,-14
36,New York,20,Kansas,123,Mitchell County,0,43,-43
36,New York,20,Kansas,125,Montgomery County,0,53,-53
36,New York,20,Kansas,131,Nemaha County,0,1,-1
36,New York,20,Kansas,141,Osborne County,0,3,-3
36,New York,20,Kansas,149,Pottawatomie County,31,73,-42
36,New York,20,Kansas,153,Rawlins County,0,2,-2
36,New York,20,Kansas,159,Rice County,0,25,-25
36,New York,20,Kansas,161,Riley County,138,115,23
36,New York,20,Kansas,169,Saline County,0,97,-97
36,New York,20,Kansas,173,Sedgwick County,112,365,-253
36,New York,20,Kansas,175,Seward County,7,3,4
36,New York,20,Kansas,177,Shawnee County,28,17,11
36,New York,20,Kansas,191,Sumner County,10,2,8
36,New York,20,Kansas,197,Wabaunsee County,0,4,-4
36,New York,20,Kansas,209,Wyandotte County,12,137,-125
36,New York,21,Kentucky,1,Adair County,0,214,-214
36,New York,21,Kentucky,9,Barren County,19,17,2
36,New York,21,Kentucky,15,Boone County,22,113,-91
36,New York,21,Kentucky,17,Bourbon County,0,21,-21
36,New York,21,Kentucky,21,Boyle County,0,51,-51
36,New York,21,Kentucky,27,Breckinridge County,0,10,-10
36,New York,21,Kentucky,29,Bullitt County,31,0,31
36,New York,21,Kentucky,35,Calloway County,17,64,-47
36,New York,21,Kentucky,37,Campbell County,0,17,-17
36,New York,21,Kentucky,47,Christian County,38,142,-104
36,New York,21,Kentucky,49,Clark County,0,13,-13
36,New York,21,Kentucky,57,Cumberland County,15,9,6
36,New York,21,Kentucky,59,Daviess County,8,20,-12
36,New York,21,Kentucky,67,Fayette County,245,827,-582
36,New York,21,Kentucky,69,Fleming County,4,73,-69
36,New York,21,Kentucky,73,Franklin County,40,22,18
36,New York,21,Kentucky,75,Fulton County,0,1,-1
36,New York,21,Kentucky,79,Garrard County,9,23,-14
36,New York,21,Kentucky,83,Graves County,53,21,32
36,New York,21,Kentucky,89,Greenup County,22,9,13
36,New York,21,Kentucky,93,Hardin County,93,369,-276
36,New York,21,Kentucky,95,Harlan County,0,8,-8
36,New York,21,Kentucky,99,Hart County,41,0,41
36,New York,21,Kentucky,101,Henderson County,0,3,-3
36,New York,21,Kentucky,103,Henry County,0,10,-10
36,New York,21,Kentucky,111,Jefferson County,210,566,-356
36,New York,21,Kentucky,113,Jessamine County,0,37,-37
36,New York,21,Kentucky,117,Kenton County,10,51,-41
36,New York,21,Kentucky,121,Knox County,2,0,2
36,New York,21,Kentucky,125,Laurel County,40,14,26
36,New York,21,Kentucky,129,Lee County,7,0,7
36,New York,21,Kentucky,139,Livingston County,0,2,-2
36,New York,21,Kentucky,145,McCracken County,44,0,44
36,New York,21,Kentucky,151,Madison County,8,8,0
36,New York,21,Kentucky,157,Marshall County,11,59,-48
36,New York,21,Kentucky,163,Meade County,0,47,-47
36,New York,21,Kentucky,167,Mercer County,0,47,-47
36,New York,21,Kentucky,173,Montgomery County,26,17,9
36,New York,21,Kentucky,179,Nelson County,10,0,10
36,New York,21,Kentucky,185,Oldham County,7,57,-50
36,New York,21,Kentucky,191,Pendleton County,0,5,-5
36,New York,21,Kentucky,193,Perry County,0,4,-4
36,New York,21,Kentucky,195,Pike County,14,5,9
36,New York,21,Kentucky,199,Pulaski County,29,0,29
36,New York,21,Kentucky,207,Russell County,0,18,-18
36,New York,21,Kentucky,209,Scott County,18,0,18
36,New York,21,Kentucky,211,Shelby County,5,0,5
36,New York,21,Kentucky,217,Taylor County,0,10,-10
36,New York,21,Kentucky,221,Trigg County,0,6,-6
36,New York,21,Kentucky,223,Trimble County,0,14,-14
36,New York,21,Kentucky,227,Warren County,22,13,9
36,New York,21,Kentucky,231,Wayne County,4,0,4
36,New York,22,Louisiana,1,Acadia Parish,0,46,-46
36,New York,22,Louisiana,3,Allen Parish,12,27,-15
36,New York,22,Louisiana,5,Ascension Parish,31,182,-151
36,New York,22,Louisiana,15,Bossier Parish,24,96,-72
36,New York,22,Louisiana,17,Caddo Parish,10,15,-5
36,New York,22,Louisiana,19,Calcasieu Parish,35,46,-11
36,New York,22,Louisiana,33,East Baton Rouge Parish,102,322,-220
36,New York,22,Louisiana,43,Grant Parish,0,18,-18
36,New York,22,Louisiana,47,Iberville Parish,0,150,-150
36,New York,22,Louisiana,51,Jefferson Parish,33,253,-220
36,New York,22,Louisiana,55,Lafayette Parish,91,56,35
36,New York,22,Louisiana,61,Lincoln Parish,67,0,67
36,New York,22,Louisiana,63,Livingston Parish,12,0,12
36,New York,22,Louisiana,67,Morehouse Parish,36,0,36
36,New York,22,Louisiana,71,Orleans Parish,578,811,-233
36,New York,22,Louisiana,73,Ouachita Parish,43,77,-34
36,New York,22,Louisiana,79,Rapides Parish,0,5,-5
36,New York,22,Louisiana,99,St. Martin Parish,2,0,2
36,New York,22,Louisiana,101,St. Mary Parish,21,0,21
36,New York,22,Louisiana,103,St. Tammany Parish,155,55,100
36,New York,22,Louisiana,105,Tangipahoa Parish,0,26,-26
36,New York,22,Louisiana,109,Terrebonne Parish,16,51,-35
36,New York,22,Louisiana,113,Vermilion Parish,8,0,8
36,New York,22,Louisiana,115,Vernon Parish,184,162,22
36,New York,22,Louisiana,117,Washington Parish,38,0,38
36,New York,23,Maine,1,Androscoggin County,57,107,-50
36,New York,23,Maine,3,Aroostook County,0,240,-240
36,New York,23,Maine,5,Cumberland County,594,516,78
36,New York,23,Maine,7,Franklin County,0,14,-14
36,New York,23,Maine,9,Hancock County,15,16,-1
36,New York,23,Maine,11,Kennebec County,104,309,-205
36,New York,23,Maine,13,Knox County,68,115,-47
36,New York,23,Maine,15,Lincoln County,39,61,-22
36,New York,23,Maine,17,Oxford County,7,28,-21
36,New York,23,Maine,19,Penobscot County,142,419,-277
36,New York,23,Maine,21,Piscataquis County,0,26,-26
36,New York,23,Maine,23,Sagadahoc County,70,54,16
36,New York,23,Maine,25,Somerset County,64,42,22
36,New York,23,Maine,27,Waldo County,60,99,-39
36,New York,23,Maine,29,Washington County,42,64,-22
36,New York,23,Maine,31,York County,166,423,-257
36,New York,24,Maryland,1,Allegany County,14,21,-7
36,New York,24,Maryland,3,Anne Arundel County,806,1272,-466
36,New York,24,Maryland,5,Baltimore County,560,2389,-1829
36,New York,24,Maryland,9,Calvert County,155,23,132
36,New York,24,Maryland,11,Caroline County,41,0,41
36,New York,24,Maryland,13,Carroll County,124,95,29
36,New York,24,Maryland,15,Cecil County,60,179,-119
36,New York,24,Maryland,17,Charles County,67,64,3
36,New York,24,Maryland,19,Dorchester County,14,177,-163
36,New York,24,Maryland,21,Frederick County,199,387,-188
36,New York,24,Maryland,23,Garrett County,9,0,9
36,New York,24,Maryland,25,Harford County,358,438,-80
36,New York,24,Maryland,27,Howard County,472,529,-57
36,New York,24,Maryland,29,Kent County,0,91,-91
36,New York,24,Maryland,31,Montgomery County,2000,3148,-1148
36,New York,24,Maryland,33,Prince George's County,749,1668,-919
36,New York,24,Maryland,35,Queen Anne's County,4,37,-33
36,New York,24,Maryland,37,St. Mary's County,166,87,79
36,New York,24,Maryland,39,Somerset County,0,58,-58
36,New York,24,Maryland,41,Talbot County,27,23,4
36,New York,24,Maryland,43,Washington County,154,212,-58
36,New York,24,Maryland,45,Wicomico County,61,348,-287
36,New York,24,Maryland,47,Worcester County,138,34,104
36,New York,24,Maryland,510,Baltimore city,1293,1781,-488
36,New York,25,Massachusetts,1,Barnstable County,246,391,-145
36,New York,25,Massachusetts,3,Berkshire County,682,738,-56
36,New York,25,Massachusetts,5,Bristol County,290,765,-475
36,New York,25,Massachusetts,7,Dukes County,11,10,1
36,New York,25,Massachusetts,9,Essex County,1247,1661,-414
36,New York,25,Massachusetts,11,Franklin County,187,160,27
36,New York,25,Massachusetts,13,Hampden County,708,1163,-455
36,New York,25,Massachusetts,15,Hampshire County,234,1063,-829
36,New York,25,Massachusetts,17,Middlesex County,5463,5472,-9
36,New York,25,Massachusetts,19,Nantucket County,84,25,59
36,New York,25,Massachusetts,21,Norfolk County,1339,2575,-1236
36,New York,25,Massachusetts,23,Plymouth County,666,470,196
36,New York,25,Massachusetts,25,Suffolk County,3130,4980,-1850
36,New York,25,Massachusetts,27,Worcester County,1577,1537,40
36,New York,26,Michigan,5,Allegan County,0,44,-44
36,New York,26,Michigan,17,Bay County,0,49,-49
36,New York,26,Michigan,19,Benzie County,0,4,-4
36,New York,26,Michigan,21,Berrien County,16,98,-82
36,New York,26,Michigan,25,Calhoun County,15,58,-43
36,New York,26,Michigan,31,Cheboygan County,2,0,2
36,New York,26,Michigan,33,Chippewa County,35,10,25
36,New York,26,Michigan,35,Clare County,0,50,-50
36,New York,26,Michigan,37,Clinton County,53,3,50
36,New York,26,Michigan,39,Crawford County,52,0,52
36,New York,26,Michigan,41,Delta County,0,8,-8
36,New York,26,Michigan,45,Eaton County,29,82,-53
36,New York,26,Michigan,49,Genesee County,117,217,-100
36,New York,26,Michigan,51,Gladwin County,0,8,-8
36,New York,26,Michigan,53,Gogebic County,9,12,-3
36,New York,26,Michigan,55,Grand Traverse County,0,76,-76
36,New York,26,Michigan,57,Gratiot County,27,21,6
36,New York,26,Michigan,59,Hillsdale County,0,11,-11
36,New York,26,Michigan,61,Houghton County,0,68,-68
36,New York,26,Michigan,65,Ingham County,117,161,-44
36,New York,26,Michigan,67,Ionia County,46,0,46
36,New York,26,Michigan,73,Isabella County,10,26,-16
36,New York,26,Michigan,75,Jackson County,95,13,82
36,New York,26,Michigan,77,Kalamazoo County,52,165,-113
36,New York,26,Michigan,81,Kent County,239,175,64
36,New York,26,Michigan,87,Lapeer County,2,0,2
36,New York,26,Michigan,89,Leelanau County,0,11,-11
36,New York,26,Michigan,91,Lenawee County,3,19,-16
36,New York,26,Michigan,93,Livingston County,117,77,40
36,New York,26,Michigan,99,Macomb County,217,402,-185
36,New York,26,Michigan,103,Marquette County,0,97,-97
36,New York,26,Michigan,105,Mason County,0,26,-26
36,New York,26,Michigan,107,Mecosta County,0,6,-6
36,New York,26,Michigan,109,Menominee County,0,19,-19
36,New York,26,Michigan,111,Midland County,0,14,-14
36,New York,26,Michigan,113,Missaukee County,0,8,-8
36,New York,26,Michigan,115,Monroe County,37,21,16
36,New York,26,Michigan,117,Montcalm County,24,0,24
36,New York,26,Michigan,121,Muskegon County,28,37,-9
36,New York,26,Michigan,123,Newaygo County,0,17,-17
36,New York,26,Michigan,125,Oakland County,708,1142,-434
36,New York,26,Michigan,127,Oceana County,0,42,-42
36,New York,26,Michigan,133,Osceola County,0,15,-15
36,New York,26,Michigan,135,Oscoda County,0,6,-6
36,New York,26,Michigan,137,Otsego County,0,1,-1
36,New York,26,Michigan,139,Ottawa County,8,149,-141
36,New York,26,Michigan,145,Saginaw County,15,30,-15
36,New York,26,Michigan,147,St. Clair County,26,46,-20
36,New York,26,Michigan,149,St. Joseph County,24,0,24
36,New York,26,Michigan,151,Sanilac County,0,36,-36
36,New York,26,Michigan,153,Schoolcraft County,0,14,-14
36,New York,26,Michigan,155,Shiawassee County,18,13,5
36,New York,26,Michigan,157,Tuscola County,19,0,19
36,New York,26,Michigan,159,Van Buren County,0,4,-4
36,New York,26,Michigan,161,Washtenaw County,755,1047,-292
36,New York,26,Michigan,163,Wayne County,483,980,-497
36,New York,26,Michigan,165,Wexford County,10,7,3
36,New York,27,Minnesota,1,Aitkin County,38,0,38
36,New York,27,Minnesota,3,Anoka County,6,97,-91
36,New York,27,Minnesota,9,Benton County,0,13,-13
36,New York,27,Minnesota,13,Blue Earth County,0,6,-6
36,New York,27,Minnesota,15,Brown County,0,3,-3
36,New York,27,Minnesota,19,Carver County,31,28,3
36,New York,27,Minnesota,21,Cass County,31,1,30
36,New York,27,Minnesota,25,Chisago County,0,9,-9
36,New York,27,Minnesota,27,Clay County,158,25,133
36,New York,27,Minnesota,37,Dakota County,117,321,-204
36,New York,27,Minnesota,39,Dodge County,8,7,1
36,New York,27,Minnesota,47,Freeborn County,7,0,7
36,New York,27,Minnesota,49,Goodhue County,0,1,-1
36,New York,27,Minnesota,53,Hennepin County,507,927,-420
36,New York,27,Minnesota,61,Itasca County,0,17,-17
36,New York,27,Minnesota,67,Kandiyohi County,0,10,-10
36,New York,27,Minnesota,73,Lac qui Parle County,0,42,-42
36,New York,27,Minnesota,75,Lake County,0,11,-11
36,New York,27,Minnesota,81,Lincoln County,0,6,-6
36,New York,27,Minnesota,89,Marshall County,0,2,-2
36,New York,27,Minnesota,93,Meeker County,0,2,-2
36,New York,27,Minnesota,99,Mower County,9,4,5
36,New York,27,Minnesota,105,Nobles County,4,31,-27
36,New York,27,Minnesota,109,Olmsted County,130,121,9
36,New York,27,Minnesota,111,Otter Tail County,24,0,24
36,New York,27,Minnesota,119,Polk County,0,1,-1
36,New York,27,Minnesota,123,Ramsey County,227,467,-240
36,New York,27,Minnesota,131,Rice County,34,28,6
36,New York,27,Minnesota,133,Rock County,0,11,-11
36,New York,27,Minnesota,137,St. Louis County,75,82,-7
36,New York,27,Minnesota,139,Scott County,0,75,-75
36,New York,27,Minnesota,141,Sherburne County,0,3,-3
36,New York,27,Minnesota,145,Stearns County,13,37,-24
36,New York,27,Minnesota,153,Todd County,0,4,-4
36,New York,27,Minnesota,161,Waseca County,0,14,-14
36,New York,27,Minnesota,163,Washington County,40,213,-173
36,New York,27,Minnesota,171,Wright County,0,31,-31
36,New York,28,Mississippi,11,Bolivar County,0,31,-31
36,New York,28,Mississippi,19,Choctaw County,17,0,17
36,New York,28,Mississippi,23,Clarke County,2,0,2
36,New York,28,Mississippi,33,DeSoto County,18,23,-5
36,New York,28,Mississippi,35,Forrest County,23,1,22
36,New York,28,Mississippi,43,Grenada County,0,6,-6
36,New York,28,Mississippi,47,Harrison County,216,229,-13
36,New York,28,Mississippi,49,Hinds County,193,5,188
36,New York,28,Mississippi,59,Jackson County,60,19,41
36,New York,28,Mississippi,71,Lafayette County,27,38,-11
36,New York,28,Mississippi,75,Lauderdale County,2,37,-35
36,New York,28,Mississippi,77,Lawrence County,0,5,-5
36,New York,28,Mississippi,79,Leake County,2,0,2
36,New York,28,Mississippi,81,Lee County,0,18,-18
36,New York,28,Mississippi,83,Leflore County,32,0,32
36,New York,28,Mississippi,87,Lowndes County,0,10,-10
36,New York,28,Mississippi,89,Madison County,6,0,6
36,New York,28,Mississippi,93,Marshall County,24,0,24
36,New York,28,Mississippi,99,Neshoba County,78,0,78
36,New York,28,Mississippi,101,Newton County,0,16,-16
36,New York,28,Mississippi,105,Oktibbeha County,0,29,-29
36,New York,28,Mississippi,107,Panola County,32,0,32
36,New York,28,Mississippi,113,Pike County,9,0,9
36,New York,28,Mississippi,115,Pontotoc County,5,26,-21
36,New York,28,Mississippi,121,Rankin County,170,0,170
36,New York,28,Mississippi,123,Scott County,0,4,-4
36,New York,28,Mississippi,131,Stone County,19,27,-8
36,New York,28,Mississippi,133,Sunflower County,18,0,18
36,New York,28,Mississippi,147,Walthall County,7,0,7
36,New York,28,Mississippi,151,Washington County,0,18,-18
36,New York,28,Mississippi,155,Webster County,0,19,-19
36,New York,28,Mississippi,161,Yalobusha County,0,6,-6
36,New York,29,Missouri,1,Adair County,9,70,-61
36,New York,29,Missouri,15,Benton County,28,0,28
36,New York,29,Missouri,19,Boone County,219,33,186
36,New York,29,Missouri,21,Buchanan County,42,0,42
36,New York,29,Missouri,23,Butler County,9,0,9
36,New York,29,Missouri,27,Callaway County,0,5,-5
36,New York,29,Missouri,31,Cape Girardeau County,61,13,48
36,New York,29,Missouri,39,Cedar County,0,51,-51
36,New York,29,Missouri,43,Christian County,4,0,4
36,New York,29,Missouri,47,Clay County,91,14,77
36,New York,29,Missouri,51,Cole County,0,41,-41
36,New York,29,Missouri,53,Cooper County,0,7,-7
36,New York,29,Missouri,55,Crawford County,3,22,-19
36,New York,29,Missouri,65,Dent County,0,21,-21
36,New York,29,Missouri,71,Franklin County,5,0,5
36,New York,29,Missouri,77,Greene County,179,33,146
36,New York,29,Missouri,91,Howell County,18,0,18
36,New York,29,Missouri,95,Jackson County,489,321,168
36,New York,29,Missouri,97,Jasper County,4,0,4
36,New York,29,Missouri,99,Jefferson County,10,70,-60
36,New York,29,Missouri,101,Johnson County,26,8,18
36,New York,29,Missouri,105,Laclede County,19,0,19
36,New York,29,Missouri,111,Lewis County,0,5,-5
36,New York,29,Missouri,121,Macon County,0,11,-11
36,New York,29,Missouri,125,Maries County,0,3,-3
36,New York,29,Missouri,145,Newton County,68,27,41
36,New York,29,Missouri,159,Pettis County,0,6,-6
36,New York,29,Missouri,161,Phelps County,9,19,-10
36,New York,29,Missouri,165,Platte County,2,108,-106
36,New York,29,Missouri,169,Pulaski County,109,587,-478
36,New York,29,Missouri,183,St. Charles County,18,33,-15
36,New York,29,Missouri,185,St. Clair County,0,3,-3
36,New York,29,Missouri,187,St. Francois County,0,76,-76
36,New York,29,Missouri,189,St. Louis County,793,694,99
36,New York,29,Missouri,197,Schuyler County,0,9,-9
36,New York,29,Missouri,209,Stone County,20,15,5
36,New York,29,Missouri,211,Sullivan County,0,10,-10
36,New York,29,Missouri,213,Taney County,0,37,-37
36,New York,29,Missouri,510,St. Louis city,491,382,109
36,New York,30,Montana,1,Beaverhead County,12,0,12
36,New York,30,Montana,13,Cascade County,0,26,-26
36,New York,30,Montana,21,Dawson County,0,1,-1
36,New York,30,Montana,27,Fergus County,0,2,-2
36,New York,30,Montana,29,Flathead County,42,31,11
36,New York,30,Montana,31,Gallatin County,32,68,-36
36,New York,30,Montana,35,Glacier County,0,43,-43
36,New York,30,Montana,45,Judith Basin County,0,10,-10
36,New York,30,Montana,47,Lake County,0,34,-34
36,New York,30,Montana,61,Mineral County,0,6,-6
36,New York,30,Montana,63,Missoula County,38,0,38
36,New York,30,Montana,67,Park County,0,4,-4
36,New York,30,Montana,81,Ravalli County,11,52,-41
36,New York,30,Montana,89,Sanders County,19,4,15
36,New York,30,Montana,95,Stillwater County,16,0,16
36,New York,30,Montana,111,Yellowstone County,78,34,44
36,New York,31,Nebraska,13,Box Butte County,0,4,-4
36,New York,31,Nebraska,19,Buffalo County,0,19,-19
36,New York,31,Nebraska,31,Cherry County,0,21,-21
36,New York,31,Nebraska,53,Dodge County,0,26,-26
36,New York,31,Nebraska,55,Douglas County,48,214,-166
36,New York,31,Nebraska,67,Gage County,0,44,-44
36,New York,31,Nebraska,69,Garden County,0,12,-12
36,New York,31,Nebraska,79,Hall County,25,23,2
36,New York,31,Nebraska,97,Johnson County,11,0,11
36,New York,31,Nebraska,101,Keith County,0,1,-1
36,New York,31,Nebraska,105,Kimball County,0,15,-15
36,New York,31,Nebraska,109,Lancaster County,36,135,-99
36,New York,31,Nebraska,119,Madison County,0,8,-8
36,New York,31,Nebraska,131,Otoe County,3,0,3
36,New York,31,Nebraska,153,Sarpy County,12,23,-11
36,New York,31,Nebraska,155,Saunders County,0,8,-8
36,New York,31,Nebraska,177,Washington County,0,16,-16
36,New York,32,Nevada,1,Churchill County,9,0,9
36,New York,32,Nevada,3,Clark County,1398,2428,-1030
36,New York,32,Nevada,5,Douglas County,0,34,-34
36,New York,32,Nevada,7,Elko County,19,0,19
36,New York,32,Nevada,13,Humboldt County,8,0,8
36,New York,32,Nevada,19,Lyon County,0,22,-22
36,New York,32,Nevada,23,Nye County,21,0,21
36,New York,32,Nevada,31,Washoe County,268,347,-79
36,New York,32,Nevada,510,Carson City,0,59,-59
36,New York,33,New Hampshire,1,Belknap County,34,46,-12
36,New York,33,New Hampshire,3,Carroll County,0,108,-108
36,New York,33,New Hampshire,5,Cheshire County,247,264,-17
36,New York,33,New Hampshire,7,Coos County,20,68,-48
36,New York,33,New Hampshire,9,Grafton County,97,594,-497
36,New York,33,New Hampshire,11,Hillsborough County,465,996,-531
36,New York,33,New Hampshire,13,Merrimack County,289,300,-11
36,New York,33,New Hampshire,15,Rockingham County,431,432,-1
36,New York,33,New Hampshire,17,Strafford County,184,292,-108
36,New York,33,New Hampshire,19,Sullivan County,108,37,71
36,New York,34,New Jersey,1,Atlantic County,452,660,-208
36,New York,34,New Jersey,3,Bergen County,7009,9219,-2210
36,New York,34,New Jersey,5,Burlington County,691,939,-248
36,New York,34,New Jersey,7,Camden County,433,467,-34
36,New York,34,New Jersey,9,Cape May County,119,166,-47
36,New York,34,New Jersey,11,Cumberland County,131,134,-3
36,New York,34,New Jersey,13,Essex County,3285,6725,-3440
36,New York,34,New Jersey,15,Gloucester County,340,220,120
36,New York,34,New Jersey,17,Hudson County,6218,11171,-4953
36,New York,34,New Jersey,19,Hunterdon County,320,319,1
36,New York,34,New Jersey,21,Mercer County,1721,2269,-548
36,New York,34,New Jersey,23,Middlesex County,3356,3487,-131
36,New York,34,New Jersey,25,Monmouth County,1781,4285,-2504
36,New York,34,New Jersey,27,Morris County,1716,1648,68
36,New York,34,New Jersey,29,Ocean County,996,1826,-830
36,New York,34,New Jersey,31,Passaic County,1131,1847,-716
36,New York,34,New Jersey,33,Salem County,34,41,-7
36,New York,34,New Jersey,35,Somerset County,1244,763,481
36,New York,34,New Jersey,37,Sussex County,328,345,-17
36,New York,34,New Jersey,39,Union County,1460,3150,-1690
36,New York,34,New Jersey,41,Warren County,175,196,-21
36,New York,35,New Mexico,1,Bernalillo County,628,286,342
36,New York,35,New Mexico,5,Chaves County,0,66,-66
36,New York,35,New Mexico,9,Curry County,0,33,-33
36,New York,35,New Mexico,13,Doña Ana County,37,126,-89
36,New York,35,New Mexico,17,Grant County,0,49,-49
36,New York,35,New Mexico,28,Los Alamos County,0,54,-54
36,New York,35,New Mexico,29,Luna County,0,61,-61
36,New York,35,New Mexico,33,Mora County,30,0,30
36,New York,35,New Mexico,35,Otero County,0,57,-57
36,New York,35,New Mexico,41,Roosevelt County,15,0,15
36,New York,35,New Mexico,43,Sandoval County,31,39,-8
36,New York,35,New Mexico,45,San Juan County,18,32,-14
36,New York,35,New Mexico,47,San Miguel County,0,19,-19
36,New York,35,New Mexico,49,Santa Fe County,165,223,-58
36,New York,35,New Mexico,55,Taos County,0,29,-29
36,New York,35,New Mexico,57,Torrance County,31,9,22
36,New York,35,New Mexico,61,Valencia County,38,0,38
36,New York,36,New York,1,Albany County,12386,16397,-4011
36,New York,36,New York,3,Allegany County,1318,2174,-856
36,New York,36,New York,5,Bronx County,33198,31475,1723
36,New York,36,New York,7,Broome County,4650,6856,-2206
36,New York,36,New York,9,Cattaraugus County,2574,1569,1005
36,New York,36,New York,11,Cayuga County,3257,3712,-455
36,New York,36,New York,13,Chautauqua County,1905,3885,-1980
36,New York,36,New York,15,Chemung County,2848,2780,68
36,New York,36,New York,17,Chenango County,1906,1351,555
36,New York,36,New York,19,Clinton County,2229,5509,-3280
36,New York,36,New York,21,Columbia County,1892,1407,485
36,New York,36,New York,23,Cortland County,1847,1908,-61
36,New York,36,New York,25,Delaware County,1514,2180,-666
36,New York,36,New York,27,Dutchess County,8154,11084,-2930
36,New York,36,New York,29,Erie County,15040,16299,-1259
36,New York,36,New York,31,Essex County,1770,1965,-195
36,New York,36,New York,33,Franklin County,2721,3655,-934
36,New York,36,New York,35,Fulton County,1858,1964,-106
36,New York,36,New York,37,Genesee County,1825,1913,-88
36,New York,36,New York,39,Greene County,1866,744,1122
36,New York,36,New York,41,Hamilton County,145,158,-13
36,New York,36,New York,43,Herkimer County,2336,1822,514
36,New York,36,New York,45,Jefferson County,3283,3097,186
36,New York,36,New York,47,Kings County,60292,44649,15643
36,New York,36,New York,49,Lewis County,856,656,200
36,New York,36,New York,51,Livingston County,2903,3513,-610
36,New York,36,New York,53,Madison County,2667,3205,-538
36,New York,36,New York,55,Monroe County,15662,18000,-2338
36,New York,36,New York,57,Montgomery County,2017,1674,343
36,New York,36,New York,59,Nassau County,26964,27710,-746
36,New York,36,New York,61,New York County,58863,41207,17656
36,New York,36,New York,63,Niagara County,5332,5423,-91
36,New York,36,New York,65,Oneida County,5814,7319,-1505
36,New York,36,New York,67,Onondaga County,12027,10802,1225
36,New York,36,New York,69,Ontario County,4213,4865,-652
36,New York,36,New York,71,Orange County,7752,7816,-64
36,New York,36,New York,73,Orleans County,2237,2292,-55
36,New York,36,New York,75,Oswego County,3957,4951,-994
36,New York,36,New York,77,Otsego County,2107,3991,-1884
36,New York,36,New York,79,Putnam County,3278,3516,-238
36,New York,36,New York,81,Queens County,49399,44390,5009
36,New York,36,New York,83,Rensselaer County,6418,8422,-2004
36,New York,36,New York,85,Richmond County,6422,7180,-758
36,New York,36,New York,87,Rockland County,5401,5421,-20
36,New York,36,New York,89,St. Lawrence County,2673,4721,-2048
36,New York,36,New York,91,Saratoga County,7756,8583,-827
36,New York,36,New York,93,Schenectady County,6272,4101,2171
36,New York,36,New York,95,Schoharie County,1285,1427,-142
36,New York,36,New York,97,Schuyler County,752,689,63
36,New York,36,New York,99,Seneca County,1946,2527,-581
36,New York,36,New York,101,Steuben County,2362,2336,26
36,New York,36,New York,103,Suffolk County,17880,20267,-2387
36,New York,36,New York,105,Sullivan County,2221,3151,-930
36,New York,36,New York,107,Tioga County,1356,1301,55
36,New York,36,New York,109,Tompkins County,3746,4549,-803
36,New York,36,New York,111,Ulster County,5296,6668,-1372
36,New York,36,New York,113,Warren County,3254,2918,336
36,New York,36,New York,115,Washington County,3516,3931,-415
36,New York,36,New York,117,Wayne County,2691,2870,-179
36,New York,36,New York,119,Westchester County,17897,24397,-6500
36,New York,36,New York,121,Wyoming County,2423,2591,-168
36,New York,36,New York,123,Yates County,583,1079,-496
36,New York,37,North Carolina,1,Alamance County,79,100,-21
36,New York,37,North Carolina,3,Alexander County,5,0,5
36,New York,37,North Carolina,9,Ashe County,8,0,8
36,New York,37,North Carolina,13,Beaufort County,0,21,-21
36,New York,37,North Carolina,15,Bertie County,47,11,36
36,New York,37,North Carolina,17,Bladen County,20,0,20
36,New York,37,North Carolina,19,Brunswick County,198,612,-414
36,New York,37,North Carolina,21,Buncombe County,408,855,-447
36,New York,37,North Carolina,23,Burke County,0,8,-8
36,New York,37,North Carolina,25,Cabarrus County,90,961,-871
36,New York,37,North Carolina,27,Caldwell County,76,4,72
36,New York,37,North Carolina,31,Carteret County,33,169,-136
36,New York,37,North Carolina,33,Caswell County,0,21,-21
36,New York,37,North Carolina,35,Catawba County,91,130,-39
36,New York,37,North Carolina,37,Chatham County,40,101,-61
36,New York,37,North Carolina,39,Cherokee County,0,12,-12
36,New York,37,North Carolina,41,Chowan County,15,0,15
36,New York,37,North Carolina,43,Clay County,25,0,25
36,New York,37,North Carolina,45,Cleveland County,95,123,-28
36,New York,37,North Carolina,47,Columbus County,0,29,-29
36,New York,37,North Carolina,49,Craven County,464,442,22
36,New York,37,North Carolina,51,Cumberland County,544,1004,-460
36,New York,37,North Carolina,53,Currituck County,0,19,-19
36,New York,37,North Carolina,55,Dare County,54,82,-28
36,New York,37,North Carolina,57,Davidson County,40,72,-32
36,New York,37,North Carolina,59,Davie County,19,0,19
36,New York,37,North Carolina,61,Duplin County,0,15,-15
36,New York,37,North Carolina,63,Durham County,746,1359,-613
36,New York,37,North Carolina,65,Edgecombe County,0,91,-91
36,New York,37,North Carolina,67,Forsyth County,167,813,-646
36,New York,37,North Carolina,69,Franklin County,9,76,-67
36,New York,37,North Carolina,71,Gaston County,26,186,-160
36,New York,37,North Carolina,73,Gates County,0,36,-36
36,New York,37,North Carolina,75,Graham County,9,0,9
36,New York,37,North Carolina,77,Granville County,72,72,0
36,New York,37,North Carolina,79,Greene County,0,91,-91
36,New York,37,North Carolina,81,Guilford County,674,1074,-400
36,New York,37,North Carolina,83,Halifax County,8,128,-120
36,New York,37,North Carolina,85,Harnett County,91,437,-346
36,New York,37,North Carolina,87,Haywood County,0,36,-36
36,New York,37,North Carolina,89,Henderson County,20,313,-293
36,New York,37,North Carolina,91,Hertford County,17,15,2
36,New York,37,North Carolina,93,Hoke County,75,59,16
36,New York,37,North Carolina,97,Iredell County,247,372,-125
36,New York,37,North Carolina,99,Jackson County,0,51,-51
36,New York,37,North Carolina,101,Johnston County,229,567,-338
36,New York,37,North Carolina,103,Jones County,0,13,-13
36,New York,37,North Carolina,105,Lee County,43,148,-105
36,New York,37,North Carolina,107,Lenoir County,0,47,-47
36,New York,37,North Carolina,109,Lincoln County,46,247,-201
36,New York,37,North Carolina,111,McDowell County,23,33,-10
36,New York,37,North Carolina,113,Macon County,15,137,-122
36,New York,37,North Carolina,115,Madison County,0,45,-45
36,New York,37,North Carolina,117,Martin County,0,36,-36
36,New York,37,North Carolina,119,Mecklenburg County,1230,4420,-3190
36,New York,37,North Carolina,121,Mitchell County,0,8,-8
36,New York,37,North Carolina,123,Montgomery County,0,10,-10
36,New York,37,North Carolina,125,Moore County,344,191,153
36,New York,37,North Carolina,127,Nash County,180,104,76
36,New York,37,North Carolina,129,New Hanover County,238,548,-310
36,New York,37,North Carolina,133,Onslow County,663,1153,-490
36,New York,37,North Carolina,135,Orange County,364,831,-467
36,New York,37,North Carolina,137,Pamlico County,7,25,-18
36,New York,37,North Carolina,139,Pasquotank County,31,194,-163
36,New York,37,North Carolina,141,Pender County,13,117,-104
36,New York,37,North Carolina,143,Perquimans County,0,20,-20
36,New York,37,North Carolina,145,Person County,125,241,-116
36,New York,37,North Carolina,147,Pitt County,46,842,-796
36,New York,37,North Carolina,149,Polk County,15,6,9
36,New York,37,North Carolina,151,Randolph County,56,50,6
36,New York,37,North Carolina,153,Richmond County,31,44,-13
36,New York,37,North Carolina,155,Robeson County,75,255,-180
36,New York,37,North Carolina,157,Rockingham County,24,87,-63
36,New York,37,North Carolina,159,Rowan County,57,227,-170
36,New York,37,North Carolina,161,Rutherford County,0,82,-82
36,New York,37,North Carolina,163,Sampson County,0,33,-33
36,New York,37,North Carolina,165,Scotland County,21,36,-15
36,New York,37,North Carolina,167,Stanly County,0,54,-54
36,New York,37,North Carolina,171,Surry County,0,18,-18
36,New York,37,North Carolina,173,Swain County,11,0,11
36,New York,37,North Carolina,175,Transylvania County,0,48,-48
36,New York,37,North Carolina,177,Tyrrell County,0,12,-12
36,New York,37,North Carolina,179,Union County,253,759,-506
36,New York,37,North Carolina,181,Vance County,4,29,-25
36,New York,37,North Carolina,183,Wake County,1527,3196,-1669
36,New York,37,North Carolina,185,Warren County,5,21,-16
36,New York,37,North Carolina,189,Watauga County,9,47,-38
36,New York,37,North Carolina,191,Wayne County,49,208,-159
36,New York,37,North Carolina,193,Wilkes County,23,0,23
36,New York,37,North Carolina,195,Wilson County,1,44,-43
36,New York,37,North Carolina,197,Yadkin County,0,34,-34
36,New York,38,North Dakota,3,Barnes County,4,0,4
36,New York,38,North Dakota,9,Bottineau County,0,2,-2
36,New York,38,North Dakota,15,Burleigh County,0,111,-111
36,New York,38,North Dakota,17,Cass County,18,212,-194
36,New York,38,North Dakota,19,Cavalier County,10,0,10
36,New York,38,North Dakota,21,Dickey County,0,45,-45
36,New York,38,North Dakota,33,Golden Valley County,0,5,-5
36,New York,38,North Dakota,35,Grand Forks County,178,43,135
36,New York,38,North Dakota,59,Morton County,23,0,23
36,New York,38,North Dakota,89,Stark County,8,0,8
36,New York,38,North Dakota,93,Stutsman County,0,1,-1
36,New York,38,North Dakota,99,Walsh County,0,21,-21
36,New York,38,North Dakota,101,Ward County,0,37,-37
36,New York,38,North Dakota,105,Williams County,51,221,-170
36,New York,39,Ohio,3,Allen County,9,119,-110
36,New York,39,Ohio,5,Ashland County,13,0,13
36,New York,39,Ohio,7,Ashtabula County,159,123,36
36,New York,39,Ohio,9,Athens County,41,177,-136
36,New York,39,Ohio,13,Belmont County,0,45,-45
36,New York,39,Ohio,15,Brown County,0,14,-14
36,New York,39,Ohio,17,Butler County,61,605,-544
36,New York,39,Ohio,19,Carroll County,10,28,-18
36,New York,39,Ohio,21,Champaign County,0,4,-4
36,New York,39,Ohio,23,Clark County,0,55,-55
36,New York,39,Ohio,25,Clermont County,55,7,48
36,New York,39,Ohio,27,Clinton County,18,0,18
36,New York,39,Ohio,29,Columbiana County,86,98,-12
36,New York,39,Ohio,31,Coshocton County,0,31,-31
36,New York,39,Ohio,33,Crawford County,0,6,-6
36,New York,39,Ohio,35,Cuyahoga County,864,1847,-983
36,New York,39,Ohio,37,Darke County,0,11,-11
36,New York,39,Ohio,39,Defiance County,0,33,-33
36,New York,39,Ohio,41,Delaware County,92,212,-120
36,New York,39,Ohio,43,Erie County,0,38,-38
36,New York,39,Ohio,45,Fairfield County,156,177,-21
36,New York,39,Ohio,49,Franklin County,1502,1784,-282
36,New York,39,Ohio,51,Fulton County,0,18,-18
36,New York,39,Ohio,55,Geauga County,93,63,30
36,New York,39,Ohio,57,Greene County,46,249,-203
36,New York,39,Ohio,59,Guernsey County,0,1,-1
36,New York,39,Ohio,61,Hamilton County,398,508,-110
36,New York,39,Ohio,63,Hancock County,38,5,33
36,New York,39,Ohio,65,Hardin County,18,26,-8
36,New York,39,Ohio,71,Highland County,0,3,-3
36,New York,39,Ohio,77,Huron County,0,4,-4
36,New York,39,Ohio,81,Jefferson County,8,79,-71
36,New York,39,Ohio,83,Knox County,43,60,-17
36,New York,39,Ohio,85,Lake County,91,89,2
36,New York,39,Ohio,87,Lawrence County,86,0,86
36,New York,39,Ohio,89,Licking County,62,71,-9
36,New York,39,Ohio,93,Lorain County,372,196,176
36,New York,39,Ohio,95,Lucas County,224,161,63
36,New York,39,Ohio,97,Madison County,0,6,-6
36,New York,39,Ohio,99,Mahoning County,100,376,-276
36,New York,39,Ohio,101,Marion County,14,15,-1
36,New York,39,Ohio,103,Medina County,71,31,40
36,New York,39,Ohio,107,Mercer County,97,0,97
36,New York,39,Ohio,113,Montgomery County,147,427,-280
36,New York,39,Ohio,117,Morrow County,12,0,12
36,New York,39,Ohio,119,Muskingum County,40,0,40
36,New York,39,Ohio,123,Ottawa County,0,36,-36
36,New York,39,Ohio,129,Pickaway County,8,14,-6
36,New York,39,Ohio,133,Portage County,292,203,89
36,New York,39,Ohio,139,Richland County,0,36,-36
36,New York,39,Ohio,141,Ross County,17,13,4
36,New York,39,Ohio,143,Sandusky County,12,15,-3
36,New York,39,Ohio,145,Scioto County,0,3,-3
36,New York,39,Ohio,147,Seneca County,6,18,-12
36,New York,39,Ohio,149,Shelby County,0,103,-103
36,New York,39,Ohio,151,Stark County,98,323,-225
36,New York,39,Ohio,153,Summit County,294,863,-569
36,New York,39,Ohio,155,Trumbull County,42,55,-13
36,New York,39,Ohio,157,Tuscarawas County,4,159,-155
36,New York,39,Ohio,159,Union County,25,36,-11
36,New York,39,Ohio,161,Van Wert County,0,21,-21
36,New York,39,Ohio,165,Warren County,71,39,32
36,New York,39,Ohio,167,Washington County,10,55,-45
36,New York,39,Ohio,169,Wayne County,37,110,-73
36,New York,39,Ohio,173,Wood County,177,52,125
36,New York,4,Arizona,1,Apache County,0,18,-18
36,New York,4,Arizona,3,Cochise County,50,159,-109
36,New York,4,Arizona,5,Coconino County,16,78,-62
36,New York,4,Arizona,9,Graham County,14,12,2
36,New York,4,Arizona,11,Greenlee County,0,3,-3
36,New York,4,Arizona,13,Maricopa County,3905,3222,683
36,New York,4,Arizona,15,Mohave County,150,342,-192
36,New York,4,Arizona,17,Navajo County,19,7,12
36,New York,4,Arizona,19,Pima County,786,938,-152
36,New York,4,Arizona,21,Pinal County,159,420,-261
36,New York,4,Arizona,23,Santa Cruz County,31,8,23
36,New York,4,Arizona,25,Yavapai County,87,225,-138
36,New York,4,Arizona,27,Yuma County,53,170,-117
36,New York,40,Oklahoma,1,Adair County,0,5,-5
36,New York,40,Oklahoma,3,Alfalfa County,10,0,10
36,New York,40,Oklahoma,17,Canadian County,26,0,26
36,New York,40,Oklahoma,21,Cherokee County,15,0,15
36,New York,40,Oklahoma,23,Choctaw County,83,0,83
36,New York,40,Oklahoma,27,Cleveland County,120,249,-129
36,New York,40,Oklahoma,31,Comanche County,252,366,-114
36,New York,40,Oklahoma,37,Creek County,56,26,30
36,New York,40,Oklahoma,45,Ellis County,17,0,17
36,New York,40,Oklahoma,47,Garfield County,72,1,71
36,New York,40,Oklahoma,51,Grady County,25,0,25
36,New York,40,Oklahoma,63,Hughes County,16,0,16
36,New York,40,Oklahoma,65,Jackson County,79,31,48
36,New York,40,Oklahoma,67,Jefferson County,0,2,-2
36,New York,40,Oklahoma,71,Kay County,0,12,-12
36,New York,40,Oklahoma,77,Latimer County,0,38,-38
36,New York,40,Oklahoma,81,Lincoln County,20,6,14
36,New York,40,Oklahoma,89,McCurtain County,22,0,22
36,New York,40,Oklahoma,91,McIntosh County,11,0,11
36,New York,40,Oklahoma,101,Muskogee County,40,3,37
36,New York,40,Oklahoma,105,Nowata County,0,1,-1
36,New York,40,Oklahoma,109,Oklahoma County,397,796,-399
36,New York,40,Oklahoma,111,Okmulgee County,2,16,-14
36,New York,40,Oklahoma,113,Osage County,20,9,11
36,New York,40,Oklahoma,115,Ottawa County,0,19,-19
36,New York,40,Oklahoma,119,Payne County,26,24,2
36,New York,40,Oklahoma,123,Pontotoc County,10,0,10
36,New York,40,Oklahoma,125,Pottawatomie County,3,11,-8
36,New York,40,Oklahoma,131,Rogers County,0,8,-8
36,New York,40,Oklahoma,133,Seminole County,0,12,-12
36,New York,40,Oklahoma,137,Stephens County,9,29,-20
36,New York,40,Oklahoma,143,Tulsa County,78,383,-305
36,New York,40,Oklahoma,145,Wagoner County,27,75,-48
36,New York,40,Oklahoma,147,Washington County,0,21,-21
36,New York,41,Oregon,3,Benton County,40,16,24
36,New York,41,Oregon,5,Clackamas County,124,269,-145
36,New York,41,Oregon,7,Clatsop County,0,26,-26
36,New York,41,Oregon,9,Columbia County,78,48,30
36,New York,41,Oregon,15,Curry County,0,66,-66
36,New York,41,Oregon,17,Deschutes County,18,74,-56
36,New York,41,Oregon,19,Douglas County,40,81,-41
36,New York,41,Oregon,25,Harney County,44,0,44
36,New York,41,Oregon,29,Jackson County,26,23,3
36,New York,41,Oregon,33,Josephine County,1,39,-38
36,New York,41,Oregon,35,Klamath County,14,6,8
36,New York,41,Oregon,39,Lane County,110,336,-226
36,New York,41,Oregon,41,Lincoln County,4,14,-10
36,New York,41,Oregon,43,Linn County,0,34,-34
36,New York,41,Oregon,47,Marion County,45,0,45
36,New York,41,Oregon,51,Multnomah County,877,959,-82
36,New York,41,Oregon,59,Umatilla County,4,8,-4
36,New York,41,Oregon,61,Union County,0,27,-27
36,New York,41,Oregon,65,Wasco County,0,3,-3
36,New York,41,Oregon,67,Washington County,300,419,-119
36,New York,41,Oregon,71,Yamhill County,2,6,-4
36,New York,42,Pennsylvania,1,Adams County,75,106,-31
36,New York,42,Pennsylvania,3,Allegheny County,1501,2859,-1358
36,New York,42,Pennsylvania,5,Armstrong County,38,10,28
36,New York,42,Pennsylvania,7,Beaver County,41,70,-29
36,New York,42,Pennsylvania,9,Bedford County,0,47,-47
36,New York,42,Pennsylvania,11,Berks County,390,1041,-651
36,New York,42,Pennsylvania,13,Blair County,19,35,-16
36,New York,42,Pennsylvania,15,Bradford County,536,596,-60
36,New York,42,Pennsylvania,17,Bucks County,1036,699,337
36,New York,42,Pennsylvania,19,Butler County,22,215,-193
36,New York,42,Pennsylvania,21,Cambria County,33,94,-61
36,New York,42,Pennsylvania,23,Cameron County,14,0,14
36,New York,42,Pennsylvania,25,Carbon County,63,53,10
36,New York,42,Pennsylvania,27,Centre County,485,1005,-520
36,New York,42,Pennsylvania,29,Chester County,835,813,22
36,New York,42,Pennsylvania,31,Clarion County,0,9,-9
36,New York,42,Pennsylvania,33,Clearfield County,61,140,-79
36,New York,42,Pennsylvania,35,Clinton County,41,11,30
36,New York,42,Pennsylvania,37,Columbia County,79,109,-30
36,New York,42,Pennsylvania,39,Crawford County,79,143,-64
36,New York,42,Pennsylvania,41,Cumberland County,387,604,-217
36,New York,42,Pennsylvania,43,Dauphin County,593,672,-79
36,New York,42,Pennsylvania,45,Delaware County,725,1419,-694
36,New York,42,Pennsylvania,47,Elk County,124,33,91
36,New York,42,Pennsylvania,49,Erie County,1155,946,209
36,New York,42,Pennsylvania,51,Fayette County,71,95,-24
36,New York,42,Pennsylvania,53,Forest County,0,11,-11
36,New York,42,Pennsylvania,55,Franklin County,202,98,104
36,New York,42,Pennsylvania,57,Fulton County,0,9,-9
36,New York,42,Pennsylvania,59,Greene County,10,33,-23
36,New York,42,Pennsylvania,61,Huntingdon County,37,61,-24
36,New York,42,Pennsylvania,63,Indiana County,75,43,32
36,New York,42,Pennsylvania,65,Jefferson County,25,17,8
36,New York,42,Pennsylvania,67,Juniata County,39,27,12
36,New York,42,Pennsylvania,69,Lackawanna County,394,1448,-1054
36,New York,42,Pennsylvania,71,Lancaster County,752,1089,-337
36,New York,42,Pennsylvania,73,Lawrence County,24,87,-63
36,New York,42,Pennsylvania,75,Lebanon County,404,134,270
36,New York,42,Pennsylvania,77,Lehigh County,1000,2102,-1102
36,New York,42,Pennsylvania,79,Luzerne County,527,1615,-1088
36,New York,42,Pennsylvania,81,Lycoming County,276,149,127
36,New York,42,Pennsylvania,83,McKean County,377,390,-13
36,New York,42,Pennsylvania,85,Mercer County,171,99,72
36,New York,42,Pennsylvania,87,Mifflin County,48,0,48
36,New York,42,Pennsylvania,89,Monroe County,928,1820,-892
36,New York,42,Pennsylvania,91,Montgomery County,1449,1511,-62
36,New York,42,Pennsylvania,93,Montour County,0,98,-98
36,New York,42,Pennsylvania,95,Northampton County,771,1956,-1185
36,New York,42,Pennsylvania,97,Northumberland County,152,113,39
36,New York,42,Pennsylvania,99,Perry County,0,6,-6
36,New York,42,Pennsylvania,101,Philadelphia County,4755,6216,-1461
36,New York,42,Pennsylvania,103,Pike County,794,1240,-446
36,New York,42,Pennsylvania,105,Potter County,140,166,-26
36,New York,42,Pennsylvania,107,Schuylkill County,154,225,-71
36,New York,42,Pennsylvania,109,Snyder County,19,80,-61
36,New York,42,Pennsylvania,111,Somerset County,11,43,-32
36,New York,42,Pennsylvania,113,Sullivan County,0,10,-10
36,New York,42,Pennsylvania,115,Susquehanna County,330,368,-38
36,New York,42,Pennsylvania,117,Tioga County,308,189,119
36,New York,42,Pennsylvania,119,Union County,270,349,-79
36,New York,42,Pennsylvania,121,Venango County,34,42,-8
36,New York,42,Pennsylvania,123,Warren County,135,346,-211
36,New York,42,Pennsylvania,125,Washington County,76,204,-128
36,New York,42,Pennsylvania,127,Wayne County,207,356,-149
36,New York,42,Pennsylvania,129,Westmoreland County,164,182,-18
36,New York,42,Pennsylvania,131,Wyoming County,80,70,10
36,New York,42,Pennsylvania,133,York County,201,517,-316
36,New York,44,Rhode Island,1,Bristol County,90,111,-21
36,New York,44,Rhode Island,3,Kent County,218,256,-38
36,New York,44,Rhode Island,5,Newport County,196,366,-170
36,New York,44,Rhode Island,7,Providence County,1141,1901,-760
36,New York,44,Rhode Island,9,Washington County,151,506,-355
36,New York,45,South Carolina,1,Abbeville County,0,3,-3
36,New York,45,South Carolina,3,Aiken County,102,326,-224
36,New York,45,South Carolina,7,Anderson County,327,146,181
36,New York,45,South Carolina,9,Bamberg County,0,34,-34
36,New York,45,South Carolina,13,Beaufort County,335,630,-295
36,New York,45,South Carolina,15,Berkeley County,722,549,173
36,New York,45,South Carolina,17,Calhoun County,0,29,-29
36,New York,45,South Carolina,19,Charleston County,693,1044,-351
36,New York,45,South Carolina,21,Cherokee County,0,22,-22
36,New York,45,South Carolina,25,Chesterfield County,10,19,-9
36,New York,45,South Carolina,27,Clarendon County,1,21,-20
36,New York,45,South Carolina,29,Colleton County,11,54,-43
36,New York,45,South Carolina,31,Darlington County,0,24,-24
36,New York,45,South Carolina,33,Dillon County,0,19,-19
36,New York,45,South Carolina,35,Dorchester County,36,113,-77
36,New York,45,South Carolina,37,Edgefield County,0,10,-10
36,New York,45,South Carolina,41,Florence County,184,183,1
36,New York,45,South Carolina,43,Georgetown County,76,161,-85
36,New York,45,South Carolina,45,Greenville County,364,829,-465
36,New York,45,South Carolina,47,Greenwood County,180,81,99
36,New York,45,South Carolina,51,Horry County,345,1610,-1265
36,New York,45,South Carolina,53,Jasper County,0,14,-14
36,New York,45,South Carolina,55,Kershaw County,71,61,10
36,New York,45,South Carolina,57,Lancaster County,26,235,-209
36,New York,45,South Carolina,59,Laurens County,0,174,-174
36,New York,45,South Carolina,63,Lexington County,73,514,-441
36,New York,45,South Carolina,65,McCormick County,0,5,-5
36,New York,45,South Carolina,67,Marion County,40,0,40
36,New York,45,South Carolina,69,Marlboro County,15,19,-4
36,New York,45,South Carolina,71,Newberry County,0,27,-27
36,New York,45,South Carolina,73,Oconee County,195,55,140
36,New York,45,South Carolina,75,Orangeburg County,0,16,-16
36,New York,45,South Carolina,77,Pickens County,161,144,17
36,New York,45,South Carolina,79,Richland County,576,1591,-1015
36,New York,45,South Carolina,81,Saluda County,95,0,95
36,New York,45,South Carolina,83,Spartanburg County,240,187,53
36,New York,45,South Carolina,85,Sumter County,168,339,-171
36,New York,45,South Carolina,87,Union County,0,12,-12
36,New York,45,South Carolina,89,Williamsburg County,6,36,-30
36,New York,45,South Carolina,91,York County,383,615,-232
36,New York,46,South Dakota,5,Beadle County,0,18,-18
36,New York,46,South Dakota,9,Bon Homme County,0,4,-4
36,New York,46,South Dakota,11,Brookings County,14,5,9
36,New York,46,South Dakota,13,Brown County,0,169,-169
36,New York,46,South Dakota,27,Clay County,0,10,-10
36,New York,46,South Dakota,39,Deuel County,0,11,-11
36,New York,46,South Dakota,45,Edmunds County,0,12,-12
36,New York,46,South Dakota,77,Kingsbury County,0,20,-20
36,New York,46,South Dakota,79,Lake County,15,0,15
36,New York,46,South Dakota,81,Lawrence County,0,19,-19
36,New York,46,South Dakota,93,Meade County,39,0,39
36,New York,46,South Dakota,99,Minnehaha County,74,6,68
36,New York,46,South Dakota,103,Pennington County,40,74,-34
36,New York,46,South Dakota,135,Yankton County,9,0,9
36,New York,47,Tennessee,1,Anderson County,0,4,-4
36,New York,47,Tennessee,7,Bledsoe County,0,25,-25
36,New York,47,Tennessee,9,Blount County,57,53,4
36,New York,47,Tennessee,11,Bradley County,25,26,-1
36,New York,47,Tennessee,17,Carroll County,26,0,26
36,New York,47,Tennessee,23,Chester County,4,5,-1
36,New York,47,Tennessee,25,Claiborne County,0,18,-18
36,New York,47,Tennessee,29,Cocke County,20,0,20
36,New York,47,Tennessee,31,Coffee County,13,61,-48
36,New York,47,Tennessee,35,Cumberland County,5,58,-53
36,New York,47,Tennessee,37,Davidson County,930,1013,-83
36,New York,47,Tennessee,41,DeKalb County,102,55,47
36,New York,47,Tennessee,49,Fentress County,0,17,-17
36,New York,47,Tennessee,55,Giles County,0,10,-10
36,New York,47,Tennessee,57,Grainger County,2,0,2
36,New York,47,Tennessee,59,Greene County,22,38,-16
36,New York,47,Tennessee,63,Hamblen County,43,177,-134
36,New York,47,Tennessee,65,Hamilton County,32,281,-249
36,New York,47,Tennessee,67,Hancock County,0,20,-20
36,New York,47,Tennessee,69,Hardeman County,11,0,11
36,New York,47,Tennessee,71,Hardin County,8,0,8
36,New York,47,Tennessee,73,Hawkins County,2,20,-18
36,New York,47,Tennessee,77,Henderson County,11,0,11
36,New York,47,Tennessee,79,Henry County,0,108,-108
36,New York,47,Tennessee,81,Hickman County,0,5,-5
36,New York,47,Tennessee,83,Houston County,0,6,-6
36,New York,47,Tennessee,85,Humphreys County,10,4,6
36,New York,47,Tennessee,87,Jackson County,21,0,21
36,New York,47,Tennessee,89,Jefferson County,0,17,-17
36,New York,47,Tennessee,93,Knox County,191,446,-255
36,New York,47,Tennessee,103,Lincoln County,3,0,3
36,New York,47,Tennessee,105,Loudon County,0,47,-47
36,New York,47,Tennessee,107,McMinn County,0,45,-45
36,New York,47,Tennessee,113,Madison County,69,5,64
36,New York,47,Tennessee,119,Maury County,78,103,-25
36,New York,47,Tennessee,123,Monroe County,0,63,-63
36,New York,47,Tennessee,125,Montgomery County,206,598,-392
36,New York,47,Tennessee,133,Overton County,3,0,3
36,New York,47,Tennessee,141,Putnam County,3,35,-32
36,New York,47,Tennessee,145,Roane County,0,35,-35
36,New York,47,Tennessee,149,Rutherford County,107,196,-89
36,New York,47,Tennessee,155,Sevier County,38,175,-137
36,New York,47,Tennessee,157,Shelby County,462,205,257
36,New York,47,Tennessee,161,Stewart County,0,93,-93
36,New York,47,Tennessee,163,Sullivan County,39,139,-100
36,New York,47,Tennessee,165,Sumner County,22,140,-118
36,New York,47,Tennessee,167,Tipton County,0,72,-72
36,New York,47,Tennessee,171,Unicoi County,0,14,-14
36,New York,47,Tennessee,177,Warren County,45,12,33
36,New York,47,Tennessee,179,Washington County,31,22,9
36,New York,47,Tennessee,183,Weakley County,0,3,-3
36,New York,47,Tennessee,185,White County,0,17,-17
36,New York,47,Tennessee,187,Williamson County,45,229,-184
36,New York,47,Tennessee,189,Wilson County,50,121,-71
36,New York,48,Texas,1,Anderson County,4,0,4
36,New York,48,Texas,5,Angelina County,0,18,-18
36,New York,48,Texas,7,Aransas County,9,0,9
36,New York,48,Texas,13,Atascosa County,11,0,11
36,New York,48,Texas,15,Austin County,25,0,25
36,New York,48,Texas,17,Bailey County,19,0,19
36,New York,48,Texas,21,Bastrop County,24,29,-5
36,New York,48,Texas,25,Bee County,0,5,-5
36,New York,48,Texas,27,Bell County,518,1172,-654
36,New York,48,Texas,29,Bexar County,1347,1320,27
36,New York,48,Texas,31,Blanco County,7,18,-11
36,New York,48,Texas,39,Brazoria County,63,87,-24
36,New York,48,Texas,41,Brazos County,434,246,188
36,New York,48,Texas,43,Brewster County,0,6,-6
36,New York,48,Texas,49,Brown County,25,0,25
36,New York,48,Texas,55,Caldwell County,0,38,-38
36,New York,48,Texas,61,Cameron County,33,0,33
36,New York,48,Texas,65,Carson County,0,1,-1
36,New York,48,Texas,73,Cherokee County,29,0,29
36,New York,48,Texas,85,Collin County,377,1228,-851
36,New York,48,Texas,91,Comal County,0,38,-38
36,New York,48,Texas,99,Coryell County,105,160,-55
36,New York,48,Texas,111,Dallam County,0,14,-14
36,New York,48,Texas,113,Dallas County,1451,2394,-943
36,New York,48,Texas,119,Delta County,3,0,3
36,New York,48,Texas,121,Denton County,377,600,-223
36,New York,48,Texas,123,DeWitt County,0,15,-15
36,New York,48,Texas,135,Ector County,0,49,-49
36,New York,48,Texas,139,Ellis County,10,29,-19
36,New York,48,Texas,141,El Paso County,543,810,-267
36,New York,48,Texas,143,Erath County,0,57,-57
36,New York,48,Texas,145,Falls County,8,0,8
36,New York,48,Texas,147,Fannin County,9,0,9
36,New York,48,Texas,157,Fort Bend County,347,664,-317
36,New York,48,Texas,161,Freestone County,37,0,37
36,New York,48,Texas,163,Frio County,0,8,-8
36,New York,48,Texas,167,Galveston County,219,143,76
36,New York,48,Texas,171,Gillespie County,0,28,-28
36,New York,48,Texas,181,Grayson County,14,16,-2
36,New York,48,Texas,183,Gregg County,55,53,2
36,New York,48,Texas,187,Guadalupe County,8,77,-69
36,New York,48,Texas,189,Hale County,0,29,-29
36,New York,48,Texas,201,Harris County,1898,4325,-2427
36,New York,48,Texas,203,Harrison County,0,22,-22
36,New York,48,Texas,209,Hays County,101,433,-332
36,New York,48,Texas,213,Henderson County,40,13,27
36,New York,48,Texas,215,Hidalgo County,42,122,-80
36,New York,48,Texas,217,Hill County,0,6,-6
36,New York,48,Texas,219,Hockley County,0,4,-4
36,New York,48,Texas,221,Hood County,10,19,-9
36,New York,48,Texas,223,Hopkins County,0,8,-8
36,New York,48,Texas,227,Howard County,0,23,-23
36,New York,48,Texas,231,Hunt County,0,82,-82
36,New York,48,Texas,233,Hutchinson County,10,0,10
36,New York,48,Texas,241,Jasper County,0,10,-10
36,New York,48,Texas,243,Jeff Davis County,11,0,11
36,New York,48,Texas,245,Jefferson County,51,113,-62
36,New York,48,Texas,251,Johnson County,11,15,-4
36,New York,48,Texas,257,Kaufman County,34,39,-5
36,New York,48,Texas,259,Kendall County,37,35,2
36,New York,48,Texas,265,Kerr County,0,30,-30
36,New York,48,Texas,273,Kleberg County,0,8,-8
36,New York,48,Texas,275,Knox County,0,5,-5
36,New York,48,Texas,277,Lamar County,7,0,7
36,New York,48,Texas,289,Leon County,0,13,-13
36,New York,48,Texas,291,Liberty County,15,2,13
36,New York,48,Texas,299,Llano County,45,0,45
36,New York,48,Texas,303,Lubbock County,152,127,25
36,New York,48,Texas,309,McLennan County,18,66,-48
36,New York,48,Texas,329,Midland County,15,54,-39
36,New York,48,Texas,339,Montgomery County,232,20,212
36,New York,48,Texas,347,Nacogdoches County,6,0,6
36,New York,48,Texas,353,Nolan County,0,7,-7
36,New York,48,Texas,355,Nueces County,135,185,-50
36,New York,48,Texas,359,Oldham County,0,24,-24
36,New York,48,Texas,361,Orange County,7,0,7
36,New York,48,Texas,363,Palo Pinto County,0,36,-36
36,New York,48,Texas,367,Parker County,0,50,-50
36,New York,48,Texas,369,Parmer County,10,0,10
36,New York,48,Texas,373,Polk County,18,0,18
36,New York,48,Texas,375,Potter County,52,21,31
36,New York,48,Texas,381,Randall County,0,25,-25
36,New York,48,Texas,397,Rockwall County,0,142,-142
36,New York,48,Texas,407,San Jacinto County,0,15,-15
36,New York,48,Texas,409,San Patricio County,15,16,-1
36,New York,48,Texas,419,Shelby County,20,0,20
36,New York,48,Texas,423,Smith County,48,65,-17
36,New York,48,Texas,427,Starr County,44,10,34
36,New York,48,Texas,439,Tarrant County,568,1296,-728
36,New York,48,Texas,441,Taylor County,14,83,-69
36,New York,48,Texas,451,Tom Green County,16,240,-224
36,New York,48,Texas,453,Travis County,1632,2855,-1223
36,New York,48,Texas,459,Upshur County,4,0,4
36,New York,48,Texas,465,Val Verde County,9,88,-79
36,New York,48,Texas,467,Van Zandt County,1,34,-33
36,New York,48,Texas,473,Waller County,0,107,-107
36,New York,48,Texas,477,Washington County,0,18,-18
36,New York,48,Texas,479,Webb County,19,33,-14
36,New York,48,Texas,485,Wichita County,108,239,-131
36,New York,48,Texas,491,Williamson County,160,494,-334
36,New York,48,Texas,493,Wilson County,18,54,-36
36,New York,49,Utah,3,Box Elder County,49,0,49
36,New York,49,Utah,5,Cache County,28,65,-37
36,New York,49,Utah,7,Carbon County,121,14,107
36,New York,49,Utah,11,Davis County,84,246,-162
36,New York,49,Utah,13,Duchesne County,0,13,-13
36,New York,49,Utah,17,Garfield County,0,2,-2
36,New York,49,Utah,19,Grand County,0,28,-28
36,New York,49,Utah,21,Iron County,0,126,-126
36,New York,49,Utah,23,Juab County,0,3,-3
36,New York,49,Utah,25,Kane County,0,25,-25
36,New York,49,Utah,35,Salt Lake County,318,947,-629
36,New York,49,Utah,37,San Juan County,0,55,-55
36,New York,49,Utah,39,Sanpete County,0,26,-26
36,New York,49,Utah,43,Summit County,13,141,-128
36,New York,49,Utah,45,Tooele County,15,5,10
36,New York,49,Utah,49,Utah County,483,358,125
36,New York,49,Utah,51,Wasatch County,0,90,-90
36,New York,49,Utah,53,Washington County,69,13,56
36,New York,49,Utah,57,Weber County,38,82,-44
36,New York,5,Arkansas,7,Benton County,102,232,-130
36,New York,5,Arkansas,15,Carroll County,0,4,-4
36,New York,5,Arkansas,19,Clark County,70,0,70
36,New York,5,Arkansas,31,Craighead County,129,134,-5
36,New York,5,Arkansas,33,Crawford County,3,0,3
36,New York,5,Arkansas,35,Crittenden County,0,5,-5
36,New York,5,Arkansas,45,Faulkner County,13,67,-54
36,New York,5,Arkansas,47,Franklin County,0,27,-27
36,New York,5,Arkansas,49,Fulton County,17,0,17
36,New York,5,Arkansas,51,Garland County,1,15,-14
36,New York,5,Arkansas,65,Izard County,12,0,12
36,New York,5,Arkansas,79,Lincoln County,0,3,-3
36,New York,5,Arkansas,81,Little River County,11,0,11
36,New York,5,Arkansas,83,Logan County,0,1,-1
36,New York,5,Arkansas,89,Marion County,0,5,-5
36,New York,5,Arkansas,93,Mississippi County,18,0,18
36,New York,5,Arkansas,103,Ouachita County,0,3,-3
36,New York,5,Arkansas,107,Phillips County,0,4,-4
36,New York,5,Arkansas,115,Pope County,54,0,54
36,New York,5,Arkansas,119,Pulaski County,120,103,17
36,New York,5,Arkansas,125,Saline County,0,21,-21
36,New York,5,Arkansas,131,Sebastian County,28,41,-13
36,New York,5,Arkansas,135,Sharp County,20,26,-6
36,New York,5,Arkansas,139,Union County,35,0,35
36,New York,5,Arkansas,143,Washington County,52,63,-11
36,New York,5,Arkansas,145,White County,29,14,15
36,New York,50,Vermont,1,Addison County,94,235,-141
36,New York,50,Vermont,3,Bennington County,209,534,-325
36,New York,50,Vermont,5,Caledonia County,81,45,36
36,New York,50,Vermont,7,Chittenden County,698,1107,-409
36,New York,50,Vermont,9,Essex County,0,14,-14
36,New York,50,Vermont,11,Franklin County,253,117,136
36,New York,50,Vermont,13,Grand Isle County,26,19,7
36,New York,50,Vermont,15,Lamoille County,187,58,129
36,New York,50,Vermont,17,Orange County,46,122,-76
36,New York,50,Vermont,19,Orleans County,75,53,22
36,New York,50,Vermont,21,Rutland County,401,186,215
36,New York,50,Vermont,23,Washington County,208,252,-44
36,New York,50,Vermont,25,Windham County,112,181,-69
36,New York,50,Vermont,27,Windsor County,333,133,200
36,New York,51,Virginia,1,Accomack County,0,42,-42
36,New York,51,Virginia,3,Albemarle County,105,298,-193
36,New York,51,Virginia,5,Alleghany County,0,5,-5
36,New York,51,Virginia,9,Amherst County,0,10,-10
36,New York,51,Virginia,13,Arlington County,626,1168,-542
36,New York,51,Virginia,15,Augusta County,4,17,-13
36,New York,51,Virginia,19,Bedford County,17,19,-2
36,New York,51,Virginia,23,Botetourt County,21,18,3
36,New York,51,Virginia,25,Brunswick County,0,5,-5
36,New York,51,Virginia,27,Buchanan County,0,12,-12
36,New York,51,Virginia,29,Buckingham County,0,36,-36
36,New York,51,Virginia,31,Campbell County,13,40,-27
36,New York,51,Virginia,33,Caroline County,26,66,-40
36,New York,51,Virginia,36,Charles City County,0,3,-3
36,New York,51,Virginia,37,Charlotte County,55,0,55
36,New York,51,Virginia,41,Chesterfield County,353,437,-84
36,New York,51,Virginia,43,Clarke County,0,59,-59
36,New York,51,Virginia,47,Culpeper County,0,25,-25
36,New York,51,Virginia,49,Cumberland County,0,25,-25
36,New York,51,Virginia,59,Fairfax County,1937,1562,375
36,New York,51,Virginia,61,Fauquier County,46,0,46
36,New York,51,Virginia,63,Floyd County,0,33,-33
36,New York,51,Virginia,65,Fluvanna County,0,72,-72
36,New York,51,Virginia,69,Frederick County,77,19,58
36,New York,51,Virginia,73,Gloucester County,26,0,26
36,New York,51,Virginia,75,Goochland County,20,9,11
36,New York,51,Virginia,79,Greene County,11,0,11
36,New York,51,Virginia,81,Greensville County,28,3,25
36,New York,51,Virginia,83,Halifax County,10,0,10
36,New York,51,Virginia,85,Hanover County,18,97,-79
36,New York,51,Virginia,87,Henrico County,473,241,232
36,New York,51,Virginia,89,Henry County,86,22,64
36,New York,51,Virginia,93,Isle of Wight County,18,0,18
36,New York,51,Virginia,95,James City County,67,303,-236
36,New York,51,Virginia,97,King and Queen County,18,0,18
36,New York,51,Virginia,99,King George County,27,0,27
36,New York,51,Virginia,101,King William County,6,0,6
36,New York,51,Virginia,103,Lancaster County,0,9,-9
36,New York,51,Virginia,105,Lee County,11,0,11
36,New York,51,Virginia,107,Loudoun County,476,714,-238
36,New York,51,Virginia,111,Lunenburg County,0,4,-4
36,New York,51,Virginia,115,Mathews County,0,34,-34
36,New York,51,Virginia,117,Mecklenburg County,0,8,-8
36,New York,51,Virginia,121,Montgomery County,104,281,-177
36,New York,51,Virginia,125,Nelson County,15,79,-64
36,New York,51,Virginia,127,New Kent County,23,0,23
36,New York,51,Virginia,131,Northampton County,0,6,-6
36,New York,51,Virginia,137,Orange County,0,44,-44
36,New York,51,Virginia,139,Page County,0,3,-3
36,New York,51,Virginia,143,Pittsylvania County,0,61,-61
36,New York,51,Virginia,145,Powhatan County,0,47,-47
36,New York,51,Virginia,147,Prince Edward County,42,8,34
36,New York,51,Virginia,149,Prince George County,117,30,87
36,New York,51,Virginia,153,Prince William County,355,434,-79
36,New York,51,Virginia,155,Pulaski County,0,18,-18
36,New York,51,Virginia,157,Rappahannock County,0,23,-23
36,New York,51,Virginia,161,Roanoke County,85,258,-173
36,New York,51,Virginia,163,Rockbridge County,0,31,-31
36,New York,51,Virginia,165,Rockingham County,38,90,-52
36,New York,51,Virginia,169,Scott County,0,41,-41
36,New York,51,Virginia,171,Shenandoah County,3,0,3
36,New York,51,Virginia,175,Southampton County,45,8,37
36,New York,51,Virginia,177,Spotsylvania County,193,144,49
36,New York,51,Virginia,179,Stafford County,21,390,-369
36,New York,51,Virginia,181,Surry County,0,5,-5
36,New York,51,Virginia,183,Sussex County,0,9,-9
36,New York,51,Virginia,185,Tazewell County,1,0,1
36,New York,51,Virginia,187,Warren County,25,10,15
36,New York,51,Virginia,191,Washington County,8,78,-70
36,New York,51,Virginia,193,Westmoreland County,3,0,3
36,New York,51,Virginia,195,Wise County,0,26,-26
36,New York,51,Virginia,199,York County,58,133,-75
36,New York,51,Virginia,510,Alexandria city,436,621,-185
36,New York,51,Virginia,520,Bristol city,0,6,-6
36,New York,51,Virginia,540,Charlottesville city,367,133,234
36,New York,51,Virginia,550,Chesapeake city,298,560,-262
36,New York,51,Virginia,590,Danville city,34,21,13
36,New York,51,Virginia,600,Fairfax city,75,10,65
36,New York,51,Virginia,610,Falls Church city,6,7,-1
36,New York,51,Virginia,620,Franklin city,0,96,-96
36,New York,51,Virginia,630,Fredericksburg city,93,272,-179
36,New York,51,Virginia,650,Hampton city,223,432,-209
36,New York,51,Virginia,660,Harrisonburg city,114,310,-196
36,New York,51,Virginia,670,Hopewell city,0,83,-83
36,New York,51,Virginia,678,Lexington city,27,56,-29
36,New York,51,Virginia,680,Lynchburg city,94,321,-227
36,New York,51,Virginia,683,Manassas city,0,22,-22
36,New York,51,Virginia,685,Manassas Park city,0,14,-14
36,New York,51,Virginia,700,Newport News city,441,458,-17
36,New York,51,Virginia,710,Norfolk city,478,1139,-661
36,New York,51,Virginia,730,Petersburg city,31,88,-57
36,New York,51,Virginia,735,Poquoson city,9,0,9
36,New York,51,Virginia,740,Portsmouth city,45,157,-112
36,New York,51,Virginia,750,Radford city,19,5,14
36,New York,51,Virginia,760,Richmond city,388,1080,-692
36,New York,51,Virginia,770,Roanoke city,49,183,-134
36,New York,51,Virginia,775,Salem city,9,25,-16
36,New York,51,Virginia,790,Staunton city,17,21,-4
36,New York,51,Virginia,800,Suffolk city,13,147,-134
36,New York,51,Virginia,810,Virginia Beach city,1019,1247,-228
36,New York,51,Virginia,820,Waynesboro city,19,9,10
36,New York,51,Virginia,830,Williamsburg city,128,57,71
36,New York,51,Virginia,840,Winchester city,0,15,-15
36,New York,53,Washington,3,Asotin County,0,1,-1
36,New York,53,Washington,5,Benton County,0,85,-85
36,New York,53,Washington,7,Chelan County,96,14,82
36,New York,53,Washington,9,Clallam County,0,9,-9
36,New York,53,Washington,11,Clark County,87,248,-161
36,New York,53,Washington,13,Columbia County,0,6,-6
36,New York,53,Washington,15,Cowlitz County,0,5,-5
36,New York,53,Washington,25,Grant County,0,29,-29
36,New York,53,Washington,29,Island County,28,67,-39
36,New York,53,Washington,31,Jefferson County,13,30,-17
36,New York,53,Washington,33,King County,2730,2829,-99
36,New York,53,Washington,35,Kitsap County,110,364,-254
36,New York,53,Washington,37,Kittitas County,0,16,-16
36,New York,53,Washington,41,Lewis County,0,25,-25
36,New York,53,Washington,47,Okanogan County,14,0,14
36,New York,53,Washington,51,Pend Oreille County,0,1,-1
36,New York,53,Washington,53,Pierce County,525,964,-439
36,New York,53,Washington,55,San Juan County,14,2,12
36,New York,53,Washington,57,Skagit County,62,13,49
36,New York,53,Washington,59,Skamania County,0,7,-7
36,New York,53,Washington,61,Snohomish County,191,358,-167
36,New York,53,Washington,63,Spokane County,155,264,-109
36,New York,53,Washington,67,Thurston County,132,60,72
36,New York,53,Washington,71,Walla Walla County,43,0,43
36,New York,53,Washington,73,Whatcom County,19,97,-78
36,New York,53,Washington,75,Whitman County,20,82,-62
36,New York,53,Washington,77,Yakima County,37,233,-196
36,New York,54,West Virginia,1,Barbour County,0,2,-2
36,New York,54,West Virginia,3,Berkeley County,0,129,-129
36,New York,54,West Virginia,11,Cabell County,84,75,9
36,New York,54,West Virginia,15,Clay County,29,33,-4
36,New York,54,West Virginia,19,Fayette County,7,10,-3
36,New York,54,West Virginia,21,Gilmer County,17,0,17
36,New York,54,West Virginia,25,Greenbrier County,11,0,11
36,New York,54,West Virginia,27,Hampshire County,9,0,9
36,New York,54,West Virginia,29,Hancock County,11,0,11
36,New York,54,West Virginia,33,Harrison County,18,0,18
36,New York,54,West Virginia,37,Jefferson County,30,0,30
36,New York,54,West Virginia,39,Kanawha County,95,135,-40
36,New York,54,West Virginia,41,Lewis County,5,0,5
36,New York,54,West Virginia,47,McDowell County,0,12,-12
36,New York,54,West Virginia,49,Marion County,21,40,-19
36,New York,54,West Virginia,51,Marshall County,5,14,-9
36,New York,54,West Virginia,55,Mercer County,8,0,8
36,New York,54,West Virginia,57,Mineral County,0,11,-11
36,New York,54,West Virginia,61,Monongalia County,432,187,245
36,New York,54,West Virginia,63,Monroe County,0,1,-1
36,New York,54,West Virginia,69,Ohio County,9,19,-10
36,New York,54,West Virginia,75,Pocahontas County,0,3,-3
36,New York,54,West Virginia,77,Preston County,0,87,-87
36,New York,54,West Virginia,79,Putnam County,12,11,1
36,New York,54,West Virginia,81,Raleigh County,89,9,80
36,New York,54,West Virginia,83,Randolph County,0,5,-5
36,New York,54,West Virginia,85,Ritchie County,49,0,49
36,New York,54,West Virginia,89,Summers County,0,43,-43
36,New York,54,West Virginia,91,Taylor County,9,0,9
36,New York,54,West Virginia,97,Upshur County,10,0,10
36,New York,54,West Virginia,99,Wayne County,0,38,-38
36,New York,54,West Virginia,103,Wetzel County,4,0,4
36,New York,54,West Virginia,107,Wood County,21,12,9
36,New York,55,Wisconsin,3,Ashland County,10,0,10
36,New York,55,Wisconsin,5,Barron County,0,3,-3
36,New York,55,Wisconsin,7,Bayfield County,1,0,1
36,New York,55,Wisconsin,9,Brown County,99,0,99
36,New York,55,Wisconsin,21,Columbia County,24,7,17
36,New York,55,Wisconsin,23,Crawford County,0,4,-4
36,New York,55,Wisconsin,25,Dane County,563,687,-124
36,New York,55,Wisconsin,27,Dodge County,10,0,10
36,New York,55,Wisconsin,29,Door County,60,2,58
36,New York,55,Wisconsin,33,Dunn County,0,2,-2
36,New York,55,Wisconsin,35,Eau Claire County,0,32,-32
36,New York,55,Wisconsin,39,Fond du Lac County,36,62,-26
36,New York,55,Wisconsin,43,Grant County,0,18,-18
36,New York,55,Wisconsin,49,Iowa County,4,0,4
36,New York,55,Wisconsin,57,Juneau County,19,0,19
36,New York,55,Wisconsin,59,Kenosha County,30,63,-33
36,New York,55,Wisconsin,61,Kewaunee County,0,3,-3
36,New York,55,Wisconsin,63,La Crosse County,14,139,-125
36,New York,55,Wisconsin,71,Manitowoc County,13,0,13
36,New York,55,Wisconsin,73,Marathon County,6,23,-17
36,New York,55,Wisconsin,75,Marinette County,0,12,-12
36,New York,55,Wisconsin,79,Milwaukee County,509,294,215
36,New York,55,Wisconsin,87,Outagamie County,26,11,15
36,New York,55,Wisconsin,89,Ozaukee County,28,40,-12
36,New York,55,Wisconsin,91,Pepin County,14,11,3
36,New York,55,Wisconsin,95,Polk County,0,14,-14
36,New York,55,Wisconsin,97,Portage County,0,66,-66
36,New York,55,Wisconsin,99,Price County,0,1,-1
36,New York,55,Wisconsin,101,Racine County,62,0,62
36,New York,55,Wisconsin,103,Richland County,0,11,-11
36,New York,55,Wisconsin,105,Rock County,0,69,-69
36,New York,55,Wisconsin,109,St. Croix County,7,0,7
36,New York,55,Wisconsin,111,Sauk County,0,21,-21
36,New York,55,Wisconsin,117,Sheboygan County,4,35,-31
36,New York,55,Wisconsin,127,Walworth County,0,103,-103
36,New York,55,Wisconsin,131,Washington County,27,31,-4
36,New York,55,Wisconsin,133,Waukesha County,105,37,68
36,New York,55,Wisconsin,135,Waupaca County,22,0,22
36,New York,55,Wisconsin,137,Waushara County,0,6,-6
36,New York,55,Wisconsin,139,Winnebago County,98,6,92
36,New York,55,Wisconsin,141,Wood County,22,7,15
36,New York,56,Wyoming,1,Albany County,28,0,28
36,New York,56,Wyoming,5,Campbell County,25,0,25
36,New York,56,Wyoming,7,Carbon County,0,38,-38
36,New York,56,Wyoming,13,Fremont County,0,28,-28
36,New York,56,Wyoming,15,Goshen County,34,0,34
36,New York,56,Wyoming,21,Laramie County,60,184,-124
36,New York,56,Wyoming,23,Lincoln County,0,36,-36
36,New York,56,Wyoming,29,Park County,0,21,-21
36,New York,56,Wyoming,33,Sheridan County,0,2,-2
36,New York,56,Wyoming,35,Sublette County,21,0,21
36,New York,56,Wyoming,39,Teton County,51,31,20
36,New York,56,Wyoming,41,Uinta County,0,1,-1
36,New York,6,California,1,Alameda County,1607,2287,-680
36,New York,6,California,5,Amador County,14,23,-9
36,New York,6,California,7,Butte County,65,73,-8
36,New York,6,California,13,Contra Costa County,386,854,-468
36,New York,6,California,15,Del Norte County,0,54,-54
36,New York,6,California,17,El Dorado County,57,9,48
36,New York,6,California,19,Fresno County,96,103,-7
36,New York,6,California,23,Humboldt County,27,47,-20
36,New York,6,California,29,Kern County,88,77,11
36,New York,6,California,31,Kings County,0,32,-32
36,New York,6,California,33,Lake County,0,39,-39
36,New York,6,California,37,Los Angeles County,7701,11197,-3496
36,New York,6,California,39,Madera County,13,0,13
36,New York,6,California,41,Marin County,486,349,137
36,New York,6,California,45,Mendocino County,37,11,26
36,New York,6,California,47,Merced County,0,82,-82
36,New York,6,California,51,Mono County,0,3,-3
36,New York,6,California,53,Monterey County,306,105,201
36,New York,6,California,55,Napa County,19,149,-130
36,New York,6,California,57,Nevada County,43,78,-35
36,New York,6,California,59,Orange County,1684,2278,-594
36,New York,6,California,61,Placer County,7,259,-252
36,New York,6,California,63,Plumas County,0,20,-20
36,New York,6,California,65,Riverside County,562,952,-390
36,New York,6,California,67,Sacramento County,525,934,-409
36,New York,6,California,69,San Benito County,22,8,14
36,New York,6,California,71,San Bernardino County,567,951,-384
36,New York,6,California,73,San Diego County,2287,3344,-1057
36,New York,6,California,75,San Francisco County,2915,3857,-942
36,New York,6,California,77,San Joaquin County,111,227,-116
36,New York,6,California,79,San Luis Obispo County,80,177,-97
36,New York,6,California,81,San Mateo County,813,929,-116
36,New York,6,California,83,Santa Barbara County,197,586,-389
36,New York,6,California,85,Santa Clara County,1645,3051,-1406
36,New York,6,California,87,Santa Cruz County,217,330,-113
36,New York,6,California,89,Shasta County,89,18,71
36,New York,6,California,93,Siskiyou County,19,0,19
36,New York,6,California,95,Solano County,91,278,-187
36,New York,6,California,97,Sonoma County,162,498,-336
36,New York,6,California,99,Stanislaus County,101,124,-23
36,New York,6,California,101,Sutter County,0,62,-62
36,New York,6,California,103,Tehama County,0,43,-43
36,New York,6,California,107,Tulare County,16,34,-18
36,New York,6,California,109,Tuolumne County,42,0,42
36,New York,6,California,111,Ventura County,336,746,-410
36,New York,6,California,113,Yolo County,85,93,-8
36,New York,6,California,115,Yuba County,0,11,-11
36,New York,72,Puerto Rico,1,Adjuntas Municipio,10,13,-3
36,New York,72,Puerto Rico,3,Aguada Municipio,7,42,-35
36,New York,72,Puerto Rico,5,Aguadilla Municipio,101,169,-68
36,New York,72,Puerto Rico,7,Aguas Buenas Municipio,11,0,11
36,New York,72,Puerto Rico,9,Aibonito Municipio,0,71,-71
36,New York,72,Puerto Rico,11,Añasco Municipio,0,18,-18
36,New York,72,Puerto Rico,13,Arecibo Municipio,141,120,21
36,New York,72,Puerto Rico,15,Arroyo Municipio,11,0,11
36,New York,72,Puerto Rico,17,Barceloneta Municipio,66,0,66
36,New York,72,Puerto Rico,19,Barranquitas Municipio,0,72,-72
36,New York,72,Puerto Rico,21,Bayamón Municipio,153,222,-69
36,New York,72,Puerto Rico,23,Cabo Rojo Municipio,0,17,-17
36,New York,72,Puerto Rico,25,Caguas Municipio,280,271,9
36,New York,72,Puerto Rico,27,Camuy Municipio,46,0,46
36,New York,72,Puerto Rico,29,Canóvanas Municipio,13,75,-62
36,New York,72,Puerto Rico,31,Carolina Municipio,431,288,143
36,New York,72,Puerto Rico,33,Cataño Municipio,0,39,-39
36,New York,72,Puerto Rico,35,Cayey Municipio,86,63,23
36,New York,72,Puerto Rico,37,Ceiba Municipio,0,16,-16
36,New York,72,Puerto Rico,39,Ciales Municipio,21,184,-163
36,New York,72,Puerto Rico,41,Cidra Municipio,77,31,46
36,New York,72,Puerto Rico,43,Coamo Municipio,106,20,86
36,New York,72,Puerto Rico,45,Comerío Municipio,15,0,15
36,New York,72,Puerto Rico,47,Corozal Municipio,9,0,9
36,New York,72,Puerto Rico,49,Culebra Municipio,0,10,-10
36,New York,72,Puerto Rico,51,Dorado Municipio,57,0,57
36,New York,72,Puerto Rico,53,Fajardo Municipio,165,43,122
36,New York,72,Puerto Rico,55,Guánica Municipio,23,38,-15
36,New York,72,Puerto Rico,57,Guayama Municipio,58,11,47
36,New York,72,Puerto Rico,59,Guayanilla Municipio,0,13,-13
36,New York,72,Puerto Rico,61,Guaynabo Municipio,233,115,118
36,New York,72,Puerto Rico,63,Gurabo Municipio,0,53,-53
36,New York,72,Puerto Rico,65,Hatillo Municipio,10,0,10
36,New York,72,Puerto Rico,67,Hormigueros Municipio,0,50,-50
36,New York,72,Puerto Rico,69,Humacao Municipio,288,52,236
36,New York,72,Puerto Rico,71,Isabela Municipio,249,73,176
36,New York,72,Puerto Rico,73,Jayuya Municipio,276,0,276
36,New York,72,Puerto Rico,75,Juana Díaz Municipio,73,50,23
36,New York,72,Puerto Rico,79,Lajas Municipio,13,39,-26
36,New York,72,Puerto Rico,83,Las Marías Municipio,0,9,-9
36,New York,72,Puerto Rico,85,Las Piedras Municipio,78,0,78
36,New York,72,Puerto Rico,87,Loíza Municipio,11,21,-10
36,New York,72,Puerto Rico,89,Luquillo Municipio,0,45,-45
36,New York,72,Puerto Rico,91,Manatí Municipio,66,14,52
36,New York,72,Puerto Rico,95,Maunabo Municipio,16,25,-9
36,New York,72,Puerto Rico,97,Mayagüez Municipio,15,103,-88
36,New York,72,Puerto Rico,99,Moca Municipio,44,32,12
36,New York,72,Puerto Rico,103,Naguabo Municipio,147,27,120
36,New York,72,Puerto Rico,109,Patillas Municipio,0,29,-29
36,New York,72,Puerto Rico,111,Peñuelas Municipio,9,0,9
36,New York,72,Puerto Rico,113,Ponce Municipio,493,42,451
36,New York,72,Puerto Rico,115,Quebradillas Municipio,54,0,54
36,New York,72,Puerto Rico,117,Rincón Municipio,0,154,-154
36,New York,72,Puerto Rico,119,Río Grande Municipio,0,32,-32
36,New York,72,Puerto Rico,121,Sabana Grande Municipio,30,31,-1
36,New York,72,Puerto Rico,123,Salinas Municipio,133,45,88
36,New York,72,Puerto Rico,125,San Germán Municipio,50,54,-4
36,New York,72,Puerto Rico,127,San Juan Municipio,1111,335,776
36,New York,72,Puerto Rico,131,San Sebastián Municipio,76,34,42
36,New York,72,Puerto Rico,133,Santa Isabel Municipio,0,12,-12
36,New York,72,Puerto Rico,135,Toa Alta Municipio,185,23,162
36,New York,72,Puerto Rico,137,Toa Baja Municipio,57,10,47
36,New York,72,Puerto Rico,139,Trujillo Alto Municipio,123,0,123
36,New York,72,Puerto Rico,141,Utuado Municipio,36,0,36
36,New York,72,Puerto Rico,145,Vega Baja Municipio,28,9,19
36,New York,72,Puerto Rico,147,Vieques Municipio,0,102,-102
36,New York,72,Puerto Rico,149,Villalba Municipio,265,17,248
36,New York,72,Puerto Rico,151,Yabucoa Municipio,0,20,-20
36,New York,72,Puerto Rico,153,Yauco Municipio,53,33,20
36,New York,8,Colorado,1,Adams County,40,443,-403
36,New York,8,Colorado,3,Alamosa County,12,0,12
36,New York,8,Colorado,5,Arapahoe County,293,991,-698
36,New York,8,Colorado,9,Baca County,0,3,-3
36,New York,8,Colorado,13,Boulder County,444,1107,-663
36,New York,8,Colorado,14,Broomfield County,0,16,-16
36,New York,8,Colorado,15,Chaffee County,0,270,-270
36,New York,8,Colorado,19,Clear Creek County,0,21,-21
36,New York,8,Colorado,27,Custer County,2,0,2
36,New York,8,Colorado,29,Delta County,11,0,11
36,New York,8,Colorado,31,Denver County,624,1528,-904
36,New York,8,Colorado,35,Douglas County,72,192,-120
36,New York,8,Colorado,37,Eagle County,52,31,21
36,New York,8,Colorado,41,El Paso County,671,1312,-641
36,New York,8,Colorado,43,Fremont County,38,0,38
36,New York,8,Colorado,45,Garfield County,11,29,-18
36,New York,8,Colorado,51,Gunnison County,25,0,25
36,New York,8,Colorado,55,Huerfano County,13,75,-62
36,New York,8,Colorado,59,Jefferson County,270,451,-181
36,New York,8,Colorado,65,Lake County,0,148,-148
36,New York,8,Colorado,67,La Plata County,86,74,12
36,New York,8,Colorado,69,Larimer County,143,371,-228
36,New York,8,Colorado,77,Mesa County,58,24,34
36,New York,8,Colorado,83,Montezuma County,52,60,-8
36,New York,8,Colorado,85,Montrose County,0,22,-22
36,New York,8,Colorado,87,Morgan County,0,46,-46
36,New York,8,Colorado,93,Park County,0,91,-91
36,New York,8,Colorado,97,Pitkin County,0,72,-72
36,New York,8,Colorado,99,Prowers County,0,45,-45
36,New York,8,Colorado,101,Pueblo County,6,80,-74
36,New York,8,Colorado,105,Rio Grande County,0,13,-13
36,New York,8,Colorado,107,Routt County,18,58,-40
36,New York,8,Colorado,113,San Miguel County,0,32,-32
36,New York,8,Colorado,117,Summit County,53,78,-25
36,New York,8,Colorado,123,Weld County,58,68,-10
36,New York,9,Connecticut,1,Fairfield County,7408,12138,-4730
36,New York,9,Connecticut,3,Hartford County,2278,3422,-1144
36,New York,9,Connecticut,5,Litchfield County,608,913,-305
36,New York,9,Connecticut,7,Middlesex County,457,703,-246
36,New York,9,Connecticut,9,New Haven County,2809,3905,-1096
36,New York,9,Connecticut,11,New London County,681,1079,-398
36,New York,9,Connecticut,13,Tolland County,226,478,-252
36,New York,9,Connecticut,15,Windham County,91,152,-61
36,New York,AFR,Africa,,-,6808,0,0
36,New York,ASI,Asia,,-,62348,0,0
36,New York,CAM,Central America,,-,7376,0,0
36,New York,CAR,Caribbean,,-,21179,0,0
36,New York,EUR,Europe,,-,29388,0,0
36,New York,ISL,U.S. Island Areas,,-,441,0,0
36,New York,NAM,Northern America,,-,4975,0,0
36,New York,OCE,Oceania and At Sea,,-,2918,0,0
36,New York,SAM,South America,,-,13098,0,0
37,North Carolina,1,Alabama,1,Autauga County,122,5,117
37,North Carolina,1,Alabama,3,Baldwin County,219,185,34
37,North Carolina,1,Alabama,5,Barbour County,54,0,54
37,North Carolina,1,Alabama,7,Bibb County,0,8,-8
37,North Carolina,1,Alabama,9,Blount County,37,0,37
37,North Carolina,1,Alabama,13,Butler County,32,9,23
37,North Carolina,1,Alabama,15,Calhoun County,39,106,-67
37,North Carolina,1,Alabama,17,Chambers County,0,7,-7
37,North Carolina,1,Alabama,19,Cherokee County,0,10,-10
37,North Carolina,1,Alabama,21,Chilton County,21,5,16
37,North Carolina,1,Alabama,31,Coffee County,117,112,5
37,North Carolina,1,Alabama,33,Colbert County,112,10,102
37,North Carolina,1,Alabama,39,Covington County,13,6,7
37,North Carolina,1,Alabama,41,Crenshaw County,0,1,-1
37,North Carolina,1,Alabama,43,Cullman County,169,7,162
37,North Carolina,1,Alabama,45,Dale County,327,213,114
37,North Carolina,1,Alabama,49,DeKalb County,0,56,-56
37,North Carolina,1,Alabama,51,Elmore County,26,79,-53
37,North Carolina,1,Alabama,55,Etowah County,0,58,-58
37,North Carolina,1,Alabama,61,Geneva County,25,0,25
37,North Carolina,1,Alabama,65,Hale County,5,0,5
37,North Carolina,1,Alabama,67,Henry County,3,0,3
37,North Carolina,1,Alabama,69,Houston County,58,86,-28
37,North Carolina,1,Alabama,73,Jefferson County,394,569,-175
37,North Carolina,1,Alabama,77,Lauderdale County,0,72,-72
37,North Carolina,1,Alabama,79,Lawrence County,6,21,-15
37,North Carolina,1,Alabama,81,Lee County,385,345,40
37,North Carolina,1,Alabama,83,Limestone County,64,0,64
37,North Carolina,1,Alabama,87,Macon County,0,6,-6
37,North Carolina,1,Alabama,89,Madison County,528,148,380
37,North Carolina,1,Alabama,93,Marion County,0,55,-55
37,North Carolina,1,Alabama,95,Marshall County,0,7,-7
37,North Carolina,1,Alabama,97,Mobile County,304,510,-206
37,North Carolina,1,Alabama,99,Monroe County,0,30,-30
37,North Carolina,1,Alabama,101,Montgomery County,77,253,-176
37,North Carolina,1,Alabama,103,Morgan County,15,78,-63
37,North Carolina,1,Alabama,105,Perry County,33,8,25
37,North Carolina,1,Alabama,107,Pickens County,0,9,-9
37,North Carolina,1,Alabama,109,Pike County,12,20,-8
37,North Carolina,1,Alabama,111,Randolph County,0,17,-17
37,North Carolina,1,Alabama,113,Russell County,162,460,-298
37,North Carolina,1,Alabama,115,St. Clair County,11,0,11
37,North Carolina,1,Alabama,117,Shelby County,253,294,-41
37,North Carolina,1,Alabama,121,Talladega County,0,35,-35
37,North Carolina,1,Alabama,123,Tallapoosa County,51,18,33
37,North Carolina,1,Alabama,125,Tuscaloosa County,190,343,-153
37,North Carolina,1,Alabama,127,Walker County,9,58,-49
37,North Carolina,1,Alabama,133,Winston County,9,0,9
37,North Carolina,10,Delaware,1,Kent County,204,265,-61
37,North Carolina,10,Delaware,3,New Castle County,773,330,443
37,North Carolina,10,Delaware,5,Sussex County,258,341,-83
37,North Carolina,11,District of Columbia,1,District of Columbia,2125,1570,555
37,North Carolina,12,Florida,1,Alachua County,700,691,9
37,North Carolina,12,Florida,3,Baker County,0,22,-22
37,North Carolina,12,Florida,5,Bay County,371,321,50
37,North Carolina,12,Florida,7,Bradford County,64,26,38
37,North Carolina,12,Florida,9,Brevard County,719,978,-259
37,North Carolina,12,Florida,11,Broward County,1728,1823,-95
37,North Carolina,12,Florida,15,Charlotte County,278,195,83
37,North Carolina,12,Florida,17,Citrus County,279,287,-8
37,North Carolina,12,Florida,19,Clay County,414,276,138
37,North Carolina,12,Florida,21,Collier County,739,790,-51
37,North Carolina,12,Florida,23,Columbia County,78,147,-69
37,North Carolina,12,Florida,27,DeSoto County,16,34,-18
37,North Carolina,12,Florida,29,Dixie County,0,77,-77
37,North Carolina,12,Florida,31,Duval County,1442,1464,-22
37,North Carolina,12,Florida,33,Escambia County,977,1356,-379
37,North Carolina,12,Florida,35,Flagler County,221,216,5
37,North Carolina,12,Florida,39,Gadsden County,62,7,55
37,North Carolina,12,Florida,41,Gilchrist County,8,4,4
37,North Carolina,12,Florida,43,Glades County,0,162,-162
37,North Carolina,12,Florida,45,Gulf County,6,0,6
37,North Carolina,12,Florida,47,Hamilton County,19,0,19
37,North Carolina,12,Florida,49,Hardee County,10,20,-10
37,North Carolina,12,Florida,51,Hendry County,0,66,-66
37,North Carolina,12,Florida,53,Hernando County,340,88,252
37,North Carolina,12,Florida,55,Highlands County,258,136,122
37,North Carolina,12,Florida,57,Hillsborough County,2461,1839,622
37,North Carolina,12,Florida,59,Holmes County,5,15,-10
37,North Carolina,12,Florida,61,Indian River County,285,144,141
37,North Carolina,12,Florida,63,Jackson County,48,28,20
37,North Carolina,12,Florida,65,Jefferson County,0,14,-14
37,North Carolina,12,Florida,69,Lake County,496,273,223
37,North Carolina,12,Florida,71,Lee County,841,654,187
37,North Carolina,12,Florida,73,Leon County,457,548,-91
37,North Carolina,12,Florida,75,Levy County,29,53,-24
37,North Carolina,12,Florida,81,Manatee County,383,899,-516
37,North Carolina,12,Florida,83,Marion County,302,625,-323
37,North Carolina,12,Florida,85,Martin County,349,180,169
37,North Carolina,12,Florida,86,Miami-Dade County,1638,1254,384
37,North Carolina,12,Florida,87,Monroe County,106,175,-69
37,North Carolina,12,Florida,89,Nassau County,3,109,-106
37,North Carolina,12,Florida,91,Okaloosa County,649,629,20
37,North Carolina,12,Florida,93,Okeechobee County,28,100,-72
37,North Carolina,12,Florida,95,Orange County,1953,2013,-60
37,North Carolina,12,Florida,97,Osceola County,196,91,105
37,North Carolina,12,Florida,99,Palm Beach County,2412,867,1545
37,North Carolina,12,Florida,101,Pasco County,954,363,591
37,North Carolina,12,Florida,103,Pinellas County,1582,1354,228
37,North Carolina,12,Florida,105,Polk County,853,695,158
37,North Carolina,12,Florida,107,Putnam County,0,75,-75
37,North Carolina,12,Florida,109,St. Johns County,497,439,58
37,North Carolina,12,Florida,111,St. Lucie County,573,616,-43
37,North Carolina,12,Florida,113,Santa Rosa County,253,571,-318
37,North Carolina,12,Florida,115,Sarasota County,719,353,366
37,North Carolina,12,Florida,117,Seminole County,684,471,213
37,North Carolina,12,Florida,119,Sumter County,1,249,-248
37,North Carolina,12,Florida,121,Suwannee County,5,0,5
37,North Carolina,12,Florida,125,Union County,0,45,-45
37,North Carolina,12,Florida,127,Volusia County,644,1149,-505
37,North Carolina,12,Florida,129,Wakulla County,45,24,21
37,North Carolina,12,Florida,131,Walton County,33,37,-4
37,North Carolina,13,Georgia,1,Appling County,28,6,22
37,North Carolina,13,Georgia,5,Bacon County,7,0,7
37,North Carolina,13,Georgia,7,Baker County,0,9,-9
37,North Carolina,13,Georgia,9,Baldwin County,31,0,31
37,North Carolina,13,Georgia,11,Banks County,24,0,24
37,North Carolina,13,Georgia,13,Barrow County,193,18,175
37,North Carolina,13,Georgia,15,Bartow County,146,5,141
37,North Carolina,13,Georgia,17,Ben Hill County,0,35,-35
37,North Carolina,13,Georgia,21,Bibb County,296,13,283
37,North Carolina,13,Georgia,23,Bleckley County,8,0,8
37,North Carolina,13,Georgia,25,Brantley County,3,6,-3
37,North Carolina,13,Georgia,29,Bryan County,17,176,-159
37,North Carolina,13,Georgia,31,Bulloch County,35,75,-40
37,North Carolina,13,Georgia,33,Burke County,8,0,8
37,North Carolina,13,Georgia,35,Butts County,53,0,53
37,North Carolina,13,Georgia,39,Camden County,145,131,14
37,North Carolina,13,Georgia,43,Candler County,71,70,1
37,North Carolina,13,Georgia,45,Carroll County,51,260,-209
37,North Carolina,13,Georgia,47,Catoosa County,33,1,32
37,North Carolina,13,Georgia,49,Charlton County,0,10,-10
37,North Carolina,13,Georgia,51,Chatham County,1005,1220,-215
37,North Carolina,13,Georgia,53,Chattahoochee County,812,159,653
37,North Carolina,13,Georgia,57,Cherokee County,489,216,273
37,North Carolina,13,Georgia,59,Clarke County,312,355,-43
37,North Carolina,13,Georgia,63,Clayton County,596,557,39
37,North Carolina,13,Georgia,67,Cobb County,1159,1291,-132
37,North Carolina,13,Georgia,69,Coffee County,0,16,-16
37,North Carolina,13,Georgia,71,Colquitt County,26,403,-377
37,North Carolina,13,Georgia,73,Columbia County,156,536,-380
37,North Carolina,13,Georgia,75,Cook County,35,0,35
37,North Carolina,13,Georgia,77,Coweta County,117,150,-33
37,North Carolina,13,Georgia,81,Crisp County,0,4,-4
37,North Carolina,13,Georgia,83,Dade County,31,39,-8
37,North Carolina,13,Georgia,85,Dawson County,257,0,257
37,North Carolina,13,Georgia,89,DeKalb County,1647,1512,135
37,North Carolina,13,Georgia,93,Dooly County,0,7,-7
37,North Carolina,13,Georgia,95,Dougherty County,278,59,219
37,North Carolina,13,Georgia,97,Douglas County,112,13,99
37,North Carolina,13,Georgia,103,Effingham County,148,55,93
37,North Carolina,13,Georgia,105,Elbert County,20,7,13
37,North Carolina,13,Georgia,107,Emanuel County,11,21,-10
37,North Carolina,13,Georgia,109,Evans County,31,0,31
37,North Carolina,13,Georgia,111,Fannin County,118,37,81
37,North Carolina,13,Georgia,113,Fayette County,159,251,-92
37,North Carolina,13,Georgia,115,Floyd County,78,261,-183
37,North Carolina,13,Georgia,117,Forsyth County,74,281,-207
37,North Carolina,13,Georgia,119,Franklin County,137,51,86
37,North Carolina,13,Georgia,121,Fulton County,2169,1835,334
37,North Carolina,13,Georgia,123,Gilmer County,44,235,-191
37,North Carolina,13,Georgia,125,Glascock County,38,0,38
37,North Carolina,13,Georgia,127,Glynn County,31,112,-81
37,North Carolina,13,Georgia,129,Gordon County,32,75,-43
37,North Carolina,13,Georgia,131,Grady County,0,44,-44
37,North Carolina,13,Georgia,133,Greene County,18,0,18
37,North Carolina,13,Georgia,135,Gwinnett County,1598,1114,484
37,North Carolina,13,Georgia,137,Habersham County,123,136,-13
37,North Carolina,13,Georgia,139,Hall County,480,146,334
37,North Carolina,13,Georgia,141,Hancock County,18,0,18
37,North Carolina,13,Georgia,143,Haralson County,3,73,-70
37,North Carolina,13,Georgia,145,Harris County,29,12,17
37,North Carolina,13,Georgia,147,Hart County,14,55,-41
37,North Carolina,13,Georgia,151,Henry County,358,318,40
37,North Carolina,13,Georgia,153,Houston County,74,75,-1
37,North Carolina,13,Georgia,155,Irwin County,0,26,-26
37,North Carolina,13,Georgia,157,Jackson County,94,40,54
37,North Carolina,13,Georgia,159,Jasper County,0,10,-10
37,North Carolina,13,Georgia,163,Jefferson County,119,14,105
37,North Carolina,13,Georgia,167,Johnson County,21,0,21
37,North Carolina,13,Georgia,173,Lanier County,12,5,7
37,North Carolina,13,Georgia,175,Laurens County,43,38,5
37,North Carolina,13,Georgia,177,Lee County,47,65,-18
37,North Carolina,13,Georgia,179,Liberty County,1051,547,504
37,North Carolina,13,Georgia,181,Lincoln County,9,11,-2
37,North Carolina,13,Georgia,183,Long County,38,72,-34
37,North Carolina,13,Georgia,185,Lowndes County,40,152,-112
37,North Carolina,13,Georgia,187,Lumpkin County,156,53,103
37,North Carolina,13,Georgia,189,McDuffie County,0,192,-192
37,North Carolina,13,Georgia,191,McIntosh County,4,16,-12
37,North Carolina,13,Georgia,193,Macon County,20,0,20
37,North Carolina,13,Georgia,195,Madison County,0,34,-34
37,North Carolina,13,Georgia,199,Meriwether County,0,1,-1
37,North Carolina,13,Georgia,205,Mitchell County,7,138,-131
37,North Carolina,13,Georgia,207,Monroe County,7,0,7
37,North Carolina,13,Georgia,213,Murray County,67,37,30
37,North Carolina,13,Georgia,215,Muscogee County,568,269,299
37,North Carolina,13,Georgia,217,Newton County,112,97,15
37,North Carolina,13,Georgia,219,Oconee County,20,53,-33
37,North Carolina,13,Georgia,221,Oglethorpe County,31,0,31
37,North Carolina,13,Georgia,223,Paulding County,149,124,25
37,North Carolina,13,Georgia,225,Peach County,46,4,42
37,North Carolina,13,Georgia,229,Pierce County,0,48,-48
37,North Carolina,13,Georgia,231,Pike County,74,4,70
37,North Carolina,13,Georgia,239,Quitman County,18,0,18
37,North Carolina,13,Georgia,241,Rabun County,172,89,83
37,North Carolina,13,Georgia,243,Randolph County,35,6,29
37,North Carolina,13,Georgia,245,Richmond County,819,309,510
37,North Carolina,13,Georgia,247,Rockdale County,63,279,-216
37,North Carolina,13,Georgia,253,Seminole County,63,0,63
37,North Carolina,13,Georgia,255,Spalding County,176,0,176
37,North Carolina,13,Georgia,257,Stephens County,31,69,-38
37,North Carolina,13,Georgia,259,Stewart County,0,149,-149
37,North Carolina,13,Georgia,261,Sumter County,6,51,-45
37,North Carolina,13,Georgia,263,Talbot County,27,0,27
37,North Carolina,13,Georgia,267,Tattnall County,0,73,-73
37,North Carolina,13,Georgia,273,Terrell County,0,9,-9
37,North Carolina,13,Georgia,275,Thomas County,180,0,180
37,North Carolina,13,Georgia,277,Tift County,199,10,189
37,North Carolina,13,Georgia,279,Toombs County,43,2,41
37,North Carolina,13,Georgia,281,Towns County,110,168,-58
37,North Carolina,13,Georgia,285,Troup County,8,34,-26
37,North Carolina,13,Georgia,291,Union County,77,118,-41
37,North Carolina,13,Georgia,295,Walker County,11,12,-1
37,North Carolina,13,Georgia,297,Walton County,147,21,126
37,North Carolina,13,Georgia,299,Ware County,0,94,-94
37,North Carolina,13,Georgia,303,Washington County,74,0,74
37,North Carolina,13,Georgia,305,Wayne County,55,0,55
37,North Carolina,13,Georgia,309,Wheeler County,19,0,19
37,North Carolina,13,Georgia,311,White County,13,23,-10
37,North Carolina,13,Georgia,313,Whitfield County,0,16,-16
37,North Carolina,13,Georgia,315,Wilcox County,103,0,103
37,North Carolina,13,Georgia,317,Wilkes County,60,0,60
37,North Carolina,13,Georgia,319,Wilkinson County,23,0,23
37,North Carolina,13,Georgia,321,Worth County,31,0,31
37,North Carolina,15,Hawaii,1,Hawaii County,39,39,0
37,North Carolina,15,Hawaii,3,Honolulu County,1895,1860,35
37,North Carolina,15,Hawaii,9,Maui County,26,76,-50
37,North Carolina,16,Idaho,1,Ada County,37,204,-167
37,North Carolina,16,Idaho,3,Adams County,0,6,-6
37,North Carolina,16,Idaho,5,Bannock County,0,50,-50
37,North Carolina,16,Idaho,13,Blaine County,0,7,-7
37,North Carolina,16,Idaho,17,Bonner County,0,10,-10
37,North Carolina,16,Idaho,19,Bonneville County,84,25,59
37,North Carolina,16,Idaho,27,Canyon County,302,246,56
37,North Carolina,16,Idaho,31,Cassia County,0,6,-6
37,North Carolina,16,Idaho,39,Elmore County,31,101,-70
37,North Carolina,16,Idaho,47,Gooding County,0,7,-7
37,North Carolina,16,Idaho,49,Idaho County,0,11,-11
37,North Carolina,16,Idaho,55,Kootenai County,0,50,-50
37,North Carolina,16,Idaho,57,Latah County,0,10,-10
37,North Carolina,16,Idaho,59,Lemhi County,3,0,3
37,North Carolina,16,Idaho,65,Madison County,53,72,-19
37,North Carolina,16,Idaho,69,Nez Perce County,0,13,-13
37,North Carolina,16,Idaho,73,Owyhee County,0,30,-30
37,North Carolina,16,Idaho,75,Payette County,85,0,85
37,North Carolina,16,Idaho,79,Shoshone County,0,32,-32
37,North Carolina,16,Idaho,81,Teton County,28,0,28
37,North Carolina,16,Idaho,83,Twin Falls County,20,19,1
37,North Carolina,17,Illinois,1,Adams County,0,2,-2
37,North Carolina,17,Illinois,5,Bond County,34,0,34
37,North Carolina,17,Illinois,7,Boone County,42,0,42
37,North Carolina,17,Illinois,11,Bureau County,53,2,51
37,North Carolina,17,Illinois,17,Cass County,0,3,-3
37,North Carolina,17,Illinois,19,Champaign County,219,133,86
37,North Carolina,17,Illinois,21,Christian County,0,13,-13
37,North Carolina,17,Illinois,27,Clinton County,19,23,-4
37,North Carolina,17,Illinois,31,Cook County,2701,2117,584
37,North Carolina,17,Illinois,37,DeKalb County,77,0,77
37,North Carolina,17,Illinois,41,Douglas County,0,3,-3
37,North Carolina,17,Illinois,43,DuPage County,764,289,475
37,North Carolina,17,Illinois,49,Effingham County,119,6,113
37,North Carolina,17,Illinois,51,Fayette County,0,14,-14
37,North Carolina,17,Illinois,55,Franklin County,0,50,-50
37,North Carolina,17,Illinois,57,Fulton County,0,24,-24
37,North Carolina,17,Illinois,65,Hamilton County,16,0,16
37,North Carolina,17,Illinois,71,Henderson County,0,5,-5
37,North Carolina,17,Illinois,73,Henry County,67,20,47
37,North Carolina,17,Illinois,77,Jackson County,103,53,50
37,North Carolina,17,Illinois,83,Jersey County,12,0,12
37,North Carolina,17,Illinois,85,Jo Daviess County,0,12,-12
37,North Carolina,17,Illinois,87,Johnson County,22,16,6
37,North Carolina,17,Illinois,89,Kane County,230,295,-65
37,North Carolina,17,Illinois,91,Kankakee County,100,0,100
37,North Carolina,17,Illinois,93,Kendall County,6,0,6
37,North Carolina,17,Illinois,95,Knox County,0,4,-4
37,North Carolina,17,Illinois,97,Lake County,594,788,-194
37,North Carolina,17,Illinois,99,LaSalle County,43,36,7
37,North Carolina,17,Illinois,103,Lee County,17,18,-1
37,North Carolina,17,Illinois,105,Livingston County,0,8,-8
37,North Carolina,17,Illinois,107,Logan County,0,23,-23
37,North Carolina,17,Illinois,111,McHenry County,169,107,62
37,North Carolina,17,Illinois,113,McLean County,252,9,243
37,North Carolina,17,Illinois,115,Macon County,90,34,56
37,North Carolina,17,Illinois,117,Macoupin County,0,4,-4
37,North Carolina,17,Illinois,119,Madison County,153,180,-27
37,North Carolina,17,Illinois,121,Marion County,13,42,-29
37,North Carolina,17,Illinois,123,Marshall County,0,7,-7
37,North Carolina,17,Illinois,127,Massac County,0,8,-8
37,North Carolina,17,Illinois,129,Menard County,0,8,-8
37,North Carolina,17,Illinois,131,Mercer County,0,25,-25
37,North Carolina,17,Illinois,135,Montgomery County,0,10,-10
37,North Carolina,17,Illinois,137,Morgan County,0,2,-2
37,North Carolina,17,Illinois,141,Ogle County,49,0,49
37,North Carolina,17,Illinois,143,Peoria County,36,43,-7
37,North Carolina,17,Illinois,147,Piatt County,20,0,20
37,North Carolina,17,Illinois,161,Rock Island County,24,82,-58
37,North Carolina,17,Illinois,163,St. Clair County,332,91,241
37,North Carolina,17,Illinois,167,Sangamon County,98,40,58
37,North Carolina,17,Illinois,177,Stephenson County,95,0,95
37,North Carolina,17,Illinois,179,Tazewell County,256,46,210
37,North Carolina,17,Illinois,191,Wayne County,7,0,7
37,North Carolina,17,Illinois,193,White County,0,3,-3
37,North Carolina,17,Illinois,197,Will County,348,72,276
37,North Carolina,17,Illinois,199,Williamson County,32,0,32
37,North Carolina,17,Illinois,201,Winnebago County,62,138,-76
37,North Carolina,17,Illinois,203,Woodford County,0,22,-22
37,North Carolina,18,Indiana,1,Adams County,16,38,-22
37,North Carolina,18,Indiana,3,Allen County,162,96,66
37,North Carolina,18,Indiana,5,Bartholomew County,16,17,-1
37,North Carolina,18,Indiana,7,Benton County,0,6,-6
37,North Carolina,18,Indiana,9,Blackford County,15,7,8
37,North Carolina,18,Indiana,11,Boone County,69,164,-95
37,North Carolina,18,Indiana,13,Brown County,0,126,-126
37,North Carolina,18,Indiana,17,Cass County,0,14,-14
37,North Carolina,18,Indiana,19,Clark County,56,73,-17
37,North Carolina,18,Indiana,21,Clay County,0,7,-7
37,North Carolina,18,Indiana,23,Clinton County,9,17,-8
37,North Carolina,18,Indiana,25,Crawford County,0,25,-25
37,North Carolina,18,Indiana,27,Daviess County,21,0,21
37,North Carolina,18,Indiana,35,Delaware County,0,39,-39
37,North Carolina,18,Indiana,37,Dubois County,52,0,52
37,North Carolina,18,Indiana,39,Elkhart County,264,50,214
37,North Carolina,18,Indiana,41,Fayette County,1,0,1
37,North Carolina,18,Indiana,43,Floyd County,77,8,69
37,North Carolina,18,Indiana,49,Fulton County,0,27,-27
37,North Carolina,18,Indiana,51,Gibson County,0,5,-5
37,North Carolina,18,Indiana,53,Grant County,86,0,86
37,North Carolina,18,Indiana,55,Greene County,0,39,-39
37,North Carolina,18,Indiana,57,Hamilton County,310,482,-172
37,North Carolina,18,Indiana,61,Harrison County,3,3,0
37,North Carolina,18,Indiana,63,Hendricks County,80,164,-84
37,North Carolina,18,Indiana,65,Henry County,12,0,12
37,North Carolina,18,Indiana,67,Howard County,9,22,-13
37,North Carolina,18,Indiana,75,Jay County,0,19,-19
37,North Carolina,18,Indiana,77,Jefferson County,0,24,-24
37,North Carolina,18,Indiana,79,Jennings County,22,99,-77
37,North Carolina,18,Indiana,81,Johnson County,235,196,39
37,North Carolina,18,Indiana,85,Kosciusko County,26,0,26
37,North Carolina,18,Indiana,87,LaGrange County,0,11,-11
37,North Carolina,18,Indiana,89,Lake County,290,48,242
37,North Carolina,18,Indiana,91,LaPorte County,3,26,-23
37,North Carolina,18,Indiana,95,Madison County,123,105,18
37,North Carolina,18,Indiana,97,Marion County,944,442,502
37,North Carolina,18,Indiana,99,Marshall County,0,31,-31
37,North Carolina,18,Indiana,103,Miami County,34,29,5
37,North Carolina,18,Indiana,105,Monroe County,107,197,-90
37,North Carolina,18,Indiana,107,Montgomery County,0,9,-9
37,North Carolina,18,Indiana,109,Morgan County,12,0,12
37,North Carolina,18,Indiana,115,Ohio County,31,0,31
37,North Carolina,18,Indiana,119,Owen County,28,5,23
37,North Carolina,18,Indiana,121,Parke County,0,72,-72
37,North Carolina,18,Indiana,123,Perry County,0,30,-30
37,North Carolina,18,Indiana,127,Porter County,111,0,111
37,North Carolina,18,Indiana,129,Posey County,4,0,4
37,North Carolina,18,Indiana,133,Putnam County,0,24,-24
37,North Carolina,18,Indiana,135,Randolph County,0,8,-8
37,North Carolina,18,Indiana,137,Ripley County,4,0,4
37,North Carolina,18,Indiana,141,St. Joseph County,119,55,64
37,North Carolina,18,Indiana,143,Scott County,0,22,-22
37,North Carolina,18,Indiana,145,Shelby County,0,42,-42
37,North Carolina,18,Indiana,149,Starke County,0,13,-13
37,North Carolina,18,Indiana,151,Steuben County,0,7,-7
37,North Carolina,18,Indiana,157,Tippecanoe County,11,36,-25
37,North Carolina,18,Indiana,163,Vanderburgh County,31,480,-449
37,North Carolina,18,Indiana,167,Vigo County,14,68,-54
37,North Carolina,18,Indiana,169,Wabash County,45,29,16
37,North Carolina,18,Indiana,173,Warrick County,0,28,-28
37,North Carolina,18,Indiana,177,Wayne County,62,40,22
37,North Carolina,18,Indiana,179,Wells County,0,24,-24
37,North Carolina,18,Indiana,181,White County,0,4,-4
37,North Carolina,19,Iowa,9,Audubon County,4,0,4
37,North Carolina,19,Iowa,13,Black Hawk County,97,149,-52
37,North Carolina,19,Iowa,19,Buchanan County,0,32,-32
37,North Carolina,19,Iowa,21,Buena Vista County,65,0,65
37,North Carolina,19,Iowa,33,Cerro Gordo County,0,10,-10
37,North Carolina,19,Iowa,41,Clay County,0,41,-41
37,North Carolina,19,Iowa,43,Clayton County,0,9,-9
37,North Carolina,19,Iowa,45,Clinton County,26,0,26
37,North Carolina,19,Iowa,47,Crawford County,0,3,-3
37,North Carolina,19,Iowa,49,Dallas County,132,33,99
37,North Carolina,19,Iowa,53,Decatur County,0,5,-5
37,North Carolina,19,Iowa,57,Des Moines County,0,10,-10
37,North Carolina,19,Iowa,61,Dubuque County,0,34,-34
37,North Carolina,19,Iowa,65,Fayette County,11,0,11
37,North Carolina,19,Iowa,69,Franklin County,0,3,-3
37,North Carolina,19,Iowa,77,Guthrie County,5,0,5
37,North Carolina,19,Iowa,87,Henry County,69,3,66
37,North Carolina,19,Iowa,91,Humboldt County,0,3,-3
37,North Carolina,19,Iowa,99,Jasper County,0,2,-2
37,North Carolina,19,Iowa,101,Jefferson County,41,121,-80
37,North Carolina,19,Iowa,103,Johnson County,80,117,-37
37,North Carolina,19,Iowa,105,Jones County,0,2,-2
37,North Carolina,19,Iowa,111,Lee County,14,0,14
37,North Carolina,19,Iowa,113,Linn County,4,28,-24
37,North Carolina,19,Iowa,125,Marion County,0,47,-47
37,North Carolina,19,Iowa,127,Marshall County,9,43,-34
37,North Carolina,19,Iowa,131,Mitchell County,0,25,-25
37,North Carolina,19,Iowa,137,Montgomery County,0,14,-14
37,North Carolina,19,Iowa,139,Muscatine County,164,22,142
37,North Carolina,19,Iowa,143,Osceola County,4,0,4
37,North Carolina,19,Iowa,149,Plymouth County,0,32,-32
37,North Carolina,19,Iowa,153,Polk County,225,183,42
37,North Carolina,19,Iowa,155,Pottawattamie County,0,20,-20
37,North Carolina,19,Iowa,163,Scott County,223,56,167
37,North Carolina,19,Iowa,169,Story County,188,86,102
37,North Carolina,19,Iowa,171,Tama County,0,16,-16
37,North Carolina,19,Iowa,181,Warren County,0,3,-3
37,North Carolina,19,Iowa,183,Washington County,0,31,-31
37,North Carolina,19,Iowa,187,Webster County,33,40,-7
37,North Carolina,19,Iowa,193,Woodbury County,52,2,50
37,North Carolina,2,Alaska,13,Aleutians East Borough,0,1,-1
37,North Carolina,2,Alaska,20,Anchorage Municipality,1123,849,274
37,North Carolina,2,Alaska,50,Bethel Census Area,0,1,-1
37,North Carolina,2,Alaska,68,Denali Borough,0,2,-2
37,North Carolina,2,Alaska,90,Fairbanks North Star Borough,812,142,670
37,North Carolina,2,Alaska,105,Hoonah-Angoon Census Area,120,0,120
37,North Carolina,2,Alaska,110,Juneau City and Borough,12,4,8
37,North Carolina,2,Alaska,130,Ketchikan Gateway Borough,16,33,-17
37,North Carolina,2,Alaska,150,Kodiak Island Borough,50,30,20
37,North Carolina,2,Alaska,170,Matanuska-Susitna Borough,65,127,-62
37,North Carolina,2,Alaska,180,Nome Census Area,0,26,-26
37,North Carolina,2,Alaska,185,North Slope Borough,0,8,-8
37,North Carolina,2,Alaska,195,Petersburg Borough,14,0,14
37,North Carolina,2,Alaska,198,Prince of Wales-Hyder Census Area,58,0,58
37,North Carolina,2,Alaska,220,Sitka City and Borough,0,27,-27
37,North Carolina,2,Alaska,261,Valdez-Cordova Census Area,0,5,-5
37,North Carolina,2,Alaska,275,Wrangell City and Borough,0,10,-10
37,North Carolina,2,Alaska,282,Yakutat City and Borough,0,1,-1
37,North Carolina,20,Kansas,5,Atchison County,14,12,2
37,North Carolina,20,Kansas,9,Barton County,0,3,-3
37,North Carolina,20,Kansas,11,Bourbon County,0,36,-36
37,North Carolina,20,Kansas,15,Butler County,4,131,-127
37,North Carolina,20,Kansas,25,Clark County,0,30,-30
37,North Carolina,20,Kansas,29,Cloud County,0,25,-25
37,North Carolina,20,Kansas,35,Cowley County,20,17,3
37,North Carolina,20,Kansas,37,Crawford County,36,9,27
37,North Carolina,20,Kansas,41,Dickinson County,0,8,-8
37,North Carolina,20,Kansas,45,Douglas County,222,75,147
37,North Carolina,20,Kansas,55,Finney County,0,5,-5
37,North Carolina,20,Kansas,57,Ford County,0,48,-48
37,North Carolina,20,Kansas,61,Geary County,323,215,108
37,North Carolina,20,Kansas,63,Gove County,0,3,-3
37,North Carolina,20,Kansas,81,Haskell County,0,22,-22
37,North Carolina,20,Kansas,87,Jefferson County,0,22,-22
37,North Carolina,20,Kansas,91,Johnson County,288,226,62
37,North Carolina,20,Kansas,95,Kingman County,0,2,-2
37,North Carolina,20,Kansas,103,Leavenworth County,511,252,259
37,North Carolina,20,Kansas,111,Lyon County,26,0,26
37,North Carolina,20,Kansas,113,McPherson County,11,0,11
37,North Carolina,20,Kansas,117,Marshall County,0,3,-3
37,North Carolina,20,Kansas,121,Miami County,10,0,10
37,North Carolina,20,Kansas,125,Montgomery County,20,0,20
37,North Carolina,20,Kansas,127,Morris County,0,25,-25
37,North Carolina,20,Kansas,131,Nemaha County,0,13,-13
37,North Carolina,20,Kansas,137,Norton County,8,3,5
37,North Carolina,20,Kansas,143,Ottawa County,0,24,-24
37,North Carolina,20,Kansas,155,Reno County,0,10,-10
37,North Carolina,20,Kansas,161,Riley County,190,84,106
37,North Carolina,20,Kansas,173,Sedgwick County,199,338,-139
37,North Carolina,20,Kansas,177,Shawnee County,0,94,-94
37,North Carolina,20,Kansas,183,Smith County,0,5,-5
37,North Carolina,20,Kansas,187,Stanton County,16,0,16
37,North Carolina,20,Kansas,197,Wabaunsee County,0,4,-4
37,North Carolina,20,Kansas,201,Washington County,0,3,-3
37,North Carolina,20,Kansas,209,Wyandotte County,58,57,1
37,North Carolina,21,Kentucky,1,Adair County,103,35,68
37,North Carolina,21,Kentucky,3,Allen County,9,24,-15
37,North Carolina,21,Kentucky,5,Anderson County,0,17,-17
37,North Carolina,21,Kentucky,9,Barren County,13,34,-21
37,North Carolina,21,Kentucky,11,Bath County,2,0,2
37,North Carolina,21,Kentucky,13,Bell County,23,10,13
37,North Carolina,21,Kentucky,15,Boone County,132,9,123
37,North Carolina,21,Kentucky,17,Bourbon County,66,0,66
37,North Carolina,21,Kentucky,19,Boyd County,53,0,53
37,North Carolina,21,Kentucky,21,Boyle County,55,136,-81
37,North Carolina,21,Kentucky,23,Bracken County,145,0,145
37,North Carolina,21,Kentucky,25,Breathitt County,0,13,-13
37,North Carolina,21,Kentucky,35,Calloway County,19,34,-15
37,North Carolina,21,Kentucky,37,Campbell County,6,0,6
37,North Carolina,21,Kentucky,39,Carlisle County,0,11,-11
37,North Carolina,21,Kentucky,43,Carter County,0,53,-53
37,North Carolina,21,Kentucky,45,Casey County,0,27,-27
37,North Carolina,21,Kentucky,47,Christian County,424,612,-188
37,North Carolina,21,Kentucky,49,Clark County,23,0,23
37,North Carolina,21,Kentucky,51,Clay County,5,15,-10
37,North Carolina,21,Kentucky,59,Daviess County,0,1,-1
37,North Carolina,21,Kentucky,61,Edmonson County,0,8,-8
37,North Carolina,21,Kentucky,67,Fayette County,436,325,111
37,North Carolina,21,Kentucky,71,Floyd County,0,25,-25
37,North Carolina,21,Kentucky,73,Franklin County,89,74,15
37,North Carolina,21,Kentucky,75,Fulton County,75,0,75
37,North Carolina,21,Kentucky,81,Grant County,10,0,10
37,North Carolina,21,Kentucky,87,Green County,37,0,37
37,North Carolina,21,Kentucky,89,Greenup County,0,27,-27
37,North Carolina,21,Kentucky,93,Hardin County,51,340,-289
37,North Carolina,21,Kentucky,95,Harlan County,0,6,-6
37,North Carolina,21,Kentucky,103,Henry County,0,12,-12
37,North Carolina,21,Kentucky,107,Hopkins County,0,20,-20
37,North Carolina,21,Kentucky,111,Jefferson County,441,456,-15
37,North Carolina,21,Kentucky,113,Jessamine County,6,16,-10
37,North Carolina,21,Kentucky,115,Johnson County,0,4,-4
37,North Carolina,21,Kentucky,117,Kenton County,16,42,-26
37,North Carolina,21,Kentucky,119,Knott County,0,10,-10
37,North Carolina,21,Kentucky,123,Larue County,0,8,-8
37,North Carolina,21,Kentucky,125,Laurel County,26,0,26
37,North Carolina,21,Kentucky,127,Lawrence County,13,17,-4
37,North Carolina,21,Kentucky,133,Letcher County,23,18,5
37,North Carolina,21,Kentucky,141,Logan County,0,3,-3
37,North Carolina,21,Kentucky,143,Lyon County,5,0,5
37,North Carolina,21,Kentucky,145,McCracken County,0,47,-47
37,North Carolina,21,Kentucky,147,McCreary County,9,13,-4
37,North Carolina,21,Kentucky,149,McLean County,0,3,-3
37,North Carolina,21,Kentucky,151,Madison County,121,80,41
37,North Carolina,21,Kentucky,157,Marshall County,22,0,22
37,North Carolina,21,Kentucky,159,Martin County,18,9,9
37,North Carolina,21,Kentucky,161,Mason County,50,0,50
37,North Carolina,21,Kentucky,163,Meade County,52,16,36
37,North Carolina,21,Kentucky,165,Menifee County,43,0,43
37,North Carolina,21,Kentucky,175,Morgan County,14,0,14
37,North Carolina,21,Kentucky,177,Muhlenberg County,24,0,24
37,North Carolina,21,Kentucky,179,Nelson County,18,0,18
37,North Carolina,21,Kentucky,183,Ohio County,10,24,-14
37,North Carolina,21,Kentucky,185,Oldham County,41,5,36
37,North Carolina,21,Kentucky,193,Perry County,0,55,-55
37,North Carolina,21,Kentucky,195,Pike County,76,42,34
37,North Carolina,21,Kentucky,197,Powell County,0,1,-1
37,North Carolina,21,Kentucky,199,Pulaski County,32,0,32
37,North Carolina,21,Kentucky,205,Rowan County,0,64,-64
37,North Carolina,21,Kentucky,209,Scott County,14,25,-11
37,North Carolina,21,Kentucky,211,Shelby County,31,34,-3
37,North Carolina,21,Kentucky,217,Taylor County,19,0,19
37,North Carolina,21,Kentucky,219,Todd County,0,6,-6
37,North Carolina,21,Kentucky,221,Trigg County,0,7,-7
37,North Carolina,21,Kentucky,225,Union County,0,112,-112
37,North Carolina,21,Kentucky,227,Warren County,100,246,-146
37,North Carolina,21,Kentucky,229,Washington County,192,0,192
37,North Carolina,21,Kentucky,239,Woodford County,0,2,-2
37,North Carolina,22,Louisiana,3,Allen Parish,0,9,-9
37,North Carolina,22,Louisiana,5,Ascension Parish,40,28,12
37,North Carolina,22,Louisiana,11,Beauregard Parish,21,30,-9
37,North Carolina,22,Louisiana,15,Bossier Parish,96,24,72
37,North Carolina,22,Louisiana,17,Caddo Parish,186,77,109
37,North Carolina,22,Louisiana,19,Calcasieu Parish,0,105,-105
37,North Carolina,22,Louisiana,33,East Baton Rouge Parish,117,426,-309
37,North Carolina,22,Louisiana,35,East Carroll Parish,10,0,10
37,North Carolina,22,Louisiana,51,Jefferson Parish,305,172,133
37,North Carolina,22,Louisiana,53,Jefferson Davis Parish,0,4,-4
37,North Carolina,22,Louisiana,55,Lafayette Parish,10,173,-163
37,North Carolina,22,Louisiana,57,Lafourche Parish,97,0,97
37,North Carolina,22,Louisiana,61,Lincoln Parish,45,0,45
37,North Carolina,22,Louisiana,63,Livingston Parish,74,85,-11
37,North Carolina,22,Louisiana,65,Madison Parish,14,0,14
37,North Carolina,22,Louisiana,69,Natchitoches Parish,0,76,-76
37,North Carolina,22,Louisiana,71,Orleans Parish,328,277,51
37,North Carolina,22,Louisiana,73,Ouachita Parish,83,18,65
37,North Carolina,22,Louisiana,75,Plaquemines Parish,105,262,-157
37,North Carolina,22,Louisiana,77,Pointe Coupee Parish,18,0,18
37,North Carolina,22,Louisiana,79,Rapides Parish,65,5,60
37,North Carolina,22,Louisiana,89,St. Charles Parish,9,0,9
37,North Carolina,22,Louisiana,93,St. James Parish,11,0,11
37,North Carolina,22,Louisiana,97,St. Landry Parish,116,13,103
37,North Carolina,22,Louisiana,103,St. Tammany Parish,73,123,-50
37,North Carolina,22,Louisiana,105,Tangipahoa Parish,30,0,30
37,North Carolina,22,Louisiana,109,Terrebonne Parish,29,217,-188
37,North Carolina,22,Louisiana,115,Vernon Parish,127,406,-279
37,North Carolina,22,Louisiana,117,Washington Parish,45,106,-61
37,North Carolina,22,Louisiana,119,Webster Parish,38,0,38
37,North Carolina,22,Louisiana,121,West Baton Rouge Parish,0,43,-43
37,North Carolina,22,Louisiana,123,West Carroll Parish,11,0,11
37,North Carolina,23,Maine,1,Androscoggin County,98,46,52
37,North Carolina,23,Maine,3,Aroostook County,57,84,-27
37,North Carolina,23,Maine,5,Cumberland County,471,183,288
37,North Carolina,23,Maine,7,Franklin County,32,22,10
37,North Carolina,23,Maine,9,Hancock County,60,16,44
37,North Carolina,23,Maine,11,Kennebec County,89,118,-29
37,North Carolina,23,Maine,13,Knox County,26,32,-6
37,North Carolina,23,Maine,15,Lincoln County,59,36,23
37,North Carolina,23,Maine,17,Oxford County,13,4,9
37,North Carolina,23,Maine,19,Penobscot County,48,92,-44
37,North Carolina,23,Maine,21,Piscataquis County,0,9,-9
37,North Carolina,23,Maine,23,Sagadahoc County,24,30,-6
37,North Carolina,23,Maine,25,Somerset County,70,0,70
37,North Carolina,23,Maine,27,Waldo County,0,25,-25
37,North Carolina,23,Maine,29,Washington County,31,9,22
37,North Carolina,23,Maine,31,York County,246,92,154
37,North Carolina,24,Maryland,1,Allegany County,55,18,37
37,North Carolina,24,Maryland,3,Anne Arundel County,939,813,126
37,North Carolina,24,Maryland,5,Baltimore County,1066,776,290
37,North Carolina,24,Maryland,9,Calvert County,198,100,98
37,North Carolina,24,Maryland,11,Caroline County,89,0,89
37,North Carolina,24,Maryland,13,Carroll County,288,72,216
37,North Carolina,24,Maryland,15,Cecil County,58,47,11
37,North Carolina,24,Maryland,17,Charles County,531,219,312
37,North Carolina,24,Maryland,19,Dorchester County,39,0,39
37,North Carolina,24,Maryland,21,Frederick County,413,231,182
37,North Carolina,24,Maryland,23,Garrett County,54,0,54
37,North Carolina,24,Maryland,25,Harford County,399,435,-36
37,North Carolina,24,Maryland,27,Howard County,657,591,66
37,North Carolina,24,Maryland,29,Kent County,53,10,43
37,North Carolina,24,Maryland,31,Montgomery County,1939,1155,784
37,North Carolina,24,Maryland,33,Prince George's County,1331,1523,-192
37,North Carolina,24,Maryland,35,Queen Anne's County,30,41,-11
37,North Carolina,24,Maryland,37,St. Mary's County,435,508,-73
37,North Carolina,24,Maryland,39,Somerset County,109,25,84
37,North Carolina,24,Maryland,41,Talbot County,0,75,-75
37,North Carolina,24,Maryland,43,Washington County,58,181,-123
37,North Carolina,24,Maryland,45,Wicomico County,540,74,466
37,North Carolina,24,Maryland,47,Worcester County,110,35,75
37,North Carolina,24,Maryland,510,Baltimore city,988,825,163
37,North Carolina,25,Massachusetts,1,Barnstable County,121,126,-5
37,North Carolina,25,Massachusetts,3,Berkshire County,108,59,49
37,North Carolina,25,Massachusetts,5,Bristol County,172,71,101
37,North Carolina,25,Massachusetts,7,Dukes County,88,30,58
37,North Carolina,25,Massachusetts,9,Essex County,385,120,265
37,North Carolina,25,Massachusetts,11,Franklin County,7,35,-28
37,North Carolina,25,Massachusetts,13,Hampden County,878,420,458
37,North Carolina,25,Massachusetts,15,Hampshire County,51,72,-21
37,North Carolina,25,Massachusetts,17,Middlesex County,1669,839,830
37,North Carolina,25,Massachusetts,21,Norfolk County,916,356,560
37,North Carolina,25,Massachusetts,23,Plymouth County,216,230,-14
37,North Carolina,25,Massachusetts,25,Suffolk County,574,514,60
37,North Carolina,25,Massachusetts,27,Worcester County,616,309,307
37,North Carolina,26,Michigan,1,Alcona County,0,13,-13
37,North Carolina,26,Michigan,3,Alger County,8,0,8
37,North Carolina,26,Michigan,5,Allegan County,73,19,54
37,North Carolina,26,Michigan,7,Alpena County,16,17,-1
37,North Carolina,26,Michigan,11,Arenac County,29,0,29
37,North Carolina,26,Michigan,13,Baraga County,0,42,-42
37,North Carolina,26,Michigan,15,Barry County,25,0,25
37,North Carolina,26,Michigan,17,Bay County,91,0,91
37,North Carolina,26,Michigan,19,Benzie County,16,6,10
37,North Carolina,26,Michigan,21,Berrien County,41,251,-210
37,North Carolina,26,Michigan,23,Branch County,0,86,-86
37,North Carolina,26,Michigan,25,Calhoun County,7,146,-139
37,North Carolina,26,Michigan,27,Cass County,4,0,4
37,North Carolina,26,Michigan,29,Charlevoix County,0,60,-60
37,North Carolina,26,Michigan,33,Chippewa County,42,0,42
37,North Carolina,26,Michigan,35,Clare County,22,116,-94
37,North Carolina,26,Michigan,37,Clinton County,192,219,-27
37,North Carolina,26,Michigan,41,Delta County,0,18,-18
37,North Carolina,26,Michigan,45,Eaton County,0,28,-28
37,North Carolina,26,Michigan,47,Emmet County,8,22,-14
37,North Carolina,26,Michigan,49,Genesee County,279,97,182
37,North Carolina,26,Michigan,53,Gogebic County,0,5,-5
37,North Carolina,26,Michigan,55,Grand Traverse County,165,34,131
37,North Carolina,26,Michigan,57,Gratiot County,5,2,3
37,North Carolina,26,Michigan,59,Hillsdale County,24,24,0
37,North Carolina,26,Michigan,63,Huron County,42,3,39
37,North Carolina,26,Michigan,65,Ingham County,82,231,-149
37,North Carolina,26,Michigan,67,Ionia County,59,28,31
37,North Carolina,26,Michigan,69,Iosco County,0,135,-135
37,North Carolina,26,Michigan,73,Isabella County,14,94,-80
37,North Carolina,26,Michigan,75,Jackson County,163,44,119
37,North Carolina,26,Michigan,77,Kalamazoo County,173,106,67
37,North Carolina,26,Michigan,79,Kalkaska County,3,15,-12
37,North Carolina,26,Michigan,81,Kent County,432,145,287
37,North Carolina,26,Michigan,85,Lake County,55,0,55
37,North Carolina,26,Michigan,87,Lapeer County,71,68,3
37,North Carolina,26,Michigan,89,Leelanau County,0,7,-7
37,North Carolina,26,Michigan,91,Lenawee County,83,25,58
37,North Carolina,26,Michigan,93,Livingston County,16,78,-62
37,North Carolina,26,Michigan,97,Mackinac County,0,20,-20
37,North Carolina,26,Michigan,99,Macomb County,415,260,155
37,North Carolina,26,Michigan,101,Manistee County,0,41,-41
37,North Carolina,26,Michigan,103,Marquette County,21,23,-2
37,North Carolina,26,Michigan,107,Mecosta County,16,13,3
37,North Carolina,26,Michigan,111,Midland County,91,105,-14
37,North Carolina,26,Michigan,113,Missaukee County,18,0,18
37,North Carolina,26,Michigan,115,Monroe County,93,17,76
37,North Carolina,26,Michigan,119,Montmorency County,0,1,-1
37,North Carolina,26,Michigan,121,Muskegon County,69,27,42
37,North Carolina,26,Michigan,123,Newaygo County,125,4,121
37,North Carolina,26,Michigan,125,Oakland County,841,475,366
37,North Carolina,26,Michigan,127,Oceana County,0,23,-23
37,North Carolina,26,Michigan,129,Ogemaw County,48,17,31
37,North Carolina,26,Michigan,133,Osceola County,0,3,-3
37,North Carolina,26,Michigan,137,Otsego County,19,1,18
37,North Carolina,26,Michigan,139,Ottawa County,120,80,40
37,North Carolina,26,Michigan,145,Saginaw County,131,17,114
37,North Carolina,26,Michigan,147,St. Clair County,0,48,-48
37,North Carolina,26,Michigan,151,Sanilac County,19,0,19
37,North Carolina,26,Michigan,153,Schoolcraft County,277,0,277
37,North Carolina,26,Michigan,155,Shiawassee County,0,56,-56
37,North Carolina,26,Michigan,157,Tuscola County,41,5,36
37,North Carolina,26,Michigan,159,Van Buren County,30,10,20
37,North Carolina,26,Michigan,161,Washtenaw County,599,242,357
37,North Carolina,26,Michigan,163,Wayne County,769,366,403
37,North Carolina,26,Michigan,165,Wexford County,20,19,1
37,North Carolina,27,Minnesota,1,Aitkin County,0,1,-1
37,North Carolina,27,Minnesota,3,Anoka County,92,30,62
37,North Carolina,27,Minnesota,7,Beltrami County,0,15,-15
37,North Carolina,27,Minnesota,17,Carlton County,7,0,7
37,North Carolina,27,Minnesota,19,Carver County,52,0,52
37,North Carolina,27,Minnesota,25,Chisago County,0,3,-3
37,North Carolina,27,Minnesota,27,Clay County,0,1,-1
37,North Carolina,27,Minnesota,35,Crow Wing County,34,16,18
37,North Carolina,27,Minnesota,37,Dakota County,226,35,191
37,North Carolina,27,Minnesota,39,Dodge County,0,12,-12
37,North Carolina,27,Minnesota,41,Douglas County,0,40,-40
37,North Carolina,27,Minnesota,43,Faribault County,2,3,-1
37,North Carolina,27,Minnesota,45,Fillmore County,0,4,-4
37,North Carolina,27,Minnesota,49,Goodhue County,0,20,-20
37,North Carolina,27,Minnesota,53,Hennepin County,741,316,425
37,North Carolina,27,Minnesota,55,Houston County,32,0,32
37,North Carolina,27,Minnesota,59,Isanti County,27,0,27
37,North Carolina,27,Minnesota,61,Itasca County,48,4,44
37,North Carolina,27,Minnesota,69,Kittson County,0,3,-3
37,North Carolina,27,Minnesota,71,Koochiching County,0,5,-5
37,North Carolina,27,Minnesota,75,Lake County,0,18,-18
37,North Carolina,27,Minnesota,79,Le Sueur County,0,4,-4
37,North Carolina,27,Minnesota,87,Mahnomen County,0,2,-2
37,North Carolina,27,Minnesota,95,Mille Lacs County,0,6,-6
37,North Carolina,27,Minnesota,97,Morrison County,14,22,-8
37,North Carolina,27,Minnesota,99,Mower County,0,43,-43
37,North Carolina,27,Minnesota,101,Murray County,0,9,-9
37,North Carolina,27,Minnesota,103,Nicollet County,9,0,9
37,North Carolina,27,Minnesota,109,Olmsted County,11,73,-62
37,North Carolina,27,Minnesota,111,Otter Tail County,0,8,-8
37,North Carolina,27,Minnesota,115,Pine County,51,0,51
37,North Carolina,27,Minnesota,119,Polk County,92,4,88
37,North Carolina,27,Minnesota,123,Ramsey County,300,536,-236
37,North Carolina,27,Minnesota,129,Renville County,0,16,-16
37,North Carolina,27,Minnesota,131,Rice County,0,19,-19
37,North Carolina,27,Minnesota,133,Rock County,0,38,-38
37,North Carolina,27,Minnesota,137,St. Louis County,104,17,87
37,North Carolina,27,Minnesota,139,Scott County,69,37,32
37,North Carolina,27,Minnesota,141,Sherburne County,64,0,64
37,North Carolina,27,Minnesota,145,Stearns County,0,10,-10
37,North Carolina,27,Minnesota,149,Stevens County,12,0,12
37,North Carolina,27,Minnesota,163,Washington County,185,166,19
37,North Carolina,27,Minnesota,169,Winona County,13,13,0
37,North Carolina,27,Minnesota,171,Wright County,297,58,239
37,North Carolina,28,Mississippi,3,Alcorn County,20,32,-12
37,North Carolina,28,Mississippi,5,Amite County,13,0,13
37,North Carolina,28,Mississippi,11,Bolivar County,0,4,-4
37,North Carolina,28,Mississippi,29,Copiah County,7,0,7
37,North Carolina,28,Mississippi,31,Covington County,0,9,-9
37,North Carolina,28,Mississippi,33,DeSoto County,112,36,76
37,North Carolina,28,Mississippi,35,Forrest County,0,141,-141
37,North Carolina,28,Mississippi,43,Grenada County,95,0,95
37,North Carolina,28,Mississippi,45,Hancock County,29,30,-1
37,North Carolina,28,Mississippi,47,Harrison County,116,226,-110
37,North Carolina,28,Mississippi,49,Hinds County,124,91,33
37,North Carolina,28,Mississippi,59,Jackson County,54,46,8
37,North Carolina,28,Mississippi,61,Jasper County,0,6,-6
37,North Carolina,28,Mississippi,67,Jones County,0,26,-26
37,North Carolina,28,Mississippi,69,Kemper County,0,8,-8
37,North Carolina,28,Mississippi,71,Lafayette County,134,167,-33
37,North Carolina,28,Mississippi,73,Lamar County,52,0,52
37,North Carolina,28,Mississippi,75,Lauderdale County,54,25,29
37,North Carolina,28,Mississippi,79,Leake County,0,34,-34
37,North Carolina,28,Mississippi,81,Lee County,0,12,-12
37,North Carolina,28,Mississippi,83,Leflore County,3,0,3
37,North Carolina,28,Mississippi,85,Lincoln County,0,44,-44
37,North Carolina,28,Mississippi,87,Lowndes County,45,28,17
37,North Carolina,28,Mississippi,89,Madison County,99,55,44
37,North Carolina,28,Mississippi,93,Marshall County,0,4,-4
37,North Carolina,28,Mississippi,95,Monroe County,0,2,-2
37,North Carolina,28,Mississippi,99,Neshoba County,0,11,-11
37,North Carolina,28,Mississippi,101,Newton County,0,1,-1
37,North Carolina,28,Mississippi,105,Oktibbeha County,104,30,74
37,North Carolina,28,Mississippi,117,Prentiss County,6,6,0
37,North Carolina,28,Mississippi,121,Rankin County,118,3,115
37,North Carolina,28,Mississippi,127,Simpson County,10,0,10
37,North Carolina,28,Mississippi,133,Sunflower County,24,0,24
37,North Carolina,28,Mississippi,137,Tate County,40,66,-26
37,North Carolina,28,Mississippi,141,Tishomingo County,18,0,18
37,North Carolina,28,Mississippi,143,Tunica County,0,25,-25
37,North Carolina,28,Mississippi,145,Union County,20,0,20
37,North Carolina,28,Mississippi,149,Warren County,20,0,20
37,North Carolina,28,Mississippi,151,Washington County,0,24,-24
37,North Carolina,28,Mississippi,153,Wayne County,0,10,-10
37,North Carolina,28,Mississippi,163,Yazoo County,6,73,-67
37,North Carolina,29,Missouri,9,Barry County,18,0,18
37,North Carolina,29,Missouri,11,Barton County,0,4,-4
37,North Carolina,29,Missouri,19,Boone County,357,167,190
37,North Carolina,29,Missouri,21,Buchanan County,3,0,3
37,North Carolina,29,Missouri,23,Butler County,8,90,-82
37,North Carolina,29,Missouri,31,Cape Girardeau County,0,36,-36
37,North Carolina,29,Missouri,37,Cass County,88,5,83
37,North Carolina,29,Missouri,43,Christian County,19,0,19
37,North Carolina,29,Missouri,47,Clay County,75,76,-1
37,North Carolina,29,Missouri,49,Clinton County,9,11,-2
37,North Carolina,29,Missouri,51,Cole County,34,31,3
37,North Carolina,29,Missouri,55,Crawford County,0,11,-11
37,North Carolina,29,Missouri,57,Dade County,28,0,28
37,North Carolina,29,Missouri,65,Dent County,0,86,-86
37,North Carolina,29,Missouri,69,Dunklin County,0,6,-6
37,North Carolina,29,Missouri,71,Franklin County,8,7,1
37,North Carolina,29,Missouri,77,Greene County,130,189,-59
37,North Carolina,29,Missouri,83,Henry County,16,0,16
37,North Carolina,29,Missouri,91,Howell County,113,0,113
37,North Carolina,29,Missouri,93,Iron County,0,16,-16
37,North Carolina,29,Missouri,95,Jackson County,305,242,63
37,North Carolina,29,Missouri,99,Jefferson County,85,40,45
37,North Carolina,29,Missouri,101,Johnson County,51,86,-35
37,North Carolina,29,Missouri,107,Lafayette County,30,0,30
37,North Carolina,29,Missouri,119,McDonald County,0,3,-3
37,North Carolina,29,Missouri,125,Maries County,0,62,-62
37,North Carolina,29,Missouri,127,Marion County,20,0,20
37,North Carolina,29,Missouri,129,Mercer County,0,20,-20
37,North Carolina,29,Missouri,139,Montgomery County,0,23,-23
37,North Carolina,29,Missouri,141,Morgan County,0,50,-50
37,North Carolina,29,Missouri,145,Newton County,0,87,-87
37,North Carolina,29,Missouri,147,Nodaway County,49,15,34
37,North Carolina,29,Missouri,157,Perry County,0,16,-16
37,North Carolina,29,Missouri,161,Phelps County,158,53,105
37,North Carolina,29,Missouri,163,Pike County,13,38,-25
37,North Carolina,29,Missouri,165,Platte County,168,102,66
37,North Carolina,29,Missouri,167,Polk County,51,5,46
37,North Carolina,29,Missouri,169,Pulaski County,376,546,-170
37,North Carolina,29,Missouri,177,Ray County,0,19,-19
37,North Carolina,29,Missouri,183,St. Charles County,205,157,48
37,North Carolina,29,Missouri,187,St. Francois County,0,28,-28
37,North Carolina,29,Missouri,189,St. Louis County,313,627,-314
37,North Carolina,29,Missouri,199,Scotland County,0,10,-10
37,North Carolina,29,Missouri,201,Scott County,0,6,-6
37,North Carolina,29,Missouri,209,Stone County,0,28,-28
37,North Carolina,29,Missouri,215,Texas County,0,9,-9
37,North Carolina,29,Missouri,217,Vernon County,0,37,-37
37,North Carolina,29,Missouri,219,Warren County,0,149,-149
37,North Carolina,29,Missouri,221,Washington County,0,31,-31
37,North Carolina,29,Missouri,225,Webster County,0,10,-10
37,North Carolina,29,Missouri,229,Wright County,23,2,21
37,North Carolina,29,Missouri,510,St. Louis city,406,182,224
37,North Carolina,30,Montana,7,Broadwater County,0,6,-6
37,North Carolina,30,Montana,9,Carbon County,0,3,-3
37,North Carolina,30,Montana,13,Cascade County,156,34,122
37,North Carolina,30,Montana,21,Dawson County,14,0,14
37,North Carolina,30,Montana,23,Deer Lodge County,0,14,-14
37,North Carolina,30,Montana,27,Fergus County,0,1,-1
37,North Carolina,30,Montana,29,Flathead County,122,177,-55
37,North Carolina,30,Montana,31,Gallatin County,7,10,-3
37,North Carolina,30,Montana,47,Lake County,10,0,10
37,North Carolina,30,Montana,49,Lewis and Clark County,6,58,-52
37,North Carolina,30,Montana,53,Lincoln County,49,0,49
37,North Carolina,30,Montana,63,Missoula County,48,180,-132
37,North Carolina,30,Montana,65,Musselshell County,0,8,-8
37,North Carolina,30,Montana,73,Pondera County,0,17,-17
37,North Carolina,30,Montana,75,Powder River County,0,6,-6
37,North Carolina,30,Montana,81,Ravalli County,0,59,-59
37,North Carolina,30,Montana,83,Richland County,18,0,18
37,North Carolina,30,Montana,85,Roosevelt County,0,35,-35
37,North Carolina,30,Montana,93,Silver Bow County,0,28,-28
37,North Carolina,30,Montana,111,Yellowstone County,46,32,14
37,North Carolina,31,Nebraska,19,Buffalo County,13,0,13
37,North Carolina,31,Nebraska,21,Burt County,0,5,-5
37,North Carolina,31,Nebraska,25,Cass County,0,1,-1
37,North Carolina,31,Nebraska,53,Dodge County,0,3,-3
37,North Carolina,31,Nebraska,55,Douglas County,419,122,297
37,North Carolina,31,Nebraska,61,Franklin County,0,2,-2
37,North Carolina,31,Nebraska,67,Gage County,0,10,-10
37,North Carolina,31,Nebraska,71,Garfield County,27,0,27
37,North Carolina,31,Nebraska,79,Hall County,0,1,-1
37,North Carolina,31,Nebraska,81,Hamilton County,0,6,-6
37,North Carolina,31,Nebraska,105,Kimball County,0,8,-8
37,North Carolina,31,Nebraska,109,Lancaster County,35,155,-120
37,North Carolina,31,Nebraska,111,Lincoln County,9,23,-14
37,North Carolina,31,Nebraska,119,Madison County,0,15,-15
37,North Carolina,31,Nebraska,141,Platte County,6,0,6
37,North Carolina,31,Nebraska,151,Saline County,34,0,34
37,North Carolina,31,Nebraska,153,Sarpy County,299,110,189
37,North Carolina,31,Nebraska,155,Saunders County,0,10,-10
37,North Carolina,32,Nevada,3,Clark County,1620,1632,-12
37,North Carolina,32,Nevada,5,Douglas County,28,3,25
37,North Carolina,32,Nevada,7,Elko County,11,0,11
37,North Carolina,32,Nevada,19,Lyon County,17,0,17
37,North Carolina,32,Nevada,21,Mineral County,18,0,18
37,North Carolina,32,Nevada,23,Nye County,0,111,-111
37,North Carolina,32,Nevada,31,Washoe County,54,61,-7
37,North Carolina,32,Nevada,510,Carson City,0,73,-73
37,North Carolina,33,New Hampshire,1,Belknap County,16,0,16
37,North Carolina,33,New Hampshire,3,Carroll County,16,0,16
37,North Carolina,33,New Hampshire,5,Cheshire County,29,14,15
37,North Carolina,33,New Hampshire,7,Coos County,65,0,65
37,North Carolina,33,New Hampshire,9,Grafton County,122,107,15
37,North Carolina,33,New Hampshire,11,Hillsborough County,319,330,-11
37,North Carolina,33,New Hampshire,13,Merrimack County,176,75,101
37,North Carolina,33,New Hampshire,15,Rockingham County,292,192,100
37,North Carolina,33,New Hampshire,17,Strafford County,186,21,165
37,North Carolina,33,New Hampshire,19,Sullivan County,7,0,7
37,North Carolina,34,New Jersey,1,Atlantic County,411,284,127
37,North Carolina,34,New Jersey,3,Bergen County,602,127,475
37,North Carolina,34,New Jersey,5,Burlington County,934,303,631
37,North Carolina,34,New Jersey,7,Camden County,361,76,285
37,North Carolina,34,New Jersey,9,Cape May County,92,49,43
37,North Carolina,34,New Jersey,11,Cumberland County,58,17,41
37,North Carolina,34,New Jersey,13,Essex County,817,419,398
37,North Carolina,34,New Jersey,15,Gloucester County,184,195,-11
37,North Carolina,34,New Jersey,17,Hudson County,1026,261,765
37,North Carolina,34,New Jersey,19,Hunterdon County,151,11,140
37,North Carolina,34,New Jersey,21,Mercer County,576,165,411
37,North Carolina,34,New Jersey,23,Middlesex County,1632,399,1233
37,North Carolina,34,New Jersey,25,Monmouth County,654,187,467
37,North Carolina,34,New Jersey,27,Morris County,1107,355,752
37,North Carolina,34,New Jersey,29,Ocean County,510,293,217
37,North Carolina,34,New Jersey,31,Passaic County,171,127,44
37,North Carolina,34,New Jersey,33,Salem County,89,26,63
37,North Carolina,34,New Jersey,35,Somerset County,559,180,379
37,North Carolina,34,New Jersey,37,Sussex County,112,6,106
37,North Carolina,34,New Jersey,39,Union County,995,131,864
37,North Carolina,34,New Jersey,41,Warren County,111,53,58
37,North Carolina,35,New Mexico,1,Bernalillo County,530,182,348
37,North Carolina,35,New Mexico,5,Chaves County,29,0,29
37,North Carolina,35,New Mexico,9,Curry County,0,73,-73
37,North Carolina,35,New Mexico,13,Doña Ana County,119,43,76
37,North Carolina,35,New Mexico,15,Eddy County,14,14,0
37,North Carolina,35,New Mexico,17,Grant County,6,0,6
37,North Carolina,35,New Mexico,25,Lea County,20,0,20
37,North Carolina,35,New Mexico,28,Los Alamos County,7,0,7
37,North Carolina,35,New Mexico,29,Luna County,0,10,-10
37,North Carolina,35,New Mexico,31,McKinley County,15,42,-27
37,North Carolina,35,New Mexico,35,Otero County,52,189,-137
37,North Carolina,35,New Mexico,41,Roosevelt County,151,0,151
37,North Carolina,35,New Mexico,43,Sandoval County,32,59,-27
37,North Carolina,35,New Mexico,45,San Juan County,9,8,1
37,North Carolina,35,New Mexico,47,San Miguel County,5,0,5
37,North Carolina,35,New Mexico,49,Santa Fe County,99,49,50
37,North Carolina,35,New Mexico,55,Taos County,12,0,12
37,North Carolina,35,New Mexico,61,Valencia County,0,20,-20
37,North Carolina,36,New York,1,Albany County,456,104,352
37,North Carolina,36,New York,3,Allegany County,28,8,20
37,North Carolina,36,New York,5,Bronx County,2012,450,1562
37,North Carolina,36,New York,7,Broome County,385,121,264
37,North Carolina,36,New York,9,Cattaraugus County,178,36,142
37,North Carolina,36,New York,11,Cayuga County,76,16,60
37,North Carolina,36,New York,13,Chautauqua County,412,155,257
37,North Carolina,36,New York,15,Chemung County,290,50,240
37,North Carolina,36,New York,17,Chenango County,153,192,-39
37,North Carolina,36,New York,19,Clinton County,103,25,78
37,North Carolina,36,New York,21,Columbia County,42,34,8
37,North Carolina,36,New York,23,Cortland County,81,0,81
37,North Carolina,36,New York,25,Delaware County,46,341,-295
37,North Carolina,36,New York,27,Dutchess County,392,198,194
37,North Carolina,36,New York,29,Erie County,1140,804,336
37,North Carolina,36,New York,31,Essex County,84,48,36
37,North Carolina,36,New York,33,Franklin County,17,16,1
37,North Carolina,36,New York,35,Fulton County,59,0,59
37,North Carolina,36,New York,37,Genesee County,44,0,44
37,North Carolina,36,New York,39,Greene County,14,38,-24
37,North Carolina,36,New York,43,Herkimer County,361,8,353
37,North Carolina,36,New York,45,Jefferson County,459,595,-136
37,North Carolina,36,New York,47,Kings County,2576,764,1812
37,North Carolina,36,New York,49,Lewis County,0,62,-62
37,North Carolina,36,New York,51,Livingston County,314,25,289
37,North Carolina,36,New York,53,Madison County,167,0,167
37,North Carolina,36,New York,55,Monroe County,804,571,233
37,North Carolina,36,New York,57,Montgomery County,49,0,49
37,North Carolina,36,New York,59,Nassau County,1235,675,560
37,North Carolina,36,New York,61,New York County,2553,1550,1003
37,North Carolina,36,New York,63,Niagara County,129,7,122
37,North Carolina,36,New York,65,Oneida County,321,202,119
37,North Carolina,36,New York,67,Onondaga County,1057,268,789
37,North Carolina,36,New York,69,Ontario County,134,74,60
37,North Carolina,36,New York,71,Orange County,900,358,542
37,North Carolina,36,New York,73,Orleans County,48,0,48
37,North Carolina,36,New York,75,Oswego County,138,43,95
37,North Carolina,36,New York,77,Otsego County,145,40,105
37,North Carolina,36,New York,79,Putnam County,62,19,43
37,North Carolina,36,New York,81,Queens County,1703,728,975
37,North Carolina,36,New York,83,Rensselaer County,72,21,51
37,North Carolina,36,New York,85,Richmond County,383,51,332
37,North Carolina,36,New York,87,Rockland County,393,173,220
37,North Carolina,36,New York,89,St. Lawrence County,123,59,64
37,North Carolina,36,New York,91,Saratoga County,362,186,176
37,North Carolina,36,New York,93,Schenectady County,395,18,377
37,North Carolina,36,New York,95,Schoharie County,30,48,-18
37,North Carolina,36,New York,97,Schuyler County,0,25,-25
37,North Carolina,36,New York,99,Seneca County,0,28,-28
37,North Carolina,36,New York,101,Steuben County,86,65,21
37,North Carolina,36,New York,103,Suffolk County,2040,297,1743
37,North Carolina,36,New York,105,Sullivan County,549,6,543
37,North Carolina,36,New York,107,Tioga County,0,141,-141
37,North Carolina,36,New York,109,Tompkins County,164,145,19
37,North Carolina,36,New York,111,Ulster County,412,79,333
37,North Carolina,36,New York,113,Warren County,69,0,69
37,North Carolina,36,New York,115,Washington County,14,0,14
37,North Carolina,36,New York,117,Wayne County,63,34,29
37,North Carolina,36,New York,119,Westchester County,910,257,653
37,North Carolina,36,New York,121,Wyoming County,0,6,-6
37,North Carolina,36,New York,123,Yates County,35,6,29
37,North Carolina,37,North Carolina,1,Alamance County,5742,4885,857
37,North Carolina,37,North Carolina,3,Alexander County,1609,1562,47
37,North Carolina,37,North Carolina,5,Alleghany County,261,71,190
37,North Carolina,37,North Carolina,7,Anson County,1196,1090,106
37,North Carolina,37,North Carolina,9,Ashe County,821,603,218
37,North Carolina,37,North Carolina,11,Avery County,664,1394,-730
37,North Carolina,37,North Carolina,13,Beaufort County,1320,695,625
37,North Carolina,37,North Carolina,15,Bertie County,874,772,102
37,North Carolina,37,North Carolina,17,Bladen County,895,726,169
37,North Carolina,37,North Carolina,19,Brunswick County,4158,5510,-1352
37,North Carolina,37,North Carolina,21,Buncombe County,7381,7513,-132
37,North Carolina,37,North Carolina,23,Burke County,3677,3257,420
37,North Carolina,37,North Carolina,25,Cabarrus County,7858,7789,69
37,North Carolina,37,North Carolina,27,Caldwell County,2812,2627,185
37,North Carolina,37,North Carolina,29,Camden County,165,478,-313
37,North Carolina,37,North Carolina,31,Carteret County,2773,2780,-7
37,North Carolina,37,North Carolina,33,Caswell County,830,782,48
37,North Carolina,37,North Carolina,35,Catawba County,5031,5650,-619
37,North Carolina,37,North Carolina,37,Chatham County,3215,2806,409
37,North Carolina,37,North Carolina,39,Cherokee County,470,340,130
37,North Carolina,37,North Carolina,41,Chowan County,637,210,427
37,North Carolina,37,North Carolina,43,Clay County,130,153,-23
37,North Carolina,37,North Carolina,45,Cleveland County,2504,2350,154
37,North Carolina,37,North Carolina,47,Columbus County,1984,2142,-158
37,North Carolina,37,North Carolina,49,Craven County,4142,4199,-57
37,North Carolina,37,North Carolina,51,Cumberland County,11603,7697,3906
37,North Carolina,37,North Carolina,53,Currituck County,761,519,242
37,North Carolina,37,North Carolina,55,Dare County,1279,576,703
37,North Carolina,37,North Carolina,57,Davidson County,6642,6340,302
37,North Carolina,37,North Carolina,59,Davie County,1391,1945,-554
37,North Carolina,37,North Carolina,61,Duplin County,2443,1983,460
37,North Carolina,37,North Carolina,63,Durham County,14073,13899,174
37,North Carolina,37,North Carolina,65,Edgecombe County,3382,1850,1532
37,North Carolina,37,North Carolina,67,Forsyth County,12181,11749,432
37,North Carolina,37,North Carolina,69,Franklin County,2319,3221,-902
37,North Carolina,37,North Carolina,71,Gaston County,6083,6899,-816
37,North Carolina,37,North Carolina,73,Gates County,401,97,304
37,North Carolina,37,North Carolina,75,Graham County,135,62,73
37,North Carolina,37,North Carolina,77,Granville County,2685,2979,-294
37,North Carolina,37,North Carolina,79,Greene County,1251,2105,-854
37,North Carolina,37,North Carolina,81,Guilford County,18269,16401,1868
37,North Carolina,37,North Carolina,83,Halifax County,1572,1796,-224
37,North Carolina,37,North Carolina,85,Harnett County,7041,7488,-447
37,North Carolina,37,North Carolina,87,Haywood County,1654,2056,-402
37,North Carolina,37,North Carolina,89,Henderson County,2581,3250,-669
37,North Carolina,37,North Carolina,91,Hertford County,945,1292,-347
37,North Carolina,37,North Carolina,93,Hoke County,2277,3821,-1544
37,North Carolina,37,North Carolina,95,Hyde County,306,465,-159
37,North Carolina,37,North Carolina,97,Iredell County,5409,4736,673
37,North Carolina,37,North Carolina,99,Jackson County,1727,3396,-1669
37,North Carolina,37,North Carolina,101,Johnston County,8131,7193,938
37,North Carolina,37,North Carolina,103,Jones County,588,459,129
37,North Carolina,37,North Carolina,105,Lee County,2384,2026,358
37,North Carolina,37,North Carolina,107,Lenoir County,2768,1743,1025
37,North Carolina,37,North Carolina,109,Lincoln County,3621,2388,1233
37,North Carolina,37,North Carolina,111,McDowell County,1249,1006,243
37,North Carolina,37,North Carolina,113,Macon County,815,446,369
37,North Carolina,37,North Carolina,115,Madison County,760,1131,-371
37,North Carolina,37,North Carolina,117,Martin County,427,532,-105
37,North Carolina,37,North Carolina,119,Mecklenburg County,29963,25890,4073
37,North Carolina,37,North Carolina,121,Mitchell County,872,614,258
37,North Carolina,37,North Carolina,123,Montgomery County,1075,1369,-294
37,North Carolina,37,North Carolina,125,Moore County,2553,2469,84
37,North Carolina,37,North Carolina,127,Nash County,5058,5089,-31
37,North Carolina,37,North Carolina,129,New Hanover County,9118,10810,-1692
37,North Carolina,37,North Carolina,131,Northampton County,1399,1339,60
37,North Carolina,37,North Carolina,133,Onslow County,5636,5900,-264
37,North Carolina,37,North Carolina,135,Orange County,9456,10262,-806
37,North Carolina,37,North Carolina,137,Pamlico County,671,904,-233
37,North Carolina,37,North Carolina,139,Pasquotank County,1588,1976,-388
37,North Carolina,37,North Carolina,141,Pender County,2707,3815,-1108
37,North Carolina,37,North Carolina,143,Perquimans County,618,236,382
37,North Carolina,37,North Carolina,145,Person County,1149,960,189
37,North Carolina,37,North Carolina,147,Pitt County,7796,12021,-4225
37,North Carolina,37,North Carolina,149,Polk County,507,618,-111
37,North Carolina,37,North Carolina,151,Randolph County,4833,4693,140
37,North Carolina,37,North Carolina,153,Richmond County,2067,1453,614
37,North Carolina,37,North Carolina,155,Robeson County,4189,2968,1221
37,North Carolina,37,North Carolina,157,Rockingham County,1881,2133,-252
37,North Carolina,37,North Carolina,159,Rowan County,4948,5402,-454
37,North Carolina,37,North Carolina,161,Rutherford County,1323,1370,-47
37,North Carolina,37,North Carolina,163,Sampson County,1966,3159,-1193
37,North Carolina,37,North Carolina,165,Scotland County,1576,1729,-153
37,North Carolina,37,North Carolina,167,Stanly County,2078,2101,-23
37,North Carolina,37,North Carolina,169,Stokes County,1598,828,770
37,North Carolina,37,North Carolina,171,Surry County,1721,1408,313
37,North Carolina,37,North Carolina,173,Swain County,589,415,174
37,North Carolina,37,North Carolina,175,Transylvania County,593,1071,-478
37,North Carolina,37,North Carolina,177,Tyrrell County,370,560,-190
37,North Carolina,37,North Carolina,179,Union County,7664,7610,54
37,North Carolina,37,North Carolina,181,Vance County,1503,1370,133
37,North Carolina,37,North Carolina,183,Wake County,31102,32204,-1102
37,North Carolina,37,North Carolina,185,Warren County,1318,1103,215
37,North Carolina,37,North Carolina,187,Washington County,379,155,224
37,North Carolina,37,North Carolina,189,Watauga County,2821,5776,-2955
37,North Carolina,37,North Carolina,191,Wayne County,4254,4653,-399
37,North Carolina,37,North Carolina,193,Wilkes County,1618,1685,-67
37,North Carolina,37,North Carolina,195,Wilson County,3018,1977,1041
37,North Carolina,37,North Carolina,197,Yadkin County,1212,1438,-226
37,North Carolina,37,North Carolina,199,Yancey County,872,498,374
37,North Carolina,38,North Dakota,7,Billings County,0,9,-9
37,North Carolina,38,North Dakota,15,Burleigh County,26,0,26
37,North Carolina,38,North Dakota,17,Cass County,89,40,49
37,North Carolina,38,North Dakota,23,Divide County,20,0,20
37,North Carolina,38,North Dakota,35,Grand Forks County,70,0,70
37,North Carolina,38,North Dakota,37,Grant County,13,0,13
37,North Carolina,38,North Dakota,53,McKenzie County,12,0,12
37,North Carolina,38,North Dakota,59,Morton County,92,0,92
37,North Carolina,38,North Dakota,61,Mountrail County,11,14,-3
37,North Carolina,38,North Dakota,63,Nelson County,0,1,-1
37,North Carolina,38,North Dakota,89,Stark County,128,81,47
37,North Carolina,38,North Dakota,101,Ward County,49,0,49
37,North Carolina,39,Ohio,3,Allen County,109,63,46
37,North Carolina,39,Ohio,5,Ashland County,0,2,-2
37,North Carolina,39,Ohio,7,Ashtabula County,0,81,-81
37,North Carolina,39,Ohio,9,Athens County,55,91,-36
37,North Carolina,39,Ohio,11,Auglaize County,46,0,46
37,North Carolina,39,Ohio,13,Belmont County,44,29,15
37,North Carolina,39,Ohio,15,Brown County,36,0,36
37,North Carolina,39,Ohio,17,Butler County,295,250,45
37,North Carolina,39,Ohio,19,Carroll County,0,23,-23
37,North Carolina,39,Ohio,21,Champaign County,9,34,-25
37,North Carolina,39,Ohio,23,Clark County,131,143,-12
37,North Carolina,39,Ohio,25,Clermont County,225,135,90
37,North Carolina,39,Ohio,27,Clinton County,124,100,24
37,North Carolina,39,Ohio,29,Columbiana County,98,20,78
37,North Carolina,39,Ohio,31,Coshocton County,51,9,42
37,North Carolina,39,Ohio,33,Crawford County,55,17,38
37,North Carolina,39,Ohio,35,Cuyahoga County,1066,672,394
37,North Carolina,39,Ohio,37,Darke County,71,29,42
37,North Carolina,39,Ohio,41,Delaware County,345,223,122
37,North Carolina,39,Ohio,43,Erie County,17,25,-8
37,North Carolina,39,Ohio,45,Fairfield County,147,303,-156
37,North Carolina,39,Ohio,47,Fayette County,0,18,-18
37,North Carolina,39,Ohio,49,Franklin County,1330,1915,-585
37,North Carolina,39,Ohio,51,Fulton County,28,0,28
37,North Carolina,39,Ohio,55,Geauga County,142,145,-3
37,North Carolina,39,Ohio,57,Greene County,165,157,8
37,North Carolina,39,Ohio,59,Guernsey County,0,14,-14
37,North Carolina,39,Ohio,61,Hamilton County,638,434,204
37,North Carolina,39,Ohio,63,Hancock County,26,13,13
37,North Carolina,39,Ohio,65,Hardin County,0,16,-16
37,North Carolina,39,Ohio,67,Harrison County,0,29,-29
37,North Carolina,39,Ohio,69,Henry County,102,2,100
37,North Carolina,39,Ohio,71,Highland County,28,0,28
37,North Carolina,39,Ohio,75,Holmes County,0,2,-2
37,North Carolina,39,Ohio,77,Huron County,26,7,19
37,North Carolina,39,Ohio,81,Jefferson County,3,123,-120
37,North Carolina,39,Ohio,83,Knox County,23,159,-136
37,North Carolina,39,Ohio,85,Lake County,204,0,204
37,North Carolina,39,Ohio,87,Lawrence County,37,56,-19
37,North Carolina,39,Ohio,89,Licking County,213,306,-93
37,North Carolina,39,Ohio,91,Logan County,0,35,-35
37,North Carolina,39,Ohio,93,Lorain County,96,64,32
37,North Carolina,39,Ohio,95,Lucas County,209,209,0
37,North Carolina,39,Ohio,97,Madison County,57,3,54
37,North Carolina,39,Ohio,99,Mahoning County,104,254,-150
37,North Carolina,39,Ohio,101,Marion County,0,11,-11
37,North Carolina,39,Ohio,103,Medina County,108,75,33
37,North Carolina,39,Ohio,105,Meigs County,12,0,12
37,North Carolina,39,Ohio,107,Mercer County,11,0,11
37,North Carolina,39,Ohio,109,Miami County,15,23,-8
37,North Carolina,39,Ohio,111,Monroe County,165,0,165
37,North Carolina,39,Ohio,113,Montgomery County,451,457,-6
37,North Carolina,39,Ohio,115,Morgan County,7,17,-10
37,North Carolina,39,Ohio,117,Morrow County,59,0,59
37,North Carolina,39,Ohio,119,Muskingum County,59,0,59
37,North Carolina,39,Ohio,123,Ottawa County,0,12,-12
37,North Carolina,39,Ohio,127,Perry County,0,71,-71
37,North Carolina,39,Ohio,129,Pickaway County,0,12,-12
37,North Carolina,39,Ohio,133,Portage County,155,62,93
37,North Carolina,39,Ohio,135,Preble County,95,0,95
37,North Carolina,39,Ohio,139,Richland County,12,39,-27
37,North Carolina,39,Ohio,141,Ross County,86,0,86
37,North Carolina,39,Ohio,143,Sandusky County,38,9,29
37,North Carolina,39,Ohio,145,Scioto County,97,25,72
37,North Carolina,39,Ohio,147,Seneca County,0,14,-14
37,North Carolina,39,Ohio,149,Shelby County,0,16,-16
37,North Carolina,39,Ohio,151,Stark County,445,112,333
37,North Carolina,39,Ohio,153,Summit County,640,42,598
37,North Carolina,39,Ohio,155,Trumbull County,244,153,91
37,North Carolina,39,Ohio,157,Tuscarawas County,0,170,-170
37,North Carolina,39,Ohio,159,Union County,82,9,73
37,North Carolina,39,Ohio,161,Van Wert County,74,4,70
37,North Carolina,39,Ohio,165,Warren County,299,775,-476
37,North Carolina,39,Ohio,167,Washington County,7,76,-69
37,North Carolina,39,Ohio,169,Wayne County,198,25,173
37,North Carolina,39,Ohio,171,Williams County,0,44,-44
37,North Carolina,39,Ohio,173,Wood County,25,11,14
37,North Carolina,4,Arizona,1,Apache County,0,23,-23
37,North Carolina,4,Arizona,3,Cochise County,464,143,321
37,North Carolina,4,Arizona,5,Coconino County,15,48,-33
37,North Carolina,4,Arizona,7,Gila County,42,0,42
37,North Carolina,4,Arizona,9,Graham County,56,0,56
37,North Carolina,4,Arizona,11,Greenlee County,0,24,-24
37,North Carolina,4,Arizona,13,Maricopa County,2452,2232,220
37,North Carolina,4,Arizona,15,Mohave County,57,117,-60
37,North Carolina,4,Arizona,17,Navajo County,33,0,33
37,North Carolina,4,Arizona,19,Pima County,709,494,215
37,North Carolina,4,Arizona,21,Pinal County,447,199,248
37,North Carolina,4,Arizona,23,Santa Cruz County,30,56,-26
37,North Carolina,4,Arizona,25,Yavapai County,99,141,-42
37,North Carolina,4,Arizona,27,Yuma County,278,405,-127
37,North Carolina,40,Oklahoma,1,Adair County,0,7,-7
37,North Carolina,40,Oklahoma,9,Beckham County,6,0,6
37,North Carolina,40,Oklahoma,11,Blaine County,0,6,-6
37,North Carolina,40,Oklahoma,13,Bryan County,8,0,8
37,North Carolina,40,Oklahoma,15,Caddo County,0,31,-31
37,North Carolina,40,Oklahoma,17,Canadian County,34,76,-42
37,North Carolina,40,Oklahoma,19,Carter County,31,67,-36
37,North Carolina,40,Oklahoma,21,Cherokee County,15,13,2
37,North Carolina,40,Oklahoma,27,Cleveland County,52,107,-55
37,North Carolina,40,Oklahoma,31,Comanche County,468,764,-296
37,North Carolina,40,Oklahoma,41,Delaware County,0,7,-7
37,North Carolina,40,Oklahoma,47,Garfield County,7,0,7
37,North Carolina,40,Oklahoma,51,Grady County,0,11,-11
37,North Carolina,40,Oklahoma,61,Haskell County,6,0,6
37,North Carolina,40,Oklahoma,65,Jackson County,43,25,18
37,North Carolina,40,Oklahoma,71,Kay County,9,3,6
37,North Carolina,40,Oklahoma,75,Kiowa County,10,0,10
37,North Carolina,40,Oklahoma,77,Latimer County,0,5,-5
37,North Carolina,40,Oklahoma,79,Le Flore County,0,5,-5
37,North Carolina,40,Oklahoma,81,Lincoln County,38,0,38
37,North Carolina,40,Oklahoma,83,Logan County,0,35,-35
37,North Carolina,40,Oklahoma,87,McClain County,0,7,-7
37,North Carolina,40,Oklahoma,89,McCurtain County,15,0,15
37,North Carolina,40,Oklahoma,91,McIntosh County,0,11,-11
37,North Carolina,40,Oklahoma,97,Mayes County,0,4,-4
37,North Carolina,40,Oklahoma,101,Muskogee County,0,12,-12
37,North Carolina,40,Oklahoma,103,Noble County,1,0,1
37,North Carolina,40,Oklahoma,107,Okfuskee County,0,8,-8
37,North Carolina,40,Oklahoma,109,Oklahoma County,212,258,-46
37,North Carolina,40,Oklahoma,111,Okmulgee County,0,7,-7
37,North Carolina,40,Oklahoma,113,Osage County,4,0,4
37,North Carolina,40,Oklahoma,119,Payne County,190,5,185
37,North Carolina,40,Oklahoma,121,Pittsburg County,0,24,-24
37,North Carolina,40,Oklahoma,123,Pontotoc County,10,0,10
37,North Carolina,40,Oklahoma,125,Pottawatomie County,15,9,6
37,North Carolina,40,Oklahoma,131,Rogers County,16,9,7
37,North Carolina,40,Oklahoma,135,Sequoyah County,12,0,12
37,North Carolina,40,Oklahoma,137,Stephens County,0,27,-27
37,North Carolina,40,Oklahoma,139,Texas County,16,0,16
37,North Carolina,40,Oklahoma,143,Tulsa County,273,342,-69
37,North Carolina,40,Oklahoma,145,Wagoner County,82,14,68
37,North Carolina,40,Oklahoma,149,Washita County,0,16,-16
37,North Carolina,41,Oregon,3,Benton County,51,109,-58
37,North Carolina,41,Oregon,5,Clackamas County,64,41,23
37,North Carolina,41,Oregon,7,Clatsop County,13,26,-13
37,North Carolina,41,Oregon,9,Columbia County,0,12,-12
37,North Carolina,41,Oregon,11,Coos County,5,64,-59
37,North Carolina,41,Oregon,17,Deschutes County,56,159,-103
37,North Carolina,41,Oregon,19,Douglas County,0,13,-13
37,North Carolina,41,Oregon,27,Hood River County,34,0,34
37,North Carolina,41,Oregon,29,Jackson County,80,110,-30
37,North Carolina,41,Oregon,31,Jefferson County,0,4,-4
37,North Carolina,41,Oregon,33,Josephine County,50,38,12
37,North Carolina,41,Oregon,35,Klamath County,0,36,-36
37,North Carolina,41,Oregon,39,Lane County,243,148,95
37,North Carolina,41,Oregon,41,Lincoln County,0,1,-1
37,North Carolina,41,Oregon,43,Linn County,28,20,8
37,North Carolina,41,Oregon,47,Marion County,0,13,-13
37,North Carolina,41,Oregon,51,Multnomah County,452,306,146
37,North Carolina,41,Oregon,53,Polk County,1,0,1
37,North Carolina,41,Oregon,59,Umatilla County,0,18,-18
37,North Carolina,41,Oregon,61,Union County,0,10,-10
37,North Carolina,41,Oregon,65,Wasco County,0,19,-19
37,North Carolina,41,Oregon,67,Washington County,222,223,-1
37,North Carolina,41,Oregon,71,Yamhill County,0,154,-154
37,North Carolina,42,Pennsylvania,1,Adams County,73,154,-81
37,North Carolina,42,Pennsylvania,3,Allegheny County,1539,1504,35
37,North Carolina,42,Pennsylvania,5,Armstrong County,0,51,-51
37,North Carolina,42,Pennsylvania,7,Beaver County,169,173,-4
37,North Carolina,42,Pennsylvania,9,Bedford County,0,48,-48
37,North Carolina,42,Pennsylvania,11,Berks County,267,130,137
37,North Carolina,42,Pennsylvania,13,Blair County,223,18,205
37,North Carolina,42,Pennsylvania,15,Bradford County,30,17,13
37,North Carolina,42,Pennsylvania,17,Bucks County,762,168,594
37,North Carolina,42,Pennsylvania,19,Butler County,171,220,-49
37,North Carolina,42,Pennsylvania,21,Cambria County,68,154,-86
37,North Carolina,42,Pennsylvania,25,Carbon County,23,0,23
37,North Carolina,42,Pennsylvania,27,Centre County,182,91,91
37,North Carolina,42,Pennsylvania,29,Chester County,835,393,442
37,North Carolina,42,Pennsylvania,31,Clarion County,47,1,46
37,North Carolina,42,Pennsylvania,33,Clearfield County,37,14,23
37,North Carolina,42,Pennsylvania,35,Clinton County,49,0,49
37,North Carolina,42,Pennsylvania,37,Columbia County,65,62,3
37,North Carolina,42,Pennsylvania,39,Crawford County,64,100,-36
37,North Carolina,42,Pennsylvania,41,Cumberland County,275,159,116
37,North Carolina,42,Pennsylvania,43,Dauphin County,405,126,279
37,North Carolina,42,Pennsylvania,45,Delaware County,412,461,-49
37,North Carolina,42,Pennsylvania,47,Elk County,0,8,-8
37,North Carolina,42,Pennsylvania,49,Erie County,428,164,264
37,North Carolina,42,Pennsylvania,51,Fayette County,32,30,2
37,North Carolina,42,Pennsylvania,53,Forest County,26,0,26
37,North Carolina,42,Pennsylvania,55,Franklin County,144,250,-106
37,North Carolina,42,Pennsylvania,59,Greene County,74,84,-10
37,North Carolina,42,Pennsylvania,61,Huntingdon County,66,12,54
37,North Carolina,42,Pennsylvania,63,Indiana County,138,137,1
37,North Carolina,42,Pennsylvania,65,Jefferson County,49,4,45
37,North Carolina,42,Pennsylvania,67,Juniata County,21,0,21
37,North Carolina,42,Pennsylvania,69,Lackawanna County,144,139,5
37,North Carolina,42,Pennsylvania,71,Lancaster County,402,281,121
37,North Carolina,42,Pennsylvania,73,Lawrence County,166,15,151
37,North Carolina,42,Pennsylvania,75,Lebanon County,134,40,94
37,North Carolina,42,Pennsylvania,77,Lehigh County,463,166,297
37,North Carolina,42,Pennsylvania,79,Luzerne County,463,25,438
37,North Carolina,42,Pennsylvania,81,Lycoming County,92,115,-23
37,North Carolina,42,Pennsylvania,83,McKean County,15,64,-49
37,North Carolina,42,Pennsylvania,85,Mercer County,78,26,52
37,North Carolina,42,Pennsylvania,87,Mifflin County,37,0,37
37,North Carolina,42,Pennsylvania,89,Monroe County,265,42,223
37,North Carolina,42,Pennsylvania,91,Montgomery County,318,444,-126
37,North Carolina,42,Pennsylvania,93,Montour County,0,11,-11
37,North Carolina,42,Pennsylvania,95,Northampton County,374,132,242
37,North Carolina,42,Pennsylvania,97,Northumberland County,108,5,103
37,North Carolina,42,Pennsylvania,99,Perry County,9,12,-3
37,North Carolina,42,Pennsylvania,101,Philadelphia County,1156,1081,75
37,North Carolina,42,Pennsylvania,103,Pike County,117,10,107
37,North Carolina,42,Pennsylvania,105,Potter County,19,9,10
37,North Carolina,42,Pennsylvania,107,Schuylkill County,62,5,57
37,North Carolina,42,Pennsylvania,109,Snyder County,78,6,72
37,North Carolina,42,Pennsylvania,111,Somerset County,26,14,12
37,North Carolina,42,Pennsylvania,115,Susquehanna County,97,35,62
37,North Carolina,42,Pennsylvania,117,Tioga County,30,7,23
37,North Carolina,42,Pennsylvania,119,Union County,52,25,27
37,North Carolina,42,Pennsylvania,121,Venango County,101,40,61
37,North Carolina,42,Pennsylvania,123,Warren County,16,18,-2
37,North Carolina,42,Pennsylvania,125,Washington County,197,163,34
37,North Carolina,42,Pennsylvania,127,Wayne County,69,61,8
37,North Carolina,42,Pennsylvania,129,Westmoreland County,356,230,126
37,North Carolina,42,Pennsylvania,131,Wyoming County,53,12,41
37,North Carolina,42,Pennsylvania,133,York County,462,273,189
37,North Carolina,44,Rhode Island,1,Bristol County,29,0,29
37,North Carolina,44,Rhode Island,3,Kent County,97,243,-146
37,North Carolina,44,Rhode Island,5,Newport County,191,201,-10
37,North Carolina,44,Rhode Island,7,Providence County,309,328,-19
37,North Carolina,44,Rhode Island,9,Washington County,173,185,-12
37,North Carolina,45,South Carolina,1,Abbeville County,75,39,36
37,North Carolina,45,South Carolina,3,Aiken County,636,582,54
37,North Carolina,45,South Carolina,5,Allendale County,57,53,4
37,North Carolina,45,South Carolina,7,Anderson County,609,643,-34
37,North Carolina,45,South Carolina,9,Bamberg County,21,32,-11
37,North Carolina,45,South Carolina,11,Barnwell County,0,42,-42
37,North Carolina,45,South Carolina,13,Beaufort County,1865,2184,-319
37,North Carolina,45,South Carolina,15,Berkeley County,773,642,131
37,North Carolina,45,South Carolina,17,Calhoun County,61,30,31
37,North Carolina,45,South Carolina,19,Charleston County,1527,1407,120
37,North Carolina,45,South Carolina,21,Cherokee County,464,286,178
37,North Carolina,45,South Carolina,23,Chester County,96,34,62
37,North Carolina,45,South Carolina,25,Chesterfield County,521,465,56
37,North Carolina,45,South Carolina,27,Clarendon County,231,54,177
37,North Carolina,45,South Carolina,29,Colleton County,0,66,-66
37,North Carolina,45,South Carolina,31,Darlington County,172,116,56
37,North Carolina,45,South Carolina,33,Dillon County,129,114,15
37,North Carolina,45,South Carolina,35,Dorchester County,472,506,-34
37,North Carolina,45,South Carolina,37,Edgefield County,32,82,-50
37,North Carolina,45,South Carolina,39,Fairfield County,162,34,128
37,North Carolina,45,South Carolina,41,Florence County,750,161,589
37,North Carolina,45,South Carolina,43,Georgetown County,265,232,33
37,North Carolina,45,South Carolina,45,Greenville County,2157,2777,-620
37,North Carolina,45,South Carolina,47,Greenwood County,124,176,-52
37,North Carolina,45,South Carolina,49,Hampton County,19,13,6
37,North Carolina,45,South Carolina,51,Horry County,2623,3621,-998
37,North Carolina,45,South Carolina,53,Jasper County,37,166,-129
37,North Carolina,45,South Carolina,55,Kershaw County,130,213,-83
37,North Carolina,45,South Carolina,57,Lancaster County,1334,1185,149
37,North Carolina,45,South Carolina,59,Laurens County,155,571,-416
37,North Carolina,45,South Carolina,61,Lee County,43,12,31
37,North Carolina,45,South Carolina,63,Lexington County,1101,870,231
37,North Carolina,45,South Carolina,65,McCormick County,11,32,-21
37,North Carolina,45,South Carolina,67,Marion County,133,75,58
37,North Carolina,45,South Carolina,69,Marlboro County,476,256,220
37,North Carolina,45,South Carolina,71,Newberry County,26,153,-127
37,North Carolina,45,South Carolina,73,Oconee County,117,373,-256
37,North Carolina,45,South Carolina,75,Orangeburg County,147,112,35
37,North Carolina,45,South Carolina,77,Pickens County,464,1124,-660
37,North Carolina,45,South Carolina,79,Richland County,3086,2907,179
37,North Carolina,45,South Carolina,81,Saluda County,0,54,-54
37,North Carolina,45,South Carolina,83,Spartanburg County,1546,1652,-106
37,North Carolina,45,South Carolina,85,Sumter County,670,227,443
37,North Carolina,45,South Carolina,87,Union County,24,4,20
37,North Carolina,45,South Carolina,89,Williamsburg County,35,29,6
37,North Carolina,45,South Carolina,91,York County,3493,4806,-1313
37,North Carolina,46,South Dakota,13,Brown County,0,4,-4
37,North Carolina,46,South Dakota,47,Fall River County,0,8,-8
37,North Carolina,46,South Dakota,57,Hamlin County,0,1,-1
37,North Carolina,46,South Dakota,61,Hanson County,0,1,-1
37,North Carolina,46,South Dakota,71,Jackson County,0,3,-3
37,North Carolina,46,South Dakota,77,Kingsbury County,0,3,-3
37,North Carolina,46,South Dakota,81,Lawrence County,24,0,24
37,North Carolina,46,South Dakota,83,Lincoln County,17,0,17
37,North Carolina,46,South Dakota,87,McCook County,0,2,-2
37,North Carolina,46,South Dakota,93,Meade County,0,18,-18
37,North Carolina,46,South Dakota,99,Minnehaha County,324,126,198
37,North Carolina,46,South Dakota,102,Oglala Lakota County,17,0,17
37,North Carolina,46,South Dakota,103,Pennington County,154,39,115
37,North Carolina,46,South Dakota,125,Turner County,0,9,-9
37,North Carolina,46,South Dakota,127,Union County,59,0,59
37,North Carolina,46,South Dakota,135,Yankton County,0,58,-58
37,North Carolina,47,Tennessee,1,Anderson County,142,43,99
37,North Carolina,47,Tennessee,3,Bedford County,28,0,28
37,North Carolina,47,Tennessee,9,Blount County,237,79,158
37,North Carolina,47,Tennessee,11,Bradley County,164,139,25
37,North Carolina,47,Tennessee,13,Campbell County,0,41,-41
37,North Carolina,47,Tennessee,17,Carroll County,9,24,-15
37,North Carolina,47,Tennessee,19,Carter County,56,181,-125
37,North Carolina,47,Tennessee,21,Cheatham County,49,0,49
37,North Carolina,47,Tennessee,23,Chester County,0,5,-5
37,North Carolina,47,Tennessee,25,Claiborne County,7,36,-29
37,North Carolina,47,Tennessee,29,Cocke County,17,6,11
37,North Carolina,47,Tennessee,31,Coffee County,39,0,39
37,North Carolina,47,Tennessee,33,Crockett County,59,17,42
37,North Carolina,47,Tennessee,35,Cumberland County,22,41,-19
37,North Carolina,47,Tennessee,37,Davidson County,653,1508,-855
37,North Carolina,47,Tennessee,43,Dickson County,16,13,3
37,North Carolina,47,Tennessee,47,Fayette County,3,0,3
37,North Carolina,47,Tennessee,51,Franklin County,12,52,-40
37,North Carolina,47,Tennessee,53,Gibson County,0,77,-77
37,North Carolina,47,Tennessee,55,Giles County,17,4,13
37,North Carolina,47,Tennessee,57,Grainger County,0,40,-40
37,North Carolina,47,Tennessee,59,Greene County,237,131,106
37,North Carolina,47,Tennessee,61,Grundy County,23,0,23
37,North Carolina,47,Tennessee,63,Hamblen County,162,161,1
37,North Carolina,47,Tennessee,65,Hamilton County,487,693,-206
37,North Carolina,47,Tennessee,71,Hardin County,0,34,-34
37,North Carolina,47,Tennessee,73,Hawkins County,140,167,-27
37,North Carolina,47,Tennessee,77,Henderson County,11,0,11
37,North Carolina,47,Tennessee,79,Henry County,62,68,-6
37,North Carolina,47,Tennessee,81,Hickman County,0,9,-9
37,North Carolina,47,Tennessee,83,Houston County,0,18,-18
37,North Carolina,47,Tennessee,87,Jackson County,0,12,-12
37,North Carolina,47,Tennessee,89,Jefferson County,37,89,-52
37,North Carolina,47,Tennessee,91,Johnson County,74,97,-23
37,North Carolina,47,Tennessee,93,Knox County,807,1301,-494
37,North Carolina,47,Tennessee,97,Lauderdale County,0,7,-7
37,North Carolina,47,Tennessee,99,Lawrence County,44,0,44
37,North Carolina,47,Tennessee,101,Lewis County,0,3,-3
37,North Carolina,47,Tennessee,105,Loudon County,16,249,-233
37,North Carolina,47,Tennessee,107,McMinn County,37,55,-18
37,North Carolina,47,Tennessee,111,Macon County,13,9,4
37,North Carolina,47,Tennessee,113,Madison County,28,46,-18
37,North Carolina,47,Tennessee,115,Marion County,18,31,-13
37,North Carolina,47,Tennessee,117,Marshall County,148,22,126
37,North Carolina,47,Tennessee,119,Maury County,43,0,43
37,North Carolina,47,Tennessee,121,Meigs County,96,20,76
37,North Carolina,47,Tennessee,123,Monroe County,155,33,122
37,North Carolina,47,Tennessee,125,Montgomery County,601,1053,-452
37,North Carolina,47,Tennessee,131,Obion County,0,4,-4
37,North Carolina,47,Tennessee,133,Overton County,75,2,73
37,North Carolina,47,Tennessee,139,Polk County,0,1,-1
37,North Carolina,47,Tennessee,141,Putnam County,29,80,-51
37,North Carolina,47,Tennessee,143,Rhea County,32,0,32
37,North Carolina,47,Tennessee,147,Robertson County,68,1,67
37,North Carolina,47,Tennessee,149,Rutherford County,218,244,-26
37,North Carolina,47,Tennessee,151,Scott County,17,0,17
37,North Carolina,47,Tennessee,153,Sequatchie County,9,24,-15
37,North Carolina,47,Tennessee,155,Sevier County,176,129,47
37,North Carolina,47,Tennessee,157,Shelby County,1061,910,151
37,North Carolina,47,Tennessee,159,Smith County,12,7,5
37,North Carolina,47,Tennessee,163,Sullivan County,307,455,-148
37,North Carolina,47,Tennessee,165,Sumner County,107,206,-99
37,North Carolina,47,Tennessee,167,Tipton County,0,25,-25
37,North Carolina,47,Tennessee,171,Unicoi County,94,273,-179
37,North Carolina,47,Tennessee,173,Union County,14,0,14
37,North Carolina,47,Tennessee,179,Washington County,552,464,88
37,North Carolina,47,Tennessee,181,Wayne County,0,19,-19
37,North Carolina,47,Tennessee,183,Weakley County,0,16,-16
37,North Carolina,47,Tennessee,187,Williamson County,86,490,-404
37,North Carolina,47,Tennessee,189,Wilson County,70,96,-26
37,North Carolina,48,Texas,5,Angelina County,0,27,-27
37,North Carolina,48,Texas,9,Archer County,16,0,16
37,North Carolina,48,Texas,15,Austin County,13,0,13
37,North Carolina,48,Texas,21,Bastrop County,61,270,-209
37,North Carolina,48,Texas,27,Bell County,787,952,-165
37,North Carolina,48,Texas,29,Bexar County,1278,1670,-392
37,North Carolina,48,Texas,31,Blanco County,22,0,22
37,North Carolina,48,Texas,35,Bosque County,3,0,3
37,North Carolina,48,Texas,39,Brazoria County,104,53,51
37,North Carolina,48,Texas,41,Brazos County,144,89,55
37,North Carolina,48,Texas,47,Brooks County,66,0,66
37,North Carolina,48,Texas,53,Burnet County,0,35,-35
37,North Carolina,48,Texas,55,Caldwell County,17,26,-9
37,North Carolina,48,Texas,59,Callahan County,27,0,27
37,North Carolina,48,Texas,61,Cameron County,35,46,-11
37,North Carolina,48,Texas,65,Carson County,0,2,-2
37,North Carolina,48,Texas,67,Cass County,0,20,-20
37,North Carolina,48,Texas,69,Castro County,30,0,30
37,North Carolina,48,Texas,71,Chambers County,3,0,3
37,North Carolina,48,Texas,73,Cherokee County,118,22,96
37,North Carolina,48,Texas,85,Collin County,206,677,-471
37,North Carolina,48,Texas,91,Comal County,52,80,-28
37,North Carolina,48,Texas,95,Concho County,0,5,-5
37,North Carolina,48,Texas,99,Coryell County,35,216,-181
37,North Carolina,48,Texas,113,Dallas County,1155,1099,56
37,North Carolina,48,Texas,121,Denton County,306,363,-57
37,North Carolina,48,Texas,133,Eastland County,39,0,39
37,North Carolina,48,Texas,135,Ector County,17,222,-205
37,North Carolina,48,Texas,139,Ellis County,99,100,-1
37,North Carolina,48,Texas,141,El Paso County,1379,917,462
37,North Carolina,48,Texas,143,Erath County,0,68,-68
37,North Carolina,48,Texas,145,Falls County,0,5,-5
37,North Carolina,48,Texas,147,Fannin County,12,24,-12
37,North Carolina,48,Texas,149,Fayette County,19,0,19
37,North Carolina,48,Texas,157,Fort Bend County,171,507,-336
37,North Carolina,48,Texas,161,Freestone County,0,23,-23
37,North Carolina,48,Texas,163,Frio County,0,16,-16
37,North Carolina,48,Texas,167,Galveston County,74,79,-5
37,North Carolina,48,Texas,179,Gray County,0,23,-23
37,North Carolina,48,Texas,181,Grayson County,31,86,-55
37,North Carolina,48,Texas,183,Gregg County,87,57,30
37,North Carolina,48,Texas,187,Guadalupe County,121,103,18
37,North Carolina,48,Texas,189,Hale County,0,19,-19
37,North Carolina,48,Texas,201,Harris County,2441,2363,78
37,North Carolina,48,Texas,209,Hays County,98,0,98
37,North Carolina,48,Texas,211,Hemphill County,0,50,-50
37,North Carolina,48,Texas,213,Henderson County,39,30,9
37,North Carolina,48,Texas,215,Hidalgo County,40,0,40
37,North Carolina,48,Texas,217,Hill County,21,7,14
37,North Carolina,48,Texas,219,Hockley County,18,0,18
37,North Carolina,48,Texas,221,Hood County,0,31,-31
37,North Carolina,48,Texas,223,Hopkins County,10,0,10
37,North Carolina,48,Texas,227,Howard County,128,0,128
37,North Carolina,48,Texas,231,Hunt County,52,88,-36
37,North Carolina,48,Texas,233,Hutchinson County,15,0,15
37,North Carolina,48,Texas,235,Irion County,15,0,15
37,North Carolina,48,Texas,245,Jefferson County,58,26,32
37,North Carolina,48,Texas,251,Johnson County,0,11,-11
37,North Carolina,48,Texas,257,Kaufman County,10,0,10
37,North Carolina,48,Texas,265,Kerr County,19,0,19
37,North Carolina,48,Texas,273,Kleberg County,10,12,-2
37,North Carolina,48,Texas,281,Lampasas County,0,45,-45
37,North Carolina,48,Texas,285,Lavaca County,0,26,-26
37,North Carolina,48,Texas,291,Liberty County,15,0,15
37,North Carolina,48,Texas,293,Limestone County,30,0,30
37,North Carolina,48,Texas,303,Lubbock County,27,154,-127
37,North Carolina,48,Texas,309,McLennan County,0,84,-84
37,North Carolina,48,Texas,321,Matagorda County,2,16,-14
37,North Carolina,48,Texas,323,Maverick County,17,0,17
37,North Carolina,48,Texas,329,Midland County,165,86,79
37,North Carolina,48,Texas,339,Montgomery County,529,347,182
37,North Carolina,48,Texas,347,Nacogdoches County,15,0,15
37,North Carolina,48,Texas,349,Navarro County,0,3,-3
37,North Carolina,48,Texas,355,Nueces County,101,256,-155
37,North Carolina,48,Texas,361,Orange County,0,4,-4
37,North Carolina,48,Texas,365,Panola County,40,0,40
37,North Carolina,48,Texas,367,Parker County,23,74,-51
37,North Carolina,48,Texas,373,Polk County,41,0,41
37,North Carolina,48,Texas,375,Potter County,0,80,-80
37,North Carolina,48,Texas,379,Rains County,25,0,25
37,North Carolina,48,Texas,381,Randall County,97,17,80
37,North Carolina,48,Texas,389,Reeves County,4,0,4
37,North Carolina,48,Texas,395,Robertson County,33,0,33
37,North Carolina,48,Texas,397,Rockwall County,107,148,-41
37,North Carolina,48,Texas,405,San Augustine County,0,10,-10
37,North Carolina,48,Texas,407,San Jacinto County,27,115,-88
37,North Carolina,48,Texas,409,San Patricio County,141,96,45
37,North Carolina,48,Texas,413,Schleicher County,89,0,89
37,North Carolina,48,Texas,423,Smith County,57,30,27
37,North Carolina,48,Texas,437,Swisher County,3,0,3
37,North Carolina,48,Texas,439,Tarrant County,674,597,77
37,North Carolina,48,Texas,441,Taylor County,64,75,-11
37,North Carolina,48,Texas,445,Terry County,0,4,-4
37,North Carolina,48,Texas,451,Tom Green County,195,328,-133
37,North Carolina,48,Texas,453,Travis County,659,817,-158
37,North Carolina,48,Texas,459,Upshur County,8,85,-77
37,North Carolina,48,Texas,463,Uvalde County,0,22,-22
37,North Carolina,48,Texas,465,Val Verde County,13,38,-25
37,North Carolina,48,Texas,467,Van Zandt County,8,0,8
37,North Carolina,48,Texas,469,Victoria County,47,0,47
37,North Carolina,48,Texas,471,Walker County,10,12,-2
37,North Carolina,48,Texas,473,Waller County,0,14,-14
37,North Carolina,48,Texas,477,Washington County,0,9,-9
37,North Carolina,48,Texas,479,Webb County,43,50,-7
37,North Carolina,48,Texas,483,Wheeler County,0,3,-3
37,North Carolina,48,Texas,485,Wichita County,181,197,-16
37,North Carolina,48,Texas,487,Wilbarger County,0,8,-8
37,North Carolina,48,Texas,489,Willacy County,11,0,11
37,North Carolina,48,Texas,491,Williamson County,333,229,104
37,North Carolina,48,Texas,493,Wilson County,0,5,-5
37,North Carolina,48,Texas,499,Wood County,50,48,2
37,North Carolina,49,Utah,3,Box Elder County,2,19,-17
37,North Carolina,49,Utah,5,Cache County,0,97,-97
37,North Carolina,49,Utah,11,Davis County,114,313,-199
37,North Carolina,49,Utah,17,Garfield County,0,11,-11
37,North Carolina,49,Utah,19,Grand County,30,0,30
37,North Carolina,49,Utah,21,Iron County,53,6,47
37,North Carolina,49,Utah,25,Kane County,9,0,9
37,North Carolina,49,Utah,27,Millard County,0,14,-14
37,North Carolina,49,Utah,35,Salt Lake County,341,375,-34
37,North Carolina,49,Utah,39,Sanpete County,0,4,-4
37,North Carolina,49,Utah,43,Summit County,52,77,-25
37,North Carolina,49,Utah,45,Tooele County,0,20,-20
37,North Carolina,49,Utah,49,Utah County,189,355,-166
37,North Carolina,49,Utah,53,Washington County,104,5,99
37,North Carolina,49,Utah,57,Weber County,83,39,44
37,North Carolina,5,Arkansas,5,Baxter County,20,0,20
37,North Carolina,5,Arkansas,7,Benton County,188,460,-272
37,North Carolina,5,Arkansas,9,Boone County,0,25,-25
37,North Carolina,5,Arkansas,19,Clark County,56,0,56
37,North Carolina,5,Arkansas,23,Cleburne County,18,0,18
37,North Carolina,5,Arkansas,31,Craighead County,85,0,85
37,North Carolina,5,Arkansas,33,Crawford County,20,25,-5
37,North Carolina,5,Arkansas,41,Desha County,0,1,-1
37,North Carolina,5,Arkansas,45,Faulkner County,23,128,-105
37,North Carolina,5,Arkansas,47,Franklin County,0,2,-2
37,North Carolina,5,Arkansas,51,Garland County,5,9,-4
37,North Carolina,5,Arkansas,53,Grant County,0,65,-65
37,North Carolina,5,Arkansas,57,Hempstead County,0,125,-125
37,North Carolina,5,Arkansas,59,Hot Spring County,15,11,4
37,North Carolina,5,Arkansas,65,Izard County,41,3,38
37,North Carolina,5,Arkansas,69,Jefferson County,0,19,-19
37,North Carolina,5,Arkansas,75,Lawrence County,26,0,26
37,North Carolina,5,Arkansas,77,Lee County,31,0,31
37,North Carolina,5,Arkansas,81,Little River County,0,8,-8
37,North Carolina,5,Arkansas,85,Lonoke County,29,108,-79
37,North Carolina,5,Arkansas,91,Miller County,14,12,2
37,North Carolina,5,Arkansas,93,Mississippi County,0,4,-4
37,North Carolina,5,Arkansas,99,Nevada County,0,5,-5
37,North Carolina,5,Arkansas,103,Ouachita County,0,9,-9
37,North Carolina,5,Arkansas,113,Polk County,0,18,-18
37,North Carolina,5,Arkansas,115,Pope County,36,0,36
37,North Carolina,5,Arkansas,119,Pulaski County,101,30,71
37,North Carolina,5,Arkansas,123,St. Francis County,0,24,-24
37,North Carolina,5,Arkansas,125,Saline County,37,0,37
37,North Carolina,5,Arkansas,127,Scott County,21,0,21
37,North Carolina,5,Arkansas,129,Searcy County,12,0,12
37,North Carolina,5,Arkansas,131,Sebastian County,27,0,27
37,North Carolina,5,Arkansas,135,Sharp County,0,5,-5
37,North Carolina,5,Arkansas,139,Union County,0,22,-22
37,North Carolina,5,Arkansas,143,Washington County,60,108,-48
37,North Carolina,5,Arkansas,145,White County,0,31,-31
37,North Carolina,50,Vermont,1,Addison County,0,33,-33
37,North Carolina,50,Vermont,3,Bennington County,9,15,-6
37,North Carolina,50,Vermont,5,Caledonia County,0,39,-39
37,North Carolina,50,Vermont,7,Chittenden County,359,110,249
37,North Carolina,50,Vermont,9,Essex County,0,10,-10
37,North Carolina,50,Vermont,11,Franklin County,41,19,22
37,North Carolina,50,Vermont,13,Grand Isle County,7,8,-1
37,North Carolina,50,Vermont,17,Orange County,0,3,-3
37,North Carolina,50,Vermont,19,Orleans County,12,28,-16
37,North Carolina,50,Vermont,21,Rutland County,36,127,-91
37,North Carolina,50,Vermont,23,Washington County,103,5,98
37,North Carolina,50,Vermont,25,Windham County,57,31,26
37,North Carolina,50,Vermont,27,Windsor County,0,3,-3
37,North Carolina,51,Virginia,1,Accomack County,62,21,41
37,North Carolina,51,Virginia,3,Albemarle County,512,219,293
37,North Carolina,51,Virginia,5,Alleghany County,0,8,-8
37,North Carolina,51,Virginia,7,Amelia County,50,0,50
37,North Carolina,51,Virginia,9,Amherst County,100,156,-56
37,North Carolina,51,Virginia,11,Appomattox County,0,9,-9
37,North Carolina,51,Virginia,13,Arlington County,672,524,148
37,North Carolina,51,Virginia,15,Augusta County,167,184,-17
37,North Carolina,51,Virginia,17,Bath County,14,24,-10
37,North Carolina,51,Virginia,19,Bedford County,291,146,145
37,North Carolina,51,Virginia,21,Bland County,0,5,-5
37,North Carolina,51,Virginia,23,Botetourt County,303,0,303
37,North Carolina,51,Virginia,25,Brunswick County,31,110,-79
37,North Carolina,51,Virginia,27,Buchanan County,99,23,76
37,North Carolina,51,Virginia,29,Buckingham County,67,0,67
37,North Carolina,51,Virginia,31,Campbell County,107,94,13
37,North Carolina,51,Virginia,33,Caroline County,15,24,-9
37,North Carolina,51,Virginia,35,Carroll County,518,267,251
37,North Carolina,51,Virginia,36,Charles City County,0,18,-18
37,North Carolina,51,Virginia,37,Charlotte County,45,0,45
37,North Carolina,51,Virginia,41,Chesterfield County,629,899,-270
37,North Carolina,51,Virginia,43,Clarke County,18,69,-51
37,North Carolina,51,Virginia,45,Craig County,0,20,-20
37,North Carolina,51,Virginia,47,Culpeper County,266,55,211
37,North Carolina,51,Virginia,51,Dickenson County,1,29,-28
37,North Carolina,51,Virginia,53,Dinwiddie County,18,21,-3
37,North Carolina,51,Virginia,57,Essex County,9,0,9
37,North Carolina,51,Virginia,59,Fairfax County,3073,1570,1503
37,North Carolina,51,Virginia,61,Fauquier County,186,25,161
37,North Carolina,51,Virginia,63,Floyd County,22,23,-1
37,North Carolina,51,Virginia,65,Fluvanna County,183,27,156
37,North Carolina,51,Virginia,67,Franklin County,127,162,-35
37,North Carolina,51,Virginia,69,Frederick County,105,68,37
37,North Carolina,51,Virginia,71,Giles County,1,12,-11
37,North Carolina,51,Virginia,73,Gloucester County,139,64,75
37,North Carolina,51,Virginia,75,Goochland County,36,103,-67
37,North Carolina,51,Virginia,77,Grayson County,110,55,55
37,North Carolina,51,Virginia,79,Greene County,143,0,143
37,North Carolina,51,Virginia,81,Greensville County,63,63,0
37,North Carolina,51,Virginia,83,Halifax County,113,317,-204
37,North Carolina,51,Virginia,85,Hanover County,127,111,16
37,North Carolina,51,Virginia,87,Henrico County,841,830,11
37,North Carolina,51,Virginia,89,Henry County,313,216,97
37,North Carolina,51,Virginia,93,Isle of Wight County,64,31,33
37,North Carolina,51,Virginia,95,James City County,247,138,109
37,North Carolina,51,Virginia,97,King and Queen County,0,51,-51
37,North Carolina,51,Virginia,99,King George County,10,87,-77
37,North Carolina,51,Virginia,101,King William County,0,9,-9
37,North Carolina,51,Virginia,103,Lancaster County,90,48,42
37,North Carolina,51,Virginia,105,Lee County,25,37,-12
37,North Carolina,51,Virginia,107,Loudoun County,641,524,117
37,North Carolina,51,Virginia,109,Louisa County,123,88,35
37,North Carolina,51,Virginia,111,Lunenburg County,9,6,3
37,North Carolina,51,Virginia,113,Madison County,19,16,3
37,North Carolina,51,Virginia,115,Mathews County,19,16,3
37,North Carolina,51,Virginia,117,Mecklenburg County,317,173,144
37,North Carolina,51,Virginia,119,Middlesex County,0,25,-25
37,North Carolina,51,Virginia,121,Montgomery County,443,549,-106
37,North Carolina,51,Virginia,127,New Kent County,64,0,64
37,North Carolina,51,Virginia,131,Northampton County,1,19,-18
37,North Carolina,51,Virginia,135,Nottoway County,92,19,73
37,North Carolina,51,Virginia,137,Orange County,151,40,111
37,North Carolina,51,Virginia,139,Page County,49,10,39
37,North Carolina,51,Virginia,141,Patrick County,274,134,140
37,North Carolina,51,Virginia,143,Pittsylvania County,391,226,165
37,North Carolina,51,Virginia,145,Powhatan County,33,0,33
37,North Carolina,51,Virginia,147,Prince Edward County,38,119,-81
37,North Carolina,51,Virginia,149,Prince George County,710,258,452
37,North Carolina,51,Virginia,153,Prince William County,1455,1174,281
37,North Carolina,51,Virginia,155,Pulaski County,93,57,36
37,North Carolina,51,Virginia,157,Rappahannock County,33,0,33
37,North Carolina,51,Virginia,161,Roanoke County,378,278,100
37,North Carolina,51,Virginia,163,Rockbridge County,37,107,-70
37,North Carolina,51,Virginia,165,Rockingham County,165,44,121
37,North Carolina,51,Virginia,167,Russell County,144,63,81
37,North Carolina,51,Virginia,171,Shenandoah County,48,0,48
37,North Carolina,51,Virginia,173,Smyth County,76,48,28
37,North Carolina,51,Virginia,175,Southampton County,180,29,151
37,North Carolina,51,Virginia,177,Spotsylvania County,587,322,265
37,North Carolina,51,Virginia,179,Stafford County,781,831,-50
37,North Carolina,51,Virginia,181,Surry County,2,10,-8
37,North Carolina,51,Virginia,183,Sussex County,0,3,-3
37,North Carolina,51,Virginia,185,Tazewell County,116,48,68
37,North Carolina,51,Virginia,187,Warren County,108,37,71
37,North Carolina,51,Virginia,191,Washington County,107,144,-37
37,North Carolina,51,Virginia,193,Westmoreland County,0,29,-29
37,North Carolina,51,Virginia,195,Wise County,127,96,31
37,North Carolina,51,Virginia,197,Wythe County,95,42,53
37,North Carolina,51,Virginia,199,York County,129,149,-20
37,North Carolina,51,Virginia,510,Alexandria city,842,361,481
37,North Carolina,51,Virginia,520,Bristol city,28,38,-10
37,North Carolina,51,Virginia,530,Buena Vista city,0,12,-12
37,North Carolina,51,Virginia,540,Charlottesville city,119,114,5
37,North Carolina,51,Virginia,550,Chesapeake city,1307,629,678
37,North Carolina,51,Virginia,570,Colonial Heights city,140,77,63
37,North Carolina,51,Virginia,580,Covington city,4,22,-18
37,North Carolina,51,Virginia,590,Danville city,485,287,198
37,North Carolina,51,Virginia,595,Emporia city,10,40,-30
37,North Carolina,51,Virginia,600,Fairfax city,198,0,198
37,North Carolina,51,Virginia,620,Franklin city,17,0,17
37,North Carolina,51,Virginia,630,Fredericksburg city,66,18,48
37,North Carolina,51,Virginia,640,Galax city,11,64,-53
37,North Carolina,51,Virginia,650,Hampton city,470,708,-238
37,North Carolina,51,Virginia,660,Harrisonburg city,101,159,-58
37,North Carolina,51,Virginia,670,Hopewell city,123,0,123
37,North Carolina,51,Virginia,678,Lexington city,31,56,-25
37,North Carolina,51,Virginia,680,Lynchburg city,224,804,-580
37,North Carolina,51,Virginia,683,Manassas city,108,145,-37
37,North Carolina,51,Virginia,685,Manassas Park city,37,8,29
37,North Carolina,51,Virginia,690,Martinsville city,65,86,-21
37,North Carolina,51,Virginia,700,Newport News city,1200,899,301
37,North Carolina,51,Virginia,710,Norfolk city,1441,1035,406
37,North Carolina,51,Virginia,720,Norton city,0,17,-17
37,North Carolina,51,Virginia,730,Petersburg city,235,111,124
37,North Carolina,51,Virginia,735,Poquoson city,113,40,73
37,North Carolina,51,Virginia,740,Portsmouth city,1160,183,977
37,North Carolina,51,Virginia,750,Radford city,413,79,334
37,North Carolina,51,Virginia,760,Richmond city,708,392,316
37,North Carolina,51,Virginia,770,Roanoke city,567,308,259
37,North Carolina,51,Virginia,775,Salem city,36,67,-31
37,North Carolina,51,Virginia,790,Staunton city,62,1,61
37,North Carolina,51,Virginia,800,Suffolk city,416,322,94
37,North Carolina,51,Virginia,810,Virginia Beach city,1932,2061,-129
37,North Carolina,51,Virginia,820,Waynesboro city,116,11,105
37,North Carolina,51,Virginia,830,Williamsburg city,12,50,-38
37,North Carolina,51,Virginia,840,Winchester city,70,188,-118
37,North Carolina,53,Washington,3,Asotin County,13,258,-245
37,North Carolina,53,Washington,5,Benton County,15,146,-131
37,North Carolina,53,Washington,9,Clallam County,36,52,-16
37,North Carolina,53,Washington,11,Clark County,291,169,122
37,North Carolina,53,Washington,15,Cowlitz County,28,0,28
37,North Carolina,53,Washington,19,Ferry County,0,13,-13
37,North Carolina,53,Washington,21,Franklin County,19,0,19
37,North Carolina,53,Washington,25,Grant County,0,4,-4
37,North Carolina,53,Washington,29,Island County,279,50,229
37,North Carolina,53,Washington,33,King County,914,1362,-448
37,North Carolina,53,Washington,35,Kitsap County,37,276,-239
37,North Carolina,53,Washington,37,Kittitas County,0,57,-57
37,North Carolina,53,Washington,41,Lewis County,61,0,61
37,North Carolina,53,Washington,45,Mason County,0,36,-36
37,North Carolina,53,Washington,47,Okanogan County,0,2,-2
37,North Carolina,53,Washington,49,Pacific County,0,1,-1
37,North Carolina,53,Washington,53,Pierce County,690,1357,-667
37,North Carolina,53,Washington,55,San Juan County,0,13,-13
37,North Carolina,53,Washington,57,Skagit County,11,13,-2
37,North Carolina,53,Washington,61,Snohomish County,438,239,199
37,North Carolina,53,Washington,63,Spokane County,282,484,-202
37,North Carolina,53,Washington,67,Thurston County,352,613,-261
37,North Carolina,53,Washington,73,Whatcom County,65,49,16
37,North Carolina,53,Washington,75,Whitman County,57,24,33
37,North Carolina,53,Washington,77,Yakima County,58,54,4
37,North Carolina,54,West Virginia,1,Barbour County,12,9,3
37,North Carolina,54,West Virginia,3,Berkeley County,156,199,-43
37,North Carolina,54,West Virginia,5,Boone County,0,89,-89
37,North Carolina,54,West Virginia,9,Brooke County,0,72,-72
37,North Carolina,54,West Virginia,11,Cabell County,187,196,-9
37,North Carolina,54,West Virginia,13,Calhoun County,1,0,1
37,North Carolina,54,West Virginia,15,Clay County,8,0,8
37,North Carolina,54,West Virginia,19,Fayette County,45,22,23
37,North Carolina,54,West Virginia,21,Gilmer County,0,52,-52
37,North Carolina,54,West Virginia,23,Grant County,1,10,-9
37,North Carolina,54,West Virginia,25,Greenbrier County,155,177,-22
37,North Carolina,54,West Virginia,27,Hampshire County,20,0,20
37,North Carolina,54,West Virginia,29,Hancock County,8,42,-34
37,North Carolina,54,West Virginia,31,Hardy County,42,0,42
37,North Carolina,54,West Virginia,33,Harrison County,49,34,15
37,North Carolina,54,West Virginia,37,Jefferson County,77,62,15
37,North Carolina,54,West Virginia,39,Kanawha County,509,184,325
37,North Carolina,54,West Virginia,41,Lewis County,22,0,22
37,North Carolina,54,West Virginia,43,Lincoln County,27,30,-3
37,North Carolina,54,West Virginia,45,Logan County,64,16,48
37,North Carolina,54,West Virginia,47,McDowell County,105,56,49
37,North Carolina,54,West Virginia,49,Marion County,39,87,-48
37,North Carolina,54,West Virginia,51,Marshall County,7,0,7
37,North Carolina,54,West Virginia,53,Mason County,20,0,20
37,North Carolina,54,West Virginia,55,Mercer County,385,377,8
37,North Carolina,54,West Virginia,57,Mineral County,223,0,223
37,North Carolina,54,West Virginia,59,Mingo County,134,89,45
37,North Carolina,54,West Virginia,61,Monongalia County,298,127,171
37,North Carolina,54,West Virginia,63,Monroe County,0,22,-22
37,North Carolina,54,West Virginia,65,Morgan County,50,0,50
37,North Carolina,54,West Virginia,67,Nicholas County,39,93,-54
37,North Carolina,54,West Virginia,69,Ohio County,13,22,-9
37,North Carolina,54,West Virginia,71,Pendleton County,0,3,-3
37,North Carolina,54,West Virginia,75,Pocahontas County,116,0,116
37,North Carolina,54,West Virginia,77,Preston County,0,40,-40
37,North Carolina,54,West Virginia,79,Putnam County,64,0,64
37,North Carolina,54,West Virginia,81,Raleigh County,439,139,300
37,North Carolina,54,West Virginia,85,Ritchie County,2,0,2
37,North Carolina,54,West Virginia,87,Roane County,0,41,-41
37,North Carolina,54,West Virginia,89,Summers County,46,57,-11
37,North Carolina,54,West Virginia,91,Taylor County,49,0,49
37,North Carolina,54,West Virginia,93,Tucker County,28,2,26
37,North Carolina,54,West Virginia,95,Tyler County,1,8,-7
37,North Carolina,54,West Virginia,97,Upshur County,49,0,49
37,North Carolina,54,West Virginia,99,Wayne County,3,0,3
37,North Carolina,54,West Virginia,107,Wood County,53,33,20
37,North Carolina,54,West Virginia,109,Wyoming County,59,41,18
37,North Carolina,55,Wisconsin,5,Barron County,0,6,-6
37,North Carolina,55,Wisconsin,9,Brown County,92,154,-62
37,North Carolina,55,Wisconsin,11,Buffalo County,30,0,30
37,North Carolina,55,Wisconsin,13,Burnett County,0,15,-15
37,North Carolina,55,Wisconsin,17,Chippewa County,0,13,-13
37,North Carolina,55,Wisconsin,21,Columbia County,0,21,-21
37,North Carolina,55,Wisconsin,25,Dane County,238,283,-45
37,North Carolina,55,Wisconsin,27,Dodge County,13,5,8
37,North Carolina,55,Wisconsin,29,Door County,0,1,-1
37,North Carolina,55,Wisconsin,31,Douglas County,15,0,15
37,North Carolina,55,Wisconsin,35,Eau Claire County,0,36,-36
37,North Carolina,55,Wisconsin,39,Fond du Lac County,13,2,11
37,North Carolina,55,Wisconsin,43,Grant County,0,1,-1
37,North Carolina,55,Wisconsin,45,Green County,0,9,-9
37,North Carolina,55,Wisconsin,53,Jackson County,0,10,-10
37,North Carolina,55,Wisconsin,55,Jefferson County,0,3,-3
37,North Carolina,55,Wisconsin,57,Juneau County,0,8,-8
37,North Carolina,55,Wisconsin,59,Kenosha County,206,72,134
37,North Carolina,55,Wisconsin,61,Kewaunee County,16,0,16
37,North Carolina,55,Wisconsin,63,La Crosse County,19,8,11
37,North Carolina,55,Wisconsin,65,Lafayette County,11,0,11
37,North Carolina,55,Wisconsin,71,Manitowoc County,14,11,3
37,North Carolina,55,Wisconsin,73,Marathon County,59,34,25
37,North Carolina,55,Wisconsin,77,Marquette County,0,6,-6
37,North Carolina,55,Wisconsin,79,Milwaukee County,471,359,112
37,North Carolina,55,Wisconsin,81,Monroe County,0,41,-41
37,North Carolina,55,Wisconsin,83,Oconto County,38,0,38
37,North Carolina,55,Wisconsin,87,Outagamie County,0,40,-40
37,North Carolina,55,Wisconsin,89,Ozaukee County,0,56,-56
37,North Carolina,55,Wisconsin,97,Portage County,0,75,-75
37,North Carolina,55,Wisconsin,99,Price County,0,42,-42
37,North Carolina,55,Wisconsin,101,Racine County,137,54,83
37,North Carolina,55,Wisconsin,103,Richland County,0,3,-3
37,North Carolina,55,Wisconsin,105,Rock County,3,54,-51
37,North Carolina,55,Wisconsin,111,Sauk County,0,4,-4
37,North Carolina,55,Wisconsin,117,Sheboygan County,152,32,120
37,North Carolina,55,Wisconsin,119,Taylor County,0,9,-9
37,North Carolina,55,Wisconsin,123,Vernon County,5,0,5
37,North Carolina,55,Wisconsin,127,Walworth County,50,36,14
37,North Carolina,55,Wisconsin,129,Washburn County,0,1,-1
37,North Carolina,55,Wisconsin,131,Washington County,0,33,-33
37,North Carolina,55,Wisconsin,133,Waukesha County,279,233,46
37,North Carolina,55,Wisconsin,139,Winnebago County,108,260,-152
37,North Carolina,55,Wisconsin,141,Wood County,14,0,14
37,North Carolina,56,Wyoming,1,Albany County,32,25,7
37,North Carolina,56,Wyoming,9,Converse County,36,0,36
37,North Carolina,56,Wyoming,13,Fremont County,9,0,9
37,North Carolina,56,Wyoming,15,Goshen County,0,4,-4
37,North Carolina,56,Wyoming,19,Johnson County,12,0,12
37,North Carolina,56,Wyoming,21,Laramie County,7,119,-112
37,North Carolina,56,Wyoming,25,Natrona County,22,0,22
37,North Carolina,56,Wyoming,29,Park County,79,0,79
37,North Carolina,56,Wyoming,37,Sweetwater County,24,6,18
37,North Carolina,56,Wyoming,39,Teton County,37,11,26
37,North Carolina,56,Wyoming,41,Uinta County,22,0,22
37,North Carolina,56,Wyoming,45,Weston County,11,0,11
37,North Carolina,6,California,1,Alameda County,863,741,122
37,North Carolina,6,California,5,Amador County,14,22,-8
37,North Carolina,6,California,7,Butte County,0,42,-42
37,North Carolina,6,California,9,Calaveras County,0,12,-12
37,North Carolina,6,California,13,Contra Costa County,394,429,-35
37,North Carolina,6,California,15,Del Norte County,21,0,21
37,North Carolina,6,California,17,El Dorado County,65,0,65
37,North Carolina,6,California,19,Fresno County,119,169,-50
37,North Carolina,6,California,23,Humboldt County,68,13,55
37,North Carolina,6,California,25,Imperial County,54,7,47
37,North Carolina,6,California,29,Kern County,363,124,239
37,North Carolina,6,California,31,Kings County,0,74,-74
37,North Carolina,6,California,33,Lake County,2,56,-54
37,North Carolina,6,California,35,Lassen County,16,0,16
37,North Carolina,6,California,37,Los Angeles County,2794,1939,855
37,North Carolina,6,California,39,Madera County,24,41,-17
37,North Carolina,6,California,41,Marin County,99,118,-19
37,North Carolina,6,California,43,Mariposa County,0,6,-6
37,North Carolina,6,California,45,Mendocino County,12,0,12
37,North Carolina,6,California,47,Merced County,27,33,-6
37,North Carolina,6,California,53,Monterey County,600,433,167
37,North Carolina,6,California,55,Napa County,74,55,19
37,North Carolina,6,California,57,Nevada County,7,0,7
37,North Carolina,6,California,59,Orange County,1321,485,836
37,North Carolina,6,California,61,Placer County,128,11,117
37,North Carolina,6,California,63,Plumas County,9,11,-2
37,North Carolina,6,California,65,Riverside County,1060,853,207
37,North Carolina,6,California,67,Sacramento County,550,710,-160
37,North Carolina,6,California,71,San Bernardino County,1887,1174,713
37,North Carolina,6,California,73,San Diego County,4256,2714,1542
37,North Carolina,6,California,75,San Francisco County,488,406,82
37,North Carolina,6,California,77,San Joaquin County,88,101,-13
37,North Carolina,6,California,79,San Luis Obispo County,35,77,-42
37,North Carolina,6,California,81,San Mateo County,439,134,305
37,North Carolina,6,California,83,Santa Barbara County,154,55,99
37,North Carolina,6,California,85,Santa Clara County,1098,1027,71
37,North Carolina,6,California,87,Santa Cruz County,56,116,-60
37,North Carolina,6,California,89,Shasta County,160,110,50
37,North Carolina,6,California,93,Siskiyou County,9,0,9
37,North Carolina,6,California,95,Solano County,85,246,-161
37,North Carolina,6,California,97,Sonoma County,109,34,75
37,North Carolina,6,California,99,Stanislaus County,112,43,69
37,North Carolina,6,California,101,Sutter County,6,23,-17
37,North Carolina,6,California,103,Tehama County,0,47,-47
37,North Carolina,6,California,107,Tulare County,55,75,-20
37,North Carolina,6,California,109,Tuolumne County,10,20,-10
37,North Carolina,6,California,111,Ventura County,248,111,137
37,North Carolina,6,California,113,Yolo County,53,26,27
37,North Carolina,6,California,115,Yuba County,5,11,-6
37,North Carolina,72,Puerto Rico,3,Aguada Municipio,89,0,89
37,North Carolina,72,Puerto Rico,5,Aguadilla Municipio,47,0,47
37,North Carolina,72,Puerto Rico,9,Aibonito Municipio,29,0,29
37,North Carolina,72,Puerto Rico,11,Añasco Municipio,0,24,-24
37,North Carolina,72,Puerto Rico,13,Arecibo Municipio,152,11,141
37,North Carolina,72,Puerto Rico,17,Barceloneta Municipio,63,0,63
37,North Carolina,72,Puerto Rico,21,Bayamón Municipio,179,31,148
37,North Carolina,72,Puerto Rico,25,Caguas Municipio,34,0,34
37,North Carolina,72,Puerto Rico,31,Carolina Municipio,103,30,73
37,North Carolina,72,Puerto Rico,37,Ceiba Municipio,0,107,-107
37,North Carolina,72,Puerto Rico,43,Coamo Municipio,14,29,-15
37,North Carolina,72,Puerto Rico,45,Comerío Municipio,29,0,29
37,North Carolina,72,Puerto Rico,57,Guayama Municipio,10,0,10
37,North Carolina,72,Puerto Rico,61,Guaynabo Municipio,33,0,33
37,North Carolina,72,Puerto Rico,63,Gurabo Municipio,69,0,69
37,North Carolina,72,Puerto Rico,75,Juana Díaz Municipio,0,2,-2
37,North Carolina,72,Puerto Rico,79,Lajas Municipio,0,98,-98
37,North Carolina,72,Puerto Rico,91,Manatí Municipio,11,0,11
37,North Carolina,72,Puerto Rico,97,Mayagüez Municipio,171,30,141
37,North Carolina,72,Puerto Rico,103,Naguabo Municipio,68,0,68
37,North Carolina,72,Puerto Rico,105,Naranjito Municipio,28,0,28
37,North Carolina,72,Puerto Rico,107,Orocovis Municipio,63,0,63
37,North Carolina,72,Puerto Rico,109,Patillas Municipio,47,0,47
37,North Carolina,72,Puerto Rico,113,Ponce Municipio,75,0,75
37,North Carolina,72,Puerto Rico,115,Quebradillas Municipio,91,0,91
37,North Carolina,72,Puerto Rico,125,San Germán Municipio,5,0,5
37,North Carolina,72,Puerto Rico,127,San Juan Municipio,140,17,123
37,North Carolina,72,Puerto Rico,137,Toa Baja Municipio,45,0,45
37,North Carolina,72,Puerto Rico,139,Trujillo Alto Municipio,0,21,-21
37,North Carolina,72,Puerto Rico,149,Villalba Municipio,63,0,63
37,North Carolina,72,Puerto Rico,151,Yabucoa Municipio,12,0,12
37,North Carolina,72,Puerto Rico,153,Yauco Municipio,56,0,56
37,North Carolina,8,Colorado,1,Adams County,314,321,-7
37,North Carolina,8,Colorado,3,Alamosa County,0,13,-13
37,North Carolina,8,Colorado,5,Arapahoe County,540,500,40
37,North Carolina,8,Colorado,13,Boulder County,295,640,-345
37,North Carolina,8,Colorado,14,Broomfield County,22,0,22
37,North Carolina,8,Colorado,19,Clear Creek County,0,128,-128
37,North Carolina,8,Colorado,29,Delta County,15,2,13
37,North Carolina,8,Colorado,31,Denver County,476,417,59
37,North Carolina,8,Colorado,35,Douglas County,187,208,-21
37,North Carolina,8,Colorado,37,Eagle County,20,34,-14
37,North Carolina,8,Colorado,41,El Paso County,1028,1861,-833
37,North Carolina,8,Colorado,43,Fremont County,58,14,44
37,North Carolina,8,Colorado,45,Garfield County,0,1,-1
37,North Carolina,8,Colorado,51,Gunnison County,99,5,94
37,North Carolina,8,Colorado,59,Jefferson County,193,328,-135
37,North Carolina,8,Colorado,63,Kit Carson County,0,5,-5
37,North Carolina,8,Colorado,65,Lake County,0,8,-8
37,North Carolina,8,Colorado,67,La Plata County,79,107,-28
37,North Carolina,8,Colorado,69,Larimer County,657,330,327
37,North Carolina,8,Colorado,73,Lincoln County,0,4,-4
37,North Carolina,8,Colorado,75,Logan County,0,4,-4
37,North Carolina,8,Colorado,77,Mesa County,54,52,2
37,North Carolina,8,Colorado,85,Montrose County,0,18,-18
37,North Carolina,8,Colorado,87,Morgan County,0,6,-6
37,North Carolina,8,Colorado,91,Ouray County,0,16,-16
37,North Carolina,8,Colorado,93,Park County,0,10,-10
37,North Carolina,8,Colorado,97,Pitkin County,20,0,20
37,North Carolina,8,Colorado,99,Prowers County,0,42,-42
37,North Carolina,8,Colorado,101,Pueblo County,88,30,58
37,North Carolina,8,Colorado,103,Rio Blanco County,0,2,-2
37,North Carolina,8,Colorado,105,Rio Grande County,25,0,25
37,North Carolina,8,Colorado,107,Routt County,13,25,-12
37,North Carolina,8,Colorado,111,San Juan County,32,0,32
37,North Carolina,8,Colorado,113,San Miguel County,0,10,-10
37,North Carolina,8,Colorado,117,Summit County,27,6,21
37,North Carolina,8,Colorado,119,Teller County,18,0,18
37,North Carolina,8,Colorado,123,Weld County,45,157,-112
37,North Carolina,9,Connecticut,1,Fairfield County,1432,510,922
37,North Carolina,9,Connecticut,3,Hartford County,1435,288,1147
37,North Carolina,9,Connecticut,5,Litchfield County,339,143,196
37,North Carolina,9,Connecticut,7,Middlesex County,137,48,89
37,North Carolina,9,Connecticut,9,New Haven County,1549,326,1223
37,North Carolina,9,Connecticut,11,New London County,476,231,245
37,North Carolina,9,Connecticut,13,Tolland County,230,18,212
37,North Carolina,9,Connecticut,15,Windham County,86,9,77
37,North Carolina,AFR,Africa,,-,3820,0,0
37,North Carolina,ASI,Asia,,-,23535,0,0
37,North Carolina,CAM,Central America,,-,6869,0,0
37,North Carolina,CAR,Caribbean,,-,2126,0,0
37,North Carolina,EUR,Europe,,-,8974,0,0
37,North Carolina,ISL,U.S. Island Areas,,-,517,0,0
37,North Carolina,NAM,Northern America,,-,1046,0,0
37,North Carolina,OCE,Oceania and At Sea,,-,723,0,0
37,North Carolina,SAM,South America,,-,2350,0,0
38,North Dakota,1,Alabama,1,Autauga County,7,0,7
38,North Dakota,1,Alabama,3,Baldwin County,10,16,-6
38,North Dakota,1,Alabama,21,Chilton County,2,0,2
38,North Dakota,1,Alabama,73,Jefferson County,0,39,-39
38,North Dakota,1,Alabama,89,Madison County,0,15,-15
38,North Dakota,1,Alabama,93,Marion County,12,0,12
38,North Dakota,1,Alabama,97,Mobile County,51,0,51
38,North Dakota,1,Alabama,101,Montgomery County,41,204,-163
38,North Dakota,1,Alabama,113,Russell County,0,10,-10
38,North Dakota,1,Alabama,125,Tuscaloosa County,0,22,-22
38,North Dakota,10,Delaware,1,Kent County,26,0,26
38,North Dakota,10,Delaware,3,New Castle County,0,113,-113
38,North Dakota,11,District of Columbia,1,District of Columbia,29,28,1
38,North Dakota,12,Florida,5,Bay County,0,76,-76
38,North Dakota,12,Florida,7,Bradford County,21,0,21
38,North Dakota,12,Florida,9,Brevard County,48,0,48
38,North Dakota,12,Florida,11,Broward County,147,44,103
38,North Dakota,12,Florida,17,Citrus County,32,0,32
38,North Dakota,12,Florida,19,Clay County,21,0,21
38,North Dakota,12,Florida,21,Collier County,49,52,-3
38,North Dakota,12,Florida,23,Columbia County,0,9,-9
38,North Dakota,12,Florida,31,Duval County,179,0,179
38,North Dakota,12,Florida,33,Escambia County,0,63,-63
38,North Dakota,12,Florida,53,Hernando County,22,63,-41
38,North Dakota,12,Florida,57,Hillsborough County,60,0,60
38,North Dakota,12,Florida,61,Indian River County,15,0,15
38,North Dakota,12,Florida,71,Lee County,7,0,7
38,North Dakota,12,Florida,73,Leon County,11,0,11
38,North Dakota,12,Florida,81,Manatee County,8,12,-4
38,North Dakota,12,Florida,83,Marion County,11,11,0
38,North Dakota,12,Florida,86,Miami-Dade County,16,0,16
38,North Dakota,12,Florida,87,Monroe County,25,0,25
38,North Dakota,12,Florida,89,Nassau County,0,4,-4
38,North Dakota,12,Florida,91,Okaloosa County,17,45,-28
38,North Dakota,12,Florida,93,Okeechobee County,12,0,12
38,North Dakota,12,Florida,95,Orange County,9,0,9
38,North Dakota,12,Florida,97,Osceola County,0,9,-9
38,North Dakota,12,Florida,99,Palm Beach County,96,202,-106
38,North Dakota,12,Florida,101,Pasco County,0,22,-22
38,North Dakota,12,Florida,103,Pinellas County,45,23,22
38,North Dakota,12,Florida,105,Polk County,1,23,-22
38,North Dakota,12,Florida,107,Putnam County,107,0,107
38,North Dakota,12,Florida,113,Santa Rosa County,40,56,-16
38,North Dakota,12,Florida,117,Seminole County,6,0,6
38,North Dakota,12,Florida,121,Suwannee County,0,15,-15
38,North Dakota,12,Florida,127,Volusia County,5,0,5
38,North Dakota,12,Florida,131,Walton County,0,4,-4
38,North Dakota,13,Georgia,13,Barrow County,0,9,-9
38,North Dakota,13,Georgia,19,Berrien County,10,0,10
38,North Dakota,13,Georgia,31,Bulloch County,4,0,4
38,North Dakota,13,Georgia,45,Carroll County,0,15,-15
38,North Dakota,13,Georgia,53,Chattahoochee County,0,14,-14
38,North Dakota,13,Georgia,57,Cherokee County,10,0,10
38,North Dakota,13,Georgia,67,Cobb County,2,0,2
38,North Dakota,13,Georgia,89,DeKalb County,14,0,14
38,North Dakota,13,Georgia,97,Douglas County,21,0,21
38,North Dakota,13,Georgia,103,Effingham County,15,0,15
38,North Dakota,13,Georgia,105,Elbert County,97,0,97
38,North Dakota,13,Georgia,115,Floyd County,0,15,-15
38,North Dakota,13,Georgia,121,Fulton County,51,0,51
38,North Dakota,13,Georgia,135,Gwinnett County,14,0,14
38,North Dakota,13,Georgia,153,Houston County,0,35,-35
38,North Dakota,13,Georgia,179,Liberty County,13,0,13
38,North Dakota,13,Georgia,185,Lowndes County,0,39,-39
38,North Dakota,13,Georgia,209,Montgomery County,0,7,-7
38,North Dakota,13,Georgia,211,Morgan County,2,0,2
38,North Dakota,13,Georgia,215,Muscogee County,12,11,1
38,North Dakota,13,Georgia,225,Peach County,8,0,8
38,North Dakota,13,Georgia,281,Towns County,0,19,-19
38,North Dakota,13,Georgia,291,Union County,28,0,28
38,North Dakota,13,Georgia,311,White County,0,11,-11
38,North Dakota,15,Hawaii,1,Hawaii County,34,0,34
38,North Dakota,15,Hawaii,3,Honolulu County,21,17,4
38,North Dakota,15,Hawaii,7,Kauai County,57,0,57
38,North Dakota,15,Hawaii,9,Maui County,5,0,5
38,North Dakota,16,Idaho,1,Ada County,22,165,-143
38,North Dakota,16,Idaho,5,Bannock County,0,8,-8
38,North Dakota,16,Idaho,9,Benewah County,16,0,16
38,North Dakota,16,Idaho,11,Bingham County,27,0,27
38,North Dakota,16,Idaho,15,Boise County,0,14,-14
38,North Dakota,16,Idaho,17,Bonner County,1,23,-22
38,North Dakota,16,Idaho,19,Bonneville County,226,59,167
38,North Dakota,16,Idaho,27,Canyon County,27,30,-3
38,North Dakota,16,Idaho,31,Cassia County,13,0,13
38,North Dakota,16,Idaho,35,Clearwater County,26,0,26
38,North Dakota,16,Idaho,39,Elmore County,0,1,-1
38,North Dakota,16,Idaho,43,Fremont County,24,0,24
38,North Dakota,16,Idaho,47,Gooding County,0,25,-25
38,North Dakota,16,Idaho,49,Idaho County,15,12,3
38,North Dakota,16,Idaho,51,Jefferson County,0,119,-119
38,North Dakota,16,Idaho,55,Kootenai County,28,105,-77
38,North Dakota,16,Idaho,57,Latah County,0,38,-38
38,North Dakota,16,Idaho,61,Lewis County,0,5,-5
38,North Dakota,16,Idaho,63,Lincoln County,8,0,8
38,North Dakota,16,Idaho,65,Madison County,0,46,-46
38,North Dakota,16,Idaho,67,Minidoka County,50,0,50
38,North Dakota,16,Idaho,69,Nez Perce County,0,47,-47
38,North Dakota,16,Idaho,79,Shoshone County,6,7,-1
38,North Dakota,16,Idaho,81,Teton County,0,12,-12
38,North Dakota,16,Idaho,85,Valley County,0,1,-1
38,North Dakota,17,Illinois,1,Adams County,1,0,1
38,North Dakota,17,Illinois,7,Boone County,0,21,-21
38,North Dakota,17,Illinois,19,Champaign County,6,6,0
38,North Dakota,17,Illinois,21,Christian County,0,14,-14
38,North Dakota,17,Illinois,29,Coles County,0,28,-28
38,North Dakota,17,Illinois,31,Cook County,96,97,-1
38,North Dakota,17,Illinois,37,DeKalb County,0,9,-9
38,North Dakota,17,Illinois,43,DuPage County,18,20,-2
38,North Dakota,17,Illinois,47,Edwards County,0,4,-4
38,North Dakota,17,Illinois,55,Franklin County,0,12,-12
38,North Dakota,17,Illinois,67,Hancock County,0,6,-6
38,North Dakota,17,Illinois,71,Henderson County,4,0,4
38,North Dakota,17,Illinois,83,Jersey County,3,0,3
38,North Dakota,17,Illinois,89,Kane County,7,0,7
38,North Dakota,17,Illinois,91,Kankakee County,14,7,7
38,North Dakota,17,Illinois,93,Kendall County,49,0,49
38,North Dakota,17,Illinois,97,Lake County,0,34,-34
38,North Dakota,17,Illinois,111,McHenry County,16,0,16
38,North Dakota,17,Illinois,115,Macon County,0,29,-29
38,North Dakota,17,Illinois,141,Ogle County,5,0,5
38,North Dakota,17,Illinois,143,Peoria County,7,11,-4
38,North Dakota,17,Illinois,163,St. Clair County,33,3,30
38,North Dakota,17,Illinois,179,Tazewell County,3,67,-64
38,North Dakota,17,Illinois,185,Wabash County,19,0,19
38,North Dakota,17,Illinois,189,Washington County,0,5,-5
38,North Dakota,17,Illinois,195,Whiteside County,0,8,-8
38,North Dakota,17,Illinois,197,Will County,51,0,51
38,North Dakota,17,Illinois,201,Winnebago County,96,0,96
38,North Dakota,17,Illinois,203,Woodford County,0,2,-2
38,North Dakota,18,Indiana,3,Allen County,2,15,-13
38,North Dakota,18,Indiana,29,Dearborn County,0,5,-5
38,North Dakota,18,Indiana,39,Elkhart County,14,0,14
38,North Dakota,18,Indiana,41,Fayette County,0,10,-10
38,North Dakota,18,Indiana,57,Hamilton County,20,0,20
38,North Dakota,18,Indiana,69,Huntington County,119,0,119
38,North Dakota,18,Indiana,81,Johnson County,22,0,22
38,North Dakota,18,Indiana,89,Lake County,0,127,-127
38,North Dakota,18,Indiana,91,LaPorte County,0,45,-45
38,North Dakota,18,Indiana,97,Marion County,5,88,-83
38,North Dakota,18,Indiana,109,Morgan County,5,0,5
38,North Dakota,18,Indiana,123,Perry County,0,32,-32
38,North Dakota,18,Indiana,127,Porter County,7,0,7
38,North Dakota,18,Indiana,141,St. Joseph County,0,6,-6
38,North Dakota,18,Indiana,157,Tippecanoe County,8,11,-3
38,North Dakota,18,Indiana,163,Vanderburgh County,0,42,-42
38,North Dakota,18,Indiana,177,Wayne County,1,0,1
38,North Dakota,19,Iowa,13,Black Hawk County,0,16,-16
38,North Dakota,19,Iowa,15,Boone County,10,17,-7
38,North Dakota,19,Iowa,19,Buchanan County,134,4,130
38,North Dakota,19,Iowa,21,Buena Vista County,6,16,-10
38,North Dakota,19,Iowa,31,Cedar County,7,0,7
38,North Dakota,19,Iowa,43,Clayton County,9,11,-2
38,North Dakota,19,Iowa,45,Clinton County,3,0,3
38,North Dakota,19,Iowa,47,Crawford County,8,0,8
38,North Dakota,19,Iowa,49,Dallas County,64,0,64
38,North Dakota,19,Iowa,61,Dubuque County,35,17,18
38,North Dakota,19,Iowa,65,Fayette County,2,0,2
38,North Dakota,19,Iowa,71,Fremont County,0,6,-6
38,North Dakota,19,Iowa,83,Hardin County,0,1,-1
38,North Dakota,19,Iowa,99,Jasper County,8,10,-2
38,North Dakota,19,Iowa,103,Johnson County,42,29,13
38,North Dakota,19,Iowa,111,Lee County,0,36,-36
38,North Dakota,19,Iowa,113,Linn County,15,30,-15
38,North Dakota,19,Iowa,123,Mahaska County,44,0,44
38,North Dakota,19,Iowa,125,Marion County,20,0,20
38,North Dakota,19,Iowa,129,Mills County,0,14,-14
38,North Dakota,19,Iowa,141,O'Brien County,0,1,-1
38,North Dakota,19,Iowa,145,Page County,22,0,22
38,North Dakota,19,Iowa,147,Palo Alto County,341,0,341
38,North Dakota,19,Iowa,153,Polk County,27,268,-241
38,North Dakota,19,Iowa,155,Pottawattamie County,4,0,4
38,North Dakota,19,Iowa,157,Poweshiek County,14,0,14
38,North Dakota,19,Iowa,163,Scott County,0,10,-10
38,North Dakota,19,Iowa,167,Sioux County,0,4,-4
38,North Dakota,19,Iowa,169,Story County,0,35,-35
38,North Dakota,19,Iowa,187,Webster County,15,17,-2
38,North Dakota,19,Iowa,189,Winnebago County,0,10,-10
38,North Dakota,19,Iowa,191,Winneshiek County,0,30,-30
38,North Dakota,19,Iowa,193,Woodbury County,0,109,-109
38,North Dakota,19,Iowa,195,Worth County,0,24,-24
38,North Dakota,2,Alaska,20,Anchorage Municipality,48,5,43
38,North Dakota,2,Alaska,90,Fairbanks North Star Borough,51,30,21
38,North Dakota,2,Alaska,110,Juneau City and Borough,4,0,4
38,North Dakota,2,Alaska,122,Kenai Peninsula Borough,22,21,1
38,North Dakota,2,Alaska,170,Matanuska-Susitna Borough,82,6,76
38,North Dakota,2,Alaska,180,Nome Census Area,0,2,-2
38,North Dakota,2,Alaska,188,Northwest Arctic Borough,4,0,4
38,North Dakota,2,Alaska,240,Southeast Fairbanks Census Area,0,12,-12
38,North Dakota,2,Alaska,275,Wrangell City and Borough,0,1,-1
38,North Dakota,20,Kansas,7,Barber County,0,13,-13
38,North Dakota,20,Kansas,31,Coffey County,1,0,1
38,North Dakota,20,Kansas,35,Cowley County,0,39,-39
38,North Dakota,20,Kansas,37,Crawford County,0,28,-28
38,North Dakota,20,Kansas,45,Douglas County,2,26,-24
38,North Dakota,20,Kansas,51,Ellis County,3,9,-6
38,North Dakota,20,Kansas,57,Ford County,0,32,-32
38,North Dakota,20,Kansas,59,Franklin County,2,0,2
38,North Dakota,20,Kansas,65,Graham County,2,0,2
38,North Dakota,20,Kansas,79,Harvey County,20,0,20
38,North Dakota,20,Kansas,91,Johnson County,82,38,44
38,North Dakota,20,Kansas,141,Osborne County,0,6,-6
38,North Dakota,20,Kansas,143,Ottawa County,0,2,-2
38,North Dakota,20,Kansas,145,Pawnee County,2,0,2
38,North Dakota,20,Kansas,161,Riley County,81,0,81
38,North Dakota,20,Kansas,165,Rush County,0,7,-7
38,North Dakota,20,Kansas,173,Sedgwick County,5,17,-12
38,North Dakota,20,Kansas,209,Wyandotte County,14,0,14
38,North Dakota,21,Kentucky,7,Ballard County,0,3,-3
38,North Dakota,21,Kentucky,9,Barren County,22,0,22
38,North Dakota,21,Kentucky,19,Boyd County,0,10,-10
38,North Dakota,21,Kentucky,23,Bracken County,4,0,4
38,North Dakota,21,Kentucky,37,Campbell County,0,9,-9
38,North Dakota,21,Kentucky,101,Henderson County,5,0,5
38,North Dakota,21,Kentucky,111,Jefferson County,0,25,-25
38,North Dakota,21,Kentucky,179,Nelson County,8,0,8
38,North Dakota,21,Kentucky,189,Owsley County,1,0,1
38,North Dakota,21,Kentucky,225,Union County,0,9,-9
38,North Dakota,21,Kentucky,227,Warren County,70,0,70
38,North Dakota,21,Kentucky,231,Wayne County,4,0,4
38,North Dakota,22,Louisiana,11,Beauregard Parish,83,0,83
38,North Dakota,22,Louisiana,15,Bossier Parish,37,77,-40
38,North Dakota,22,Louisiana,33,East Baton Rouge Parish,0,65,-65
38,North Dakota,22,Louisiana,51,Jefferson Parish,0,13,-13
38,North Dakota,22,Louisiana,55,Lafayette Parish,0,51,-51
38,North Dakota,22,Louisiana,71,Orleans Parish,31,0,31
38,North Dakota,22,Louisiana,97,St. Landry Parish,0,6,-6
38,North Dakota,22,Louisiana,103,St. Tammany Parish,18,0,18
38,North Dakota,22,Louisiana,109,Terrebonne Parish,2,0,2
38,North Dakota,22,Louisiana,115,Vernon Parish,1,0,1
38,North Dakota,22,Louisiana,121,West Baton Rouge Parish,25,0,25
38,North Dakota,22,Louisiana,123,West Carroll Parish,21,0,21
38,North Dakota,23,Maine,5,Cumberland County,0,41,-41
38,North Dakota,23,Maine,17,Oxford County,0,11,-11
38,North Dakota,24,Maryland,1,Allegany County,11,0,11
38,North Dakota,24,Maryland,3,Anne Arundel County,11,0,11
38,North Dakota,24,Maryland,9,Calvert County,5,66,-61
38,North Dakota,24,Maryland,13,Carroll County,0,34,-34
38,North Dakota,24,Maryland,17,Charles County,10,0,10
38,North Dakota,24,Maryland,25,Harford County,12,0,12
38,North Dakota,24,Maryland,31,Montgomery County,26,12,14
38,North Dakota,24,Maryland,33,Prince George's County,9,50,-41
38,North Dakota,24,Maryland,510,Baltimore city,11,0,11
38,North Dakota,25,Massachusetts,1,Barnstable County,0,32,-32
38,North Dakota,25,Massachusetts,5,Bristol County,0,12,-12
38,North Dakota,25,Massachusetts,9,Essex County,10,10,0
38,North Dakota,25,Massachusetts,17,Middlesex County,9,12,-3
38,North Dakota,25,Massachusetts,21,Norfolk County,3,0,3
38,North Dakota,25,Massachusetts,23,Plymouth County,0,11,-11
38,North Dakota,25,Massachusetts,27,Worcester County,26,0,26
38,North Dakota,26,Michigan,1,Alcona County,0,6,-6
38,North Dakota,26,Michigan,5,Allegan County,7,0,7
38,North Dakota,26,Michigan,7,Alpena County,0,8,-8
38,North Dakota,26,Michigan,13,Baraga County,16,0,16
38,North Dakota,26,Michigan,15,Barry County,3,24,-21
38,North Dakota,26,Michigan,23,Branch County,0,22,-22
38,North Dakota,26,Michigan,31,Cheboygan County,8,0,8
38,North Dakota,26,Michigan,33,Chippewa County,2,0,2
38,North Dakota,26,Michigan,45,Eaton County,63,0,63
38,North Dakota,26,Michigan,49,Genesee County,2,0,2
38,North Dakota,26,Michigan,51,Gladwin County,30,0,30
38,North Dakota,26,Michigan,53,Gogebic County,47,0,47
38,North Dakota,26,Michigan,55,Grand Traverse County,21,3,18
38,North Dakota,26,Michigan,57,Gratiot County,14,0,14
38,North Dakota,26,Michigan,59,Hillsdale County,22,0,22
38,North Dakota,26,Michigan,61,Houghton County,0,9,-9
38,North Dakota,26,Michigan,65,Ingham County,13,0,13
38,North Dakota,26,Michigan,67,Ionia County,0,33,-33
38,North Dakota,26,Michigan,73,Isabella County,5,0,5
38,North Dakota,26,Michigan,75,Jackson County,48,24,24
38,North Dakota,26,Michigan,77,Kalamazoo County,38,86,-48
38,North Dakota,26,Michigan,79,Kalkaska County,51,59,-8
38,North Dakota,26,Michigan,81,Kent County,21,109,-88
38,North Dakota,26,Michigan,83,Keweenaw County,0,3,-3
38,North Dakota,26,Michigan,87,Lapeer County,27,0,27
38,North Dakota,26,Michigan,91,Lenawee County,77,0,77
38,North Dakota,26,Michigan,93,Livingston County,0,29,-29
38,North Dakota,26,Michigan,95,Luce County,0,3,-3
38,North Dakota,26,Michigan,97,Mackinac County,64,0,64
38,North Dakota,26,Michigan,99,Macomb County,3,10,-7
38,North Dakota,26,Michigan,101,Manistee County,3,0,3
38,North Dakota,26,Michigan,103,Marquette County,0,13,-13
38,North Dakota,26,Michigan,111,Midland County,3,0,3
38,North Dakota,26,Michigan,115,Monroe County,3,0,3
38,North Dakota,26,Michigan,117,Montcalm County,0,18,-18
38,North Dakota,26,Michigan,119,Montmorency County,12,3,9
38,North Dakota,26,Michigan,121,Muskegon County,2,13,-11
38,North Dakota,26,Michigan,123,Newaygo County,3,0,3
38,North Dakota,26,Michigan,125,Oakland County,64,34,30
38,North Dakota,26,Michigan,127,Oceana County,0,22,-22
38,North Dakota,26,Michigan,129,Ogemaw County,25,0,25
38,North Dakota,26,Michigan,131,Ontonagon County,0,5,-5
38,North Dakota,26,Michigan,133,Osceola County,0,16,-16
38,North Dakota,26,Michigan,135,Oscoda County,0,3,-3
38,North Dakota,26,Michigan,137,Otsego County,0,33,-33
38,North Dakota,26,Michigan,139,Ottawa County,5,0,5
38,North Dakota,26,Michigan,143,Roscommon County,43,0,43
38,North Dakota,26,Michigan,147,St. Clair County,14,10,4
38,North Dakota,26,Michigan,155,Shiawassee County,16,0,16
38,North Dakota,26,Michigan,159,Van Buren County,0,41,-41
38,North Dakota,26,Michigan,161,Washtenaw County,1,25,-24
38,North Dakota,26,Michigan,163,Wayne County,44,24,20
38,North Dakota,26,Michigan,165,Wexford County,1,3,-2
38,North Dakota,27,Minnesota,1,Aitkin County,8,16,-8
38,North Dakota,27,Minnesota,3,Anoka County,683,199,484
38,North Dakota,27,Minnesota,5,Becker County,375,235,140
38,North Dakota,27,Minnesota,7,Beltrami County,232,186,46
38,North Dakota,27,Minnesota,9,Benton County,64,90,-26
38,North Dakota,27,Minnesota,11,Big Stone County,54,6,48
38,North Dakota,27,Minnesota,13,Blue Earth County,17,97,-80
38,North Dakota,27,Minnesota,15,Brown County,17,0,17
38,North Dakota,27,Minnesota,17,Carlton County,59,14,45
38,North Dakota,27,Minnesota,19,Carver County,228,18,210
38,North Dakota,27,Minnesota,21,Cass County,12,47,-35
38,North Dakota,27,Minnesota,23,Chippewa County,30,2,28
38,North Dakota,27,Minnesota,25,Chisago County,32,71,-39
38,North Dakota,27,Minnesota,27,Clay County,2906,1860,1046
38,North Dakota,27,Minnesota,29,Clearwater County,6,28,-22
38,North Dakota,27,Minnesota,33,Cottonwood County,8,0,8
38,North Dakota,27,Minnesota,35,Crow Wing County,310,177,133
38,North Dakota,27,Minnesota,37,Dakota County,676,294,382
38,North Dakota,27,Minnesota,39,Dodge County,21,60,-39
38,North Dakota,27,Minnesota,41,Douglas County,142,90,52
38,North Dakota,27,Minnesota,45,Fillmore County,9,0,9
38,North Dakota,27,Minnesota,47,Freeborn County,0,2,-2
38,North Dakota,27,Minnesota,49,Goodhue County,173,40,133
38,North Dakota,27,Minnesota,51,Grant County,40,6,34
38,North Dakota,27,Minnesota,53,Hennepin County,1503,1478,25
38,North Dakota,27,Minnesota,57,Hubbard County,449,97,352
38,North Dakota,27,Minnesota,59,Isanti County,39,26,13
38,North Dakota,27,Minnesota,61,Itasca County,44,43,1
38,North Dakota,27,Minnesota,63,Jackson County,26,1,25
38,North Dakota,27,Minnesota,65,Kanabec County,5,9,-4
38,North Dakota,27,Minnesota,67,Kandiyohi County,360,24,336
38,North Dakota,27,Minnesota,69,Kittson County,178,33,145
38,North Dakota,27,Minnesota,71,Koochiching County,29,2,27
38,North Dakota,27,Minnesota,73,Lac qui Parle County,3,17,-14
38,North Dakota,27,Minnesota,75,Lake County,9,0,9
38,North Dakota,27,Minnesota,79,Le Sueur County,40,12,28
38,North Dakota,27,Minnesota,83,Lyon County,40,32,8
38,North Dakota,27,Minnesota,85,McLeod County,119,80,39
38,North Dakota,27,Minnesota,87,Mahnomen County,8,14,-6
38,North Dakota,27,Minnesota,89,Marshall County,69,68,1
38,North Dakota,27,Minnesota,91,Martin County,5,20,-15
38,North Dakota,27,Minnesota,93,Meeker County,18,25,-7
38,North Dakota,27,Minnesota,95,Mille Lacs County,88,11,77
38,North Dakota,27,Minnesota,97,Morrison County,116,43,73
38,North Dakota,27,Minnesota,99,Mower County,7,101,-94
38,North Dakota,27,Minnesota,101,Murray County,5,10,-5
38,North Dakota,27,Minnesota,103,Nicollet County,14,0,14
38,North Dakota,27,Minnesota,105,Nobles County,0,24,-24
38,North Dakota,27,Minnesota,107,Norman County,312,60,252
38,North Dakota,27,Minnesota,109,Olmsted County,150,126,24
38,North Dakota,27,Minnesota,111,Otter Tail County,300,412,-112
38,North Dakota,27,Minnesota,113,Pennington County,97,80,17
38,North Dakota,27,Minnesota,115,Pine County,11,6,5
38,North Dakota,27,Minnesota,117,Pipestone County,0,33,-33
38,North Dakota,27,Minnesota,119,Polk County,936,725,211
38,North Dakota,27,Minnesota,121,Pope County,7,7,0
38,North Dakota,27,Minnesota,123,Ramsey County,558,386,172
38,North Dakota,27,Minnesota,125,Red Lake County,54,10,44
38,North Dakota,27,Minnesota,127,Redwood County,5,6,-1
38,North Dakota,27,Minnesota,129,Renville County,4,7,-3
38,North Dakota,27,Minnesota,131,Rice County,46,26,20
38,North Dakota,27,Minnesota,133,Rock County,0,43,-43
38,North Dakota,27,Minnesota,135,Roseau County,125,79,46
38,North Dakota,27,Minnesota,137,St. Louis County,183,199,-16
38,North Dakota,27,Minnesota,139,Scott County,163,154,9
38,North Dakota,27,Minnesota,141,Sherburne County,86,279,-193
38,North Dakota,27,Minnesota,143,Sibley County,4,3,1
38,North Dakota,27,Minnesota,145,Stearns County,328,220,108
38,North Dakota,27,Minnesota,147,Steele County,0,29,-29
38,North Dakota,27,Minnesota,149,Stevens County,117,72,45
38,North Dakota,27,Minnesota,151,Swift County,16,7,9
38,North Dakota,27,Minnesota,153,Todd County,51,40,11
38,North Dakota,27,Minnesota,155,Traverse County,108,13,95
38,North Dakota,27,Minnesota,157,Wabasha County,11,3,8
38,North Dakota,27,Minnesota,159,Wadena County,52,23,29
38,North Dakota,27,Minnesota,161,Waseca County,0,23,-23
38,North Dakota,27,Minnesota,163,Washington County,294,200,94
38,North Dakota,27,Minnesota,167,Wilkin County,193,297,-104
38,North Dakota,27,Minnesota,169,Winona County,21,40,-19
38,North Dakota,27,Minnesota,171,Wright County,353,174,179
38,North Dakota,27,Minnesota,173,Yellow Medicine County,5,43,-38
38,North Dakota,28,Mississippi,13,Calhoun County,8,0,8
38,North Dakota,28,Mississippi,25,Clay County,0,2,-2
38,North Dakota,28,Mississippi,33,DeSoto County,16,0,16
38,North Dakota,28,Mississippi,39,George County,7,0,7
38,North Dakota,28,Mississippi,43,Grenada County,7,0,7
38,North Dakota,28,Mississippi,47,Harrison County,168,4,164
38,North Dakota,28,Mississippi,49,Hinds County,3,0,3
38,North Dakota,28,Mississippi,61,Jasper County,10,0,10
38,North Dakota,28,Mississippi,71,Lafayette County,27,0,27
38,North Dakota,28,Mississippi,81,Lee County,26,0,26
38,North Dakota,28,Mississippi,87,Lowndes County,5,0,5
38,North Dakota,28,Mississippi,93,Marshall County,7,0,7
38,North Dakota,28,Mississippi,103,Noxubee County,82,0,82
38,North Dakota,28,Mississippi,121,Rankin County,12,0,12
38,North Dakota,29,Missouri,7,Audrain County,1,12,-11
38,North Dakota,29,Missouri,19,Boone County,63,59,4
38,North Dakota,29,Missouri,25,Caldwell County,0,2,-2
38,North Dakota,29,Missouri,31,Cape Girardeau County,17,0,17
38,North Dakota,29,Missouri,35,Carter County,2,0,2
38,North Dakota,29,Missouri,43,Christian County,6,56,-50
38,North Dakota,29,Missouri,47,Clay County,98,0,98
38,North Dakota,29,Missouri,51,Cole County,0,6,-6
38,North Dakota,29,Missouri,61,Daviess County,4,0,4
38,North Dakota,29,Missouri,63,DeKalb County,0,10,-10
38,North Dakota,29,Missouri,65,Dent County,19,0,19
38,North Dakota,29,Missouri,81,Harrison County,108,0,108
38,North Dakota,29,Missouri,95,Jackson County,105,22,83
38,North Dakota,29,Missouri,99,Jefferson County,34,0,34
38,North Dakota,29,Missouri,101,Johnson County,1,86,-85
38,North Dakota,29,Missouri,113,Lincoln County,20,0,20
38,North Dakota,29,Missouri,127,Marion County,10,0,10
38,North Dakota,29,Missouri,131,Miller County,0,124,-124
38,North Dakota,29,Missouri,145,Newton County,0,5,-5
38,North Dakota,29,Missouri,147,Nodaway County,5,85,-80
38,North Dakota,29,Missouri,165,Platte County,63,0,63
38,North Dakota,29,Missouri,169,Pulaski County,0,17,-17
38,North Dakota,29,Missouri,183,St. Charles County,23,71,-48
38,North Dakota,29,Missouri,189,St. Louis County,13,0,13
38,North Dakota,29,Missouri,207,Stoddard County,2,0,2
38,North Dakota,29,Missouri,213,Taney County,13,0,13
38,North Dakota,29,Missouri,215,Texas County,0,3,-3
38,North Dakota,29,Missouri,221,Washington County,4,0,4
38,North Dakota,29,Missouri,510,St. Louis city,30,11,19
38,North Dakota,30,Montana,1,Beaverhead County,76,0,76
38,North Dakota,30,Montana,3,Big Horn County,5,19,-14
38,North Dakota,30,Montana,5,Blaine County,49,0,49
38,North Dakota,30,Montana,7,Broadwater County,32,0,32
38,North Dakota,30,Montana,9,Carbon County,5,18,-13
38,North Dakota,30,Montana,11,Carter County,4,0,4
38,North Dakota,30,Montana,13,Cascade County,64,94,-30
38,North Dakota,30,Montana,17,Custer County,16,3,13
38,North Dakota,30,Montana,21,Dawson County,41,139,-98
38,North Dakota,30,Montana,25,Fallon County,35,72,-37
38,North Dakota,30,Montana,27,Fergus County,43,0,43
38,North Dakota,30,Montana,29,Flathead County,78,199,-121
38,North Dakota,30,Montana,31,Gallatin County,55,99,-44
38,North Dakota,30,Montana,35,Glacier County,0,8,-8
38,North Dakota,30,Montana,41,Hill County,26,13,13
38,North Dakota,30,Montana,43,Jefferson County,0,13,-13
38,North Dakota,30,Montana,47,Lake County,1,0,1
38,North Dakota,30,Montana,49,Lewis and Clark County,29,10,19
38,North Dakota,30,Montana,53,Lincoln County,0,25,-25
38,North Dakota,30,Montana,55,McCone County,5,4,1
38,North Dakota,30,Montana,57,Madison County,2,0,2
38,North Dakota,30,Montana,63,Missoula County,40,242,-202
38,North Dakota,30,Montana,65,Musselshell County,0,17,-17
38,North Dakota,30,Montana,71,Phillips County,21,0,21
38,North Dakota,30,Montana,73,Pondera County,0,4,-4
38,North Dakota,30,Montana,75,Powder River County,0,2,-2
38,North Dakota,30,Montana,81,Ravalli County,5,11,-6
38,North Dakota,30,Montana,83,Richland County,267,125,142
38,North Dakota,30,Montana,85,Roosevelt County,143,54,89
38,North Dakota,30,Montana,87,Rosebud County,11,10,1
38,North Dakota,30,Montana,89,Sanders County,34,35,-1
38,North Dakota,30,Montana,91,Sheridan County,46,10,36
38,North Dakota,30,Montana,93,Silver Bow County,12,112,-100
38,North Dakota,30,Montana,95,Stillwater County,64,15,49
38,North Dakota,30,Montana,97,Sweet Grass County,2,0,2
38,North Dakota,30,Montana,101,Toole County,0,3,-3
38,North Dakota,30,Montana,105,Valley County,24,20,4
38,North Dakota,30,Montana,109,Wibaux County,33,31,2
38,North Dakota,30,Montana,111,Yellowstone County,197,308,-111
38,North Dakota,31,Nebraska,1,Adams County,0,23,-23
38,North Dakota,31,Nebraska,13,Box Butte County,7,7,0
38,North Dakota,31,Nebraska,19,Buffalo County,0,5,-5
38,North Dakota,31,Nebraska,21,Burt County,1,0,1
38,North Dakota,31,Nebraska,23,Butler County,2,0,2
38,North Dakota,31,Nebraska,25,Cass County,56,0,56
38,North Dakota,31,Nebraska,33,Cheyenne County,0,11,-11
38,North Dakota,31,Nebraska,45,Dawes County,0,22,-22
38,North Dakota,31,Nebraska,47,Dawson County,0,36,-36
38,North Dakota,31,Nebraska,51,Dixon County,0,1,-1
38,North Dakota,31,Nebraska,53,Dodge County,0,23,-23
38,North Dakota,31,Nebraska,55,Douglas County,159,85,74
38,North Dakota,31,Nebraska,67,Gage County,27,0,27
38,North Dakota,31,Nebraska,79,Hall County,40,82,-42
38,North Dakota,31,Nebraska,93,Howard County,6,0,6
38,North Dakota,31,Nebraska,105,Kimball County,0,15,-15
38,North Dakota,31,Nebraska,107,Knox County,0,1,-1
38,North Dakota,31,Nebraska,109,Lancaster County,71,127,-56
38,North Dakota,31,Nebraska,111,Lincoln County,18,0,18
38,North Dakota,31,Nebraska,123,Morrill County,0,10,-10
38,North Dakota,31,Nebraska,131,Otoe County,6,0,6
38,North Dakota,31,Nebraska,137,Phelps County,0,31,-31
38,North Dakota,31,Nebraska,147,Richardson County,0,6,-6
38,North Dakota,31,Nebraska,153,Sarpy County,96,58,38
38,North Dakota,31,Nebraska,155,Saunders County,0,31,-31
38,North Dakota,31,Nebraska,157,Scotts Bluff County,2,0,2
38,North Dakota,31,Nebraska,159,Seward County,0,2,-2
38,North Dakota,31,Nebraska,173,Thurston County,3,2,1
38,North Dakota,31,Nebraska,185,York County,1,3,-2
38,North Dakota,32,Nevada,3,Clark County,147,163,-16
38,North Dakota,32,Nevada,7,Elko County,34,10,24
38,North Dakota,32,Nevada,23,Nye County,1,0,1
38,North Dakota,32,Nevada,27,Pershing County,2,0,2
38,North Dakota,32,Nevada,31,Washoe County,68,9,59
38,North Dakota,33,New Hampshire,1,Belknap County,3,0,3
38,North Dakota,33,New Hampshire,5,Cheshire County,9,0,9
38,North Dakota,33,New Hampshire,7,Coos County,35,0,35
38,North Dakota,33,New Hampshire,9,Grafton County,5,0,5
38,North Dakota,33,New Hampshire,11,Hillsborough County,23,0,23
38,North Dakota,33,New Hampshire,13,Merrimack County,47,0,47
38,North Dakota,33,New Hampshire,15,Rockingham County,2,177,-175
38,North Dakota,34,New Jersey,3,Bergen County,31,0,31
38,North Dakota,34,New Jersey,5,Burlington County,11,0,11
38,North Dakota,34,New Jersey,7,Camden County,6,14,-8
38,North Dakota,34,New Jersey,9,Cape May County,0,48,-48
38,North Dakota,34,New Jersey,13,Essex County,44,0,44
38,North Dakota,34,New Jersey,21,Mercer County,167,20,147
38,North Dakota,34,New Jersey,25,Monmouth County,0,3,-3
38,North Dakota,34,New Jersey,33,Salem County,0,16,-16
38,North Dakota,34,New Jersey,41,Warren County,0,50,-50
38,North Dakota,35,New Mexico,1,Bernalillo County,70,8,62
38,North Dakota,35,New Mexico,7,Colfax County,12,0,12
38,North Dakota,35,New Mexico,9,Curry County,8,0,8
38,North Dakota,35,New Mexico,13,Doña Ana County,6,0,6
38,North Dakota,35,New Mexico,15,Eddy County,9,20,-11
38,North Dakota,35,New Mexico,23,Hidalgo County,4,0,4
38,North Dakota,35,New Mexico,25,Lea County,3,8,-5
38,North Dakota,35,New Mexico,35,Otero County,8,0,8
38,North Dakota,35,New Mexico,45,San Juan County,6,0,6
38,North Dakota,35,New Mexico,49,Santa Fe County,4,0,4
38,North Dakota,35,New Mexico,55,Taos County,0,3,-3
38,North Dakota,35,New Mexico,61,Valencia County,8,0,8
38,North Dakota,36,New York,1,Albany County,10,0,10
38,North Dakota,36,New York,5,Bronx County,17,0,17
38,North Dakota,36,New York,7,Broome County,178,0,178
38,North Dakota,36,New York,13,Chautauqua County,7,0,7
38,North Dakota,36,New York,15,Chemung County,176,0,176
38,North Dakota,36,New York,21,Columbia County,29,0,29
38,North Dakota,36,New York,29,Erie County,8,0,8
38,North Dakota,36,New York,35,Fulton County,0,5,-5
38,North Dakota,36,New York,37,Genesee County,0,3,-3
38,North Dakota,36,New York,47,Kings County,76,66,10
38,North Dakota,36,New York,55,Monroe County,0,32,-32
38,North Dakota,36,New York,59,Nassau County,0,30,-30
38,North Dakota,36,New York,61,New York County,20,0,20
38,North Dakota,36,New York,63,Niagara County,23,0,23
38,North Dakota,36,New York,67,Onondaga County,90,17,73
38,North Dakota,36,New York,71,Orange County,0,53,-53
38,North Dakota,36,New York,79,Putnam County,1,0,1
38,North Dakota,36,New York,85,Richmond County,8,0,8
38,North Dakota,36,New York,87,Rockland County,21,40,-19
38,North Dakota,36,New York,91,Saratoga County,3,0,3
38,North Dakota,36,New York,103,Suffolk County,23,7,16
38,North Dakota,36,New York,109,Tompkins County,8,5,3
38,North Dakota,36,New York,115,Washington County,0,23,-23
38,North Dakota,36,New York,119,Westchester County,0,11,-11
38,North Dakota,37,North Carolina,27,Caldwell County,0,33,-33
38,North Dakota,37,North Carolina,51,Cumberland County,14,33,-19
38,North Dakota,37,North Carolina,57,Davidson County,0,50,-50
38,North Dakota,37,North Carolina,71,Gaston County,0,32,-32
38,North Dakota,37,North Carolina,81,Guilford County,70,118,-48
38,North Dakota,37,North Carolina,119,Mecklenburg County,21,32,-11
38,North Dakota,37,North Carolina,125,Moore County,0,13,-13
38,North Dakota,37,North Carolina,133,Onslow County,0,26,-26
38,North Dakota,37,North Carolina,135,Orange County,0,30,-30
38,North Dakota,37,North Carolina,137,Pamlico County,0,3,-3
38,North Dakota,37,North Carolina,151,Randolph County,40,24,16
38,North Dakota,37,North Carolina,159,Rowan County,0,39,-39
38,North Dakota,37,North Carolina,171,Surry County,0,5,-5
38,North Dakota,37,North Carolina,181,Vance County,0,14,-14
38,North Dakota,37,North Carolina,183,Wake County,0,21,-21
38,North Dakota,37,North Carolina,189,Watauga County,0,20,-20
38,North Dakota,37,North Carolina,191,Wayne County,0,17,-17
38,North Dakota,38,North Dakota,1,Adams County,418,45,373
38,North Dakota,38,North Dakota,3,Barnes County,387,394,-7
38,North Dakota,38,North Dakota,5,Benson County,288,268,20
38,North Dakota,38,North Dakota,7,Billings County,70,59,11
38,North Dakota,38,North Dakota,9,Bottineau County,492,325,167
38,North Dakota,38,North Dakota,11,Bowman County,175,61,114
38,North Dakota,38,North Dakota,13,Burke County,27,111,-84
38,North Dakota,38,North Dakota,15,Burleigh County,3422,4283,-861
38,North Dakota,38,North Dakota,17,Cass County,3113,3957,-844
38,North Dakota,38,North Dakota,19,Cavalier County,135,167,-32
38,North Dakota,38,North Dakota,21,Dickey County,213,181,32
38,North Dakota,38,North Dakota,23,Divide County,49,52,-3
38,North Dakota,38,North Dakota,25,Dunn County,76,135,-59
38,North Dakota,38,North Dakota,27,Eddy County,155,66,89
38,North Dakota,38,North Dakota,29,Emmons County,69,28,41
38,North Dakota,38,North Dakota,31,Foster County,149,131,18
38,North Dakota,38,North Dakota,33,Golden Valley County,88,26,62
38,North Dakota,38,North Dakota,35,Grand Forks County,1787,2321,-534
38,North Dakota,38,North Dakota,37,Grant County,64,117,-53
38,North Dakota,38,North Dakota,39,Griggs County,125,118,7
38,North Dakota,38,North Dakota,41,Hettinger County,139,176,-37
38,North Dakota,38,North Dakota,43,Kidder County,70,86,-16
38,North Dakota,38,North Dakota,45,LaMoure County,87,108,-21
38,North Dakota,38,North Dakota,47,Logan County,154,64,90
38,North Dakota,38,North Dakota,49,McHenry County,428,260,168
38,North Dakota,38,North Dakota,51,McIntosh County,98,78,20
38,North Dakota,38,North Dakota,53,McKenzie County,615,337,278
38,North Dakota,38,North Dakota,55,McLean County,509,499,10
38,North Dakota,38,North Dakota,57,Mercer County,453,317,136
38,North Dakota,38,North Dakota,59,Morton County,1841,1860,-19
38,North Dakota,38,North Dakota,61,Mountrail County,498,620,-122
38,North Dakota,38,North Dakota,63,Nelson County,156,160,-4
38,North Dakota,38,North Dakota,65,Oliver County,38,127,-89
38,North Dakota,38,North Dakota,67,Pembina County,463,237,226
38,North Dakota,38,North Dakota,69,Pierce County,96,421,-325
38,North Dakota,38,North Dakota,71,Ramsey County,428,518,-90
38,North Dakota,38,North Dakota,73,Ransom County,283,120,163
38,North Dakota,38,North Dakota,75,Renville County,205,142,63
38,North Dakota,38,North Dakota,77,Richland County,548,550,-2
38,North Dakota,38,North Dakota,79,Rolette County,331,241,90
38,North Dakota,38,North Dakota,81,Sargent County,270,68,202
38,North Dakota,38,North Dakota,83,Sheridan County,29,68,-39
38,North Dakota,38,North Dakota,85,Sioux County,266,75,191
38,North Dakota,38,North Dakota,87,Slope County,5,2,3
38,North Dakota,38,North Dakota,89,Stark County,987,718,269
38,North Dakota,38,North Dakota,91,Steele County,77,68,9
38,North Dakota,38,North Dakota,93,Stutsman County,654,892,-238
38,North Dakota,38,North Dakota,95,Towner County,133,79,54
38,North Dakota,38,North Dakota,97,Traill County,278,275,3
38,North Dakota,38,North Dakota,99,Walsh County,399,223,176
38,North Dakota,38,North Dakota,101,Ward County,2231,1600,631
38,North Dakota,38,North Dakota,103,Wells County,190,153,37
38,North Dakota,38,North Dakota,105,Williams County,779,1053,-274
38,North Dakota,39,Ohio,9,Athens County,13,6,7
38,North Dakota,39,Ohio,15,Brown County,0,14,-14
38,North Dakota,39,Ohio,17,Butler County,9,59,-50
38,North Dakota,39,Ohio,19,Carroll County,1,0,1
38,North Dakota,39,Ohio,25,Clermont County,8,0,8
38,North Dakota,39,Ohio,27,Clinton County,0,2,-2
38,North Dakota,39,Ohio,35,Cuyahoga County,30,0,30
38,North Dakota,39,Ohio,43,Erie County,0,46,-46
38,North Dakota,39,Ohio,47,Fayette County,0,2,-2
38,North Dakota,39,Ohio,49,Franklin County,141,0,141
38,North Dakota,39,Ohio,55,Geauga County,8,0,8
38,North Dakota,39,Ohio,57,Greene County,78,3,75
38,North Dakota,39,Ohio,61,Hamilton County,10,10,0
38,North Dakota,39,Ohio,63,Hancock County,0,1,-1
38,North Dakota,39,Ohio,67,Harrison County,0,9,-9
38,North Dakota,39,Ohio,69,Henry County,32,0,32
38,North Dakota,39,Ohio,83,Knox County,44,0,44
38,North Dakota,39,Ohio,93,Lorain County,67,0,67
38,North Dakota,39,Ohio,113,Montgomery County,109,24,85
38,North Dakota,39,Ohio,139,Richland County,0,31,-31
38,North Dakota,39,Ohio,147,Seneca County,0,4,-4
38,North Dakota,39,Ohio,151,Stark County,0,2,-2
38,North Dakota,39,Ohio,153,Summit County,1,18,-17
38,North Dakota,39,Ohio,155,Trumbull County,1,0,1
38,North Dakota,39,Ohio,157,Tuscarawas County,0,34,-34
38,North Dakota,4,Arizona,1,Apache County,5,0,5
38,North Dakota,4,Arizona,7,Gila County,0,16,-16
38,North Dakota,4,Arizona,13,Maricopa County,417,815,-398
38,North Dakota,4,Arizona,15,Mohave County,251,351,-100
38,North Dakota,4,Arizona,17,Navajo County,84,0,84
38,North Dakota,4,Arizona,19,Pima County,62,153,-91
38,North Dakota,4,Arizona,21,Pinal County,23,187,-164
38,North Dakota,4,Arizona,23,Santa Cruz County,61,0,61
38,North Dakota,4,Arizona,25,Yavapai County,7,0,7
38,North Dakota,4,Arizona,27,Yuma County,5,18,-13
38,North Dakota,40,Oklahoma,1,Adair County,0,22,-22
38,North Dakota,40,Oklahoma,15,Caddo County,0,6,-6
38,North Dakota,40,Oklahoma,17,Canadian County,0,40,-40
38,North Dakota,40,Oklahoma,19,Carter County,13,0,13
38,North Dakota,40,Oklahoma,21,Cherokee County,0,1,-1
38,North Dakota,40,Oklahoma,27,Cleveland County,22,0,22
38,North Dakota,40,Oklahoma,37,Creek County,0,1,-1
38,North Dakota,40,Oklahoma,39,Custer County,12,0,12
38,North Dakota,40,Oklahoma,47,Garfield County,47,1,46
38,North Dakota,40,Oklahoma,65,Jackson County,13,0,13
38,North Dakota,40,Oklahoma,71,Kay County,0,62,-62
38,North Dakota,40,Oklahoma,77,Latimer County,2,0,2
38,North Dakota,40,Oklahoma,91,McIntosh County,0,13,-13
38,North Dakota,40,Oklahoma,97,Mayes County,0,1,-1
38,North Dakota,40,Oklahoma,101,Muskogee County,20,2,18
38,North Dakota,40,Oklahoma,109,Oklahoma County,22,62,-40
38,North Dakota,40,Oklahoma,113,Osage County,0,10,-10
38,North Dakota,40,Oklahoma,119,Payne County,21,3,18
38,North Dakota,40,Oklahoma,131,Rogers County,22,0,22
38,North Dakota,40,Oklahoma,135,Sequoyah County,0,16,-16
38,North Dakota,40,Oklahoma,137,Stephens County,43,0,43
38,North Dakota,40,Oklahoma,143,Tulsa County,0,52,-52
38,North Dakota,40,Oklahoma,145,Wagoner County,0,12,-12
38,North Dakota,40,Oklahoma,147,Washington County,7,37,-30
38,North Dakota,41,Oregon,3,Benton County,8,63,-55
38,North Dakota,41,Oregon,5,Clackamas County,8,56,-48
38,North Dakota,41,Oregon,9,Columbia County,28,0,28
38,North Dakota,41,Oregon,11,Coos County,1,0,1
38,North Dakota,41,Oregon,17,Deschutes County,0,32,-32
38,North Dakota,41,Oregon,19,Douglas County,48,0,48
38,North Dakota,41,Oregon,29,Jackson County,64,106,-42
38,North Dakota,41,Oregon,31,Jefferson County,23,12,11
38,North Dakota,41,Oregon,35,Klamath County,3,0,3
38,North Dakota,41,Oregon,39,Lane County,39,94,-55
38,North Dakota,41,Oregon,41,Lincoln County,0,19,-19
38,North Dakota,41,Oregon,43,Linn County,0,24,-24
38,North Dakota,41,Oregon,45,Malheur County,21,0,21
38,North Dakota,41,Oregon,47,Marion County,36,46,-10
38,North Dakota,41,Oregon,51,Multnomah County,156,100,56
38,North Dakota,41,Oregon,61,Union County,0,8,-8
38,North Dakota,41,Oregon,63,Wallowa County,0,9,-9
38,North Dakota,41,Oregon,65,Wasco County,0,36,-36
38,North Dakota,41,Oregon,67,Washington County,48,32,16
38,North Dakota,41,Oregon,71,Yamhill County,2,0,2
38,North Dakota,42,Pennsylvania,1,Adams County,0,12,-12
38,North Dakota,42,Pennsylvania,3,Allegheny County,129,10,119
38,North Dakota,42,Pennsylvania,27,Centre County,0,11,-11
38,North Dakota,42,Pennsylvania,39,Crawford County,0,25,-25
38,North Dakota,42,Pennsylvania,41,Cumberland County,26,1,25
38,North Dakota,42,Pennsylvania,45,Delaware County,78,0,78
38,North Dakota,42,Pennsylvania,49,Erie County,2,0,2
38,North Dakota,42,Pennsylvania,53,Forest County,0,5,-5
38,North Dakota,42,Pennsylvania,55,Franklin County,108,0,108
38,North Dakota,42,Pennsylvania,63,Indiana County,21,0,21
38,North Dakota,42,Pennsylvania,71,Lancaster County,0,57,-57
38,North Dakota,42,Pennsylvania,79,Luzerne County,0,8,-8
38,North Dakota,42,Pennsylvania,81,Lycoming County,0,17,-17
38,North Dakota,42,Pennsylvania,85,Mercer County,0,3,-3
38,North Dakota,42,Pennsylvania,91,Montgomery County,40,34,6
38,North Dakota,42,Pennsylvania,95,Northampton County,5,0,5
38,North Dakota,42,Pennsylvania,101,Philadelphia County,5,0,5
38,North Dakota,42,Pennsylvania,105,Potter County,4,0,4
38,North Dakota,42,Pennsylvania,111,Somerset County,24,0,24
38,North Dakota,42,Pennsylvania,117,Tioga County,0,8,-8
38,North Dakota,42,Pennsylvania,125,Washington County,0,53,-53
38,North Dakota,42,Pennsylvania,129,Westmoreland County,9,0,9
38,North Dakota,42,Pennsylvania,133,York County,9,17,-8
38,North Dakota,44,Rhode Island,7,Providence County,5,20,-15
38,North Dakota,45,South Carolina,3,Aiken County,68,0,68
38,North Dakota,45,South Carolina,15,Berkeley County,0,14,-14
38,North Dakota,45,South Carolina,19,Charleston County,6,39,-33
38,North Dakota,45,South Carolina,21,Cherokee County,0,9,-9
38,North Dakota,45,South Carolina,35,Dorchester County,0,53,-53
38,North Dakota,45,South Carolina,51,Horry County,132,0,132
38,North Dakota,45,South Carolina,57,Lancaster County,11,0,11
38,North Dakota,45,South Carolina,73,Oconee County,8,0,8
38,North Dakota,45,South Carolina,77,Pickens County,11,20,-9
38,North Dakota,45,South Carolina,79,Richland County,4,22,-18
38,North Dakota,45,South Carolina,85,Sumter County,10,0,10
38,North Dakota,45,South Carolina,91,York County,14,0,14
38,North Dakota,46,South Dakota,5,Beadle County,71,4,67
38,North Dakota,46,South Dakota,7,Bennett County,6,0,6
38,North Dakota,46,South Dakota,9,Bon Homme County,0,8,-8
38,North Dakota,46,South Dakota,11,Brookings County,55,121,-66
38,North Dakota,46,South Dakota,13,Brown County,311,374,-63
38,North Dakota,46,South Dakota,15,Brule County,0,8,-8
38,North Dakota,46,South Dakota,17,Buffalo County,0,3,-3
38,North Dakota,46,South Dakota,21,Campbell County,6,0,6
38,North Dakota,46,South Dakota,23,Charles Mix County,5,12,-7
38,North Dakota,46,South Dakota,25,Clark County,0,1,-1
38,North Dakota,46,South Dakota,27,Clay County,0,35,-35
38,North Dakota,46,South Dakota,29,Codington County,137,25,112
38,North Dakota,46,South Dakota,31,Corson County,120,18,102
38,North Dakota,46,South Dakota,35,Davison County,5,11,-6
38,North Dakota,46,South Dakota,37,Day County,15,19,-4
38,North Dakota,46,South Dakota,41,Dewey County,4,4,0
38,North Dakota,46,South Dakota,43,Douglas County,0,9,-9
38,North Dakota,46,South Dakota,45,Edmunds County,7,0,7
38,North Dakota,46,South Dakota,49,Faulk County,0,4,-4
38,North Dakota,46,South Dakota,51,Grant County,4,0,4
38,North Dakota,46,South Dakota,53,Gregory County,0,2,-2
38,North Dakota,46,South Dakota,57,Hamlin County,7,0,7
38,North Dakota,46,South Dakota,63,Harding County,17,0,17
38,North Dakota,46,South Dakota,65,Hughes County,44,32,12
38,North Dakota,46,South Dakota,67,Hutchinson County,0,11,-11
38,North Dakota,46,South Dakota,79,Lake County,0,6,-6
38,North Dakota,46,South Dakota,81,Lawrence County,17,83,-66
38,North Dakota,46,South Dakota,83,Lincoln County,10,143,-133
38,North Dakota,46,South Dakota,85,Lyman County,2,0,2
38,North Dakota,46,South Dakota,87,McCook County,12,0,12
38,North Dakota,46,South Dakota,89,McPherson County,55,18,37
38,North Dakota,46,South Dakota,91,Marshall County,76,4,72
38,North Dakota,46,South Dakota,93,Meade County,7,47,-40
38,North Dakota,46,South Dakota,95,Mellette County,0,4,-4
38,North Dakota,46,South Dakota,99,Minnehaha County,335,418,-83
38,North Dakota,46,South Dakota,101,Moody County,0,8,-8
38,North Dakota,46,South Dakota,102,Oglala Lakota County,13,0,13
38,North Dakota,46,South Dakota,103,Pennington County,247,439,-192
38,North Dakota,46,South Dakota,105,Perkins County,25,61,-36
38,North Dakota,46,South Dakota,109,Roberts County,76,43,33
38,North Dakota,46,South Dakota,115,Spink County,6,60,-54
38,North Dakota,46,South Dakota,117,Stanley County,11,0,11
38,North Dakota,46,South Dakota,119,Sully County,14,3,11
38,North Dakota,46,South Dakota,121,Todd County,9,9,0
38,North Dakota,46,South Dakota,125,Turner County,0,3,-3
38,North Dakota,46,South Dakota,129,Walworth County,104,33,71
38,North Dakota,46,South Dakota,135,Yankton County,0,43,-43
38,North Dakota,46,South Dakota,137,Ziebach County,97,3,94
38,North Dakota,47,Tennessee,37,Davidson County,0,12,-12
38,North Dakota,47,Tennessee,65,Hamilton County,179,0,179
38,North Dakota,47,Tennessee,93,Knox County,46,0,46
38,North Dakota,47,Tennessee,105,Loudon County,0,158,-158
38,North Dakota,47,Tennessee,113,Madison County,31,0,31
38,North Dakota,47,Tennessee,149,Rutherford County,37,0,37
38,North Dakota,47,Tennessee,153,Sequatchie County,0,7,-7
38,North Dakota,47,Tennessee,157,Shelby County,135,9,126
38,North Dakota,48,Texas,27,Bell County,7,10,-3
38,North Dakota,48,Texas,29,Bexar County,416,74,342
38,North Dakota,48,Texas,39,Brazoria County,8,63,-55
38,North Dakota,48,Texas,49,Brown County,0,10,-10
38,North Dakota,48,Texas,51,Burleson County,0,15,-15
38,North Dakota,48,Texas,61,Cameron County,2,35,-33
38,North Dakota,48,Texas,91,Comal County,12,0,12
38,North Dakota,48,Texas,113,Dallas County,119,14,105
38,North Dakota,48,Texas,121,Denton County,3,0,3
38,North Dakota,48,Texas,127,Dimmit County,10,0,10
38,North Dakota,48,Texas,133,Eastland County,12,0,12
38,North Dakota,48,Texas,135,Ector County,31,0,31
38,North Dakota,48,Texas,139,Ellis County,0,22,-22
38,North Dakota,48,Texas,141,El Paso County,23,74,-51
38,North Dakota,48,Texas,147,Fannin County,12,0,12
38,North Dakota,48,Texas,167,Galveston County,4,0,4
38,North Dakota,48,Texas,181,Grayson County,8,0,8
38,North Dakota,48,Texas,201,Harris County,708,134,574
38,North Dakota,48,Texas,209,Hays County,6,0,6
38,North Dakota,48,Texas,213,Henderson County,23,0,23
38,North Dakota,48,Texas,215,Hidalgo County,76,49,27
38,North Dakota,48,Texas,217,Hill County,0,4,-4
38,North Dakota,48,Texas,221,Hood County,5,0,5
38,North Dakota,48,Texas,227,Howard County,29,0,29
38,North Dakota,48,Texas,233,Hutchinson County,0,1,-1
38,North Dakota,48,Texas,241,Jasper County,21,0,21
38,North Dakota,48,Texas,245,Jefferson County,0,16,-16
38,North Dakota,48,Texas,251,Johnson County,74,0,74
38,North Dakota,48,Texas,295,Lipscomb County,0,4,-4
38,North Dakota,48,Texas,297,Live Oak County,0,3,-3
38,North Dakota,48,Texas,303,Lubbock County,3,34,-31
38,North Dakota,48,Texas,309,McLennan County,10,0,10
38,North Dakota,48,Texas,321,Matagorda County,22,0,22
38,North Dakota,48,Texas,325,Medina County,15,0,15
38,North Dakota,48,Texas,327,Menard County,0,21,-21
38,North Dakota,48,Texas,329,Midland County,26,0,26
38,North Dakota,48,Texas,335,Mitchell County,0,33,-33
38,North Dakota,48,Texas,337,Montague County,6,0,6
38,North Dakota,48,Texas,339,Montgomery County,43,98,-55
38,North Dakota,48,Texas,355,Nueces County,44,14,30
38,North Dakota,48,Texas,361,Orange County,0,2,-2
38,North Dakota,48,Texas,367,Parker County,28,0,28
38,North Dakota,48,Texas,371,Pecos County,0,23,-23
38,North Dakota,48,Texas,391,Refugio County,0,3,-3
38,North Dakota,48,Texas,397,Rockwall County,0,31,-31
38,North Dakota,48,Texas,399,Runnels County,0,22,-22
38,North Dakota,48,Texas,403,Sabine County,0,40,-40
38,North Dakota,48,Texas,405,San Augustine County,6,0,6
38,North Dakota,48,Texas,413,Schleicher County,0,4,-4
38,North Dakota,48,Texas,439,Tarrant County,127,77,50
38,North Dakota,48,Texas,451,Tom Green County,54,23,31
38,North Dakota,48,Texas,453,Travis County,56,68,-12
38,North Dakota,48,Texas,463,Uvalde County,0,40,-40
38,North Dakota,48,Texas,467,Van Zandt County,52,0,52
38,North Dakota,48,Texas,469,Victoria County,0,47,-47
38,North Dakota,48,Texas,479,Webb County,0,10,-10
38,North Dakota,48,Texas,485,Wichita County,77,43,34
38,North Dakota,48,Texas,491,Williamson County,110,70,40
38,North Dakota,48,Texas,497,Wise County,1,0,1
38,North Dakota,49,Utah,5,Cache County,0,18,-18
38,North Dakota,49,Utah,11,Davis County,17,12,5
38,North Dakota,49,Utah,13,Duchesne County,0,22,-22
38,North Dakota,49,Utah,17,Garfield County,46,6,40
38,North Dakota,49,Utah,27,Millard County,15,0,15
38,North Dakota,49,Utah,29,Morgan County,2,0,2
38,North Dakota,49,Utah,35,Salt Lake County,31,274,-243
38,North Dakota,49,Utah,39,Sanpete County,6,12,-6
38,North Dakota,49,Utah,45,Tooele County,6,0,6
38,North Dakota,49,Utah,47,Uintah County,135,0,135
38,North Dakota,49,Utah,49,Utah County,15,101,-86
38,North Dakota,49,Utah,53,Washington County,0,192,-192
38,North Dakota,49,Utah,57,Weber County,17,111,-94
38,North Dakota,5,Arkansas,5,Baxter County,0,3,-3
38,North Dakota,5,Arkansas,7,Benton County,18,2,16
38,North Dakota,5,Arkansas,9,Boone County,2,0,2
38,North Dakota,5,Arkansas,15,Carroll County,0,13,-13
38,North Dakota,5,Arkansas,31,Craighead County,28,0,28
38,North Dakota,5,Arkansas,51,Garland County,10,0,10
38,North Dakota,5,Arkansas,69,Jefferson County,0,2,-2
38,North Dakota,5,Arkansas,95,Monroe County,8,0,8
38,North Dakota,5,Arkansas,119,Pulaski County,5,48,-43
38,North Dakota,5,Arkansas,125,Saline County,3,0,3
38,North Dakota,5,Arkansas,131,Sebastian County,36,0,36
38,North Dakota,5,Arkansas,139,Union County,8,0,8
38,North Dakota,5,Arkansas,143,Washington County,9,0,9
38,North Dakota,50,Vermont,7,Chittenden County,22,0,22
38,North Dakota,50,Vermont,17,Orange County,0,6,-6
38,North Dakota,50,Vermont,25,Windham County,0,13,-13
38,North Dakota,51,Virginia,3,Albemarle County,0,7,-7
38,North Dakota,51,Virginia,7,Amelia County,9,0,9
38,North Dakota,51,Virginia,15,Augusta County,0,38,-38
38,North Dakota,51,Virginia,31,Campbell County,0,9,-9
38,North Dakota,51,Virginia,59,Fairfax County,122,76,46
38,North Dakota,51,Virginia,73,Gloucester County,0,57,-57
38,North Dakota,51,Virginia,85,Hanover County,9,0,9
38,North Dakota,51,Virginia,87,Henrico County,41,5,36
38,North Dakota,51,Virginia,95,James City County,0,25,-25
38,North Dakota,51,Virginia,121,Montgomery County,14,0,14
38,North Dakota,51,Virginia,149,Prince George County,0,16,-16
38,North Dakota,51,Virginia,159,Richmond County,5,0,5
38,North Dakota,51,Virginia,161,Roanoke County,0,238,-238
38,North Dakota,51,Virginia,199,York County,0,11,-11
38,North Dakota,51,Virginia,510,Alexandria city,10,0,10
38,North Dakota,51,Virginia,550,Chesapeake city,0,47,-47
38,North Dakota,51,Virginia,570,Colonial Heights city,15,0,15
38,North Dakota,51,Virginia,680,Lynchburg city,0,34,-34
38,North Dakota,51,Virginia,810,Virginia Beach city,31,0,31
38,North Dakota,53,Washington,5,Benton County,123,22,101
38,North Dakota,53,Washington,7,Chelan County,0,47,-47
38,North Dakota,53,Washington,9,Clallam County,6,0,6
38,North Dakota,53,Washington,11,Clark County,232,64,168
38,North Dakota,53,Washington,15,Cowlitz County,0,40,-40
38,North Dakota,53,Washington,27,Grays Harbor County,0,3,-3
38,North Dakota,53,Washington,29,Island County,0,7,-7
38,North Dakota,53,Washington,31,Jefferson County,3,4,-1
38,North Dakota,53,Washington,33,King County,186,219,-33
38,North Dakota,53,Washington,35,Kitsap County,34,69,-35
38,North Dakota,53,Washington,37,Kittitas County,6,7,-1
38,North Dakota,53,Washington,39,Klickitat County,7,0,7
38,North Dakota,53,Washington,41,Lewis County,118,7,111
38,North Dakota,53,Washington,47,Okanogan County,0,41,-41
38,North Dakota,53,Washington,49,Pacific County,0,7,-7
38,North Dakota,53,Washington,51,Pend Oreille County,0,19,-19
38,North Dakota,53,Washington,53,Pierce County,96,162,-66
38,North Dakota,53,Washington,55,San Juan County,0,5,-5
38,North Dakota,53,Washington,57,Skagit County,4,24,-20
38,North Dakota,53,Washington,59,Skamania County,0,18,-18
38,North Dakota,53,Washington,61,Snohomish County,23,216,-193
38,North Dakota,53,Washington,63,Spokane County,62,130,-68
38,North Dakota,53,Washington,65,Stevens County,14,6,8
38,North Dakota,53,Washington,67,Thurston County,71,97,-26
38,North Dakota,53,Washington,71,Walla Walla County,0,99,-99
38,North Dakota,53,Washington,73,Whatcom County,58,0,58
38,North Dakota,53,Washington,75,Whitman County,0,9,-9
38,North Dakota,53,Washington,77,Yakima County,58,34,24
38,North Dakota,54,West Virginia,25,Greenbrier County,0,13,-13
38,North Dakota,54,West Virginia,61,Monongalia County,11,0,11
38,North Dakota,54,West Virginia,63,Monroe County,22,0,22
38,North Dakota,54,West Virginia,69,Ohio County,25,0,25
38,North Dakota,54,West Virginia,81,Raleigh County,9,0,9
38,North Dakota,54,West Virginia,97,Upshur County,0,12,-12
38,North Dakota,55,Wisconsin,1,Adams County,4,0,4
38,North Dakota,55,Wisconsin,3,Ashland County,0,5,-5
38,North Dakota,55,Wisconsin,5,Barron County,5,11,-6
38,North Dakota,55,Wisconsin,7,Bayfield County,0,7,-7
38,North Dakota,55,Wisconsin,9,Brown County,32,0,32
38,North Dakota,55,Wisconsin,13,Burnett County,16,0,16
38,North Dakota,55,Wisconsin,17,Chippewa County,4,23,-19
38,North Dakota,55,Wisconsin,19,Clark County,43,0,43
38,North Dakota,55,Wisconsin,21,Columbia County,0,16,-16
38,North Dakota,55,Wisconsin,25,Dane County,17,86,-69
38,North Dakota,55,Wisconsin,31,Douglas County,13,7,6
38,North Dakota,55,Wisconsin,33,Dunn County,0,87,-87
38,North Dakota,55,Wisconsin,35,Eau Claire County,3,46,-43
38,North Dakota,55,Wisconsin,37,Florence County,25,0,25
38,North Dakota,55,Wisconsin,39,Fond du Lac County,7,19,-12
38,North Dakota,55,Wisconsin,41,Forest County,0,2,-2
38,North Dakota,55,Wisconsin,43,Grant County,0,2,-2
38,North Dakota,55,Wisconsin,45,Green County,0,12,-12
38,North Dakota,55,Wisconsin,47,Green Lake County,10,2,8
38,North Dakota,55,Wisconsin,55,Jefferson County,7,0,7
38,North Dakota,55,Wisconsin,57,Juneau County,6,11,-5
38,North Dakota,55,Wisconsin,59,Kenosha County,10,0,10
38,North Dakota,55,Wisconsin,61,Kewaunee County,5,0,5
38,North Dakota,55,Wisconsin,63,La Crosse County,7,14,-7
38,North Dakota,55,Wisconsin,67,Langlade County,12,0,12
38,North Dakota,55,Wisconsin,69,Lincoln County,4,2,2
38,North Dakota,55,Wisconsin,71,Manitowoc County,6,0,6
38,North Dakota,55,Wisconsin,73,Marathon County,5,31,-26
38,North Dakota,55,Wisconsin,75,Marinette County,0,13,-13
38,North Dakota,55,Wisconsin,79,Milwaukee County,78,15,63
38,North Dakota,55,Wisconsin,81,Monroe County,18,0,18
38,North Dakota,55,Wisconsin,83,Oconto County,15,0,15
38,North Dakota,55,Wisconsin,87,Outagamie County,15,20,-5
38,North Dakota,55,Wisconsin,93,Pierce County,16,22,-6
38,North Dakota,55,Wisconsin,95,Polk County,10,0,10
38,North Dakota,55,Wisconsin,97,Portage County,0,13,-13
38,North Dakota,55,Wisconsin,107,Rusk County,12,4,8
38,North Dakota,55,Wisconsin,109,St. Croix County,22,16,6
38,North Dakota,55,Wisconsin,111,Sauk County,19,25,-6
38,North Dakota,55,Wisconsin,113,Sawyer County,0,4,-4
38,North Dakota,55,Wisconsin,115,Shawano County,14,8,6
38,North Dakota,55,Wisconsin,117,Sheboygan County,0,4,-4
38,North Dakota,55,Wisconsin,121,Trempealeau County,21,17,4
38,North Dakota,55,Wisconsin,123,Vernon County,4,11,-7
38,North Dakota,55,Wisconsin,125,Vilas County,9,0,9
38,North Dakota,55,Wisconsin,127,Walworth County,42,3,39
38,North Dakota,55,Wisconsin,129,Washburn County,0,1,-1
38,North Dakota,55,Wisconsin,131,Washington County,15,0,15
38,North Dakota,55,Wisconsin,133,Waukesha County,36,0,36
38,North Dakota,55,Wisconsin,135,Waupaca County,5,35,-30
38,North Dakota,55,Wisconsin,137,Waushara County,2,0,2
38,North Dakota,55,Wisconsin,139,Winnebago County,38,55,-17
38,North Dakota,55,Wisconsin,141,Wood County,0,12,-12
38,North Dakota,56,Wyoming,1,Albany County,104,122,-18
38,North Dakota,56,Wyoming,3,Big Horn County,9,0,9
38,North Dakota,56,Wyoming,5,Campbell County,35,141,-106
38,North Dakota,56,Wyoming,7,Carbon County,3,0,3
38,North Dakota,56,Wyoming,9,Converse County,7,1,6
38,North Dakota,56,Wyoming,11,Crook County,0,33,-33
38,North Dakota,56,Wyoming,13,Fremont County,4,143,-139
38,North Dakota,56,Wyoming,21,Laramie County,52,61,-9
38,North Dakota,56,Wyoming,23,Lincoln County,0,23,-23
38,North Dakota,56,Wyoming,25,Natrona County,27,66,-39
38,North Dakota,56,Wyoming,29,Park County,125,0,125
38,North Dakota,56,Wyoming,33,Sheridan County,84,0,84
38,North Dakota,56,Wyoming,35,Sublette County,156,0,156
38,North Dakota,56,Wyoming,37,Sweetwater County,20,18,2
38,North Dakota,56,Wyoming,39,Teton County,3,1,2
38,North Dakota,56,Wyoming,41,Uinta County,12,13,-1
38,North Dakota,56,Wyoming,43,Washakie County,17,0,17
38,North Dakota,56,Wyoming,45,Weston County,11,0,11
38,North Dakota,6,California,1,Alameda County,43,13,30
38,North Dakota,6,California,7,Butte County,23,0,23
38,North Dakota,6,California,9,Calaveras County,9,0,9
38,North Dakota,6,California,13,Contra Costa County,5,0,5
38,North Dakota,6,California,19,Fresno County,15,48,-33
38,North Dakota,6,California,29,Kern County,150,40,110
38,North Dakota,6,California,31,Kings County,10,0,10
38,North Dakota,6,California,33,Lake County,91,0,91
38,North Dakota,6,California,37,Los Angeles County,250,166,84
38,North Dakota,6,California,39,Madera County,0,13,-13
38,North Dakota,6,California,43,Mariposa County,0,15,-15
38,North Dakota,6,California,53,Monterey County,4,106,-102
38,North Dakota,6,California,55,Napa County,5,33,-28
38,North Dakota,6,California,59,Orange County,98,37,61
38,North Dakota,6,California,61,Placer County,27,193,-166
38,North Dakota,6,California,63,Plumas County,8,0,8
38,North Dakota,6,California,65,Riverside County,320,66,254
38,North Dakota,6,California,67,Sacramento County,42,18,24
38,North Dakota,6,California,71,San Bernardino County,339,163,176
38,North Dakota,6,California,73,San Diego County,239,320,-81
38,North Dakota,6,California,75,San Francisco County,0,30,-30
38,North Dakota,6,California,77,San Joaquin County,62,59,3
38,North Dakota,6,California,79,San Luis Obispo County,3,0,3
38,North Dakota,6,California,81,San Mateo County,7,0,7
38,North Dakota,6,California,83,Santa Barbara County,238,38,200
38,North Dakota,6,California,85,Santa Clara County,6,53,-47
38,North Dakota,6,California,87,Santa Cruz County,0,17,-17
38,North Dakota,6,California,93,Siskiyou County,174,0,174
38,North Dakota,6,California,95,Solano County,92,0,92
38,North Dakota,6,California,97,Sonoma County,13,69,-56
38,North Dakota,6,California,99,Stanislaus County,26,0,26
38,North Dakota,6,California,101,Sutter County,1,4,-3
38,North Dakota,6,California,103,Tehama County,4,0,4
38,North Dakota,6,California,107,Tulare County,0,2,-2
38,North Dakota,6,California,111,Ventura County,44,0,44
38,North Dakota,6,California,115,Yuba County,66,15,51
38,North Dakota,72,Puerto Rico,11,Añasco Municipio,43,0,43
38,North Dakota,72,Puerto Rico,71,Isabela Municipio,132,0,132
38,North Dakota,72,Puerto Rico,97,Mayagüez Municipio,19,0,19
38,North Dakota,72,Puerto Rico,141,Utuado Municipio,59,0,59
38,North Dakota,8,Colorado,1,Adams County,13,111,-98
38,North Dakota,8,Colorado,5,Arapahoe County,76,84,-8
38,North Dakota,8,Colorado,11,Bent County,0,8,-8
38,North Dakota,8,Colorado,13,Boulder County,3,0,3
38,North Dakota,8,Colorado,29,Delta County,4,0,4
38,North Dakota,8,Colorado,31,Denver County,109,165,-56
38,North Dakota,8,Colorado,35,Douglas County,32,0,32
38,North Dakota,8,Colorado,39,Elbert County,0,48,-48
38,North Dakota,8,Colorado,41,El Paso County,53,314,-261
38,North Dakota,8,Colorado,43,Fremont County,1,0,1
38,North Dakota,8,Colorado,45,Garfield County,0,15,-15
38,North Dakota,8,Colorado,49,Grand County,6,0,6
38,North Dakota,8,Colorado,55,Huerfano County,0,33,-33
38,North Dakota,8,Colorado,59,Jefferson County,146,100,46
38,North Dakota,8,Colorado,63,Kit Carson County,0,37,-37
38,North Dakota,8,Colorado,67,La Plata County,1,3,-2
38,North Dakota,8,Colorado,69,Larimer County,121,93,28
38,North Dakota,8,Colorado,71,Las Animas County,1,10,-9
38,North Dakota,8,Colorado,73,Lincoln County,17,0,17
38,North Dakota,8,Colorado,75,Logan County,12,0,12
38,North Dakota,8,Colorado,77,Mesa County,42,119,-77
38,North Dakota,8,Colorado,85,Montrose County,0,48,-48
38,North Dakota,8,Colorado,93,Park County,14,5,9
38,North Dakota,8,Colorado,101,Pueblo County,11,0,11
38,North Dakota,8,Colorado,107,Routt County,58,0,58
38,North Dakota,8,Colorado,113,San Miguel County,0,9,-9
38,North Dakota,8,Colorado,119,Teller County,0,7,-7
38,North Dakota,8,Colorado,121,Washington County,0,2,-2
38,North Dakota,8,Colorado,123,Weld County,268,23,245
38,North Dakota,9,Connecticut,1,Fairfield County,50,11,39
38,North Dakota,9,Connecticut,3,Hartford County,10,18,-8
38,North Dakota,9,Connecticut,7,Middlesex County,4,0,4
38,North Dakota,9,Connecticut,9,New Haven County,0,30,-30
38,North Dakota,9,Connecticut,11,New London County,2,0,2
38,North Dakota,AFR,Africa,,-,448,0,0
38,North Dakota,ASI,Asia,,-,1696,0,0
38,North Dakota,CAM,Central America,,-,67,0,0
38,North Dakota,CAR,Caribbean,,-,147,0,0
38,North Dakota,EUR,Europe,,-,517,0,0
38,North Dakota,ISL,U.S. Island Areas,,-,68,0,0
38,North Dakota,NAM,Northern America,,-,383,0,0
38,North Dakota,OCE,Oceania and At Sea,,-,14,0,0
38,North Dakota,SAM,South America,,-,333,0,0
39,Ohio,1,Alabama,1,Autauga County,30,0,30
39,Ohio,1,Alabama,3,Baldwin County,37,92,-55
39,Ohio,1,Alabama,9,Blount County,77,25,52
39,Ohio,1,Alabama,13,Butler County,20,35,-15
39,Ohio,1,Alabama,15,Calhoun County,0,8,-8
39,Ohio,1,Alabama,19,Cherokee County,0,46,-46
39,Ohio,1,Alabama,21,Chilton County,33,3,30
39,Ohio,1,Alabama,23,Choctaw County,0,4,-4
39,Ohio,1,Alabama,25,Clarke County,130,0,130
39,Ohio,1,Alabama,31,Coffee County,0,42,-42
39,Ohio,1,Alabama,33,Colbert County,45,60,-15
39,Ohio,1,Alabama,39,Covington County,0,23,-23
39,Ohio,1,Alabama,45,Dale County,0,60,-60
39,Ohio,1,Alabama,47,Dallas County,0,4,-4
39,Ohio,1,Alabama,49,DeKalb County,0,81,-81
39,Ohio,1,Alabama,51,Elmore County,32,0,32
39,Ohio,1,Alabama,53,Escambia County,0,32,-32
39,Ohio,1,Alabama,55,Etowah County,0,6,-6
39,Ohio,1,Alabama,59,Franklin County,4,30,-26
39,Ohio,1,Alabama,61,Geneva County,0,18,-18
39,Ohio,1,Alabama,65,Hale County,0,11,-11
39,Ohio,1,Alabama,69,Houston County,0,71,-71
39,Ohio,1,Alabama,71,Jackson County,0,26,-26
39,Ohio,1,Alabama,73,Jefferson County,350,481,-131
39,Ohio,1,Alabama,77,Lauderdale County,97,50,47
39,Ohio,1,Alabama,81,Lee County,279,152,127
39,Ohio,1,Alabama,83,Limestone County,0,79,-79
39,Ohio,1,Alabama,85,Lowndes County,0,11,-11
39,Ohio,1,Alabama,87,Macon County,0,22,-22
39,Ohio,1,Alabama,89,Madison County,217,218,-1
39,Ohio,1,Alabama,93,Marion County,67,0,67
39,Ohio,1,Alabama,95,Marshall County,14,17,-3
39,Ohio,1,Alabama,97,Mobile County,151,105,46
39,Ohio,1,Alabama,101,Montgomery County,28,124,-96
39,Ohio,1,Alabama,103,Morgan County,0,12,-12
39,Ohio,1,Alabama,105,Perry County,0,8,-8
39,Ohio,1,Alabama,107,Pickens County,0,12,-12
39,Ohio,1,Alabama,109,Pike County,0,7,-7
39,Ohio,1,Alabama,115,St. Clair County,0,97,-97
39,Ohio,1,Alabama,117,Shelby County,173,172,1
39,Ohio,1,Alabama,121,Talladega County,128,76,52
39,Ohio,1,Alabama,125,Tuscaloosa County,79,202,-123
39,Ohio,1,Alabama,131,Wilcox County,18,0,18
39,Ohio,1,Alabama,133,Winston County,0,9,-9
39,Ohio,10,Delaware,1,Kent County,103,42,61
39,Ohio,10,Delaware,3,New Castle County,264,104,160
39,Ohio,10,Delaware,5,Sussex County,31,38,-7
39,Ohio,11,District of Columbia,1,District of Columbia,885,665,220
39,Ohio,12,Florida,1,Alachua County,406,48,358
39,Ohio,12,Florida,5,Bay County,198,436,-238
39,Ohio,12,Florida,7,Bradford County,15,58,-43
39,Ohio,12,Florida,9,Brevard County,907,662,245
39,Ohio,12,Florida,11,Broward County,585,1110,-525
39,Ohio,12,Florida,13,Calhoun County,0,5,-5
39,Ohio,12,Florida,15,Charlotte County,210,501,-291
39,Ohio,12,Florida,17,Citrus County,124,307,-183
39,Ohio,12,Florida,19,Clay County,26,484,-458
39,Ohio,12,Florida,21,Collier County,330,789,-459
39,Ohio,12,Florida,27,DeSoto County,39,55,-16
39,Ohio,12,Florida,31,Duval County,756,1057,-301
39,Ohio,12,Florida,33,Escambia County,583,638,-55
39,Ohio,12,Florida,35,Flagler County,86,161,-75
39,Ohio,12,Florida,37,Franklin County,0,24,-24
39,Ohio,12,Florida,39,Gadsden County,1,0,1
39,Ohio,12,Florida,41,Gilchrist County,0,45,-45
39,Ohio,12,Florida,47,Hamilton County,0,23,-23
39,Ohio,12,Florida,49,Hardee County,9,19,-10
39,Ohio,12,Florida,51,Hendry County,51,121,-70
39,Ohio,12,Florida,53,Hernando County,254,167,87
39,Ohio,12,Florida,55,Highlands County,65,205,-140
39,Ohio,12,Florida,57,Hillsborough County,1513,2347,-834
39,Ohio,12,Florida,59,Holmes County,7,0,7
39,Ohio,12,Florida,61,Indian River County,78,254,-176
39,Ohio,12,Florida,63,Jackson County,19,85,-66
39,Ohio,12,Florida,67,Lafayette County,42,0,42
39,Ohio,12,Florida,69,Lake County,259,741,-482
39,Ohio,12,Florida,71,Lee County,1006,2371,-1365
39,Ohio,12,Florida,73,Leon County,119,341,-222
39,Ohio,12,Florida,75,Levy County,0,170,-170
39,Ohio,12,Florida,79,Madison County,0,45,-45
39,Ohio,12,Florida,81,Manatee County,329,1175,-846
39,Ohio,12,Florida,83,Marion County,185,324,-139
39,Ohio,12,Florida,85,Martin County,94,237,-143
39,Ohio,12,Florida,86,Miami-Dade County,1388,454,934
39,Ohio,12,Florida,87,Monroe County,84,93,-9
39,Ohio,12,Florida,89,Nassau County,94,76,18
39,Ohio,12,Florida,91,Okaloosa County,131,289,-158
39,Ohio,12,Florida,93,Okeechobee County,24,27,-3
39,Ohio,12,Florida,95,Orange County,901,750,151
39,Ohio,12,Florida,97,Osceola County,86,193,-107
39,Ohio,12,Florida,99,Palm Beach County,762,1313,-551
39,Ohio,12,Florida,101,Pasco County,302,882,-580
39,Ohio,12,Florida,103,Pinellas County,1030,1991,-961
39,Ohio,12,Florida,105,Polk County,424,1143,-719
39,Ohio,12,Florida,107,Putnam County,95,82,13
39,Ohio,12,Florida,109,St. Johns County,76,178,-102
39,Ohio,12,Florida,111,St. Lucie County,178,58,120
39,Ohio,12,Florida,113,Santa Rosa County,114,166,-52
39,Ohio,12,Florida,115,Sarasota County,322,1049,-727
39,Ohio,12,Florida,117,Seminole County,97,662,-565
39,Ohio,12,Florida,119,Sumter County,147,270,-123
39,Ohio,12,Florida,125,Union County,3,0,3
39,Ohio,12,Florida,127,Volusia County,366,871,-505
39,Ohio,12,Florida,129,Wakulla County,0,18,-18
39,Ohio,12,Florida,131,Walton County,52,74,-22
39,Ohio,13,Georgia,9,Baldwin County,0,50,-50
39,Ohio,13,Georgia,13,Barrow County,14,22,-8
39,Ohio,13,Georgia,15,Bartow County,7,0,7
39,Ohio,13,Georgia,21,Bibb County,49,18,31
39,Ohio,13,Georgia,23,Bleckley County,0,18,-18
39,Ohio,13,Georgia,29,Bryan County,0,135,-135
39,Ohio,13,Georgia,31,Bulloch County,30,202,-172
39,Ohio,13,Georgia,39,Camden County,0,8,-8
39,Ohio,13,Georgia,43,Candler County,0,4,-4
39,Ohio,13,Georgia,45,Carroll County,0,25,-25
39,Ohio,13,Georgia,47,Catoosa County,0,52,-52
39,Ohio,13,Georgia,49,Charlton County,8,0,8
39,Ohio,13,Georgia,51,Chatham County,198,526,-328
39,Ohio,13,Georgia,53,Chattahoochee County,70,41,29
39,Ohio,13,Georgia,57,Cherokee County,79,203,-124
39,Ohio,13,Georgia,59,Clarke County,21,191,-170
39,Ohio,13,Georgia,63,Clayton County,180,93,87
39,Ohio,13,Georgia,67,Cobb County,353,827,-474
39,Ohio,13,Georgia,71,Colquitt County,0,37,-37
39,Ohio,13,Georgia,73,Columbia County,66,0,66
39,Ohio,13,Georgia,77,Coweta County,57,84,-27
39,Ohio,13,Georgia,85,Dawson County,0,11,-11
39,Ohio,13,Georgia,87,Decatur County,32,11,21
39,Ohio,13,Georgia,89,DeKalb County,545,585,-40
39,Ohio,13,Georgia,95,Dougherty County,9,154,-145
39,Ohio,13,Georgia,97,Douglas County,57,246,-189
39,Ohio,13,Georgia,99,Early County,0,3,-3
39,Ohio,13,Georgia,101,Echols County,0,10,-10
39,Ohio,13,Georgia,103,Effingham County,0,27,-27
39,Ohio,13,Georgia,105,Elbert County,0,11,-11
39,Ohio,13,Georgia,113,Fayette County,39,45,-6
39,Ohio,13,Georgia,115,Floyd County,52,168,-116
39,Ohio,13,Georgia,117,Forsyth County,156,216,-60
39,Ohio,13,Georgia,119,Franklin County,8,0,8
39,Ohio,13,Georgia,121,Fulton County,701,1511,-810
39,Ohio,13,Georgia,123,Gilmer County,0,19,-19
39,Ohio,13,Georgia,127,Glynn County,0,80,-80
39,Ohio,13,Georgia,129,Gordon County,0,67,-67
39,Ohio,13,Georgia,133,Greene County,0,11,-11
39,Ohio,13,Georgia,135,Gwinnett County,293,1356,-1063
39,Ohio,13,Georgia,137,Habersham County,33,24,9
39,Ohio,13,Georgia,139,Hall County,72,137,-65
39,Ohio,13,Georgia,145,Harris County,5,0,5
39,Ohio,13,Georgia,151,Henry County,133,9,124
39,Ohio,13,Georgia,153,Houston County,74,266,-192
39,Ohio,13,Georgia,157,Jackson County,198,9,189
39,Ohio,13,Georgia,169,Jones County,0,9,-9
39,Ohio,13,Georgia,175,Laurens County,20,11,9
39,Ohio,13,Georgia,177,Lee County,0,9,-9
39,Ohio,13,Georgia,179,Liberty County,169,154,15
39,Ohio,13,Georgia,183,Long County,38,0,38
39,Ohio,13,Georgia,185,Lowndes County,101,54,47
39,Ohio,13,Georgia,195,Madison County,39,0,39
39,Ohio,13,Georgia,201,Miller County,0,5,-5
39,Ohio,13,Georgia,213,Murray County,0,50,-50
39,Ohio,13,Georgia,215,Muscogee County,50,246,-196
39,Ohio,13,Georgia,217,Newton County,97,42,55
39,Ohio,13,Georgia,219,Oconee County,15,3,12
39,Ohio,13,Georgia,221,Oglethorpe County,0,1,-1
39,Ohio,13,Georgia,223,Paulding County,130,20,110
39,Ohio,13,Georgia,227,Pickens County,0,36,-36
39,Ohio,13,Georgia,229,Pierce County,0,155,-155
39,Ohio,13,Georgia,233,Polk County,0,4,-4
39,Ohio,13,Georgia,237,Putnam County,33,20,13
39,Ohio,13,Georgia,245,Richmond County,206,102,104
39,Ohio,13,Georgia,247,Rockdale County,2,134,-132
39,Ohio,13,Georgia,253,Seminole County,9,0,9
39,Ohio,13,Georgia,255,Spalding County,95,21,74
39,Ohio,13,Georgia,257,Stephens County,0,22,-22
39,Ohio,13,Georgia,271,Telfair County,0,8,-8
39,Ohio,13,Georgia,275,Thomas County,0,19,-19
39,Ohio,13,Georgia,285,Troup County,31,132,-101
39,Ohio,13,Georgia,291,Union County,0,4,-4
39,Ohio,13,Georgia,295,Walker County,50,0,50
39,Ohio,13,Georgia,297,Walton County,0,29,-29
39,Ohio,13,Georgia,299,Ware County,7,0,7
39,Ohio,13,Georgia,305,Wayne County,0,37,-37
39,Ohio,13,Georgia,307,Webster County,0,15,-15
39,Ohio,13,Georgia,311,White County,0,4,-4
39,Ohio,13,Georgia,313,Whitfield County,27,7,20
39,Ohio,15,Hawaii,1,Hawaii County,26,60,-34
39,Ohio,15,Hawaii,3,Honolulu County,421,538,-117
39,Ohio,15,Hawaii,7,Kauai County,0,34,-34
39,Ohio,15,Hawaii,9,Maui County,0,49,-49
39,Ohio,16,Idaho,1,Ada County,93,69,24
39,Ohio,16,Idaho,5,Bannock County,75,121,-46
39,Ohio,16,Idaho,9,Benewah County,0,18,-18
39,Ohio,16,Idaho,15,Boise County,0,20,-20
39,Ohio,16,Idaho,19,Bonneville County,49,10,39
39,Ohio,16,Idaho,21,Boundary County,0,35,-35
39,Ohio,16,Idaho,27,Canyon County,15,28,-13
39,Ohio,16,Idaho,31,Cassia County,58,0,58
39,Ohio,16,Idaho,37,Custer County,0,2,-2
39,Ohio,16,Idaho,39,Elmore County,0,28,-28
39,Ohio,16,Idaho,53,Jerome County,11,0,11
39,Ohio,16,Idaho,55,Kootenai County,161,26,135
39,Ohio,16,Idaho,57,Latah County,0,10,-10
39,Ohio,16,Idaho,69,Nez Perce County,8,0,8
39,Ohio,17,Illinois,5,Bond County,0,3,-3
39,Ohio,17,Illinois,7,Boone County,25,6,19
39,Ohio,17,Illinois,11,Bureau County,62,4,58
39,Ohio,17,Illinois,15,Carroll County,10,2,8
39,Ohio,17,Illinois,19,Champaign County,216,266,-50
39,Ohio,17,Illinois,23,Clark County,41,50,-9
39,Ohio,17,Illinois,27,Clinton County,32,82,-50
39,Ohio,17,Illinois,29,Coles County,57,17,40
39,Ohio,17,Illinois,31,Cook County,4856,4695,161
39,Ohio,17,Illinois,33,Crawford County,22,0,22
39,Ohio,17,Illinois,35,Cumberland County,6,0,6
39,Ohio,17,Illinois,37,DeKalb County,63,10,53
39,Ohio,17,Illinois,41,Douglas County,42,0,42
39,Ohio,17,Illinois,43,DuPage County,731,522,209
39,Ohio,17,Illinois,45,Edgar County,50,0,50
39,Ohio,17,Illinois,47,Edwards County,0,2,-2
39,Ohio,17,Illinois,49,Effingham County,67,51,16
39,Ohio,17,Illinois,55,Franklin County,30,37,-7
39,Ohio,17,Illinois,57,Fulton County,0,36,-36
39,Ohio,17,Illinois,61,Greene County,11,0,11
39,Ohio,17,Illinois,63,Grundy County,53,3,50
39,Ohio,17,Illinois,75,Iroquois County,0,3,-3
39,Ohio,17,Illinois,77,Jackson County,315,7,308
39,Ohio,17,Illinois,79,Jasper County,2,0,2
39,Ohio,17,Illinois,81,Jefferson County,104,8,96
39,Ohio,17,Illinois,87,Johnson County,0,3,-3
39,Ohio,17,Illinois,89,Kane County,266,210,56
39,Ohio,17,Illinois,91,Kankakee County,119,251,-132
39,Ohio,17,Illinois,93,Kendall County,92,48,44
39,Ohio,17,Illinois,95,Knox County,14,19,-5
39,Ohio,17,Illinois,97,Lake County,1100,574,526
39,Ohio,17,Illinois,99,LaSalle County,33,31,2
39,Ohio,17,Illinois,101,Lawrence County,0,57,-57
39,Ohio,17,Illinois,103,Lee County,4,2,2
39,Ohio,17,Illinois,105,Livingston County,14,4,10
39,Ohio,17,Illinois,107,Logan County,18,0,18
39,Ohio,17,Illinois,109,McDonough County,52,84,-32
39,Ohio,17,Illinois,111,McHenry County,101,38,63
39,Ohio,17,Illinois,113,McLean County,122,144,-22
39,Ohio,17,Illinois,115,Macon County,16,28,-12
39,Ohio,17,Illinois,117,Macoupin County,55,22,33
39,Ohio,17,Illinois,119,Madison County,77,12,65
39,Ohio,17,Illinois,121,Marion County,0,25,-25
39,Ohio,17,Illinois,133,Monroe County,12,0,12
39,Ohio,17,Illinois,135,Montgomery County,16,0,16
39,Ohio,17,Illinois,137,Morgan County,0,19,-19
39,Ohio,17,Illinois,143,Peoria County,74,89,-15
39,Ohio,17,Illinois,145,Perry County,0,2,-2
39,Ohio,17,Illinois,147,Piatt County,10,32,-22
39,Ohio,17,Illinois,149,Pike County,0,2,-2
39,Ohio,17,Illinois,157,Randolph County,1,5,-4
39,Ohio,17,Illinois,159,Richland County,0,17,-17
39,Ohio,17,Illinois,161,Rock Island County,67,118,-51
39,Ohio,17,Illinois,163,St. Clair County,149,288,-139
39,Ohio,17,Illinois,165,Saline County,13,0,13
39,Ohio,17,Illinois,167,Sangamon County,33,67,-34
39,Ohio,17,Illinois,173,Shelby County,19,0,19
39,Ohio,17,Illinois,175,Stark County,8,0,8
39,Ohio,17,Illinois,177,Stephenson County,14,0,14
39,Ohio,17,Illinois,179,Tazewell County,65,12,53
39,Ohio,17,Illinois,183,Vermilion County,18,21,-3
39,Ohio,17,Illinois,189,Washington County,26,14,12
39,Ohio,17,Illinois,193,White County,0,3,-3
39,Ohio,17,Illinois,195,Whiteside County,13,0,13
39,Ohio,17,Illinois,197,Will County,328,211,117
39,Ohio,17,Illinois,199,Williamson County,42,0,42
39,Ohio,17,Illinois,201,Winnebago County,259,85,174
39,Ohio,17,Illinois,203,Woodford County,18,0,18
39,Ohio,18,Indiana,1,Adams County,55,65,-10
39,Ohio,18,Indiana,3,Allen County,1316,877,439
39,Ohio,18,Indiana,5,Bartholomew County,231,35,196
39,Ohio,18,Indiana,9,Blackford County,29,21,8
39,Ohio,18,Indiana,11,Boone County,31,21,10
39,Ohio,18,Indiana,13,Brown County,74,0,74
39,Ohio,18,Indiana,15,Carroll County,9,0,9
39,Ohio,18,Indiana,17,Cass County,0,4,-4
39,Ohio,18,Indiana,19,Clark County,60,53,7
39,Ohio,18,Indiana,21,Clay County,0,24,-24
39,Ohio,18,Indiana,23,Clinton County,10,72,-62
39,Ohio,18,Indiana,25,Crawford County,0,9,-9
39,Ohio,18,Indiana,27,Daviess County,0,2,-2
39,Ohio,18,Indiana,29,Dearborn County,587,1113,-526
39,Ohio,18,Indiana,31,Decatur County,51,148,-97
39,Ohio,18,Indiana,33,DeKalb County,61,150,-89
39,Ohio,18,Indiana,35,Delaware County,358,351,7
39,Ohio,18,Indiana,37,Dubois County,0,19,-19
39,Ohio,18,Indiana,39,Elkhart County,93,129,-36
39,Ohio,18,Indiana,41,Fayette County,249,81,168
39,Ohio,18,Indiana,43,Floyd County,1,14,-13
39,Ohio,18,Indiana,47,Franklin County,281,149,132
39,Ohio,18,Indiana,49,Fulton County,16,0,16
39,Ohio,18,Indiana,51,Gibson County,9,2,7
39,Ohio,18,Indiana,53,Grant County,60,204,-144
39,Ohio,18,Indiana,55,Greene County,9,6,3
39,Ohio,18,Indiana,57,Hamilton County,965,578,387
39,Ohio,18,Indiana,59,Hancock County,116,0,116
39,Ohio,18,Indiana,61,Harrison County,13,0,13
39,Ohio,18,Indiana,63,Hendricks County,170,137,33
39,Ohio,18,Indiana,65,Henry County,73,99,-26
39,Ohio,18,Indiana,67,Howard County,38,22,16
39,Ohio,18,Indiana,69,Huntington County,62,84,-22
39,Ohio,18,Indiana,71,Jackson County,10,55,-45
39,Ohio,18,Indiana,73,Jasper County,16,6,10
39,Ohio,18,Indiana,75,Jay County,487,21,466
39,Ohio,18,Indiana,77,Jefferson County,109,81,28
39,Ohio,18,Indiana,79,Jennings County,80,45,35
39,Ohio,18,Indiana,81,Johnson County,178,172,6
39,Ohio,18,Indiana,85,Kosciusko County,113,249,-136
39,Ohio,18,Indiana,87,LaGrange County,0,44,-44
39,Ohio,18,Indiana,89,Lake County,403,238,165
39,Ohio,18,Indiana,91,LaPorte County,0,77,-77
39,Ohio,18,Indiana,93,Lawrence County,99,0,99
39,Ohio,18,Indiana,95,Madison County,31,109,-78
39,Ohio,18,Indiana,97,Marion County,1543,1325,218
39,Ohio,18,Indiana,99,Marshall County,38,8,30
39,Ohio,18,Indiana,103,Miami County,7,12,-5
39,Ohio,18,Indiana,105,Monroe County,574,224,350
39,Ohio,18,Indiana,107,Montgomery County,55,0,55
39,Ohio,18,Indiana,109,Morgan County,65,21,44
39,Ohio,18,Indiana,111,Newton County,0,13,-13
39,Ohio,18,Indiana,113,Noble County,43,207,-164
39,Ohio,18,Indiana,115,Ohio County,80,61,19
39,Ohio,18,Indiana,117,Orange County,0,64,-64
39,Ohio,18,Indiana,121,Parke County,0,13,-13
39,Ohio,18,Indiana,123,Perry County,0,13,-13
39,Ohio,18,Indiana,127,Porter County,130,100,30
39,Ohio,18,Indiana,131,Pulaski County,23,0,23
39,Ohio,18,Indiana,133,Putnam County,0,137,-137
39,Ohio,18,Indiana,135,Randolph County,225,109,116
39,Ohio,18,Indiana,137,Ripley County,155,116,39
39,Ohio,18,Indiana,139,Rush County,14,0,14
39,Ohio,18,Indiana,141,St. Joseph County,496,500,-4
39,Ohio,18,Indiana,145,Shelby County,72,12,60
39,Ohio,18,Indiana,147,Spencer County,0,12,-12
39,Ohio,18,Indiana,149,Starke County,6,28,-22
39,Ohio,18,Indiana,151,Steuben County,142,119,23
39,Ohio,18,Indiana,155,Switzerland County,0,145,-145
39,Ohio,18,Indiana,157,Tippecanoe County,417,483,-66
39,Ohio,18,Indiana,159,Tipton County,64,11,53
39,Ohio,18,Indiana,161,Union County,163,510,-347
39,Ohio,18,Indiana,163,Vanderburgh County,46,149,-103
39,Ohio,18,Indiana,165,Vermillion County,24,0,24
39,Ohio,18,Indiana,167,Vigo County,114,452,-338
39,Ohio,18,Indiana,169,Wabash County,0,29,-29
39,Ohio,18,Indiana,173,Warrick County,10,3,7
39,Ohio,18,Indiana,175,Washington County,11,0,11
39,Ohio,18,Indiana,177,Wayne County,510,866,-356
39,Ohio,18,Indiana,179,Wells County,87,3,84
39,Ohio,18,Indiana,183,Whitley County,0,7,-7
39,Ohio,19,Iowa,7,Appanoose County,0,3,-3
39,Ohio,19,Iowa,13,Black Hawk County,31,174,-143
39,Ohio,19,Iowa,17,Bremer County,0,6,-6
39,Ohio,19,Iowa,21,Buena Vista County,0,23,-23
39,Ohio,19,Iowa,27,Carroll County,0,9,-9
39,Ohio,19,Iowa,33,Cerro Gordo County,0,5,-5
39,Ohio,19,Iowa,37,Chickasaw County,179,0,179
39,Ohio,19,Iowa,43,Clayton County,0,2,-2
39,Ohio,19,Iowa,45,Clinton County,0,16,-16
39,Ohio,19,Iowa,47,Crawford County,0,8,-8
39,Ohio,19,Iowa,49,Dallas County,11,0,11
39,Ohio,19,Iowa,57,Des Moines County,36,10,26
39,Ohio,19,Iowa,61,Dubuque County,54,15,39
39,Ohio,19,Iowa,63,Emmet County,50,2,48
39,Ohio,19,Iowa,65,Fayette County,0,24,-24
39,Ohio,19,Iowa,67,Floyd County,0,62,-62
39,Ohio,19,Iowa,83,Hardin County,17,11,6
39,Ohio,19,Iowa,103,Johnson County,276,349,-73
39,Ohio,19,Iowa,107,Keokuk County,0,29,-29
39,Ohio,19,Iowa,109,Kossuth County,16,0,16
39,Ohio,19,Iowa,111,Lee County,0,2,-2
39,Ohio,19,Iowa,113,Linn County,153,60,93
39,Ohio,19,Iowa,115,Louisa County,13,0,13
39,Ohio,19,Iowa,119,Lyon County,0,2,-2
39,Ohio,19,Iowa,123,Mahaska County,1,20,-19
39,Ohio,19,Iowa,129,Mills County,27,10,17
39,Ohio,19,Iowa,139,Muscatine County,41,0,41
39,Ohio,19,Iowa,153,Polk County,201,74,127
39,Ohio,19,Iowa,155,Pottawattamie County,11,10,1
39,Ohio,19,Iowa,157,Poweshiek County,6,0,6
39,Ohio,19,Iowa,163,Scott County,0,35,-35
39,Ohio,19,Iowa,169,Story County,83,43,40
39,Ohio,19,Iowa,173,Taylor County,0,2,-2
39,Ohio,19,Iowa,177,Van Buren County,0,1,-1
39,Ohio,19,Iowa,179,Wapello County,9,0,9
39,Ohio,19,Iowa,181,Warren County,27,0,27
39,Ohio,19,Iowa,187,Webster County,0,67,-67
39,Ohio,19,Iowa,191,Winneshiek County,35,0,35
39,Ohio,19,Iowa,193,Woodbury County,46,92,-46
39,Ohio,19,Iowa,195,Worth County,0,1,-1
39,Ohio,19,Iowa,197,Wright County,0,54,-54
39,Ohio,2,Alaska,16,Aleutians West Census Area,0,3,-3
39,Ohio,2,Alaska,20,Anchorage Municipality,337,244,93
39,Ohio,2,Alaska,68,Denali Borough,0,2,-2
39,Ohio,2,Alaska,90,Fairbanks North Star Borough,69,79,-10
39,Ohio,2,Alaska,110,Juneau City and Borough,107,11,96
39,Ohio,2,Alaska,122,Kenai Peninsula Borough,21,46,-25
39,Ohio,2,Alaska,150,Kodiak Island Borough,53,0,53
39,Ohio,2,Alaska,170,Matanuska-Susitna Borough,60,88,-28
39,Ohio,2,Alaska,261,Valdez-Cordova Census Area,0,1,-1
39,Ohio,2,Alaska,290,Yukon-Koyukuk Census Area,0,2,-2
39,Ohio,20,Kansas,5,Atchison County,0,36,-36
39,Ohio,20,Kansas,9,Barton County,0,130,-130
39,Ohio,20,Kansas,11,Bourbon County,13,0,13
39,Ohio,20,Kansas,13,Brown County,0,36,-36
39,Ohio,20,Kansas,21,Cherokee County,15,3,12
39,Ohio,20,Kansas,27,Clay County,0,13,-13
39,Ohio,20,Kansas,35,Cowley County,19,21,-2
39,Ohio,20,Kansas,37,Crawford County,59,0,59
39,Ohio,20,Kansas,45,Douglas County,26,141,-115
39,Ohio,20,Kansas,47,Edwards County,0,3,-3
39,Ohio,20,Kansas,55,Finney County,55,18,37
39,Ohio,20,Kansas,57,Ford County,8,0,8
39,Ohio,20,Kansas,61,Geary County,215,53,162
39,Ohio,20,Kansas,63,Gove County,8,4,4
39,Ohio,20,Kansas,77,Harper County,7,0,7
39,Ohio,20,Kansas,79,Harvey County,90,16,74
39,Ohio,20,Kansas,81,Haskell County,0,7,-7
39,Ohio,20,Kansas,91,Johnson County,385,361,24
39,Ohio,20,Kansas,103,Leavenworth County,0,117,-117
39,Ohio,20,Kansas,111,Lyon County,0,18,-18
39,Ohio,20,Kansas,113,McPherson County,0,3,-3
39,Ohio,20,Kansas,119,Meade County,0,3,-3
39,Ohio,20,Kansas,121,Miami County,20,0,20
39,Ohio,20,Kansas,125,Montgomery County,7,0,7
39,Ohio,20,Kansas,133,Neosho County,0,12,-12
39,Ohio,20,Kansas,141,Osborne County,0,8,-8
39,Ohio,20,Kansas,153,Rawlins County,0,3,-3
39,Ohio,20,Kansas,155,Reno County,0,130,-130
39,Ohio,20,Kansas,161,Riley County,172,19,153
39,Ohio,20,Kansas,167,Russell County,0,8,-8
39,Ohio,20,Kansas,169,Saline County,0,13,-13
39,Ohio,20,Kansas,173,Sedgwick County,78,180,-102
39,Ohio,20,Kansas,177,Shawnee County,37,59,-22
39,Ohio,20,Kansas,181,Sherman County,71,0,71
39,Ohio,20,Kansas,199,Wallace County,2,0,2
39,Ohio,20,Kansas,209,Wyandotte County,62,4,58
39,Ohio,21,Kentucky,1,Adair County,0,52,-52
39,Ohio,21,Kentucky,3,Allen County,31,10,21
39,Ohio,21,Kentucky,9,Barren County,36,30,6
39,Ohio,21,Kentucky,11,Bath County,0,12,-12
39,Ohio,21,Kentucky,15,Boone County,1369,1499,-130
39,Ohio,21,Kentucky,17,Bourbon County,0,42,-42
39,Ohio,21,Kentucky,19,Boyd County,792,607,185
39,Ohio,21,Kentucky,21,Boyle County,81,53,28
39,Ohio,21,Kentucky,23,Bracken County,59,52,7
39,Ohio,21,Kentucky,25,Breathitt County,22,32,-10
39,Ohio,21,Kentucky,27,Breckinridge County,0,21,-21
39,Ohio,21,Kentucky,29,Bullitt County,6,212,-206
39,Ohio,21,Kentucky,31,Butler County,0,19,-19
39,Ohio,21,Kentucky,35,Calloway County,14,43,-29
39,Ohio,21,Kentucky,37,Campbell County,1625,2393,-768
39,Ohio,21,Kentucky,41,Carroll County,11,4,7
39,Ohio,21,Kentucky,43,Carter County,154,68,86
39,Ohio,21,Kentucky,45,Casey County,4,49,-45
39,Ohio,21,Kentucky,47,Christian County,215,248,-33
39,Ohio,21,Kentucky,49,Clark County,351,79,272
39,Ohio,21,Kentucky,51,Clay County,105,4,101
39,Ohio,21,Kentucky,53,Clinton County,0,5,-5
39,Ohio,21,Kentucky,55,Crittenden County,0,11,-11
39,Ohio,21,Kentucky,57,Cumberland County,0,25,-25
39,Ohio,21,Kentucky,59,Daviess County,284,72,212
39,Ohio,21,Kentucky,63,Elliott County,19,0,19
39,Ohio,21,Kentucky,65,Estill County,17,27,-10
39,Ohio,21,Kentucky,67,Fayette County,993,1576,-583
39,Ohio,21,Kentucky,69,Fleming County,65,1,64
39,Ohio,21,Kentucky,71,Floyd County,28,15,13
39,Ohio,21,Kentucky,73,Franklin County,174,111,63
39,Ohio,21,Kentucky,75,Fulton County,0,7,-7
39,Ohio,21,Kentucky,77,Gallatin County,47,49,-2
39,Ohio,21,Kentucky,81,Grant County,171,134,37
39,Ohio,21,Kentucky,83,Graves County,0,20,-20
39,Ohio,21,Kentucky,85,Grayson County,0,12,-12
39,Ohio,21,Kentucky,89,Greenup County,464,500,-36
39,Ohio,21,Kentucky,91,Hancock County,0,4,-4
39,Ohio,21,Kentucky,93,Hardin County,436,111,325
39,Ohio,21,Kentucky,95,Harlan County,27,6,21
39,Ohio,21,Kentucky,97,Harrison County,72,0,72
39,Ohio,21,Kentucky,99,Hart County,0,8,-8
39,Ohio,21,Kentucky,101,Henderson County,221,0,221
39,Ohio,21,Kentucky,103,Henry County,9,21,-12
39,Ohio,21,Kentucky,105,Hickman County,0,10,-10
39,Ohio,21,Kentucky,109,Jackson County,0,88,-88
39,Ohio,21,Kentucky,111,Jefferson County,963,900,63
39,Ohio,21,Kentucky,113,Jessamine County,26,43,-17
39,Ohio,21,Kentucky,115,Johnson County,75,44,31
39,Ohio,21,Kentucky,117,Kenton County,2721,3414,-693
39,Ohio,21,Kentucky,119,Knott County,12,85,-73
39,Ohio,21,Kentucky,121,Knox County,19,11,8
39,Ohio,21,Kentucky,123,Larue County,0,14,-14
39,Ohio,21,Kentucky,125,Laurel County,40,186,-146
39,Ohio,21,Kentucky,127,Lawrence County,153,12,141
39,Ohio,21,Kentucky,129,Lee County,40,0,40
39,Ohio,21,Kentucky,131,Leslie County,7,134,-127
39,Ohio,21,Kentucky,133,Letcher County,17,4,13
39,Ohio,21,Kentucky,135,Lewis County,152,146,6
39,Ohio,21,Kentucky,137,Lincoln County,0,5,-5
39,Ohio,21,Kentucky,141,Logan County,11,43,-32
39,Ohio,21,Kentucky,143,Lyon County,0,1,-1
39,Ohio,21,Kentucky,145,McCracken County,0,32,-32
39,Ohio,21,Kentucky,147,McCreary County,57,29,28
39,Ohio,21,Kentucky,151,Madison County,127,392,-265
39,Ohio,21,Kentucky,153,Magoffin County,301,0,301
39,Ohio,21,Kentucky,155,Marion County,8,17,-9
39,Ohio,21,Kentucky,157,Marshall County,11,6,5
39,Ohio,21,Kentucky,159,Martin County,8,5,3
39,Ohio,21,Kentucky,161,Mason County,143,91,52
39,Ohio,21,Kentucky,163,Meade County,0,98,-98
39,Ohio,21,Kentucky,165,Menifee County,8,0,8
39,Ohio,21,Kentucky,167,Mercer County,32,15,17
39,Ohio,21,Kentucky,169,Metcalfe County,30,15,15
39,Ohio,21,Kentucky,171,Monroe County,0,24,-24
39,Ohio,21,Kentucky,173,Montgomery County,28,119,-91
39,Ohio,21,Kentucky,175,Morgan County,48,94,-46
39,Ohio,21,Kentucky,177,Muhlenberg County,8,20,-12
39,Ohio,21,Kentucky,179,Nelson County,216,10,206
39,Ohio,21,Kentucky,183,Ohio County,0,10,-10
39,Ohio,21,Kentucky,185,Oldham County,213,185,28
39,Ohio,21,Kentucky,187,Owen County,0,8,-8
39,Ohio,21,Kentucky,189,Owsley County,63,0,63
39,Ohio,21,Kentucky,191,Pendleton County,129,194,-65
39,Ohio,21,Kentucky,193,Perry County,87,0,87
39,Ohio,21,Kentucky,195,Pike County,101,128,-27
39,Ohio,21,Kentucky,197,Powell County,41,0,41
39,Ohio,21,Kentucky,199,Pulaski County,114,170,-56
39,Ohio,21,Kentucky,203,Rockcastle County,30,27,3
39,Ohio,21,Kentucky,205,Rowan County,172,133,39
39,Ohio,21,Kentucky,207,Russell County,30,20,10
39,Ohio,21,Kentucky,209,Scott County,75,166,-91
39,Ohio,21,Kentucky,211,Shelby County,33,42,-9
39,Ohio,21,Kentucky,213,Simpson County,0,22,-22
39,Ohio,21,Kentucky,217,Taylor County,4,4,0
39,Ohio,21,Kentucky,219,Todd County,7,8,-1
39,Ohio,21,Kentucky,225,Union County,0,26,-26
39,Ohio,21,Kentucky,227,Warren County,11,112,-101
39,Ohio,21,Kentucky,229,Washington County,34,0,34
39,Ohio,21,Kentucky,231,Wayne County,5,28,-23
39,Ohio,21,Kentucky,233,Webster County,0,7,-7
39,Ohio,21,Kentucky,235,Whitley County,85,67,18
39,Ohio,21,Kentucky,239,Woodford County,54,13,41
39,Ohio,22,Louisiana,1,Acadia Parish,26,0,26
39,Ohio,22,Louisiana,5,Ascension Parish,2,8,-6
39,Ohio,22,Louisiana,11,Beauregard Parish,0,68,-68
39,Ohio,22,Louisiana,15,Bossier Parish,0,225,-225
39,Ohio,22,Louisiana,17,Caddo Parish,49,58,-9
39,Ohio,22,Louisiana,19,Calcasieu Parish,24,1,23
39,Ohio,22,Louisiana,27,Claiborne Parish,0,6,-6
39,Ohio,22,Louisiana,29,Concordia Parish,21,0,21
39,Ohio,22,Louisiana,33,East Baton Rouge Parish,33,53,-20
39,Ohio,22,Louisiana,51,Jefferson Parish,61,246,-185
39,Ohio,22,Louisiana,55,Lafayette Parish,56,180,-124
39,Ohio,22,Louisiana,57,Lafourche Parish,36,0,36
39,Ohio,22,Louisiana,63,Livingston Parish,6,27,-21
39,Ohio,22,Louisiana,71,Orleans Parish,196,249,-53
39,Ohio,22,Louisiana,73,Ouachita Parish,8,25,-17
39,Ohio,22,Louisiana,79,Rapides Parish,40,9,31
39,Ohio,22,Louisiana,87,St. Bernard Parish,62,25,37
39,Ohio,22,Louisiana,89,St. Charles Parish,36,0,36
39,Ohio,22,Louisiana,97,St. Landry Parish,0,1,-1
39,Ohio,22,Louisiana,99,St. Martin Parish,0,7,-7
39,Ohio,22,Louisiana,101,St. Mary Parish,43,0,43
39,Ohio,22,Louisiana,103,St. Tammany Parish,114,327,-213
39,Ohio,22,Louisiana,105,Tangipahoa Parish,106,0,106
39,Ohio,22,Louisiana,115,Vernon Parish,162,47,115
39,Ohio,22,Louisiana,121,West Baton Rouge Parish,236,0,236
39,Ohio,22,Louisiana,123,West Carroll Parish,14,0,14
39,Ohio,22,Louisiana,127,Winn Parish,0,4,-4
39,Ohio,23,Maine,1,Androscoggin County,19,8,11
39,Ohio,23,Maine,3,Aroostook County,0,28,-28
39,Ohio,23,Maine,5,Cumberland County,215,136,79
39,Ohio,23,Maine,7,Franklin County,21,0,21
39,Ohio,23,Maine,11,Kennebec County,9,138,-129
39,Ohio,23,Maine,13,Knox County,0,12,-12
39,Ohio,23,Maine,15,Lincoln County,0,3,-3
39,Ohio,23,Maine,17,Oxford County,0,67,-67
39,Ohio,23,Maine,19,Penobscot County,25,83,-58
39,Ohio,23,Maine,23,Sagadahoc County,70,0,70
39,Ohio,23,Maine,25,Somerset County,20,5,15
39,Ohio,23,Maine,27,Waldo County,0,6,-6
39,Ohio,23,Maine,29,Washington County,0,14,-14
39,Ohio,23,Maine,31,York County,8,29,-21
39,Ohio,24,Maryland,1,Allegany County,27,35,-8
39,Ohio,24,Maryland,3,Anne Arundel County,471,340,131
39,Ohio,24,Maryland,5,Baltimore County,187,479,-292
39,Ohio,24,Maryland,9,Calvert County,89,73,16
39,Ohio,24,Maryland,11,Caroline County,19,0,19
39,Ohio,24,Maryland,13,Carroll County,81,63,18
39,Ohio,24,Maryland,15,Cecil County,40,65,-25
39,Ohio,24,Maryland,17,Charles County,71,89,-18
39,Ohio,24,Maryland,19,Dorchester County,0,20,-20
39,Ohio,24,Maryland,21,Frederick County,181,36,145
39,Ohio,24,Maryland,23,Garrett County,34,64,-30
39,Ohio,24,Maryland,25,Harford County,41,57,-16
39,Ohio,24,Maryland,27,Howard County,163,59,104
39,Ohio,24,Maryland,31,Montgomery County,796,706,90
39,Ohio,24,Maryland,33,Prince George's County,734,422,312
39,Ohio,24,Maryland,35,Queen Anne's County,8,18,-10
39,Ohio,24,Maryland,37,St. Mary's County,65,69,-4
39,Ohio,24,Maryland,41,Talbot County,0,5,-5
39,Ohio,24,Maryland,43,Washington County,76,99,-23
39,Ohio,24,Maryland,45,Wicomico County,89,51,38
39,Ohio,24,Maryland,47,Worcester County,11,8,3
39,Ohio,24,Maryland,510,Baltimore city,312,459,-147
39,Ohio,25,Massachusetts,1,Barnstable County,36,50,-14
39,Ohio,25,Massachusetts,3,Berkshire County,31,34,-3
39,Ohio,25,Massachusetts,5,Bristol County,84,57,27
39,Ohio,25,Massachusetts,7,Dukes County,0,1,-1
39,Ohio,25,Massachusetts,9,Essex County,404,144,260
39,Ohio,25,Massachusetts,11,Franklin County,13,0,13
39,Ohio,25,Massachusetts,13,Hampden County,249,37,212
39,Ohio,25,Massachusetts,15,Hampshire County,174,86,88
39,Ohio,25,Massachusetts,17,Middlesex County,1016,727,289
39,Ohio,25,Massachusetts,19,Nantucket County,10,5,5
39,Ohio,25,Massachusetts,21,Norfolk County,276,385,-109
39,Ohio,25,Massachusetts,23,Plymouth County,41,61,-20
39,Ohio,25,Massachusetts,25,Suffolk County,520,397,123
39,Ohio,25,Massachusetts,27,Worcester County,88,120,-32
39,Ohio,26,Michigan,1,Alcona County,0,6,-6
39,Ohio,26,Michigan,3,Alger County,0,12,-12
39,Ohio,26,Michigan,5,Allegan County,27,52,-25
39,Ohio,26,Michigan,7,Alpena County,27,2,25
39,Ohio,26,Michigan,9,Antrim County,0,40,-40
39,Ohio,26,Michigan,11,Arenac County,0,8,-8
39,Ohio,26,Michigan,15,Barry County,8,67,-59
39,Ohio,26,Michigan,17,Bay County,146,42,104
39,Ohio,26,Michigan,19,Benzie County,0,16,-16
39,Ohio,26,Michigan,21,Berrien County,316,86,230
39,Ohio,26,Michigan,23,Branch County,116,47,69
39,Ohio,26,Michigan,25,Calhoun County,144,103,41
39,Ohio,26,Michigan,27,Cass County,0,30,-30
39,Ohio,26,Michigan,29,Charlevoix County,0,28,-28
39,Ohio,26,Michigan,31,Cheboygan County,17,72,-55
39,Ohio,26,Michigan,33,Chippewa County,17,23,-6
39,Ohio,26,Michigan,35,Clare County,55,69,-14
39,Ohio,26,Michigan,37,Clinton County,108,16,92
39,Ohio,26,Michigan,39,Crawford County,4,15,-11
39,Ohio,26,Michigan,41,Delta County,10,32,-22
39,Ohio,26,Michigan,43,Dickinson County,6,0,6
39,Ohio,26,Michigan,45,Eaton County,175,197,-22
39,Ohio,26,Michigan,47,Emmet County,0,16,-16
39,Ohio,26,Michigan,49,Genesee County,281,410,-129
39,Ohio,26,Michigan,51,Gladwin County,5,0,5
39,Ohio,26,Michigan,53,Gogebic County,4,1,3
39,Ohio,26,Michigan,55,Grand Traverse County,114,100,14
39,Ohio,26,Michigan,57,Gratiot County,100,33,67
39,Ohio,26,Michigan,59,Hillsdale County,261,240,21
39,Ohio,26,Michigan,61,Houghton County,22,0,22
39,Ohio,26,Michigan,63,Huron County,6,15,-9
39,Ohio,26,Michigan,65,Ingham County,589,485,104
39,Ohio,26,Michigan,67,Ionia County,0,28,-28
39,Ohio,26,Michigan,69,Iosco County,35,26,9
39,Ohio,26,Michigan,73,Isabella County,62,93,-31
39,Ohio,26,Michigan,75,Jackson County,123,137,-14
39,Ohio,26,Michigan,77,Kalamazoo County,541,637,-96
39,Ohio,26,Michigan,79,Kalkaska County,0,16,-16
39,Ohio,26,Michigan,81,Kent County,539,457,82
39,Ohio,26,Michigan,85,Lake County,8,76,-68
39,Ohio,26,Michigan,87,Lapeer County,7,9,-2
39,Ohio,26,Michigan,89,Leelanau County,0,11,-11
39,Ohio,26,Michigan,91,Lenawee County,606,689,-83
39,Ohio,26,Michigan,93,Livingston County,281,72,209
39,Ohio,26,Michigan,95,Luce County,18,3,15
39,Ohio,26,Michigan,97,Mackinac County,37,3,34
39,Ohio,26,Michigan,99,Macomb County,515,549,-34
39,Ohio,26,Michigan,101,Manistee County,36,21,15
39,Ohio,26,Michigan,103,Marquette County,0,33,-33
39,Ohio,26,Michigan,105,Mason County,9,17,-8
39,Ohio,26,Michigan,107,Mecosta County,9,30,-21
39,Ohio,26,Michigan,109,Menominee County,0,50,-50
39,Ohio,26,Michigan,111,Midland County,47,110,-63
39,Ohio,26,Michigan,113,Missaukee County,41,30,11
39,Ohio,26,Michigan,115,Monroe County,1454,1662,-208
39,Ohio,26,Michigan,117,Montcalm County,0,51,-51
39,Ohio,26,Michigan,119,Montmorency County,0,37,-37
39,Ohio,26,Michigan,121,Muskegon County,47,263,-216
39,Ohio,26,Michigan,123,Newaygo County,49,12,37
39,Ohio,26,Michigan,125,Oakland County,1811,1793,18
39,Ohio,26,Michigan,127,Oceana County,0,68,-68
39,Ohio,26,Michigan,129,Ogemaw County,4,25,-21
39,Ohio,26,Michigan,133,Osceola County,43,0,43
39,Ohio,26,Michigan,135,Oscoda County,1,0,1
39,Ohio,26,Michigan,137,Otsego County,47,5,42
39,Ohio,26,Michigan,139,Ottawa County,345,252,93
39,Ohio,26,Michigan,141,Presque Isle County,31,20,11
39,Ohio,26,Michigan,143,Roscommon County,14,37,-23
39,Ohio,26,Michigan,145,Saginaw County,79,57,22
39,Ohio,26,Michigan,147,St. Clair County,119,132,-13
39,Ohio,26,Michigan,149,St. Joseph County,9,11,-2
39,Ohio,26,Michigan,151,Sanilac County,18,27,-9
39,Ohio,26,Michigan,155,Shiawassee County,0,3,-3
39,Ohio,26,Michigan,157,Tuscola County,40,86,-46
39,Ohio,26,Michigan,159,Van Buren County,13,68,-55
39,Ohio,26,Michigan,161,Washtenaw County,1208,1764,-556
39,Ohio,26,Michigan,163,Wayne County,2653,1390,1263
39,Ohio,26,Michigan,165,Wexford County,5,26,-21
39,Ohio,27,Minnesota,3,Anoka County,7,85,-78
39,Ohio,27,Minnesota,7,Beltrami County,0,2,-2
39,Ohio,27,Minnesota,13,Blue Earth County,0,62,-62
39,Ohio,27,Minnesota,15,Brown County,7,3,4
39,Ohio,27,Minnesota,19,Carver County,40,25,15
39,Ohio,27,Minnesota,27,Clay County,53,1,52
39,Ohio,27,Minnesota,33,Cottonwood County,0,27,-27
39,Ohio,27,Minnesota,35,Crow Wing County,0,78,-78
39,Ohio,27,Minnesota,37,Dakota County,76,356,-280
39,Ohio,27,Minnesota,41,Douglas County,94,0,94
39,Ohio,27,Minnesota,45,Fillmore County,0,6,-6
39,Ohio,27,Minnesota,49,Goodhue County,11,113,-102
39,Ohio,27,Minnesota,53,Hennepin County,765,672,93
39,Ohio,27,Minnesota,55,Houston County,0,4,-4
39,Ohio,27,Minnesota,61,Itasca County,0,6,-6
39,Ohio,27,Minnesota,67,Kandiyohi County,37,0,37
39,Ohio,27,Minnesota,71,Koochiching County,0,9,-9
39,Ohio,27,Minnesota,91,Martin County,4,0,4
39,Ohio,27,Minnesota,97,Morrison County,0,1,-1
39,Ohio,27,Minnesota,99,Mower County,0,14,-14
39,Ohio,27,Minnesota,103,Nicollet County,37,0,37
39,Ohio,27,Minnesota,109,Olmsted County,139,37,102
39,Ohio,27,Minnesota,113,Pennington County,0,8,-8
39,Ohio,27,Minnesota,119,Polk County,69,0,69
39,Ohio,27,Minnesota,121,Pope County,0,2,-2
39,Ohio,27,Minnesota,123,Ramsey County,204,556,-352
39,Ohio,27,Minnesota,129,Renville County,11,0,11
39,Ohio,27,Minnesota,131,Rice County,13,38,-25
39,Ohio,27,Minnesota,137,St. Louis County,23,110,-87
39,Ohio,27,Minnesota,139,Scott County,0,74,-74
39,Ohio,27,Minnesota,141,Sherburne County,4,0,4
39,Ohio,27,Minnesota,143,Sibley County,0,4,-4
39,Ohio,27,Minnesota,145,Stearns County,91,84,7
39,Ohio,27,Minnesota,147,Steele County,10,0,10
39,Ohio,27,Minnesota,149,Stevens County,33,0,33
39,Ohio,27,Minnesota,151,Swift County,0,20,-20
39,Ohio,27,Minnesota,153,Todd County,0,13,-13
39,Ohio,27,Minnesota,157,Wabasha County,0,7,-7
39,Ohio,27,Minnesota,161,Waseca County,16,0,16
39,Ohio,27,Minnesota,163,Washington County,5,34,-29
39,Ohio,27,Minnesota,165,Watonwan County,8,0,8
39,Ohio,27,Minnesota,169,Winona County,43,0,43
39,Ohio,28,Mississippi,7,Attala County,0,50,-50
39,Ohio,28,Mississippi,11,Bolivar County,0,10,-10
39,Ohio,28,Mississippi,13,Calhoun County,0,6,-6
39,Ohio,28,Mississippi,21,Claiborne County,0,2,-2
39,Ohio,28,Mississippi,29,Copiah County,9,0,9
39,Ohio,28,Mississippi,33,DeSoto County,0,48,-48
39,Ohio,28,Mississippi,35,Forrest County,194,47,147
39,Ohio,28,Mississippi,45,Hancock County,0,17,-17
39,Ohio,28,Mississippi,47,Harrison County,37,200,-163
39,Ohio,28,Mississippi,49,Hinds County,195,68,127
39,Ohio,28,Mississippi,59,Jackson County,0,54,-54
39,Ohio,28,Mississippi,67,Jones County,6,0,6
39,Ohio,28,Mississippi,71,Lafayette County,89,21,68
39,Ohio,28,Mississippi,73,Lamar County,25,0,25
39,Ohio,28,Mississippi,75,Lauderdale County,0,63,-63
39,Ohio,28,Mississippi,81,Lee County,0,1,-1
39,Ohio,28,Mississippi,85,Lincoln County,0,4,-4
39,Ohio,28,Mississippi,87,Lowndes County,0,15,-15
39,Ohio,28,Mississippi,89,Madison County,0,6,-6
39,Ohio,28,Mississippi,93,Marshall County,0,13,-13
39,Ohio,28,Mississippi,99,Neshoba County,0,10,-10
39,Ohio,28,Mississippi,105,Oktibbeha County,0,64,-64
39,Ohio,28,Mississippi,109,Pearl River County,0,98,-98
39,Ohio,28,Mississippi,111,Perry County,0,32,-32
39,Ohio,28,Mississippi,113,Pike County,0,15,-15
39,Ohio,28,Mississippi,115,Pontotoc County,24,39,-15
39,Ohio,28,Mississippi,117,Prentiss County,0,1,-1
39,Ohio,28,Mississippi,121,Rankin County,146,64,82
39,Ohio,28,Mississippi,129,Smith County,4,0,4
39,Ohio,28,Mississippi,137,Tate County,20,0,20
39,Ohio,28,Mississippi,139,Tippah County,82,0,82
39,Ohio,28,Mississippi,141,Tishomingo County,10,3,7
39,Ohio,28,Mississippi,149,Warren County,0,73,-73
39,Ohio,28,Mississippi,151,Washington County,66,0,66
39,Ohio,28,Mississippi,153,Wayne County,21,0,21
39,Ohio,29,Missouri,1,Adair County,11,0,11
39,Ohio,29,Missouri,7,Audrain County,0,4,-4
39,Ohio,29,Missouri,9,Barry County,24,2,22
39,Ohio,29,Missouri,17,Bollinger County,0,3,-3
39,Ohio,29,Missouri,19,Boone County,285,126,159
39,Ohio,29,Missouri,21,Buchanan County,54,69,-15
39,Ohio,29,Missouri,23,Butler County,0,16,-16
39,Ohio,29,Missouri,27,Callaway County,0,90,-90
39,Ohio,29,Missouri,31,Cape Girardeau County,0,32,-32
39,Ohio,29,Missouri,37,Cass County,13,0,13
39,Ohio,29,Missouri,43,Christian County,17,17,0
39,Ohio,29,Missouri,47,Clay County,7,44,-37
39,Ohio,29,Missouri,51,Cole County,12,77,-65
39,Ohio,29,Missouri,55,Crawford County,19,0,19
39,Ohio,29,Missouri,57,Dade County,0,7,-7
39,Ohio,29,Missouri,59,Dallas County,21,0,21
39,Ohio,29,Missouri,61,Daviess County,0,106,-106
39,Ohio,29,Missouri,67,Douglas County,12,5,7
39,Ohio,29,Missouri,77,Greene County,113,242,-129
39,Ohio,29,Missouri,81,Harrison County,0,27,-27
39,Ohio,29,Missouri,91,Howell County,7,0,7
39,Ohio,29,Missouri,95,Jackson County,184,409,-225
39,Ohio,29,Missouri,97,Jasper County,0,121,-121
39,Ohio,29,Missouri,99,Jefferson County,25,152,-127
39,Ohio,29,Missouri,101,Johnson County,67,240,-173
39,Ohio,29,Missouri,107,Lafayette County,9,0,9
39,Ohio,29,Missouri,109,Lawrence County,0,3,-3
39,Ohio,29,Missouri,113,Lincoln County,39,0,39
39,Ohio,29,Missouri,115,Linn County,9,0,9
39,Ohio,29,Missouri,117,Livingston County,0,13,-13
39,Ohio,29,Missouri,127,Marion County,0,28,-28
39,Ohio,29,Missouri,129,Mercer County,0,1,-1
39,Ohio,29,Missouri,131,Miller County,0,14,-14
39,Ohio,29,Missouri,139,Montgomery County,10,4,6
39,Ohio,29,Missouri,147,Nodaway County,45,4,41
39,Ohio,29,Missouri,153,Ozark County,0,3,-3
39,Ohio,29,Missouri,157,Perry County,11,12,-1
39,Ohio,29,Missouri,159,Pettis County,0,65,-65
39,Ohio,29,Missouri,161,Phelps County,13,0,13
39,Ohio,29,Missouri,165,Platte County,149,117,32
39,Ohio,29,Missouri,169,Pulaski County,49,371,-322
39,Ohio,29,Missouri,181,Ripley County,4,0,4
39,Ohio,29,Missouri,183,St. Charles County,149,127,22
39,Ohio,29,Missouri,187,St. Francois County,0,11,-11
39,Ohio,29,Missouri,189,St. Louis County,911,462,449
39,Ohio,29,Missouri,209,Stone County,19,0,19
39,Ohio,29,Missouri,211,Sullivan County,0,2,-2
39,Ohio,29,Missouri,213,Taney County,0,19,-19
39,Ohio,29,Missouri,215,Texas County,0,117,-117
39,Ohio,29,Missouri,217,Vernon County,13,0,13
39,Ohio,29,Missouri,225,Webster County,19,17,2
39,Ohio,29,Missouri,229,Wright County,0,3,-3
39,Ohio,29,Missouri,510,St. Louis city,193,176,17
39,Ohio,30,Montana,7,Broadwater County,23,0,23
39,Ohio,30,Montana,9,Carbon County,5,0,5
39,Ohio,30,Montana,13,Cascade County,50,17,33
39,Ohio,30,Montana,19,Daniels County,0,3,-3
39,Ohio,30,Montana,29,Flathead County,60,31,29
39,Ohio,30,Montana,31,Gallatin County,42,78,-36
39,Ohio,30,Montana,43,Jefferson County,20,0,20
39,Ohio,30,Montana,47,Lake County,8,0,8
39,Ohio,30,Montana,49,Lewis and Clark County,0,9,-9
39,Ohio,30,Montana,63,Missoula County,34,47,-13
39,Ohio,30,Montana,73,Pondera County,0,7,-7
39,Ohio,30,Montana,75,Powder River County,0,2,-2
39,Ohio,30,Montana,81,Ravalli County,13,6,7
39,Ohio,30,Montana,83,Richland County,19,0,19
39,Ohio,30,Montana,91,Sheridan County,16,0,16
39,Ohio,30,Montana,95,Stillwater County,12,0,12
39,Ohio,30,Montana,105,Valley County,0,2,-2
39,Ohio,30,Montana,111,Yellowstone County,135,17,118
39,Ohio,31,Nebraska,35,Clay County,0,1,-1
39,Ohio,31,Nebraska,43,Dakota County,8,0,8
39,Ohio,31,Nebraska,45,Dawes County,0,18,-18
39,Ohio,31,Nebraska,53,Dodge County,0,31,-31
39,Ohio,31,Nebraska,55,Douglas County,187,118,69
39,Ohio,31,Nebraska,63,Frontier County,0,1,-1
39,Ohio,31,Nebraska,67,Gage County,14,0,14
39,Ohio,31,Nebraska,81,Hamilton County,10,0,10
39,Ohio,31,Nebraska,105,Kimball County,0,4,-4
39,Ohio,31,Nebraska,109,Lancaster County,268,107,161
39,Ohio,31,Nebraska,113,Logan County,0,4,-4
39,Ohio,31,Nebraska,119,Madison County,0,9,-9
39,Ohio,31,Nebraska,123,Morrill County,0,1,-1
39,Ohio,31,Nebraska,125,Nance County,0,6,-6
39,Ohio,31,Nebraska,127,Nemaha County,0,27,-27
39,Ohio,31,Nebraska,129,Nuckolls County,0,5,-5
39,Ohio,31,Nebraska,131,Otoe County,0,5,-5
39,Ohio,31,Nebraska,139,Pierce County,0,2,-2
39,Ohio,31,Nebraska,141,Platte County,11,0,11
39,Ohio,31,Nebraska,153,Sarpy County,64,67,-3
39,Ohio,31,Nebraska,157,Scotts Bluff County,16,0,16
39,Ohio,31,Nebraska,159,Seward County,0,3,-3
39,Ohio,31,Nebraska,169,Thayer County,0,6,-6
39,Ohio,32,Nevada,3,Clark County,1205,1394,-189
39,Ohio,32,Nevada,5,Douglas County,0,53,-53
39,Ohio,32,Nevada,19,Lyon County,21,57,-36
39,Ohio,32,Nevada,23,Nye County,29,0,29
39,Ohio,32,Nevada,29,Storey County,7,0,7
39,Ohio,32,Nevada,31,Washoe County,203,109,94
39,Ohio,32,Nevada,510,Carson City,0,12,-12
39,Ohio,33,New Hampshire,1,Belknap County,61,27,34
39,Ohio,33,New Hampshire,3,Carroll County,6,21,-15
39,Ohio,33,New Hampshire,5,Cheshire County,5,12,-7
39,Ohio,33,New Hampshire,9,Grafton County,95,50,45
39,Ohio,33,New Hampshire,11,Hillsborough County,249,113,136
39,Ohio,33,New Hampshire,13,Merrimack County,496,41,455
39,Ohio,33,New Hampshire,15,Rockingham County,89,41,48
39,Ohio,33,New Hampshire,17,Strafford County,24,0,24
39,Ohio,33,New Hampshire,19,Sullivan County,73,23,50
39,Ohio,34,New Jersey,1,Atlantic County,146,259,-113
39,Ohio,34,New Jersey,3,Bergen County,407,235,172
39,Ohio,34,New Jersey,5,Burlington County,228,35,193
39,Ohio,34,New Jersey,7,Camden County,92,74,18
39,Ohio,34,New Jersey,9,Cape May County,31,20,11
39,Ohio,34,New Jersey,11,Cumberland County,25,7,18
39,Ohio,34,New Jersey,13,Essex County,361,54,307
39,Ohio,34,New Jersey,15,Gloucester County,50,18,32
39,Ohio,34,New Jersey,17,Hudson County,217,217,0
39,Ohio,34,New Jersey,19,Hunterdon County,296,41,255
39,Ohio,34,New Jersey,21,Mercer County,128,110,18
39,Ohio,34,New Jersey,23,Middlesex County,678,83,595
39,Ohio,34,New Jersey,25,Monmouth County,165,0,165
39,Ohio,34,New Jersey,27,Morris County,179,48,131
39,Ohio,34,New Jersey,29,Ocean County,213,14,199
39,Ohio,34,New Jersey,31,Passaic County,51,0,51
39,Ohio,34,New Jersey,33,Salem County,0,6,-6
39,Ohio,34,New Jersey,35,Somerset County,82,155,-73
39,Ohio,34,New Jersey,39,Union County,250,127,123
39,Ohio,34,New Jersey,41,Warren County,20,0,20
39,Ohio,35,New Mexico,1,Bernalillo County,174,326,-152
39,Ohio,35,New Mexico,6,Cibola County,0,11,-11
39,Ohio,35,New Mexico,9,Curry County,37,26,11
39,Ohio,35,New Mexico,13,Doña Ana County,244,37,207
39,Ohio,35,New Mexico,15,Eddy County,42,31,11
39,Ohio,35,New Mexico,28,Los Alamos County,101,0,101
39,Ohio,35,New Mexico,31,McKinley County,0,29,-29
39,Ohio,35,New Mexico,35,Otero County,0,38,-38
39,Ohio,35,New Mexico,43,Sandoval County,3,19,-16
39,Ohio,35,New Mexico,45,San Juan County,28,87,-59
39,Ohio,35,New Mexico,47,San Miguel County,4,0,4
39,Ohio,35,New Mexico,49,Santa Fe County,66,44,22
39,Ohio,35,New Mexico,53,Socorro County,0,26,-26
39,Ohio,35,New Mexico,57,Torrance County,8,20,-12
39,Ohio,35,New Mexico,61,Valencia County,79,54,25
39,Ohio,36,New York,1,Albany County,284,51,233
39,Ohio,36,New York,3,Allegany County,68,16,52
39,Ohio,36,New York,5,Bronx County,477,344,133
39,Ohio,36,New York,7,Broome County,95,45,50
39,Ohio,36,New York,9,Cattaraugus County,81,22,59
39,Ohio,36,New York,11,Cayuga County,120,32,88
39,Ohio,36,New York,13,Chautauqua County,376,199,177
39,Ohio,36,New York,15,Chemung County,58,88,-30
39,Ohio,36,New York,17,Chenango County,0,14,-14
39,Ohio,36,New York,19,Clinton County,8,0,8
39,Ohio,36,New York,23,Cortland County,0,4,-4
39,Ohio,36,New York,25,Delaware County,17,57,-40
39,Ohio,36,New York,27,Dutchess County,101,86,15
39,Ohio,36,New York,29,Erie County,1213,411,802
39,Ohio,36,New York,31,Essex County,17,10,7
39,Ohio,36,New York,33,Franklin County,49,12,37
39,Ohio,36,New York,35,Fulton County,0,49,-49
39,Ohio,36,New York,37,Genesee County,6,3,3
39,Ohio,36,New York,45,Jefferson County,208,282,-74
39,Ohio,36,New York,47,Kings County,1205,449,756
39,Ohio,36,New York,49,Lewis County,18,2,16
39,Ohio,36,New York,51,Livingston County,46,5,41
39,Ohio,36,New York,53,Madison County,290,66,224
39,Ohio,36,New York,55,Monroe County,761,410,351
39,Ohio,36,New York,57,Montgomery County,27,0,27
39,Ohio,36,New York,59,Nassau County,430,89,341
39,Ohio,36,New York,61,New York County,807,978,-171
39,Ohio,36,New York,63,Niagara County,304,126,178
39,Ohio,36,New York,65,Oneida County,20,123,-103
39,Ohio,36,New York,67,Onondaga County,463,402,61
39,Ohio,36,New York,69,Ontario County,62,91,-29
39,Ohio,36,New York,71,Orange County,50,72,-22
39,Ohio,36,New York,73,Orleans County,7,6,1
39,Ohio,36,New York,75,Oswego County,45,97,-52
39,Ohio,36,New York,77,Otsego County,23,38,-15
39,Ohio,36,New York,79,Putnam County,121,0,121
39,Ohio,36,New York,81,Queens County,400,366,34
39,Ohio,36,New York,83,Rensselaer County,61,22,39
39,Ohio,36,New York,85,Richmond County,153,61,92
39,Ohio,36,New York,87,Rockland County,213,10,203
39,Ohio,36,New York,89,St. Lawrence County,52,23,29
39,Ohio,36,New York,91,Saratoga County,124,65,59
39,Ohio,36,New York,93,Schenectady County,20,32,-12
39,Ohio,36,New York,95,Schoharie County,35,13,22
39,Ohio,36,New York,99,Seneca County,0,28,-28
39,Ohio,36,New York,101,Steuben County,5,36,-31
39,Ohio,36,New York,103,Suffolk County,475,217,258
39,Ohio,36,New York,105,Sullivan County,0,34,-34
39,Ohio,36,New York,107,Tioga County,26,0,26
39,Ohio,36,New York,109,Tompkins County,51,142,-91
39,Ohio,36,New York,111,Ulster County,54,50,4
39,Ohio,36,New York,113,Warren County,62,0,62
39,Ohio,36,New York,115,Washington County,50,0,50
39,Ohio,36,New York,117,Wayne County,60,15,45
39,Ohio,36,New York,119,Westchester County,225,303,-78
39,Ohio,36,New York,121,Wyoming County,33,19,14
39,Ohio,36,New York,123,Yates County,0,4,-4
39,Ohio,37,North Carolina,1,Alamance County,33,82,-49
39,Ohio,37,North Carolina,7,Anson County,20,6,14
39,Ohio,37,North Carolina,9,Ashe County,0,12,-12
39,Ohio,37,North Carolina,11,Avery County,0,1,-1
39,Ohio,37,North Carolina,17,Bladen County,62,37,25
39,Ohio,37,North Carolina,19,Brunswick County,73,192,-119
39,Ohio,37,North Carolina,21,Buncombe County,574,210,364
39,Ohio,37,North Carolina,23,Burke County,0,3,-3
39,Ohio,37,North Carolina,25,Cabarrus County,232,39,193
39,Ohio,37,North Carolina,27,Caldwell County,13,73,-60
39,Ohio,37,North Carolina,29,Camden County,34,0,34
39,Ohio,37,North Carolina,31,Carteret County,30,125,-95
39,Ohio,37,North Carolina,35,Catawba County,45,137,-92
39,Ohio,37,North Carolina,37,Chatham County,77,35,42
39,Ohio,37,North Carolina,39,Cherokee County,0,104,-104
39,Ohio,37,North Carolina,45,Cleveland County,0,15,-15
39,Ohio,37,North Carolina,47,Columbus County,0,5,-5
39,Ohio,37,North Carolina,49,Craven County,690,370,320
39,Ohio,37,North Carolina,51,Cumberland County,937,456,481
39,Ohio,37,North Carolina,53,Currituck County,19,29,-10
39,Ohio,37,North Carolina,55,Dare County,7,0,7
39,Ohio,37,North Carolina,57,Davidson County,26,97,-71
39,Ohio,37,North Carolina,59,Davie County,14,0,14
39,Ohio,37,North Carolina,61,Duplin County,0,3,-3
39,Ohio,37,North Carolina,63,Durham County,110,331,-221
39,Ohio,37,North Carolina,65,Edgecombe County,41,0,41
39,Ohio,37,North Carolina,67,Forsyth County,364,316,48
39,Ohio,37,North Carolina,69,Franklin County,0,19,-19
39,Ohio,37,North Carolina,71,Gaston County,240,164,76
39,Ohio,37,North Carolina,73,Gates County,30,0,30
39,Ohio,37,North Carolina,77,Granville County,15,0,15
39,Ohio,37,North Carolina,79,Greene County,6,0,6
39,Ohio,37,North Carolina,81,Guilford County,233,648,-415
39,Ohio,37,North Carolina,85,Harnett County,142,209,-67
39,Ohio,37,North Carolina,87,Haywood County,33,134,-101
39,Ohio,37,North Carolina,89,Henderson County,141,98,43
39,Ohio,37,North Carolina,93,Hoke County,0,46,-46
39,Ohio,37,North Carolina,97,Iredell County,74,257,-183
39,Ohio,37,North Carolina,99,Jackson County,137,32,105
39,Ohio,37,North Carolina,101,Johnston County,83,31,52
39,Ohio,37,North Carolina,103,Jones County,0,4,-4
39,Ohio,37,North Carolina,107,Lenoir County,70,17,53
39,Ohio,37,North Carolina,109,Lincoln County,11,20,-9
39,Ohio,37,North Carolina,113,Macon County,0,15,-15
39,Ohio,37,North Carolina,115,Madison County,0,6,-6
39,Ohio,37,North Carolina,117,Martin County,9,0,9
39,Ohio,37,North Carolina,119,Mecklenburg County,1031,1267,-236
39,Ohio,37,North Carolina,125,Moore County,30,48,-18
39,Ohio,37,North Carolina,127,Nash County,7,12,-5
39,Ohio,37,North Carolina,129,New Hanover County,221,400,-179
39,Ohio,37,North Carolina,131,Northampton County,5,0,5
39,Ohio,37,North Carolina,133,Onslow County,805,972,-167
39,Ohio,37,North Carolina,135,Orange County,219,220,-1
39,Ohio,37,North Carolina,139,Pasquotank County,0,32,-32
39,Ohio,37,North Carolina,141,Pender County,53,21,32
39,Ohio,37,North Carolina,147,Pitt County,15,341,-326
39,Ohio,37,North Carolina,149,Polk County,0,39,-39
39,Ohio,37,North Carolina,151,Randolph County,21,187,-166
39,Ohio,37,North Carolina,153,Richmond County,17,14,3
39,Ohio,37,North Carolina,155,Robeson County,32,2,30
39,Ohio,37,North Carolina,157,Rockingham County,31,0,31
39,Ohio,37,North Carolina,159,Rowan County,177,53,124
39,Ohio,37,North Carolina,161,Rutherford County,0,6,-6
39,Ohio,37,North Carolina,163,Sampson County,18,3,15
39,Ohio,37,North Carolina,165,Scotland County,13,91,-78
39,Ohio,37,North Carolina,167,Stanly County,0,20,-20
39,Ohio,37,North Carolina,171,Surry County,0,13,-13
39,Ohio,37,North Carolina,173,Swain County,57,0,57
39,Ohio,37,North Carolina,175,Transylvania County,72,1,71
39,Ohio,37,North Carolina,177,Tyrrell County,0,8,-8
39,Ohio,37,North Carolina,179,Union County,201,157,44
39,Ohio,37,North Carolina,181,Vance County,10,0,10
39,Ohio,37,North Carolina,183,Wake County,610,1232,-622
39,Ohio,37,North Carolina,185,Warren County,0,7,-7
39,Ohio,37,North Carolina,187,Washington County,0,32,-32
39,Ohio,37,North Carolina,189,Watauga County,32,41,-9
39,Ohio,37,North Carolina,191,Wayne County,134,135,-1
39,Ohio,37,North Carolina,195,Wilson County,21,4,17
39,Ohio,37,North Carolina,197,Yadkin County,17,0,17
39,Ohio,37,North Carolina,199,Yancey County,0,3,-3
39,Ohio,38,North Dakota,9,Bottineau County,0,3,-3
39,Ohio,38,North Dakota,15,Burleigh County,10,8,2
39,Ohio,38,North Dakota,17,Cass County,41,0,41
39,Ohio,38,North Dakota,35,Grand Forks County,76,224,-148
39,Ohio,38,North Dakota,45,LaMoure County,0,10,-10
39,Ohio,38,North Dakota,53,McKenzie County,60,0,60
39,Ohio,38,North Dakota,77,Richland County,12,8,4
39,Ohio,38,North Dakota,79,Rolette County,6,0,6
39,Ohio,38,North Dakota,81,Sargent County,0,3,-3
39,Ohio,38,North Dakota,89,Stark County,1,10,-9
39,Ohio,38,North Dakota,93,Stutsman County,0,7,-7
39,Ohio,38,North Dakota,101,Ward County,59,264,-205
39,Ohio,38,North Dakota,105,Williams County,0,15,-15
39,Ohio,39,Ohio,1,Adams County,1152,379,773
39,Ohio,39,Ohio,3,Allen County,4203,3520,683
39,Ohio,39,Ohio,5,Ashland County,2291,3069,-778
39,Ohio,39,Ohio,7,Ashtabula County,2911,2564,347
39,Ohio,39,Ohio,9,Athens County,2672,8160,-5488
39,Ohio,39,Ohio,11,Auglaize County,2338,1951,387
39,Ohio,39,Ohio,13,Belmont County,1677,2106,-429
39,Ohio,39,Ohio,15,Brown County,1819,1477,342
39,Ohio,39,Ohio,17,Butler County,13701,16867,-3166
39,Ohio,39,Ohio,19,Carroll County,1108,1038,70
39,Ohio,39,Ohio,21,Champaign County,2225,2084,141
39,Ohio,39,Ohio,23,Clark County,4744,4738,6
39,Ohio,39,Ohio,25,Clermont County,7875,6675,1200
39,Ohio,39,Ohio,27,Clinton County,2118,1990,128
39,Ohio,39,Ohio,29,Columbiana County,3088,2263,825
39,Ohio,39,Ohio,31,Coshocton County,1149,1453,-304
39,Ohio,39,Ohio,33,Crawford County,1523,1628,-105
39,Ohio,39,Ohio,35,Cuyahoga County,31706,21157,10549
39,Ohio,39,Ohio,37,Darke County,1301,1145,156
39,Ohio,39,Ohio,39,Defiance County,1514,1532,-18
39,Ohio,39,Ohio,41,Delaware County,8518,9643,-1125
39,Ohio,39,Ohio,43,Erie County,3105,2758,347
39,Ohio,39,Ohio,45,Fairfield County,6525,7743,-1218
39,Ohio,39,Ohio,47,Fayette County,1938,931,1007
39,Ohio,39,Ohio,49,Franklin County,37740,38289,-549
39,Ohio,39,Ohio,51,Fulton County,2039,1443,596
39,Ohio,39,Ohio,53,Gallia County,765,788,-23
39,Ohio,39,Ohio,55,Geauga County,3457,3269,188
39,Ohio,39,Ohio,57,Greene County,8865,9992,-1127
39,Ohio,39,Ohio,59,Guernsey County,1277,942,335
39,Ohio,39,Ohio,61,Hamilton County,19400,22163,-2763
39,Ohio,39,Ohio,63,Hancock County,3686,3207,479
39,Ohio,39,Ohio,65,Hardin County,1482,1637,-155
39,Ohio,39,Ohio,67,Harrison County,1056,410,646
39,Ohio,39,Ohio,69,Henry County,1072,1286,-214
39,Ohio,39,Ohio,71,Highland County,2040,1698,342
39,Ohio,39,Ohio,73,Hocking County,1023,1206,-183
39,Ohio,39,Ohio,75,Holmes County,1514,969,545
39,Ohio,39,Ohio,77,Huron County,2600,1986,614
39,Ohio,39,Ohio,79,Jackson County,973,996,-23
39,Ohio,39,Ohio,81,Jefferson County,1405,1558,-153
39,Ohio,39,Ohio,83,Knox County,1965,2571,-606
39,Ohio,39,Ohio,85,Lake County,6095,4898,1197
39,Ohio,39,Ohio,87,Lawrence County,1169,527,642
39,Ohio,39,Ohio,89,Licking County,6550,8610,-2060
39,Ohio,39,Ohio,91,Logan County,1821,1532,289
39,Ohio,39,Ohio,93,Lorain County,8813,10003,-1190
39,Ohio,39,Ohio,95,Lucas County,10572,10556,16
39,Ohio,39,Ohio,97,Madison County,2725,4032,-1307
39,Ohio,39,Ohio,99,Mahoning County,7215,6209,1006
39,Ohio,39,Ohio,101,Marion County,2050,3639,-1589
39,Ohio,39,Ohio,103,Medina County,7766,6985,781
39,Ohio,39,Ohio,105,Meigs County,683,579,104
39,Ohio,39,Ohio,107,Mercer County,1354,1015,339
39,Ohio,39,Ohio,109,Miami County,4266,3823,443
39,Ohio,39,Ohio,111,Monroe County,470,174,296
39,Ohio,39,Ohio,113,Montgomery County,17852,16476,1376
39,Ohio,39,Ohio,115,Morgan County,624,452,172
39,Ohio,39,Ohio,117,Morrow County,1493,1125,368
39,Ohio,39,Ohio,119,Muskingum County,3017,2389,628
39,Ohio,39,Ohio,121,Noble County,937,1301,-364
39,Ohio,39,Ohio,123,Ottawa County,1520,1368,152
39,Ohio,39,Ohio,125,Paulding County,1073,566,507
39,Ohio,39,Ohio,127,Perry County,1960,1841,119
39,Ohio,39,Ohio,129,Pickaway County,3656,4995,-1339
39,Ohio,39,Ohio,131,Pike County,1255,1332,-77
39,Ohio,39,Ohio,133,Portage County,7005,9675,-2670
39,Ohio,39,Ohio,135,Preble County,1290,1108,182
39,Ohio,39,Ohio,137,Putnam County,968,1145,-177
39,Ohio,39,Ohio,139,Richland County,6325,5609,716
39,Ohio,39,Ohio,141,Ross County,3351,4118,-767
39,Ohio,39,Ohio,143,Sandusky County,2258,1446,812
39,Ohio,39,Ohio,145,Scioto County,1996,2367,-371
39,Ohio,39,Ohio,147,Seneca County,2433,3083,-650
39,Ohio,39,Ohio,149,Shelby County,1704,994,710
39,Ohio,39,Ohio,151,Stark County,9471,9580,-109
39,Ohio,39,Ohio,153,Summit County,16815,14836,1979
39,Ohio,39,Ohio,155,Trumbull County,5379,4390,989
39,Ohio,39,Ohio,157,Tuscarawas County,2961,2328,633
39,Ohio,39,Ohio,159,Union County,3242,4747,-1505
39,Ohio,39,Ohio,161,Van Wert County,907,1120,-213
39,Ohio,39,Ohio,163,Vinton County,891,600,291
39,Ohio,39,Ohio,165,Warren County,12389,11673,716
39,Ohio,39,Ohio,167,Washington County,989,1120,-131
39,Ohio,39,Ohio,169,Wayne County,4341,4754,-413
39,Ohio,39,Ohio,171,Williams County,1034,1171,-137
39,Ohio,39,Ohio,173,Wood County,7317,9855,-2538
39,Ohio,39,Ohio,175,Wyandot County,862,997,-135
39,Ohio,4,Arizona,1,Apache County,0,27,-27
39,Ohio,4,Arizona,3,Cochise County,45,120,-75
39,Ohio,4,Arizona,5,Coconino County,67,14,53
39,Ohio,4,Arizona,7,Gila County,38,0,38
39,Ohio,4,Arizona,9,Graham County,0,18,-18
39,Ohio,4,Arizona,13,Maricopa County,1639,3506,-1867
39,Ohio,4,Arizona,15,Mohave County,94,206,-112
39,Ohio,4,Arizona,17,Navajo County,0,14,-14
39,Ohio,4,Arizona,19,Pima County,666,589,77
39,Ohio,4,Arizona,21,Pinal County,189,118,71
39,Ohio,4,Arizona,23,Santa Cruz County,6,0,6
39,Ohio,4,Arizona,25,Yavapai County,240,107,133
39,Ohio,4,Arizona,27,Yuma County,95,64,31
39,Ohio,40,Oklahoma,1,Adair County,0,9,-9
39,Ohio,40,Oklahoma,9,Beckham County,55,2,53
39,Ohio,40,Oklahoma,11,Blaine County,0,13,-13
39,Ohio,40,Oklahoma,13,Bryan County,17,71,-54
39,Ohio,40,Oklahoma,15,Caddo County,0,4,-4
39,Ohio,40,Oklahoma,17,Canadian County,0,60,-60
39,Ohio,40,Oklahoma,21,Cherokee County,0,16,-16
39,Ohio,40,Oklahoma,27,Cleveland County,130,147,-17
39,Ohio,40,Oklahoma,29,Coal County,0,2,-2
39,Ohio,40,Oklahoma,31,Comanche County,195,173,22
39,Ohio,40,Oklahoma,35,Craig County,12,3,9
39,Ohio,40,Oklahoma,39,Custer County,0,4,-4
39,Ohio,40,Oklahoma,41,Delaware County,0,7,-7
39,Ohio,40,Oklahoma,47,Garfield County,88,10,78
39,Ohio,40,Oklahoma,49,Garvin County,0,5,-5
39,Ohio,40,Oklahoma,51,Grady County,0,22,-22
39,Ohio,40,Oklahoma,61,Haskell County,153,0,153
39,Ohio,40,Oklahoma,65,Jackson County,50,6,44
39,Ohio,40,Oklahoma,69,Johnston County,0,23,-23
39,Ohio,40,Oklahoma,71,Kay County,0,52,-52
39,Ohio,40,Oklahoma,79,Le Flore County,0,23,-23
39,Ohio,40,Oklahoma,81,Lincoln County,0,12,-12
39,Ohio,40,Oklahoma,83,Logan County,4,0,4
39,Ohio,40,Oklahoma,97,Mayes County,0,10,-10
39,Ohio,40,Oklahoma,101,Muskogee County,10,8,2
39,Ohio,40,Oklahoma,105,Nowata County,0,10,-10
39,Ohio,40,Oklahoma,109,Oklahoma County,162,297,-135
39,Ohio,40,Oklahoma,113,Osage County,56,12,44
39,Ohio,40,Oklahoma,115,Ottawa County,0,15,-15
39,Ohio,40,Oklahoma,119,Payne County,76,0,76
39,Ohio,40,Oklahoma,125,Pottawatomie County,0,10,-10
39,Ohio,40,Oklahoma,127,Pushmataha County,0,7,-7
39,Ohio,40,Oklahoma,131,Rogers County,46,18,28
39,Ohio,40,Oklahoma,135,Sequoyah County,7,24,-17
39,Ohio,40,Oklahoma,137,Stephens County,0,1,-1
39,Ohio,40,Oklahoma,139,Texas County,0,2,-2
39,Ohio,40,Oklahoma,141,Tillman County,0,68,-68
39,Ohio,40,Oklahoma,143,Tulsa County,121,206,-85
39,Ohio,40,Oklahoma,145,Wagoner County,0,13,-13
39,Ohio,40,Oklahoma,147,Washington County,56,39,17
39,Ohio,40,Oklahoma,149,Washita County,0,1,-1
39,Ohio,40,Oklahoma,153,Woodward County,43,3,40
39,Ohio,41,Oregon,3,Benton County,141,15,126
39,Ohio,41,Oregon,5,Clackamas County,145,63,82
39,Ohio,41,Oregon,7,Clatsop County,0,33,-33
39,Ohio,41,Oregon,9,Columbia County,74,0,74
39,Ohio,41,Oregon,11,Coos County,0,38,-38
39,Ohio,41,Oregon,15,Curry County,3,0,3
39,Ohio,41,Oregon,17,Deschutes County,57,31,26
39,Ohio,41,Oregon,19,Douglas County,0,3,-3
39,Ohio,41,Oregon,25,Harney County,37,0,37
39,Ohio,41,Oregon,29,Jackson County,129,5,124
39,Ohio,41,Oregon,35,Klamath County,0,21,-21
39,Ohio,41,Oregon,39,Lane County,105,53,52
39,Ohio,41,Oregon,41,Lincoln County,0,30,-30
39,Ohio,41,Oregon,43,Linn County,123,6,117
39,Ohio,41,Oregon,45,Malheur County,0,4,-4
39,Ohio,41,Oregon,47,Marion County,0,29,-29
39,Ohio,41,Oregon,51,Multnomah County,216,340,-124
39,Ohio,41,Oregon,53,Polk County,0,10,-10
39,Ohio,41,Oregon,57,Tillamook County,128,0,128
39,Ohio,41,Oregon,59,Umatilla County,18,82,-64
39,Ohio,41,Oregon,61,Union County,0,29,-29
39,Ohio,41,Oregon,65,Wasco County,0,5,-5
39,Ohio,41,Oregon,67,Washington County,124,229,-105
39,Ohio,41,Oregon,71,Yamhill County,0,9,-9
39,Ohio,42,Pennsylvania,1,Adams County,16,15,1
39,Ohio,42,Pennsylvania,3,Allegheny County,3082,2626,456
39,Ohio,42,Pennsylvania,5,Armstrong County,99,83,16
39,Ohio,42,Pennsylvania,7,Beaver County,851,542,309
39,Ohio,42,Pennsylvania,9,Bedford County,0,7,-7
39,Ohio,42,Pennsylvania,11,Berks County,385,170,215
39,Ohio,42,Pennsylvania,13,Blair County,159,23,136
39,Ohio,42,Pennsylvania,15,Bradford County,103,49,54
39,Ohio,42,Pennsylvania,17,Bucks County,122,269,-147
39,Ohio,42,Pennsylvania,19,Butler County,516,467,49
39,Ohio,42,Pennsylvania,21,Cambria County,135,93,42
39,Ohio,42,Pennsylvania,23,Cameron County,0,19,-19
39,Ohio,42,Pennsylvania,25,Carbon County,238,0,238
39,Ohio,42,Pennsylvania,27,Centre County,195,440,-245
39,Ohio,42,Pennsylvania,29,Chester County,356,206,150
39,Ohio,42,Pennsylvania,31,Clarion County,79,105,-26
39,Ohio,42,Pennsylvania,33,Clearfield County,14,85,-71
39,Ohio,42,Pennsylvania,35,Clinton County,30,15,15
39,Ohio,42,Pennsylvania,37,Columbia County,41,39,2
39,Ohio,42,Pennsylvania,39,Crawford County,299,205,94
39,Ohio,42,Pennsylvania,41,Cumberland County,271,228,43
39,Ohio,42,Pennsylvania,43,Dauphin County,187,91,96
39,Ohio,42,Pennsylvania,45,Delaware County,314,240,74
39,Ohio,42,Pennsylvania,47,Elk County,38,33,5
39,Ohio,42,Pennsylvania,49,Erie County,905,851,54
39,Ohio,42,Pennsylvania,51,Fayette County,144,115,29
39,Ohio,42,Pennsylvania,53,Forest County,0,1,-1
39,Ohio,42,Pennsylvania,55,Franklin County,139,24,115
39,Ohio,42,Pennsylvania,57,Fulton County,5,0,5
39,Ohio,42,Pennsylvania,59,Greene County,70,68,2
39,Ohio,42,Pennsylvania,61,Huntingdon County,84,48,36
39,Ohio,42,Pennsylvania,63,Indiana County,111,157,-46
39,Ohio,42,Pennsylvania,65,Jefferson County,28,101,-73
39,Ohio,42,Pennsylvania,67,Juniata County,0,22,-22
39,Ohio,42,Pennsylvania,69,Lackawanna County,27,61,-34
39,Ohio,42,Pennsylvania,71,Lancaster County,592,224,368
39,Ohio,42,Pennsylvania,73,Lawrence County,679,401,278
39,Ohio,42,Pennsylvania,75,Lebanon County,40,27,13
39,Ohio,42,Pennsylvania,77,Lehigh County,456,254,202
39,Ohio,42,Pennsylvania,79,Luzerne County,0,139,-139
39,Ohio,42,Pennsylvania,81,Lycoming County,0,8,-8
39,Ohio,42,Pennsylvania,83,McKean County,116,30,86
39,Ohio,42,Pennsylvania,85,Mercer County,811,499,312
39,Ohio,42,Pennsylvania,87,Mifflin County,56,14,42
39,Ohio,42,Pennsylvania,89,Monroe County,53,0,53
39,Ohio,42,Pennsylvania,91,Montgomery County,356,360,-4
39,Ohio,42,Pennsylvania,93,Montour County,10,8,2
39,Ohio,42,Pennsylvania,95,Northampton County,126,132,-6
39,Ohio,42,Pennsylvania,97,Northumberland County,0,406,-406
39,Ohio,42,Pennsylvania,99,Perry County,44,17,27
39,Ohio,42,Pennsylvania,101,Philadelphia County,608,500,108
39,Ohio,42,Pennsylvania,103,Pike County,15,43,-28
39,Ohio,42,Pennsylvania,105,Potter County,0,7,-7
39,Ohio,42,Pennsylvania,107,Schuylkill County,17,24,-7
39,Ohio,42,Pennsylvania,109,Snyder County,6,15,-9
39,Ohio,42,Pennsylvania,111,Somerset County,24,3,21
39,Ohio,42,Pennsylvania,115,Susquehanna County,11,16,-5
39,Ohio,42,Pennsylvania,117,Tioga County,37,35,2
39,Ohio,42,Pennsylvania,119,Union County,61,126,-65
39,Ohio,42,Pennsylvania,121,Venango County,63,46,17
39,Ohio,42,Pennsylvania,123,Warren County,12,55,-43
39,Ohio,42,Pennsylvania,125,Washington County,754,388,366
39,Ohio,42,Pennsylvania,127,Wayne County,90,9,81
39,Ohio,42,Pennsylvania,129,Westmoreland County,309,294,15
39,Ohio,42,Pennsylvania,131,Wyoming County,13,0,13
39,Ohio,42,Pennsylvania,133,York County,386,158,228
39,Ohio,44,Rhode Island,3,Kent County,17,16,1
39,Ohio,44,Rhode Island,5,Newport County,50,146,-96
39,Ohio,44,Rhode Island,7,Providence County,399,79,320
39,Ohio,44,Rhode Island,9,Washington County,79,0,79
39,Ohio,45,South Carolina,1,Abbeville County,8,14,-6
39,Ohio,45,South Carolina,3,Aiken County,53,93,-40
39,Ohio,45,South Carolina,7,Anderson County,106,172,-66
39,Ohio,45,South Carolina,13,Beaufort County,122,1008,-886
39,Ohio,45,South Carolina,15,Berkeley County,119,392,-273
39,Ohio,45,South Carolina,19,Charleston County,426,688,-262
39,Ohio,45,South Carolina,25,Chesterfield County,68,1,67
39,Ohio,45,South Carolina,29,Colleton County,216,0,216
39,Ohio,45,South Carolina,31,Darlington County,0,17,-17
39,Ohio,45,South Carolina,35,Dorchester County,111,164,-53
39,Ohio,45,South Carolina,37,Edgefield County,0,11,-11
39,Ohio,45,South Carolina,41,Florence County,11,50,-39
39,Ohio,45,South Carolina,43,Georgetown County,45,14,31
39,Ohio,45,South Carolina,45,Greenville County,245,424,-179
39,Ohio,45,South Carolina,47,Greenwood County,7,85,-78
39,Ohio,45,South Carolina,49,Hampton County,14,0,14
39,Ohio,45,South Carolina,51,Horry County,249,950,-701
39,Ohio,45,South Carolina,53,Jasper County,0,11,-11
39,Ohio,45,South Carolina,55,Kershaw County,37,24,13
39,Ohio,45,South Carolina,57,Lancaster County,17,50,-33
39,Ohio,45,South Carolina,59,Laurens County,8,22,-14
39,Ohio,45,South Carolina,63,Lexington County,48,116,-68
39,Ohio,45,South Carolina,65,McCormick County,0,16,-16
39,Ohio,45,South Carolina,67,Marion County,28,0,28
39,Ohio,45,South Carolina,69,Marlboro County,0,7,-7
39,Ohio,45,South Carolina,71,Newberry County,34,0,34
39,Ohio,45,South Carolina,73,Oconee County,32,21,11
39,Ohio,45,South Carolina,75,Orangeburg County,0,2,-2
39,Ohio,45,South Carolina,77,Pickens County,42,217,-175
39,Ohio,45,South Carolina,79,Richland County,275,801,-526
39,Ohio,45,South Carolina,81,Saluda County,19,0,19
39,Ohio,45,South Carolina,83,Spartanburg County,26,400,-374
39,Ohio,45,South Carolina,85,Sumter County,49,143,-94
39,Ohio,45,South Carolina,87,Union County,17,0,17
39,Ohio,45,South Carolina,91,York County,96,477,-381
39,Ohio,46,South Dakota,11,Brookings County,0,53,-53
39,Ohio,46,South Dakota,27,Clay County,0,9,-9
39,Ohio,46,South Dakota,37,Day County,0,3,-3
39,Ohio,46,South Dakota,41,Dewey County,17,0,17
39,Ohio,46,South Dakota,45,Edmunds County,5,0,5
39,Ohio,46,South Dakota,77,Kingsbury County,0,3,-3
39,Ohio,46,South Dakota,83,Lincoln County,0,63,-63
39,Ohio,46,South Dakota,93,Meade County,0,15,-15
39,Ohio,46,South Dakota,99,Minnehaha County,19,57,-38
39,Ohio,46,South Dakota,103,Pennington County,70,27,43
39,Ohio,46,South Dakota,121,Todd County,0,1,-1
39,Ohio,46,South Dakota,129,Walworth County,0,24,-24
39,Ohio,46,South Dakota,135,Yankton County,2,6,-4
39,Ohio,47,Tennessee,1,Anderson County,125,32,93
39,Ohio,47,Tennessee,3,Bedford County,59,6,53
39,Ohio,47,Tennessee,9,Blount County,104,24,80
39,Ohio,47,Tennessee,11,Bradley County,121,354,-233
39,Ohio,47,Tennessee,13,Campbell County,2,116,-114
39,Ohio,47,Tennessee,15,Cannon County,0,19,-19
39,Ohio,47,Tennessee,19,Carter County,123,180,-57
39,Ohio,47,Tennessee,21,Cheatham County,10,0,10
39,Ohio,47,Tennessee,23,Chester County,0,10,-10
39,Ohio,47,Tennessee,25,Claiborne County,20,40,-20
39,Ohio,47,Tennessee,29,Cocke County,6,14,-8
39,Ohio,47,Tennessee,31,Coffee County,5,96,-91
39,Ohio,47,Tennessee,35,Cumberland County,81,145,-64
39,Ohio,47,Tennessee,37,Davidson County,693,1243,-550
39,Ohio,47,Tennessee,39,Decatur County,0,32,-32
39,Ohio,47,Tennessee,41,DeKalb County,0,3,-3
39,Ohio,47,Tennessee,43,Dickson County,38,14,24
39,Ohio,47,Tennessee,45,Dyer County,34,0,34
39,Ohio,47,Tennessee,47,Fayette County,0,4,-4
39,Ohio,47,Tennessee,51,Franklin County,18,63,-45
39,Ohio,47,Tennessee,53,Gibson County,110,0,110
39,Ohio,47,Tennessee,55,Giles County,52,18,34
39,Ohio,47,Tennessee,57,Grainger County,138,0,138
39,Ohio,47,Tennessee,59,Greene County,134,46,88
39,Ohio,47,Tennessee,63,Hamblen County,9,133,-124
39,Ohio,47,Tennessee,65,Hamilton County,108,209,-101
39,Ohio,47,Tennessee,73,Hawkins County,0,39,-39
39,Ohio,47,Tennessee,75,Haywood County,60,0,60
39,Ohio,47,Tennessee,79,Henry County,0,6,-6
39,Ohio,47,Tennessee,81,Hickman County,219,23,196
39,Ohio,47,Tennessee,85,Humphreys County,26,0,26
39,Ohio,47,Tennessee,89,Jefferson County,18,72,-54
39,Ohio,47,Tennessee,91,Johnson County,7,16,-9
39,Ohio,47,Tennessee,93,Knox County,650,607,43
39,Ohio,47,Tennessee,95,Lake County,3,0,3
39,Ohio,47,Tennessee,105,Loudon County,4,2,2
39,Ohio,47,Tennessee,107,McMinn County,0,104,-104
39,Ohio,47,Tennessee,109,McNairy County,0,2,-2
39,Ohio,47,Tennessee,111,Macon County,14,0,14
39,Ohio,47,Tennessee,113,Madison County,52,0,52
39,Ohio,47,Tennessee,115,Marion County,26,0,26
39,Ohio,47,Tennessee,119,Maury County,216,181,35
39,Ohio,47,Tennessee,125,Montgomery County,593,246,347
39,Ohio,47,Tennessee,129,Morgan County,8,5,3
39,Ohio,47,Tennessee,131,Obion County,21,0,21
39,Ohio,47,Tennessee,135,Perry County,6,61,-55
39,Ohio,47,Tennessee,139,Polk County,17,12,5
39,Ohio,47,Tennessee,141,Putnam County,164,41,123
39,Ohio,47,Tennessee,143,Rhea County,51,0,51
39,Ohio,47,Tennessee,145,Roane County,8,12,-4
39,Ohio,47,Tennessee,147,Robertson County,78,46,32
39,Ohio,47,Tennessee,149,Rutherford County,51,262,-211
39,Ohio,47,Tennessee,151,Scott County,30,31,-1
39,Ohio,47,Tennessee,155,Sevier County,251,160,91
39,Ohio,47,Tennessee,157,Shelby County,805,226,579
39,Ohio,47,Tennessee,159,Smith County,0,17,-17
39,Ohio,47,Tennessee,163,Sullivan County,68,32,36
39,Ohio,47,Tennessee,165,Sumner County,171,254,-83
39,Ohio,47,Tennessee,167,Tipton County,61,0,61
39,Ohio,47,Tennessee,173,Union County,0,9,-9
39,Ohio,47,Tennessee,179,Washington County,28,0,28
39,Ohio,47,Tennessee,181,Wayne County,4,0,4
39,Ohio,47,Tennessee,183,Weakley County,0,35,-35
39,Ohio,47,Tennessee,185,White County,0,25,-25
39,Ohio,47,Tennessee,187,Williamson County,147,236,-89
39,Ohio,47,Tennessee,189,Wilson County,37,99,-62
39,Ohio,48,Texas,5,Angelina County,0,24,-24
39,Ohio,48,Texas,7,Aransas County,8,0,8
39,Ohio,48,Texas,15,Austin County,0,51,-51
39,Ohio,48,Texas,21,Bastrop County,56,0,56
39,Ohio,48,Texas,27,Bell County,561,384,177
39,Ohio,48,Texas,29,Bexar County,1229,448,781
39,Ohio,48,Texas,31,Blanco County,0,55,-55
39,Ohio,48,Texas,37,Bowie County,54,11,43
39,Ohio,48,Texas,39,Brazoria County,56,141,-85
39,Ohio,48,Texas,41,Brazos County,295,166,129
39,Ohio,48,Texas,43,Brewster County,0,8,-8
39,Ohio,48,Texas,47,Brooks County,7,0,7
39,Ohio,48,Texas,53,Burnet County,0,1,-1
39,Ohio,48,Texas,55,Caldwell County,0,8,-8
39,Ohio,48,Texas,57,Calhoun County,7,11,-4
39,Ohio,48,Texas,61,Cameron County,96,59,37
39,Ohio,48,Texas,63,Camp County,9,28,-19
39,Ohio,48,Texas,69,Castro County,0,13,-13
39,Ohio,48,Texas,71,Chambers County,5,0,5
39,Ohio,48,Texas,73,Cherokee County,10,28,-18
39,Ohio,48,Texas,79,Cochran County,0,3,-3
39,Ohio,48,Texas,85,Collin County,257,608,-351
39,Ohio,48,Texas,89,Colorado County,37,30,7
39,Ohio,48,Texas,91,Comal County,75,77,-2
39,Ohio,48,Texas,95,Concho County,0,37,-37
39,Ohio,48,Texas,97,Cooke County,0,16,-16
39,Ohio,48,Texas,99,Coryell County,17,70,-53
39,Ohio,48,Texas,113,Dallas County,773,1317,-544
39,Ohio,48,Texas,115,Dawson County,0,2,-2
39,Ohio,48,Texas,121,Denton County,311,763,-452
39,Ohio,48,Texas,125,Dickens County,0,8,-8
39,Ohio,48,Texas,135,Ector County,10,7,3
39,Ohio,48,Texas,139,Ellis County,127,26,101
39,Ohio,48,Texas,141,El Paso County,599,90,509
39,Ohio,48,Texas,147,Fannin County,0,197,-197
39,Ohio,48,Texas,157,Fort Bend County,226,393,-167
39,Ohio,48,Texas,161,Freestone County,57,0,57
39,Ohio,48,Texas,167,Galveston County,58,260,-202
39,Ohio,48,Texas,169,Garza County,8,0,8
39,Ohio,48,Texas,181,Grayson County,28,2,26
39,Ohio,48,Texas,183,Gregg County,53,68,-15
39,Ohio,48,Texas,185,Grimes County,5,0,5
39,Ohio,48,Texas,187,Guadalupe County,108,40,68
39,Ohio,48,Texas,193,Hamilton County,29,0,29
39,Ohio,48,Texas,199,Hardin County,0,20,-20
39,Ohio,48,Texas,201,Harris County,1021,2409,-1388
39,Ohio,48,Texas,205,Hartley County,0,1,-1
39,Ohio,48,Texas,209,Hays County,76,59,17
39,Ohio,48,Texas,213,Henderson County,0,8,-8
39,Ohio,48,Texas,215,Hidalgo County,89,35,54
39,Ohio,48,Texas,217,Hill County,0,5,-5
39,Ohio,48,Texas,221,Hood County,159,0,159
39,Ohio,48,Texas,225,Houston County,10,0,10
39,Ohio,48,Texas,227,Howard County,1,0,1
39,Ohio,48,Texas,231,Hunt County,10,16,-6
39,Ohio,48,Texas,239,Jackson County,0,11,-11
39,Ohio,48,Texas,245,Jefferson County,57,34,23
39,Ohio,48,Texas,251,Johnson County,346,90,256
39,Ohio,48,Texas,257,Kaufman County,16,0,16
39,Ohio,48,Texas,265,Kerr County,31,0,31
39,Ohio,48,Texas,277,Lamar County,0,6,-6
39,Ohio,48,Texas,281,Lampasas County,0,21,-21
39,Ohio,48,Texas,291,Liberty County,66,5,61
39,Ohio,48,Texas,293,Limestone County,6,0,6
39,Ohio,48,Texas,297,Live Oak County,21,0,21
39,Ohio,48,Texas,299,Llano County,0,47,-47
39,Ohio,48,Texas,303,Lubbock County,49,70,-21
39,Ohio,48,Texas,309,McLennan County,0,41,-41
39,Ohio,48,Texas,321,Matagorda County,0,21,-21
39,Ohio,48,Texas,323,Maverick County,12,0,12
39,Ohio,48,Texas,325,Medina County,10,0,10
39,Ohio,48,Texas,329,Midland County,64,0,64
39,Ohio,48,Texas,339,Montgomery County,283,599,-316
39,Ohio,48,Texas,343,Morris County,18,0,18
39,Ohio,48,Texas,347,Nacogdoches County,10,14,-4
39,Ohio,48,Texas,349,Navarro County,6,0,6
39,Ohio,48,Texas,353,Nolan County,0,21,-21
39,Ohio,48,Texas,355,Nueces County,94,203,-109
39,Ohio,48,Texas,361,Orange County,0,16,-16
39,Ohio,48,Texas,363,Palo Pinto County,0,17,-17
39,Ohio,48,Texas,367,Parker County,0,19,-19
39,Ohio,48,Texas,373,Polk County,56,42,14
39,Ohio,48,Texas,375,Potter County,57,26,31
39,Ohio,48,Texas,381,Randall County,12,21,-9
39,Ohio,48,Texas,389,Reeves County,0,8,-8
39,Ohio,48,Texas,397,Rockwall County,55,0,55
39,Ohio,48,Texas,401,Rusk County,31,6,25
39,Ohio,48,Texas,407,San Jacinto County,21,0,21
39,Ohio,48,Texas,409,San Patricio County,1,8,-7
39,Ohio,48,Texas,423,Smith County,40,102,-62
39,Ohio,48,Texas,425,Somervell County,0,3,-3
39,Ohio,48,Texas,429,Stephens County,29,0,29
39,Ohio,48,Texas,435,Sutton County,0,2,-2
39,Ohio,48,Texas,439,Tarrant County,822,482,340
39,Ohio,48,Texas,441,Taylor County,77,21,56
39,Ohio,48,Texas,447,Throckmorton County,0,8,-8
39,Ohio,48,Texas,451,Tom Green County,59,215,-156
39,Ohio,48,Texas,453,Travis County,206,609,-403
39,Ohio,48,Texas,459,Upshur County,75,0,75
39,Ohio,48,Texas,463,Uvalde County,12,137,-125
39,Ohio,48,Texas,465,Val Verde County,0,34,-34
39,Ohio,48,Texas,469,Victoria County,20,103,-83
39,Ohio,48,Texas,471,Walker County,0,14,-14
39,Ohio,48,Texas,473,Waller County,0,18,-18
39,Ohio,48,Texas,477,Washington County,29,0,29
39,Ohio,48,Texas,479,Webb County,121,142,-21
39,Ohio,48,Texas,481,Wharton County,12,0,12
39,Ohio,48,Texas,485,Wichita County,36,287,-251
39,Ohio,48,Texas,489,Willacy County,122,0,122
39,Ohio,48,Texas,491,Williamson County,55,351,-296
39,Ohio,48,Texas,493,Wilson County,9,0,9
39,Ohio,48,Texas,495,Winkler County,69,0,69
39,Ohio,48,Texas,497,Wise County,5,0,5
39,Ohio,48,Texas,499,Wood County,0,10,-10
39,Ohio,48,Texas,501,Yoakum County,38,0,38
39,Ohio,49,Utah,3,Box Elder County,21,2,19
39,Ohio,49,Utah,5,Cache County,196,141,55
39,Ohio,49,Utah,11,Davis County,266,377,-111
39,Ohio,49,Utah,13,Duchesne County,19,0,19
39,Ohio,49,Utah,19,Grand County,0,1,-1
39,Ohio,49,Utah,21,Iron County,53,11,42
39,Ohio,49,Utah,27,Millard County,0,6,-6
39,Ohio,49,Utah,35,Salt Lake County,680,366,314
39,Ohio,49,Utah,41,Sevier County,25,5,20
39,Ohio,49,Utah,43,Summit County,11,61,-50
39,Ohio,49,Utah,45,Tooele County,35,0,35
39,Ohio,49,Utah,49,Utah County,181,314,-133
39,Ohio,49,Utah,51,Wasatch County,18,22,-4
39,Ohio,49,Utah,53,Washington County,19,105,-86
39,Ohio,49,Utah,57,Weber County,35,120,-85
39,Ohio,5,Arkansas,5,Baxter County,0,48,-48
39,Ohio,5,Arkansas,7,Benton County,110,85,25
39,Ohio,5,Arkansas,17,Chicot County,0,9,-9
39,Ohio,5,Arkansas,29,Conway County,0,21,-21
39,Ohio,5,Arkansas,31,Craighead County,20,0,20
39,Ohio,5,Arkansas,33,Crawford County,7,32,-25
39,Ohio,5,Arkansas,35,Crittenden County,43,3,40
39,Ohio,5,Arkansas,45,Faulkner County,79,26,53
39,Ohio,5,Arkansas,51,Garland County,53,42,11
39,Ohio,5,Arkansas,55,Greene County,0,25,-25
39,Ohio,5,Arkansas,61,Howard County,12,0,12
39,Ohio,5,Arkansas,63,Independence County,40,0,40
39,Ohio,5,Arkansas,69,Jefferson County,0,30,-30
39,Ohio,5,Arkansas,85,Lonoke County,0,15,-15
39,Ohio,5,Arkansas,87,Madison County,17,0,17
39,Ohio,5,Arkansas,89,Marion County,36,0,36
39,Ohio,5,Arkansas,93,Mississippi County,0,8,-8
39,Ohio,5,Arkansas,95,Monroe County,34,0,34
39,Ohio,5,Arkansas,103,Ouachita County,10,0,10
39,Ohio,5,Arkansas,115,Pope County,135,0,135
39,Ohio,5,Arkansas,119,Pulaski County,305,228,77
39,Ohio,5,Arkansas,123,St. Francis County,2,1,1
39,Ohio,5,Arkansas,125,Saline County,22,0,22
39,Ohio,5,Arkansas,131,Sebastian County,17,20,-3
39,Ohio,5,Arkansas,139,Union County,24,0,24
39,Ohio,5,Arkansas,143,Washington County,123,97,26
39,Ohio,5,Arkansas,145,White County,57,0,57
39,Ohio,50,Vermont,1,Addison County,6,19,-13
39,Ohio,50,Vermont,3,Bennington County,4,3,1
39,Ohio,50,Vermont,5,Caledonia County,26,4,22
39,Ohio,50,Vermont,7,Chittenden County,92,121,-29
39,Ohio,50,Vermont,9,Essex County,0,1,-1
39,Ohio,50,Vermont,11,Franklin County,27,4,23
39,Ohio,50,Vermont,15,Lamoille County,0,23,-23
39,Ohio,50,Vermont,19,Orleans County,35,9,26
39,Ohio,50,Vermont,21,Rutland County,12,9,3
39,Ohio,50,Vermont,23,Washington County,9,8,1
39,Ohio,50,Vermont,25,Windham County,0,22,-22
39,Ohio,50,Vermont,27,Windsor County,69,0,69
39,Ohio,51,Virginia,1,Accomack County,5,0,5
39,Ohio,51,Virginia,3,Albemarle County,158,34,124
39,Ohio,51,Virginia,5,Alleghany County,19,0,19
39,Ohio,51,Virginia,9,Amherst County,50,0,50
39,Ohio,51,Virginia,13,Arlington County,161,402,-241
39,Ohio,51,Virginia,15,Augusta County,30,13,17
39,Ohio,51,Virginia,19,Bedford County,2,18,-16
39,Ohio,51,Virginia,23,Botetourt County,12,52,-40
39,Ohio,51,Virginia,27,Buchanan County,0,2,-2
39,Ohio,51,Virginia,31,Campbell County,2,0,2
39,Ohio,51,Virginia,35,Carroll County,2,14,-12
39,Ohio,51,Virginia,36,Charles City County,0,3,-3
39,Ohio,51,Virginia,37,Charlotte County,0,19,-19
39,Ohio,51,Virginia,41,Chesterfield County,144,192,-48
39,Ohio,51,Virginia,43,Clarke County,7,0,7
39,Ohio,51,Virginia,47,Culpeper County,5,85,-80
39,Ohio,51,Virginia,59,Fairfax County,1277,639,638
39,Ohio,51,Virginia,61,Fauquier County,0,26,-26
39,Ohio,51,Virginia,65,Fluvanna County,10,0,10
39,Ohio,51,Virginia,67,Franklin County,120,13,107
39,Ohio,51,Virginia,69,Frederick County,18,21,-3
39,Ohio,51,Virginia,73,Gloucester County,4,22,-18
39,Ohio,51,Virginia,75,Goochland County,10,9,1
39,Ohio,51,Virginia,77,Grayson County,0,49,-49
39,Ohio,51,Virginia,81,Greensville County,0,2,-2
39,Ohio,51,Virginia,83,Halifax County,73,0,73
39,Ohio,51,Virginia,85,Hanover County,9,0,9
39,Ohio,51,Virginia,87,Henrico County,75,122,-47
39,Ohio,51,Virginia,91,Highland County,0,2,-2
39,Ohio,51,Virginia,93,Isle of Wight County,9,16,-7
39,Ohio,51,Virginia,95,James City County,62,33,29
39,Ohio,51,Virginia,97,King and Queen County,0,12,-12
39,Ohio,51,Virginia,99,King George County,2,0,2
39,Ohio,51,Virginia,105,Lee County,0,33,-33
39,Ohio,51,Virginia,107,Loudoun County,530,412,118
39,Ohio,51,Virginia,109,Louisa County,27,17,10
39,Ohio,51,Virginia,119,Middlesex County,10,0,10
39,Ohio,51,Virginia,121,Montgomery County,67,67,0
39,Ohio,51,Virginia,127,New Kent County,29,0,29
39,Ohio,51,Virginia,135,Nottoway County,0,4,-4
39,Ohio,51,Virginia,139,Page County,17,10,7
39,Ohio,51,Virginia,143,Pittsylvania County,32,6,26
39,Ohio,51,Virginia,147,Prince Edward County,45,0,45
39,Ohio,51,Virginia,149,Prince George County,17,6,11
39,Ohio,51,Virginia,153,Prince William County,225,198,27
39,Ohio,51,Virginia,155,Pulaski County,17,58,-41
39,Ohio,51,Virginia,161,Roanoke County,359,48,311
39,Ohio,51,Virginia,163,Rockbridge County,0,1,-1
39,Ohio,51,Virginia,165,Rockingham County,0,74,-74
39,Ohio,51,Virginia,167,Russell County,0,11,-11
39,Ohio,51,Virginia,169,Scott County,0,16,-16
39,Ohio,51,Virginia,171,Shenandoah County,0,14,-14
39,Ohio,51,Virginia,173,Smyth County,0,54,-54
39,Ohio,51,Virginia,177,Spotsylvania County,97,97,0
39,Ohio,51,Virginia,179,Stafford County,280,218,62
39,Ohio,51,Virginia,185,Tazewell County,38,32,6
39,Ohio,51,Virginia,187,Warren County,49,32,17
39,Ohio,51,Virginia,191,Washington County,18,85,-67
39,Ohio,51,Virginia,195,Wise County,0,16,-16
39,Ohio,51,Virginia,199,York County,51,32,19
39,Ohio,51,Virginia,510,Alexandria city,271,231,40
39,Ohio,51,Virginia,520,Bristol city,21,0,21
39,Ohio,51,Virginia,530,Buena Vista city,44,0,44
39,Ohio,51,Virginia,540,Charlottesville city,76,27,49
39,Ohio,51,Virginia,550,Chesapeake city,95,154,-59
39,Ohio,51,Virginia,600,Fairfax city,13,0,13
39,Ohio,51,Virginia,630,Fredericksburg city,11,55,-44
39,Ohio,51,Virginia,650,Hampton city,61,78,-17
39,Ohio,51,Virginia,660,Harrisonburg city,75,76,-1
39,Ohio,51,Virginia,670,Hopewell city,0,123,-123
39,Ohio,51,Virginia,678,Lexington city,5,46,-41
39,Ohio,51,Virginia,680,Lynchburg city,0,212,-212
39,Ohio,51,Virginia,683,Manassas city,29,0,29
39,Ohio,51,Virginia,690,Martinsville city,0,59,-59
39,Ohio,51,Virginia,700,Newport News city,292,488,-196
39,Ohio,51,Virginia,710,Norfolk city,329,616,-287
39,Ohio,51,Virginia,730,Petersburg city,21,0,21
39,Ohio,51,Virginia,740,Portsmouth city,48,125,-77
39,Ohio,51,Virginia,750,Radford city,0,10,-10
39,Ohio,51,Virginia,760,Richmond city,222,231,-9
39,Ohio,51,Virginia,770,Roanoke city,228,0,228
39,Ohio,51,Virginia,775,Salem city,0,12,-12
39,Ohio,51,Virginia,800,Suffolk city,149,1,148
39,Ohio,51,Virginia,810,Virginia Beach city,479,422,57
39,Ohio,51,Virginia,830,Williamsburg city,0,19,-19
39,Ohio,51,Virginia,840,Winchester city,0,5,-5
39,Ohio,53,Washington,3,Asotin County,11,0,11
39,Ohio,53,Washington,5,Benton County,4,21,-17
39,Ohio,53,Washington,9,Clallam County,51,28,23
39,Ohio,53,Washington,11,Clark County,90,115,-25
39,Ohio,53,Washington,15,Cowlitz County,0,11,-11
39,Ohio,53,Washington,21,Franklin County,0,15,-15
39,Ohio,53,Washington,25,Grant County,16,0,16
39,Ohio,53,Washington,29,Island County,85,73,12
39,Ohio,53,Washington,33,King County,1414,1249,165
39,Ohio,53,Washington,35,Kitsap County,257,169,88
39,Ohio,53,Washington,37,Kittitas County,35,29,6
39,Ohio,53,Washington,39,Klickitat County,0,3,-3
39,Ohio,53,Washington,41,Lewis County,18,0,18
39,Ohio,53,Washington,45,Mason County,7,18,-11
39,Ohio,53,Washington,49,Pacific County,0,12,-12
39,Ohio,53,Washington,53,Pierce County,472,560,-88
39,Ohio,53,Washington,57,Skagit County,21,20,1
39,Ohio,53,Washington,61,Snohomish County,237,322,-85
39,Ohio,53,Washington,63,Spokane County,250,197,53
39,Ohio,53,Washington,65,Stevens County,0,8,-8
39,Ohio,53,Washington,67,Thurston County,156,165,-9
39,Ohio,53,Washington,73,Whatcom County,99,39,60
39,Ohio,53,Washington,75,Whitman County,24,23,1
39,Ohio,53,Washington,77,Yakima County,0,24,-24
39,Ohio,54,West Virginia,1,Barbour County,21,111,-90
39,Ohio,54,West Virginia,3,Berkeley County,127,15,112
39,Ohio,54,West Virginia,5,Boone County,11,0,11
39,Ohio,54,West Virginia,7,Braxton County,24,81,-57
39,Ohio,54,West Virginia,9,Brooke County,126,103,23
39,Ohio,54,West Virginia,11,Cabell County,1235,1012,223
39,Ohio,54,West Virginia,13,Calhoun County,28,135,-107
39,Ohio,54,West Virginia,17,Doddridge County,17,55,-38
39,Ohio,54,West Virginia,19,Fayette County,103,65,38
39,Ohio,54,West Virginia,21,Gilmer County,54,78,-24
39,Ohio,54,West Virginia,23,Grant County,24,37,-13
39,Ohio,54,West Virginia,25,Greenbrier County,52,73,-21
39,Ohio,54,West Virginia,29,Hancock County,663,484,179
39,Ohio,54,West Virginia,31,Hardy County,0,4,-4
39,Ohio,54,West Virginia,33,Harrison County,344,245,99
39,Ohio,54,West Virginia,35,Jackson County,120,129,-9
39,Ohio,54,West Virginia,37,Jefferson County,134,10,124
39,Ohio,54,West Virginia,39,Kanawha County,512,430,82
39,Ohio,54,West Virginia,41,Lewis County,56,63,-7
39,Ohio,54,West Virginia,43,Lincoln County,59,145,-86
39,Ohio,54,West Virginia,45,Logan County,42,2,40
39,Ohio,54,West Virginia,47,McDowell County,47,0,47
39,Ohio,54,West Virginia,49,Marion County,98,81,17
39,Ohio,54,West Virginia,51,Marshall County,382,174,208
39,Ohio,54,West Virginia,53,Mason County,438,308,130
39,Ohio,54,West Virginia,55,Mercer County,37,29,8
39,Ohio,54,West Virginia,57,Mineral County,18,8,10
39,Ohio,54,West Virginia,59,Mingo County,87,12,75
39,Ohio,54,West Virginia,61,Monongalia County,223,593,-370
39,Ohio,54,West Virginia,65,Morgan County,0,7,-7
39,Ohio,54,West Virginia,67,Nicholas County,38,25,13
39,Ohio,54,West Virginia,69,Ohio County,1003,926,77
39,Ohio,54,West Virginia,73,Pleasants County,47,152,-105
39,Ohio,54,West Virginia,75,Pocahontas County,81,9,72
39,Ohio,54,West Virginia,77,Preston County,28,9,19
39,Ohio,54,West Virginia,79,Putnam County,282,84,198
39,Ohio,54,West Virginia,81,Raleigh County,223,122,101
39,Ohio,54,West Virginia,83,Randolph County,50,35,15
39,Ohio,54,West Virginia,85,Ritchie County,74,98,-24
39,Ohio,54,West Virginia,87,Roane County,0,21,-21
39,Ohio,54,West Virginia,89,Summers County,0,24,-24
39,Ohio,54,West Virginia,91,Taylor County,39,7,32
39,Ohio,54,West Virginia,93,Tucker County,15,0,15
39,Ohio,54,West Virginia,95,Tyler County,32,52,-20
39,Ohio,54,West Virginia,97,Upshur County,54,38,16
39,Ohio,54,West Virginia,99,Wayne County,763,133,630
39,Ohio,54,West Virginia,101,Webster County,25,0,25
39,Ohio,54,West Virginia,103,Wetzel County,112,68,44
39,Ohio,54,West Virginia,105,Wirt County,0,34,-34
39,Ohio,54,West Virginia,107,Wood County,1044,825,219
39,Ohio,54,West Virginia,109,Wyoming County,8,0,8
39,Ohio,55,Wisconsin,5,Barron County,0,6,-6
39,Ohio,55,Wisconsin,7,Bayfield County,0,5,-5
39,Ohio,55,Wisconsin,9,Brown County,169,0,169
39,Ohio,55,Wisconsin,13,Burnett County,0,1,-1
39,Ohio,55,Wisconsin,17,Chippewa County,45,17,28
39,Ohio,55,Wisconsin,19,Clark County,4,0,4
39,Ohio,55,Wisconsin,21,Columbia County,0,10,-10
39,Ohio,55,Wisconsin,25,Dane County,445,876,-431
39,Ohio,55,Wisconsin,29,Door County,10,1,9
39,Ohio,55,Wisconsin,31,Douglas County,0,6,-6
39,Ohio,55,Wisconsin,33,Dunn County,17,33,-16
39,Ohio,55,Wisconsin,35,Eau Claire County,0,28,-28
39,Ohio,55,Wisconsin,39,Fond du Lac County,31,6,25
39,Ohio,55,Wisconsin,49,Iowa County,0,7,-7
39,Ohio,55,Wisconsin,51,Iron County,29,0,29
39,Ohio,55,Wisconsin,55,Jefferson County,34,14,20
39,Ohio,55,Wisconsin,57,Juneau County,0,22,-22
39,Ohio,55,Wisconsin,59,Kenosha County,82,105,-23
39,Ohio,55,Wisconsin,61,Kewaunee County,0,20,-20
39,Ohio,55,Wisconsin,63,La Crosse County,0,51,-51
39,Ohio,55,Wisconsin,65,Lafayette County,0,8,-8
39,Ohio,55,Wisconsin,71,Manitowoc County,26,0,26
39,Ohio,55,Wisconsin,73,Marathon County,0,33,-33
39,Ohio,55,Wisconsin,75,Marinette County,18,12,6
39,Ohio,55,Wisconsin,77,Marquette County,9,3,6
39,Ohio,55,Wisconsin,79,Milwaukee County,461,534,-73
39,Ohio,55,Wisconsin,81,Monroe County,28,57,-29
39,Ohio,55,Wisconsin,83,Oconto County,9,4,5
39,Ohio,55,Wisconsin,85,Oneida County,0,3,-3
39,Ohio,55,Wisconsin,87,Outagamie County,31,76,-45
39,Ohio,55,Wisconsin,89,Ozaukee County,101,97,4
39,Ohio,55,Wisconsin,93,Pierce County,25,8,17
39,Ohio,55,Wisconsin,99,Price County,0,1,-1
39,Ohio,55,Wisconsin,101,Racine County,35,59,-24
39,Ohio,55,Wisconsin,105,Rock County,196,29,167
39,Ohio,55,Wisconsin,107,Rusk County,0,5,-5
39,Ohio,55,Wisconsin,109,St. Croix County,24,1,23
39,Ohio,55,Wisconsin,111,Sauk County,13,0,13
39,Ohio,55,Wisconsin,113,Sawyer County,0,3,-3
39,Ohio,55,Wisconsin,115,Shawano County,0,23,-23
39,Ohio,55,Wisconsin,117,Sheboygan County,46,26,20
39,Ohio,55,Wisconsin,119,Taylor County,10,0,10
39,Ohio,55,Wisconsin,123,Vernon County,0,5,-5
39,Ohio,55,Wisconsin,125,Vilas County,2,28,-26
39,Ohio,55,Wisconsin,127,Walworth County,54,12,42
39,Ohio,55,Wisconsin,131,Washington County,9,48,-39
39,Ohio,55,Wisconsin,133,Waukesha County,225,158,67
39,Ohio,55,Wisconsin,135,Waupaca County,17,0,17
39,Ohio,55,Wisconsin,139,Winnebago County,17,9,8
39,Ohio,55,Wisconsin,141,Wood County,11,36,-25
39,Ohio,56,Wyoming,1,Albany County,9,2,7
39,Ohio,56,Wyoming,5,Campbell County,8,8,0
39,Ohio,56,Wyoming,13,Fremont County,0,11,-11
39,Ohio,56,Wyoming,21,Laramie County,50,92,-42
39,Ohio,56,Wyoming,23,Lincoln County,0,1,-1
39,Ohio,56,Wyoming,25,Natrona County,43,18,25
39,Ohio,56,Wyoming,29,Park County,13,3,10
39,Ohio,56,Wyoming,35,Sublette County,0,2,-2
39,Ohio,56,Wyoming,39,Teton County,30,6,24
39,Ohio,6,California,1,Alameda County,491,580,-89
39,Ohio,6,California,7,Butte County,96,0,96
39,Ohio,6,California,13,Contra Costa County,175,365,-190
39,Ohio,6,California,15,Del Norte County,3,0,3
39,Ohio,6,California,17,El Dorado County,56,7,49
39,Ohio,6,California,19,Fresno County,37,92,-55
39,Ohio,6,California,21,Glenn County,0,32,-32
39,Ohio,6,California,23,Humboldt County,9,12,-3
39,Ohio,6,California,29,Kern County,219,156,63
39,Ohio,6,California,31,Kings County,258,7,251
39,Ohio,6,California,35,Lassen County,5,0,5
39,Ohio,6,California,37,Los Angeles County,2574,2189,385
39,Ohio,6,California,39,Madera County,80,22,58
39,Ohio,6,California,41,Marin County,108,88,20
39,Ohio,6,California,45,Mendocino County,0,33,-33
39,Ohio,6,California,53,Monterey County,58,181,-123
39,Ohio,6,California,55,Napa County,16,11,5
39,Ohio,6,California,57,Nevada County,12,0,12
39,Ohio,6,California,59,Orange County,726,552,174
39,Ohio,6,California,61,Placer County,161,83,78
39,Ohio,6,California,63,Plumas County,11,0,11
39,Ohio,6,California,65,Riverside County,555,303,252
39,Ohio,6,California,67,Sacramento County,306,268,38
39,Ohio,6,California,71,San Bernardino County,651,463,188
39,Ohio,6,California,73,San Diego County,1557,1571,-14
39,Ohio,6,California,75,San Francisco County,505,318,187
39,Ohio,6,California,77,San Joaquin County,20,44,-24
39,Ohio,6,California,79,San Luis Obispo County,26,116,-90
39,Ohio,6,California,81,San Mateo County,370,123,247
39,Ohio,6,California,83,Santa Barbara County,82,205,-123
39,Ohio,6,California,85,Santa Clara County,336,871,-535
39,Ohio,6,California,87,Santa Cruz County,40,87,-47
39,Ohio,6,California,89,Shasta County,68,93,-25
39,Ohio,6,California,95,Solano County,111,102,9
39,Ohio,6,California,97,Sonoma County,29,58,-29
39,Ohio,6,California,101,Sutter County,7,8,-1
39,Ohio,6,California,107,Tulare County,0,13,-13
39,Ohio,6,California,111,Ventura County,293,225,68
39,Ohio,6,California,113,Yolo County,47,153,-106
39,Ohio,6,California,115,Yuba County,58,16,42
39,Ohio,72,Puerto Rico,1,Adjuntas Municipio,81,0,81
39,Ohio,72,Puerto Rico,3,Aguada Municipio,11,0,11
39,Ohio,72,Puerto Rico,5,Aguadilla Municipio,5,0,5
39,Ohio,72,Puerto Rico,7,Aguas Buenas Municipio,277,0,277
39,Ohio,72,Puerto Rico,15,Arroyo Municipio,29,0,29
39,Ohio,72,Puerto Rico,21,Bayamón Municipio,44,0,44
39,Ohio,72,Puerto Rico,23,Cabo Rojo Municipio,11,0,11
39,Ohio,72,Puerto Rico,25,Caguas Municipio,49,0,49
39,Ohio,72,Puerto Rico,29,Canóvanas Municipio,118,0,118
39,Ohio,72,Puerto Rico,31,Carolina Municipio,490,50,440
39,Ohio,72,Puerto Rico,41,Cidra Municipio,13,16,-3
39,Ohio,72,Puerto Rico,43,Coamo Municipio,7,0,7
39,Ohio,72,Puerto Rico,47,Corozal Municipio,89,0,89
39,Ohio,72,Puerto Rico,51,Dorado Municipio,102,0,102
39,Ohio,72,Puerto Rico,53,Fajardo Municipio,11,0,11
39,Ohio,72,Puerto Rico,54,Florida Municipio,0,43,-43
39,Ohio,72,Puerto Rico,57,Guayama Municipio,18,6,12
39,Ohio,72,Puerto Rico,61,Guaynabo Municipio,74,0,74
39,Ohio,72,Puerto Rico,65,Hatillo Municipio,128,0,128
39,Ohio,72,Puerto Rico,69,Humacao Municipio,20,0,20
39,Ohio,72,Puerto Rico,71,Isabela Municipio,15,0,15
39,Ohio,72,Puerto Rico,73,Jayuya Municipio,3,0,3
39,Ohio,72,Puerto Rico,75,Juana Díaz Municipio,68,16,52
39,Ohio,72,Puerto Rico,77,Juncos Municipio,124,0,124
39,Ohio,72,Puerto Rico,83,Las Marías Municipio,0,13,-13
39,Ohio,72,Puerto Rico,85,Las Piedras Municipio,0,105,-105
39,Ohio,72,Puerto Rico,87,Loíza Municipio,87,0,87
39,Ohio,72,Puerto Rico,91,Manatí Municipio,0,106,-106
39,Ohio,72,Puerto Rico,99,Moca Municipio,33,39,-6
39,Ohio,72,Puerto Rico,103,Naguabo Municipio,7,0,7
39,Ohio,72,Puerto Rico,109,Patillas Municipio,158,0,158
39,Ohio,72,Puerto Rico,113,Ponce Municipio,71,0,71
39,Ohio,72,Puerto Rico,119,Río Grande Municipio,108,0,108
39,Ohio,72,Puerto Rico,123,Salinas Municipio,7,0,7
39,Ohio,72,Puerto Rico,127,San Juan Municipio,375,66,309
39,Ohio,72,Puerto Rico,129,San Lorenzo Municipio,253,0,253
39,Ohio,72,Puerto Rico,133,Santa Isabel Municipio,9,0,9
39,Ohio,72,Puerto Rico,135,Toa Alta Municipio,21,0,21
39,Ohio,72,Puerto Rico,137,Toa Baja Municipio,56,0,56
39,Ohio,72,Puerto Rico,139,Trujillo Alto Municipio,68,0,68
39,Ohio,72,Puerto Rico,141,Utuado Municipio,31,16,15
39,Ohio,72,Puerto Rico,143,Vega Alta Municipio,82,0,82
39,Ohio,72,Puerto Rico,145,Vega Baja Municipio,68,0,68
39,Ohio,72,Puerto Rico,147,Vieques Municipio,36,0,36
39,Ohio,72,Puerto Rico,153,Yauco Municipio,50,35,15
39,Ohio,8,Colorado,1,Adams County,137,75,62
39,Ohio,8,Colorado,3,Alamosa County,0,8,-8
39,Ohio,8,Colorado,5,Arapahoe County,194,425,-231
39,Ohio,8,Colorado,7,Archuleta County,0,23,-23
39,Ohio,8,Colorado,9,Baca County,0,1,-1
39,Ohio,8,Colorado,13,Boulder County,239,365,-126
39,Ohio,8,Colorado,14,Broomfield County,36,70,-34
39,Ohio,8,Colorado,17,Cheyenne County,0,9,-9
39,Ohio,8,Colorado,31,Denver County,539,666,-127
39,Ohio,8,Colorado,33,Dolores County,0,1,-1
39,Ohio,8,Colorado,35,Douglas County,54,283,-229
39,Ohio,8,Colorado,37,Eagle County,34,128,-94
39,Ohio,8,Colorado,41,El Paso County,1416,709,707
39,Ohio,8,Colorado,43,Fremont County,14,12,2
39,Ohio,8,Colorado,45,Garfield County,50,0,50
39,Ohio,8,Colorado,49,Grand County,0,15,-15
39,Ohio,8,Colorado,51,Gunnison County,0,7,-7
39,Ohio,8,Colorado,59,Jefferson County,177,410,-233
39,Ohio,8,Colorado,65,Lake County,11,0,11
39,Ohio,8,Colorado,67,La Plata County,9,1,8
39,Ohio,8,Colorado,69,Larimer County,185,386,-201
39,Ohio,8,Colorado,71,Las Animas County,0,32,-32
39,Ohio,8,Colorado,75,Logan County,8,52,-44
39,Ohio,8,Colorado,77,Mesa County,110,147,-37
39,Ohio,8,Colorado,79,Mineral County,0,4,-4
39,Ohio,8,Colorado,81,Moffat County,2,0,2
39,Ohio,8,Colorado,87,Morgan County,0,2,-2
39,Ohio,8,Colorado,93,Park County,14,0,14
39,Ohio,8,Colorado,97,Pitkin County,0,11,-11
39,Ohio,8,Colorado,99,Prowers County,0,5,-5
39,Ohio,8,Colorado,101,Pueblo County,104,11,93
39,Ohio,8,Colorado,103,Rio Blanco County,4,0,4
39,Ohio,8,Colorado,107,Routt County,0,18,-18
39,Ohio,8,Colorado,113,San Miguel County,0,5,-5
39,Ohio,8,Colorado,117,Summit County,42,141,-99
39,Ohio,8,Colorado,119,Teller County,96,0,96
39,Ohio,8,Colorado,121,Washington County,0,7,-7
39,Ohio,8,Colorado,123,Weld County,72,144,-72
39,Ohio,8,Colorado,125,Yuma County,0,18,-18
39,Ohio,9,Connecticut,1,Fairfield County,486,413,73
39,Ohio,9,Connecticut,3,Hartford County,415,253,162
39,Ohio,9,Connecticut,5,Litchfield County,120,25,95
39,Ohio,9,Connecticut,7,Middlesex County,57,83,-26
39,Ohio,9,Connecticut,9,New Haven County,217,273,-56
39,Ohio,9,Connecticut,11,New London County,147,141,6
39,Ohio,9,Connecticut,13,Tolland County,76,17,59
39,Ohio,9,Connecticut,15,Windham County,59,0,59
39,Ohio,AFR,Africa,,-,4537,0,0
39,Ohio,ASI,Asia,,-,25018,0,0
39,Ohio,CAM,Central America,,-,2918,0,0
39,Ohio,CAR,Caribbean,,-,781,0,0
39,Ohio,EUR,Europe,,-,6209,0,0
39,Ohio,ISL,U.S. Island Areas,,-,267,0,0
39,Ohio,NAM,Northern America,,-,1543,0,0
39,Ohio,OCE,Oceania and At Sea,,-,487,0,0
39,Ohio,SAM,South America,,-,1019,0,0
40,Oklahoma,1,Alabama,3,Baldwin County,24,76,-52
40,Oklahoma,1,Alabama,9,Blount County,8,0,8
40,Oklahoma,1,Alabama,13,Butler County,13,0,13
40,Oklahoma,1,Alabama,15,Calhoun County,6,0,6
40,Oklahoma,1,Alabama,21,Chilton County,9,0,9
40,Oklahoma,1,Alabama,23,Choctaw County,5,0,5
40,Oklahoma,1,Alabama,31,Coffee County,23,43,-20
40,Oklahoma,1,Alabama,33,Colbert County,9,0,9
40,Oklahoma,1,Alabama,39,Covington County,16,3,13
40,Oklahoma,1,Alabama,43,Cullman County,0,10,-10
40,Oklahoma,1,Alabama,45,Dale County,11,19,-8
40,Oklahoma,1,Alabama,49,DeKalb County,0,2,-2
40,Oklahoma,1,Alabama,51,Elmore County,0,18,-18
40,Oklahoma,1,Alabama,55,Etowah County,28,121,-93
40,Oklahoma,1,Alabama,69,Houston County,9,13,-4
40,Oklahoma,1,Alabama,71,Jackson County,0,4,-4
40,Oklahoma,1,Alabama,73,Jefferson County,185,137,48
40,Oklahoma,1,Alabama,81,Lee County,5,0,5
40,Oklahoma,1,Alabama,83,Limestone County,39,15,24
40,Oklahoma,1,Alabama,85,Lowndes County,2,0,2
40,Oklahoma,1,Alabama,89,Madison County,175,37,138
40,Oklahoma,1,Alabama,95,Marshall County,95,1,94
40,Oklahoma,1,Alabama,97,Mobile County,45,135,-90
40,Oklahoma,1,Alabama,101,Montgomery County,4,52,-48
40,Oklahoma,1,Alabama,103,Morgan County,36,0,36
40,Oklahoma,1,Alabama,109,Pike County,3,0,3
40,Oklahoma,1,Alabama,115,St. Clair County,23,28,-5
40,Oklahoma,1,Alabama,117,Shelby County,10,89,-79
40,Oklahoma,1,Alabama,121,Talladega County,20,0,20
40,Oklahoma,1,Alabama,123,Tallapoosa County,36,0,36
40,Oklahoma,1,Alabama,125,Tuscaloosa County,32,119,-87
40,Oklahoma,10,Delaware,1,Kent County,84,111,-27
40,Oklahoma,10,Delaware,3,New Castle County,62,2,60
40,Oklahoma,10,Delaware,5,Sussex County,25,29,-4
40,Oklahoma,11,District of Columbia,1,District of Columbia,221,99,122
40,Oklahoma,12,Florida,1,Alachua County,51,131,-80
40,Oklahoma,12,Florida,5,Bay County,186,117,69
40,Oklahoma,12,Florida,9,Brevard County,72,207,-135
40,Oklahoma,12,Florida,11,Broward County,112,175,-63
40,Oklahoma,12,Florida,15,Charlotte County,23,13,10
40,Oklahoma,12,Florida,17,Citrus County,6,0,6
40,Oklahoma,12,Florida,19,Clay County,53,274,-221
40,Oklahoma,12,Florida,21,Collier County,20,14,6
40,Oklahoma,12,Florida,23,Columbia County,1,0,1
40,Oklahoma,12,Florida,27,DeSoto County,6,0,6
40,Oklahoma,12,Florida,31,Duval County,131,135,-4
40,Oklahoma,12,Florida,33,Escambia County,378,215,163
40,Oklahoma,12,Florida,35,Flagler County,0,58,-58
40,Oklahoma,12,Florida,41,Gilchrist County,0,25,-25
40,Oklahoma,12,Florida,45,Gulf County,0,6,-6
40,Oklahoma,12,Florida,53,Hernando County,66,0,66
40,Oklahoma,12,Florida,55,Highlands County,39,0,39
40,Oklahoma,12,Florida,57,Hillsborough County,269,291,-22
40,Oklahoma,12,Florida,61,Indian River County,27,0,27
40,Oklahoma,12,Florida,69,Lake County,102,127,-25
40,Oklahoma,12,Florida,71,Lee County,105,169,-64
40,Oklahoma,12,Florida,73,Leon County,116,14,102
40,Oklahoma,12,Florida,75,Levy County,0,16,-16
40,Oklahoma,12,Florida,81,Manatee County,107,117,-10
40,Oklahoma,12,Florida,83,Marion County,108,45,63
40,Oklahoma,12,Florida,86,Miami-Dade County,255,187,68
40,Oklahoma,12,Florida,87,Monroe County,0,50,-50
40,Oklahoma,12,Florida,89,Nassau County,0,64,-64
40,Oklahoma,12,Florida,91,Okaloosa County,165,125,40
40,Oklahoma,12,Florida,95,Orange County,283,99,184
40,Oklahoma,12,Florida,97,Osceola County,11,0,11
40,Oklahoma,12,Florida,99,Palm Beach County,41,42,-1
40,Oklahoma,12,Florida,101,Pasco County,160,126,34
40,Oklahoma,12,Florida,103,Pinellas County,129,154,-25
40,Oklahoma,12,Florida,105,Polk County,167,392,-225
40,Oklahoma,12,Florida,107,Putnam County,7,0,7
40,Oklahoma,12,Florida,109,St. Johns County,0,191,-191
40,Oklahoma,12,Florida,111,St. Lucie County,30,333,-303
40,Oklahoma,12,Florida,113,Santa Rosa County,232,83,149
40,Oklahoma,12,Florida,115,Sarasota County,80,102,-22
40,Oklahoma,12,Florida,117,Seminole County,112,0,112
40,Oklahoma,12,Florida,119,Sumter County,38,30,8
40,Oklahoma,12,Florida,127,Volusia County,40,27,13
40,Oklahoma,13,Georgia,13,Barrow County,0,18,-18
40,Oklahoma,13,Georgia,15,Bartow County,11,28,-17
40,Oklahoma,13,Georgia,21,Bibb County,11,0,11
40,Oklahoma,13,Georgia,29,Bryan County,0,3,-3
40,Oklahoma,13,Georgia,35,Butts County,41,0,41
40,Oklahoma,13,Georgia,39,Camden County,5,11,-6
40,Oklahoma,13,Georgia,51,Chatham County,33,279,-246
40,Oklahoma,13,Georgia,53,Chattahoochee County,0,24,-24
40,Oklahoma,13,Georgia,59,Clarke County,13,25,-12
40,Oklahoma,13,Georgia,63,Clayton County,35,15,20
40,Oklahoma,13,Georgia,67,Cobb County,148,105,43
40,Oklahoma,13,Georgia,69,Coffee County,0,33,-33
40,Oklahoma,13,Georgia,73,Columbia County,30,90,-60
40,Oklahoma,13,Georgia,77,Coweta County,0,10,-10
40,Oklahoma,13,Georgia,81,Crisp County,0,8,-8
40,Oklahoma,13,Georgia,89,DeKalb County,169,156,13
40,Oklahoma,13,Georgia,95,Dougherty County,0,4,-4
40,Oklahoma,13,Georgia,97,Douglas County,11,0,11
40,Oklahoma,13,Georgia,99,Early County,16,13,3
40,Oklahoma,13,Georgia,103,Effingham County,0,50,-50
40,Oklahoma,13,Georgia,109,Evans County,0,21,-21
40,Oklahoma,13,Georgia,111,Fannin County,14,25,-11
40,Oklahoma,13,Georgia,113,Fayette County,52,0,52
40,Oklahoma,13,Georgia,117,Forsyth County,8,0,8
40,Oklahoma,13,Georgia,119,Franklin County,34,0,34
40,Oklahoma,13,Georgia,121,Fulton County,209,172,37
40,Oklahoma,13,Georgia,123,Gilmer County,21,0,21
40,Oklahoma,13,Georgia,125,Glascock County,0,4,-4
40,Oklahoma,13,Georgia,127,Glynn County,0,58,-58
40,Oklahoma,13,Georgia,135,Gwinnett County,322,82,240
40,Oklahoma,13,Georgia,137,Habersham County,3,0,3
40,Oklahoma,13,Georgia,139,Hall County,0,7,-7
40,Oklahoma,13,Georgia,145,Harris County,95,0,95
40,Oklahoma,13,Georgia,147,Hart County,79,0,79
40,Oklahoma,13,Georgia,151,Henry County,62,0,62
40,Oklahoma,13,Georgia,153,Houston County,49,8,41
40,Oklahoma,13,Georgia,173,Lanier County,25,0,25
40,Oklahoma,13,Georgia,175,Laurens County,0,19,-19
40,Oklahoma,13,Georgia,179,Liberty County,73,150,-77
40,Oklahoma,13,Georgia,185,Lowndes County,320,75,245
40,Oklahoma,13,Georgia,195,Madison County,0,2,-2
40,Oklahoma,13,Georgia,207,Monroe County,4,0,4
40,Oklahoma,13,Georgia,215,Muscogee County,163,325,-162
40,Oklahoma,13,Georgia,217,Newton County,49,0,49
40,Oklahoma,13,Georgia,219,Oconee County,38,0,38
40,Oklahoma,13,Georgia,223,Paulding County,14,47,-33
40,Oklahoma,13,Georgia,235,Pulaski County,1,0,1
40,Oklahoma,13,Georgia,243,Randolph County,35,0,35
40,Oklahoma,13,Georgia,245,Richmond County,47,105,-58
40,Oklahoma,13,Georgia,269,Taylor County,9,0,9
40,Oklahoma,13,Georgia,281,Towns County,0,26,-26
40,Oklahoma,13,Georgia,285,Troup County,0,3,-3
40,Oklahoma,13,Georgia,293,Upson County,18,0,18
40,Oklahoma,13,Georgia,295,Walker County,1,0,1
40,Oklahoma,13,Georgia,297,Walton County,59,0,59
40,Oklahoma,13,Georgia,299,Ware County,39,3,36
40,Oklahoma,13,Georgia,305,Wayne County,0,45,-45
40,Oklahoma,13,Georgia,317,Wilkes County,0,10,-10
40,Oklahoma,15,Hawaii,1,Hawaii County,18,9,9
40,Oklahoma,15,Hawaii,3,Honolulu County,437,435,2
40,Oklahoma,15,Hawaii,9,Maui County,0,58,-58
40,Oklahoma,16,Idaho,1,Ada County,101,129,-28
40,Oklahoma,16,Idaho,17,Bonner County,16,0,16
40,Oklahoma,16,Idaho,19,Bonneville County,4,0,4
40,Oklahoma,16,Idaho,27,Canyon County,98,0,98
40,Oklahoma,16,Idaho,37,Custer County,0,2,-2
40,Oklahoma,16,Idaho,39,Elmore County,22,4,18
40,Oklahoma,16,Idaho,49,Idaho County,13,16,-3
40,Oklahoma,16,Idaho,55,Kootenai County,104,150,-46
40,Oklahoma,16,Idaho,57,Latah County,0,31,-31
40,Oklahoma,16,Idaho,65,Madison County,50,0,50
40,Oklahoma,16,Idaho,69,Nez Perce County,17,37,-20
40,Oklahoma,16,Idaho,75,Payette County,12,0,12
40,Oklahoma,16,Idaho,83,Twin Falls County,0,19,-19
40,Oklahoma,16,Idaho,85,Valley County,32,1,31
40,Oklahoma,17,Illinois,1,Adams County,32,0,32
40,Oklahoma,17,Illinois,3,Alexander County,7,0,7
40,Oklahoma,17,Illinois,11,Bureau County,0,56,-56
40,Oklahoma,17,Illinois,13,Calhoun County,0,15,-15
40,Oklahoma,17,Illinois,15,Carroll County,16,0,16
40,Oklahoma,17,Illinois,19,Champaign County,31,29,2
40,Oklahoma,17,Illinois,21,Christian County,0,10,-10
40,Oklahoma,17,Illinois,23,Clark County,0,12,-12
40,Oklahoma,17,Illinois,27,Clinton County,26,11,15
40,Oklahoma,17,Illinois,29,Coles County,66,17,49
40,Oklahoma,17,Illinois,31,Cook County,710,335,375
40,Oklahoma,17,Illinois,37,DeKalb County,2,20,-18
40,Oklahoma,17,Illinois,41,Douglas County,0,8,-8
40,Oklahoma,17,Illinois,43,DuPage County,366,82,284
40,Oklahoma,17,Illinois,49,Effingham County,8,27,-19
40,Oklahoma,17,Illinois,57,Fulton County,0,42,-42
40,Oklahoma,17,Illinois,63,Grundy County,22,0,22
40,Oklahoma,17,Illinois,67,Hancock County,0,3,-3
40,Oklahoma,17,Illinois,73,Henry County,39,0,39
40,Oklahoma,17,Illinois,75,Iroquois County,5,0,5
40,Oklahoma,17,Illinois,77,Jackson County,4,12,-8
40,Oklahoma,17,Illinois,81,Jefferson County,0,2,-2
40,Oklahoma,17,Illinois,85,Jo Daviess County,39,0,39
40,Oklahoma,17,Illinois,87,Johnson County,16,0,16
40,Oklahoma,17,Illinois,89,Kane County,33,11,22
40,Oklahoma,17,Illinois,91,Kankakee County,2,36,-34
40,Oklahoma,17,Illinois,95,Knox County,0,13,-13
40,Oklahoma,17,Illinois,97,Lake County,118,168,-50
40,Oklahoma,17,Illinois,101,Lawrence County,4,5,-1
40,Oklahoma,17,Illinois,105,Livingston County,0,5,-5
40,Oklahoma,17,Illinois,109,McDonough County,38,9,29
40,Oklahoma,17,Illinois,111,McHenry County,0,99,-99
40,Oklahoma,17,Illinois,113,McLean County,9,39,-30
40,Oklahoma,17,Illinois,115,Macon County,30,0,30
40,Oklahoma,17,Illinois,117,Macoupin County,42,17,25
40,Oklahoma,17,Illinois,119,Madison County,34,72,-38
40,Oklahoma,17,Illinois,121,Marion County,0,15,-15
40,Oklahoma,17,Illinois,131,Mercer County,15,0,15
40,Oklahoma,17,Illinois,137,Morgan County,0,57,-57
40,Oklahoma,17,Illinois,141,Ogle County,6,0,6
40,Oklahoma,17,Illinois,143,Peoria County,32,16,16
40,Oklahoma,17,Illinois,157,Randolph County,21,0,21
40,Oklahoma,17,Illinois,161,Rock Island County,26,20,6
40,Oklahoma,17,Illinois,163,St. Clair County,23,129,-106
40,Oklahoma,17,Illinois,167,Sangamon County,38,16,22
40,Oklahoma,17,Illinois,169,Schuyler County,29,0,29
40,Oklahoma,17,Illinois,177,Stephenson County,25,0,25
40,Oklahoma,17,Illinois,179,Tazewell County,73,11,62
40,Oklahoma,17,Illinois,183,Vermilion County,7,7,0
40,Oklahoma,17,Illinois,189,Washington County,3,0,3
40,Oklahoma,17,Illinois,191,Wayne County,10,7,3
40,Oklahoma,17,Illinois,197,Will County,123,61,62
40,Oklahoma,17,Illinois,199,Williamson County,28,17,11
40,Oklahoma,17,Illinois,201,Winnebago County,84,50,34
40,Oklahoma,17,Illinois,203,Woodford County,0,24,-24
40,Oklahoma,18,Indiana,3,Allen County,0,38,-38
40,Oklahoma,18,Indiana,11,Boone County,122,28,94
40,Oklahoma,18,Indiana,21,Clay County,3,0,3
40,Oklahoma,18,Indiana,25,Crawford County,40,0,40
40,Oklahoma,18,Indiana,29,Dearborn County,7,0,7
40,Oklahoma,18,Indiana,35,Delaware County,15,0,15
40,Oklahoma,18,Indiana,39,Elkhart County,4,24,-20
40,Oklahoma,18,Indiana,43,Floyd County,37,0,37
40,Oklahoma,18,Indiana,45,Fountain County,8,6,2
40,Oklahoma,18,Indiana,51,Gibson County,6,0,6
40,Oklahoma,18,Indiana,55,Greene County,0,28,-28
40,Oklahoma,18,Indiana,57,Hamilton County,31,16,15
40,Oklahoma,18,Indiana,61,Harrison County,19,0,19
40,Oklahoma,18,Indiana,65,Henry County,15,3,12
40,Oklahoma,18,Indiana,69,Huntington County,12,10,2
40,Oklahoma,18,Indiana,71,Jackson County,9,21,-12
40,Oklahoma,18,Indiana,81,Johnson County,28,0,28
40,Oklahoma,18,Indiana,83,Knox County,0,138,-138
40,Oklahoma,18,Indiana,87,LaGrange County,0,10,-10
40,Oklahoma,18,Indiana,89,Lake County,172,67,105
40,Oklahoma,18,Indiana,91,LaPorte County,31,6,25
40,Oklahoma,18,Indiana,95,Madison County,0,59,-59
40,Oklahoma,18,Indiana,97,Marion County,542,155,387
40,Oklahoma,18,Indiana,99,Marshall County,0,14,-14
40,Oklahoma,18,Indiana,101,Martin County,0,2,-2
40,Oklahoma,18,Indiana,103,Miami County,0,22,-22
40,Oklahoma,18,Indiana,105,Monroe County,16,57,-41
40,Oklahoma,18,Indiana,109,Morgan County,30,0,30
40,Oklahoma,18,Indiana,113,Noble County,12,0,12
40,Oklahoma,18,Indiana,127,Porter County,9,35,-26
40,Oklahoma,18,Indiana,129,Posey County,0,3,-3
40,Oklahoma,18,Indiana,139,Rush County,0,33,-33
40,Oklahoma,18,Indiana,141,St. Joseph County,148,5,143
40,Oklahoma,18,Indiana,153,Sullivan County,1,27,-26
40,Oklahoma,18,Indiana,157,Tippecanoe County,4,16,-12
40,Oklahoma,18,Indiana,159,Tipton County,9,0,9
40,Oklahoma,18,Indiana,163,Vanderburgh County,64,53,11
40,Oklahoma,18,Indiana,167,Vigo County,0,97,-97
40,Oklahoma,18,Indiana,169,Wabash County,10,0,10
40,Oklahoma,18,Indiana,171,Warren County,0,11,-11
40,Oklahoma,18,Indiana,173,Warrick County,62,0,62
40,Oklahoma,18,Indiana,175,Washington County,34,0,34
40,Oklahoma,18,Indiana,177,Wayne County,26,0,26
40,Oklahoma,18,Indiana,181,White County,0,34,-34
40,Oklahoma,18,Indiana,183,Whitley County,9,2,7
40,Oklahoma,19,Iowa,3,Adams County,16,0,16
40,Oklahoma,19,Iowa,7,Appanoose County,14,0,14
40,Oklahoma,19,Iowa,13,Black Hawk County,34,0,34
40,Oklahoma,19,Iowa,15,Boone County,0,191,-191
40,Oklahoma,19,Iowa,19,Buchanan County,0,15,-15
40,Oklahoma,19,Iowa,23,Butler County,21,0,21
40,Oklahoma,19,Iowa,39,Clarke County,10,0,10
40,Oklahoma,19,Iowa,45,Clinton County,0,30,-30
40,Oklahoma,19,Iowa,49,Dallas County,17,32,-15
40,Oklahoma,19,Iowa,57,Des Moines County,0,14,-14
40,Oklahoma,19,Iowa,61,Dubuque County,61,0,61
40,Oklahoma,19,Iowa,63,Emmet County,8,0,8
40,Oklahoma,19,Iowa,67,Floyd County,19,0,19
40,Oklahoma,19,Iowa,77,Guthrie County,0,33,-33
40,Oklahoma,19,Iowa,83,Hardin County,6,24,-18
40,Oklahoma,19,Iowa,87,Henry County,0,2,-2
40,Oklahoma,19,Iowa,95,Iowa County,29,0,29
40,Oklahoma,19,Iowa,97,Jackson County,0,2,-2
40,Oklahoma,19,Iowa,99,Jasper County,0,85,-85
40,Oklahoma,19,Iowa,103,Johnson County,22,0,22
40,Oklahoma,19,Iowa,105,Jones County,7,0,7
40,Oklahoma,19,Iowa,109,Kossuth County,0,25,-25
40,Oklahoma,19,Iowa,111,Lee County,0,27,-27
40,Oklahoma,19,Iowa,113,Linn County,30,19,11
40,Oklahoma,19,Iowa,117,Lucas County,5,5,0
40,Oklahoma,19,Iowa,125,Marion County,0,5,-5
40,Oklahoma,19,Iowa,127,Marshall County,7,0,7
40,Oklahoma,19,Iowa,131,Mitchell County,67,0,67
40,Oklahoma,19,Iowa,133,Monona County,0,4,-4
40,Oklahoma,19,Iowa,135,Monroe County,0,6,-6
40,Oklahoma,19,Iowa,137,Montgomery County,27,3,24
40,Oklahoma,19,Iowa,139,Muscatine County,12,0,12
40,Oklahoma,19,Iowa,141,O'Brien County,31,0,31
40,Oklahoma,19,Iowa,143,Osceola County,0,6,-6
40,Oklahoma,19,Iowa,147,Palo Alto County,2,9,-7
40,Oklahoma,19,Iowa,149,Plymouth County,27,0,27
40,Oklahoma,19,Iowa,153,Polk County,91,53,38
40,Oklahoma,19,Iowa,155,Pottawattamie County,115,6,109
40,Oklahoma,19,Iowa,159,Ringgold County,6,0,6
40,Oklahoma,19,Iowa,163,Scott County,68,0,68
40,Oklahoma,19,Iowa,169,Story County,39,0,39
40,Oklahoma,19,Iowa,171,Tama County,0,2,-2
40,Oklahoma,19,Iowa,177,Van Buren County,0,31,-31
40,Oklahoma,19,Iowa,179,Wapello County,15,52,-37
40,Oklahoma,19,Iowa,181,Warren County,37,12,25
40,Oklahoma,19,Iowa,183,Washington County,0,34,-34
40,Oklahoma,19,Iowa,187,Webster County,21,48,-27
40,Oklahoma,19,Iowa,189,Winnebago County,0,1,-1
40,Oklahoma,19,Iowa,193,Woodbury County,281,0,281
40,Oklahoma,19,Iowa,195,Worth County,0,1,-1
40,Oklahoma,19,Iowa,197,Wright County,45,28,17
40,Oklahoma,2,Alaska,20,Anchorage Municipality,432,259,173
40,Oklahoma,2,Alaska,50,Bethel Census Area,0,8,-8
40,Oklahoma,2,Alaska,90,Fairbanks North Star Borough,141,181,-40
40,Oklahoma,2,Alaska,110,Juneau City and Borough,52,0,52
40,Oklahoma,2,Alaska,122,Kenai Peninsula Borough,94,71,23
40,Oklahoma,2,Alaska,150,Kodiak Island Borough,0,4,-4
40,Oklahoma,2,Alaska,164,Lake and Peninsula Borough,0,4,-4
40,Oklahoma,2,Alaska,170,Matanuska-Susitna Borough,31,10,21
40,Oklahoma,2,Alaska,180,Nome Census Area,184,0,184
40,Oklahoma,2,Alaska,185,North Slope Borough,0,3,-3
40,Oklahoma,2,Alaska,220,Sitka City and Borough,0,26,-26
40,Oklahoma,2,Alaska,290,Yukon-Koyukuk Census Area,38,7,31
40,Oklahoma,20,Kansas,1,Allen County,22,0,22
40,Oklahoma,20,Kansas,3,Anderson County,0,46,-46
40,Oklahoma,20,Kansas,5,Atchison County,27,21,6
40,Oklahoma,20,Kansas,7,Barber County,53,59,-6
40,Oklahoma,20,Kansas,9,Barton County,26,80,-54
40,Oklahoma,20,Kansas,11,Bourbon County,10,0,10
40,Oklahoma,20,Kansas,13,Brown County,0,20,-20
40,Oklahoma,20,Kansas,15,Butler County,119,163,-44
40,Oklahoma,20,Kansas,17,Chase County,0,6,-6
40,Oklahoma,20,Kansas,19,Chautauqua County,45,12,33
40,Oklahoma,20,Kansas,21,Cherokee County,174,15,159
40,Oklahoma,20,Kansas,23,Cheyenne County,0,4,-4
40,Oklahoma,20,Kansas,25,Clark County,0,42,-42
40,Oklahoma,20,Kansas,27,Clay County,0,10,-10
40,Oklahoma,20,Kansas,29,Cloud County,0,8,-8
40,Oklahoma,20,Kansas,31,Coffey County,0,35,-35
40,Oklahoma,20,Kansas,33,Comanche County,24,0,24
40,Oklahoma,20,Kansas,35,Cowley County,292,459,-167
40,Oklahoma,20,Kansas,37,Crawford County,178,64,114
40,Oklahoma,20,Kansas,39,Decatur County,0,1,-1
40,Oklahoma,20,Kansas,41,Dickinson County,9,0,9
40,Oklahoma,20,Kansas,45,Douglas County,269,377,-108
40,Oklahoma,20,Kansas,47,Edwards County,0,7,-7
40,Oklahoma,20,Kansas,49,Elk County,7,0,7
40,Oklahoma,20,Kansas,51,Ellis County,5,122,-117
40,Oklahoma,20,Kansas,53,Ellsworth County,12,21,-9
40,Oklahoma,20,Kansas,55,Finney County,12,0,12
40,Oklahoma,20,Kansas,57,Ford County,255,40,215
40,Oklahoma,20,Kansas,59,Franklin County,12,9,3
40,Oklahoma,20,Kansas,61,Geary County,103,188,-85
40,Oklahoma,20,Kansas,63,Gove County,0,3,-3
40,Oklahoma,20,Kansas,65,Graham County,0,13,-13
40,Oklahoma,20,Kansas,67,Grant County,125,0,125
40,Oklahoma,20,Kansas,69,Gray County,6,0,6
40,Oklahoma,20,Kansas,73,Greenwood County,8,1,7
40,Oklahoma,20,Kansas,75,Hamilton County,56,0,56
40,Oklahoma,20,Kansas,77,Harper County,43,31,12
40,Oklahoma,20,Kansas,79,Harvey County,140,179,-39
40,Oklahoma,20,Kansas,81,Haskell County,0,8,-8
40,Oklahoma,20,Kansas,85,Jackson County,0,70,-70
40,Oklahoma,20,Kansas,87,Jefferson County,0,9,-9
40,Oklahoma,20,Kansas,91,Johnson County,619,412,207
40,Oklahoma,20,Kansas,95,Kingman County,106,31,75
40,Oklahoma,20,Kansas,97,Kiowa County,13,10,3
40,Oklahoma,20,Kansas,99,Labette County,136,34,102
40,Oklahoma,20,Kansas,103,Leavenworth County,336,167,169
40,Oklahoma,20,Kansas,105,Lincoln County,0,8,-8
40,Oklahoma,20,Kansas,111,Lyon County,37,66,-29
40,Oklahoma,20,Kansas,113,McPherson County,37,111,-74
40,Oklahoma,20,Kansas,115,Marion County,0,12,-12
40,Oklahoma,20,Kansas,117,Marshall County,0,18,-18
40,Oklahoma,20,Kansas,119,Meade County,70,21,49
40,Oklahoma,20,Kansas,121,Miami County,0,14,-14
40,Oklahoma,20,Kansas,123,Mitchell County,0,14,-14
40,Oklahoma,20,Kansas,125,Montgomery County,714,224,490
40,Oklahoma,20,Kansas,129,Morton County,47,4,43
40,Oklahoma,20,Kansas,131,Nemaha County,5,15,-10
40,Oklahoma,20,Kansas,133,Neosho County,39,26,13
40,Oklahoma,20,Kansas,137,Norton County,0,5,-5
40,Oklahoma,20,Kansas,139,Osage County,0,2,-2
40,Oklahoma,20,Kansas,141,Osborne County,0,41,-41
40,Oklahoma,20,Kansas,143,Ottawa County,4,11,-7
40,Oklahoma,20,Kansas,145,Pawnee County,21,1,20
40,Oklahoma,20,Kansas,147,Phillips County,0,5,-5
40,Oklahoma,20,Kansas,149,Pottawatomie County,41,3,38
40,Oklahoma,20,Kansas,151,Pratt County,27,33,-6
40,Oklahoma,20,Kansas,155,Reno County,207,186,21
40,Oklahoma,20,Kansas,157,Republic County,4,16,-12
40,Oklahoma,20,Kansas,159,Rice County,14,47,-33
40,Oklahoma,20,Kansas,161,Riley County,199,52,147
40,Oklahoma,20,Kansas,165,Rush County,0,6,-6
40,Oklahoma,20,Kansas,167,Russell County,66,0,66
40,Oklahoma,20,Kansas,169,Saline County,19,39,-20
40,Oklahoma,20,Kansas,173,Sedgwick County,2181,995,1186
40,Oklahoma,20,Kansas,175,Seward County,266,131,135
40,Oklahoma,20,Kansas,177,Shawnee County,254,214,40
40,Oklahoma,20,Kansas,185,Stafford County,0,19,-19
40,Oklahoma,20,Kansas,187,Stanton County,7,0,7
40,Oklahoma,20,Kansas,189,Stevens County,9,73,-64
40,Oklahoma,20,Kansas,191,Sumner County,72,52,20
40,Oklahoma,20,Kansas,193,Thomas County,4,0,4
40,Oklahoma,20,Kansas,195,Trego County,2,30,-28
40,Oklahoma,20,Kansas,197,Wabaunsee County,0,7,-7
40,Oklahoma,20,Kansas,201,Washington County,14,0,14
40,Oklahoma,20,Kansas,203,Wichita County,0,3,-3
40,Oklahoma,20,Kansas,205,Wilson County,22,0,22
40,Oklahoma,20,Kansas,207,Woodson County,69,0,69
40,Oklahoma,20,Kansas,209,Wyandotte County,197,22,175
40,Oklahoma,21,Kentucky,1,Adair County,9,0,9
40,Oklahoma,21,Kentucky,3,Allen County,0,69,-69
40,Oklahoma,21,Kentucky,11,Bath County,10,0,10
40,Oklahoma,21,Kentucky,13,Bell County,51,0,51
40,Oklahoma,21,Kentucky,17,Bourbon County,8,0,8
40,Oklahoma,21,Kentucky,31,Butler County,6,0,6
40,Oklahoma,21,Kentucky,37,Campbell County,0,11,-11
40,Oklahoma,21,Kentucky,39,Carlisle County,18,0,18
40,Oklahoma,21,Kentucky,47,Christian County,268,48,220
40,Oklahoma,21,Kentucky,59,Daviess County,72,29,43
40,Oklahoma,21,Kentucky,67,Fayette County,41,183,-142
40,Oklahoma,21,Kentucky,73,Franklin County,17,0,17
40,Oklahoma,21,Kentucky,75,Fulton County,0,40,-40
40,Oklahoma,21,Kentucky,89,Greenup County,2,0,2
40,Oklahoma,21,Kentucky,93,Hardin County,104,57,47
40,Oklahoma,21,Kentucky,95,Harlan County,76,6,70
40,Oklahoma,21,Kentucky,111,Jefferson County,256,27,229
40,Oklahoma,21,Kentucky,113,Jessamine County,0,117,-117
40,Oklahoma,21,Kentucky,117,Kenton County,63,0,63
40,Oklahoma,21,Kentucky,119,Knott County,14,0,14
40,Oklahoma,21,Kentucky,123,Larue County,0,14,-14
40,Oklahoma,21,Kentucky,125,Laurel County,0,54,-54
40,Oklahoma,21,Kentucky,127,Lawrence County,4,0,4
40,Oklahoma,21,Kentucky,141,Logan County,8,0,8
40,Oklahoma,21,Kentucky,145,McCracken County,63,6,57
40,Oklahoma,21,Kentucky,147,McCreary County,0,40,-40
40,Oklahoma,21,Kentucky,151,Madison County,15,11,4
40,Oklahoma,21,Kentucky,155,Marion County,1,0,1
40,Oklahoma,21,Kentucky,157,Marshall County,0,15,-15
40,Oklahoma,21,Kentucky,159,Martin County,0,10,-10
40,Oklahoma,21,Kentucky,161,Mason County,0,6,-6
40,Oklahoma,21,Kentucky,163,Meade County,29,20,9
40,Oklahoma,21,Kentucky,165,Menifee County,0,18,-18
40,Oklahoma,21,Kentucky,183,Ohio County,2,0,2
40,Oklahoma,21,Kentucky,185,Oldham County,26,8,18
40,Oklahoma,21,Kentucky,199,Pulaski County,70,11,59
40,Oklahoma,22,Louisiana,1,Acadia Parish,54,0,54
40,Oklahoma,22,Louisiana,3,Allen Parish,37,33,4
40,Oklahoma,22,Louisiana,5,Ascension Parish,0,126,-126
40,Oklahoma,22,Louisiana,9,Avoyelles Parish,6,0,6
40,Oklahoma,22,Louisiana,11,Beauregard Parish,0,4,-4
40,Oklahoma,22,Louisiana,15,Bossier Parish,138,0,138
40,Oklahoma,22,Louisiana,17,Caddo Parish,160,42,118
40,Oklahoma,22,Louisiana,19,Calcasieu Parish,118,160,-42
40,Oklahoma,22,Louisiana,21,Caldwell Parish,0,7,-7
40,Oklahoma,22,Louisiana,27,Claiborne Parish,0,18,-18
40,Oklahoma,22,Louisiana,31,De Soto Parish,0,3,-3
40,Oklahoma,22,Louisiana,33,East Baton Rouge Parish,213,177,36
40,Oklahoma,22,Louisiana,39,Evangeline Parish,27,0,27
40,Oklahoma,22,Louisiana,41,Franklin Parish,0,12,-12
40,Oklahoma,22,Louisiana,47,Iberville Parish,20,106,-86
40,Oklahoma,22,Louisiana,49,Jackson Parish,0,21,-21
40,Oklahoma,22,Louisiana,51,Jefferson Parish,165,211,-46
40,Oklahoma,22,Louisiana,53,Jefferson Davis Parish,24,0,24
40,Oklahoma,22,Louisiana,55,Lafayette Parish,38,18,20
40,Oklahoma,22,Louisiana,61,Lincoln Parish,0,118,-118
40,Oklahoma,22,Louisiana,63,Livingston Parish,79,118,-39
40,Oklahoma,22,Louisiana,67,Morehouse Parish,55,24,31
40,Oklahoma,22,Louisiana,69,Natchitoches Parish,39,0,39
40,Oklahoma,22,Louisiana,71,Orleans Parish,164,123,41
40,Oklahoma,22,Louisiana,73,Ouachita Parish,108,17,91
40,Oklahoma,22,Louisiana,79,Rapides Parish,88,166,-78
40,Oklahoma,22,Louisiana,85,Sabine Parish,5,7,-2
40,Oklahoma,22,Louisiana,87,St. Bernard Parish,24,9,15
40,Oklahoma,22,Louisiana,91,St. Helena Parish,13,0,13
40,Oklahoma,22,Louisiana,95,St. John the Baptist Parish,0,103,-103
40,Oklahoma,22,Louisiana,97,St. Landry Parish,62,1,61
40,Oklahoma,22,Louisiana,103,St. Tammany Parish,58,0,58
40,Oklahoma,22,Louisiana,105,Tangipahoa Parish,80,74,6
40,Oklahoma,22,Louisiana,109,Terrebonne Parish,0,79,-79
40,Oklahoma,22,Louisiana,111,Union Parish,0,5,-5
40,Oklahoma,22,Louisiana,113,Vermilion Parish,15,0,15
40,Oklahoma,22,Louisiana,115,Vernon Parish,151,58,93
40,Oklahoma,22,Louisiana,117,Washington Parish,0,10,-10
40,Oklahoma,22,Louisiana,119,Webster Parish,52,0,52
40,Oklahoma,22,Louisiana,123,West Carroll Parish,34,11,23
40,Oklahoma,23,Maine,5,Cumberland County,83,21,62
40,Oklahoma,23,Maine,9,Hancock County,0,3,-3
40,Oklahoma,23,Maine,11,Kennebec County,7,4,3
40,Oklahoma,23,Maine,13,Knox County,0,23,-23
40,Oklahoma,23,Maine,17,Oxford County,0,28,-28
40,Oklahoma,23,Maine,19,Penobscot County,36,0,36
40,Oklahoma,23,Maine,27,Waldo County,0,5,-5
40,Oklahoma,23,Maine,29,Washington County,0,6,-6
40,Oklahoma,23,Maine,31,York County,14,33,-19
40,Oklahoma,24,Maryland,3,Anne Arundel County,147,114,33
40,Oklahoma,24,Maryland,5,Baltimore County,42,35,7
40,Oklahoma,24,Maryland,11,Caroline County,0,9,-9
40,Oklahoma,24,Maryland,13,Carroll County,30,4,26
40,Oklahoma,24,Maryland,17,Charles County,14,0,14
40,Oklahoma,24,Maryland,19,Dorchester County,0,15,-15
40,Oklahoma,24,Maryland,21,Frederick County,133,101,32
40,Oklahoma,24,Maryland,25,Harford County,37,35,2
40,Oklahoma,24,Maryland,27,Howard County,81,18,63
40,Oklahoma,24,Maryland,29,Kent County,0,34,-34
40,Oklahoma,24,Maryland,31,Montgomery County,44,89,-45
40,Oklahoma,24,Maryland,33,Prince George's County,130,17,113
40,Oklahoma,24,Maryland,35,Queen Anne's County,15,0,15
40,Oklahoma,24,Maryland,37,St. Mary's County,149,11,138
40,Oklahoma,24,Maryland,41,Talbot County,12,0,12
40,Oklahoma,24,Maryland,43,Washington County,14,0,14
40,Oklahoma,24,Maryland,45,Wicomico County,3,0,3
40,Oklahoma,24,Maryland,47,Worcester County,0,19,-19
40,Oklahoma,24,Maryland,510,Baltimore city,81,56,25
40,Oklahoma,25,Massachusetts,1,Barnstable County,11,44,-33
40,Oklahoma,25,Massachusetts,5,Bristol County,0,29,-29
40,Oklahoma,25,Massachusetts,9,Essex County,72,55,17
40,Oklahoma,25,Massachusetts,17,Middlesex County,103,283,-180
40,Oklahoma,25,Massachusetts,21,Norfolk County,87,8,79
40,Oklahoma,25,Massachusetts,23,Plymouth County,3,0,3
40,Oklahoma,25,Massachusetts,25,Suffolk County,31,98,-67
40,Oklahoma,25,Massachusetts,27,Worcester County,161,13,148
40,Oklahoma,26,Michigan,1,Alcona County,20,0,20
40,Oklahoma,26,Michigan,5,Allegan County,2,0,2
40,Oklahoma,26,Michigan,11,Arenac County,0,2,-2
40,Oklahoma,26,Michigan,17,Bay County,19,0,19
40,Oklahoma,26,Michigan,21,Berrien County,25,35,-10
40,Oklahoma,26,Michigan,25,Calhoun County,737,5,732
40,Oklahoma,26,Michigan,27,Cass County,0,51,-51
40,Oklahoma,26,Michigan,33,Chippewa County,3,0,3
40,Oklahoma,26,Michigan,45,Eaton County,11,3,8
40,Oklahoma,26,Michigan,49,Genesee County,71,70,1
40,Oklahoma,26,Michigan,51,Gladwin County,6,3,3
40,Oklahoma,26,Michigan,55,Grand Traverse County,8,0,8
40,Oklahoma,26,Michigan,59,Hillsdale County,0,7,-7
40,Oklahoma,26,Michigan,63,Huron County,36,13,23
40,Oklahoma,26,Michigan,65,Ingham County,23,39,-16
40,Oklahoma,26,Michigan,69,Iosco County,0,26,-26
40,Oklahoma,26,Michigan,73,Isabella County,12,7,5
40,Oklahoma,26,Michigan,75,Jackson County,77,34,43
40,Oklahoma,26,Michigan,77,Kalamazoo County,9,39,-30
40,Oklahoma,26,Michigan,81,Kent County,137,62,75
40,Oklahoma,26,Michigan,89,Leelanau County,28,0,28
40,Oklahoma,26,Michigan,93,Livingston County,21,0,21
40,Oklahoma,26,Michigan,99,Macomb County,33,38,-5
40,Oklahoma,26,Michigan,105,Mason County,0,41,-41
40,Oklahoma,26,Michigan,109,Menominee County,0,21,-21
40,Oklahoma,26,Michigan,113,Missaukee County,0,2,-2
40,Oklahoma,26,Michigan,115,Monroe County,0,15,-15
40,Oklahoma,26,Michigan,117,Montcalm County,0,71,-71
40,Oklahoma,26,Michigan,121,Muskegon County,35,0,35
40,Oklahoma,26,Michigan,123,Newaygo County,0,17,-17
40,Oklahoma,26,Michigan,125,Oakland County,181,66,115
40,Oklahoma,26,Michigan,127,Oceana County,0,26,-26
40,Oklahoma,26,Michigan,129,Ogemaw County,0,4,-4
40,Oklahoma,26,Michigan,133,Osceola County,11,0,11
40,Oklahoma,26,Michigan,139,Ottawa County,57,7,50
40,Oklahoma,26,Michigan,145,Saginaw County,76,20,56
40,Oklahoma,26,Michigan,147,St. Clair County,49,72,-23
40,Oklahoma,26,Michigan,149,St. Joseph County,14,36,-22
40,Oklahoma,26,Michigan,155,Shiawassee County,0,8,-8
40,Oklahoma,26,Michigan,161,Washtenaw County,207,32,175
40,Oklahoma,26,Michigan,163,Wayne County,288,58,230
40,Oklahoma,26,Michigan,165,Wexford County,8,0,8
40,Oklahoma,27,Minnesota,3,Anoka County,23,0,23
40,Oklahoma,27,Minnesota,5,Becker County,0,2,-2
40,Oklahoma,27,Minnesota,11,Big Stone County,0,3,-3
40,Oklahoma,27,Minnesota,13,Blue Earth County,6,0,6
40,Oklahoma,27,Minnesota,15,Brown County,0,2,-2
40,Oklahoma,27,Minnesota,19,Carver County,21,0,21
40,Oklahoma,27,Minnesota,21,Cass County,0,5,-5
40,Oklahoma,27,Minnesota,23,Chippewa County,0,3,-3
40,Oklahoma,27,Minnesota,25,Chisago County,12,0,12
40,Oklahoma,27,Minnesota,27,Clay County,56,140,-84
40,Oklahoma,27,Minnesota,29,Clearwater County,0,5,-5
40,Oklahoma,27,Minnesota,37,Dakota County,78,27,51
40,Oklahoma,27,Minnesota,53,Hennepin County,168,219,-51
40,Oklahoma,27,Minnesota,61,Itasca County,12,2,10
40,Oklahoma,27,Minnesota,69,Kittson County,0,4,-4
40,Oklahoma,27,Minnesota,73,Lac qui Parle County,0,19,-19
40,Oklahoma,27,Minnesota,79,Le Sueur County,0,59,-59
40,Oklahoma,27,Minnesota,83,Lyon County,0,4,-4
40,Oklahoma,27,Minnesota,85,McLeod County,25,3,22
40,Oklahoma,27,Minnesota,93,Meeker County,0,3,-3
40,Oklahoma,27,Minnesota,95,Mille Lacs County,0,12,-12
40,Oklahoma,27,Minnesota,97,Morrison County,0,1,-1
40,Oklahoma,27,Minnesota,105,Nobles County,7,3,4
40,Oklahoma,27,Minnesota,109,Olmsted County,21,8,13
40,Oklahoma,27,Minnesota,111,Otter Tail County,0,2,-2
40,Oklahoma,27,Minnesota,113,Pennington County,13,0,13
40,Oklahoma,27,Minnesota,117,Pipestone County,3,0,3
40,Oklahoma,27,Minnesota,123,Ramsey County,98,60,38
40,Oklahoma,27,Minnesota,127,Redwood County,0,12,-12
40,Oklahoma,27,Minnesota,131,Rice County,17,10,7
40,Oklahoma,27,Minnesota,137,St. Louis County,26,74,-48
40,Oklahoma,27,Minnesota,139,Scott County,38,10,28
40,Oklahoma,27,Minnesota,141,Sherburne County,0,20,-20
40,Oklahoma,27,Minnesota,143,Sibley County,19,0,19
40,Oklahoma,27,Minnesota,145,Stearns County,11,0,11
40,Oklahoma,27,Minnesota,147,Steele County,13,3,10
40,Oklahoma,27,Minnesota,153,Todd County,36,0,36
40,Oklahoma,27,Minnesota,161,Waseca County,0,51,-51
40,Oklahoma,27,Minnesota,163,Washington County,96,21,75
40,Oklahoma,27,Minnesota,173,Yellow Medicine County,16,0,16
40,Oklahoma,28,Mississippi,1,Adams County,9,0,9
40,Oklahoma,28,Mississippi,3,Alcorn County,3,0,3
40,Oklahoma,28,Mississippi,5,Amite County,2,0,2
40,Oklahoma,28,Mississippi,7,Attala County,31,6,25
40,Oklahoma,28,Mississippi,21,Claiborne County,16,11,5
40,Oklahoma,28,Mississippi,31,Covington County,5,0,5
40,Oklahoma,28,Mississippi,33,DeSoto County,213,22,191
40,Oklahoma,28,Mississippi,47,Harrison County,106,152,-46
40,Oklahoma,28,Mississippi,49,Hinds County,128,0,128
40,Oklahoma,28,Mississippi,51,Holmes County,0,9,-9
40,Oklahoma,28,Mississippi,59,Jackson County,19,0,19
40,Oklahoma,28,Mississippi,61,Jasper County,3,45,-42
40,Oklahoma,28,Mississippi,65,Jefferson Davis County,0,10,-10
40,Oklahoma,28,Mississippi,67,Jones County,5,0,5
40,Oklahoma,28,Mississippi,71,Lafayette County,34,22,12
40,Oklahoma,28,Mississippi,73,Lamar County,10,66,-56
40,Oklahoma,28,Mississippi,75,Lauderdale County,15,23,-8
40,Oklahoma,28,Mississippi,79,Leake County,14,0,14
40,Oklahoma,28,Mississippi,81,Lee County,78,11,67
40,Oklahoma,28,Mississippi,83,Leflore County,8,5,3
40,Oklahoma,28,Mississippi,85,Lincoln County,34,0,34
40,Oklahoma,28,Mississippi,87,Lowndes County,138,0,138
40,Oklahoma,28,Mississippi,91,Marion County,30,0,30
40,Oklahoma,28,Mississippi,93,Marshall County,16,0,16
40,Oklahoma,28,Mississippi,97,Montgomery County,17,0,17
40,Oklahoma,28,Mississippi,99,Neshoba County,24,39,-15
40,Oklahoma,28,Mississippi,105,Oktibbeha County,32,102,-70
40,Oklahoma,28,Mississippi,107,Panola County,42,4,38
40,Oklahoma,28,Mississippi,109,Pearl River County,23,0,23
40,Oklahoma,28,Mississippi,113,Pike County,20,0,20
40,Oklahoma,28,Mississippi,115,Pontotoc County,0,25,-25
40,Oklahoma,28,Mississippi,121,Rankin County,0,18,-18
40,Oklahoma,28,Mississippi,131,Stone County,0,16,-16
40,Oklahoma,28,Mississippi,133,Sunflower County,7,0,7
40,Oklahoma,28,Mississippi,135,Tallahatchie County,24,123,-99
40,Oklahoma,28,Mississippi,137,Tate County,40,0,40
40,Oklahoma,28,Mississippi,149,Warren County,6,0,6
40,Oklahoma,28,Mississippi,151,Washington County,16,41,-25
40,Oklahoma,28,Mississippi,161,Yalobusha County,0,10,-10
40,Oklahoma,28,Mississippi,163,Yazoo County,15,0,15
40,Oklahoma,29,Missouri,1,Adair County,0,6,-6
40,Oklahoma,29,Missouri,3,Andrew County,0,11,-11
40,Oklahoma,29,Missouri,5,Atchison County,0,3,-3
40,Oklahoma,29,Missouri,9,Barry County,158,215,-57
40,Oklahoma,29,Missouri,11,Barton County,0,53,-53
40,Oklahoma,29,Missouri,13,Bates County,0,33,-33
40,Oklahoma,29,Missouri,15,Benton County,36,96,-60
40,Oklahoma,29,Missouri,19,Boone County,42,251,-209
40,Oklahoma,29,Missouri,21,Buchanan County,15,202,-187
40,Oklahoma,29,Missouri,23,Butler County,11,0,11
40,Oklahoma,29,Missouri,27,Callaway County,5,0,5
40,Oklahoma,29,Missouri,29,Camden County,3,31,-28
40,Oklahoma,29,Missouri,31,Cape Girardeau County,16,67,-51
40,Oklahoma,29,Missouri,35,Carter County,0,55,-55
40,Oklahoma,29,Missouri,37,Cass County,10,8,2
40,Oklahoma,29,Missouri,39,Cedar County,19,24,-5
40,Oklahoma,29,Missouri,41,Chariton County,0,1,-1
40,Oklahoma,29,Missouri,43,Christian County,82,132,-50
40,Oklahoma,29,Missouri,47,Clay County,159,408,-249
40,Oklahoma,29,Missouri,49,Clinton County,3,3,0
40,Oklahoma,29,Missouri,51,Cole County,0,7,-7
40,Oklahoma,29,Missouri,53,Cooper County,25,8,17
40,Oklahoma,29,Missouri,57,Dade County,0,6,-6
40,Oklahoma,29,Missouri,59,Dallas County,23,9,14
40,Oklahoma,29,Missouri,63,DeKalb County,0,6,-6
40,Oklahoma,29,Missouri,65,Dent County,0,15,-15
40,Oklahoma,29,Missouri,67,Douglas County,0,4,-4
40,Oklahoma,29,Missouri,71,Franklin County,14,72,-58
40,Oklahoma,29,Missouri,73,Gasconade County,0,20,-20
40,Oklahoma,29,Missouri,77,Greene County,582,318,264
40,Oklahoma,29,Missouri,81,Harrison County,0,32,-32
40,Oklahoma,29,Missouri,83,Henry County,36,0,36
40,Oklahoma,29,Missouri,85,Hickory County,10,0,10
40,Oklahoma,29,Missouri,89,Howard County,8,0,8
40,Oklahoma,29,Missouri,91,Howell County,39,32,7
40,Oklahoma,29,Missouri,95,Jackson County,572,606,-34
40,Oklahoma,29,Missouri,97,Jasper County,482,528,-46
40,Oklahoma,29,Missouri,99,Jefferson County,21,7,14
40,Oklahoma,29,Missouri,101,Johnson County,106,73,33
40,Oklahoma,29,Missouri,103,Knox County,137,0,137
40,Oklahoma,29,Missouri,105,Laclede County,12,95,-83
40,Oklahoma,29,Missouri,107,Lafayette County,5,5,0
40,Oklahoma,29,Missouri,109,Lawrence County,16,40,-24
40,Oklahoma,29,Missouri,111,Lewis County,0,9,-9
40,Oklahoma,29,Missouri,113,Lincoln County,14,0,14
40,Oklahoma,29,Missouri,115,Linn County,43,0,43
40,Oklahoma,29,Missouri,117,Livingston County,0,22,-22
40,Oklahoma,29,Missouri,119,McDonald County,344,131,213
40,Oklahoma,29,Missouri,121,Macon County,0,8,-8
40,Oklahoma,29,Missouri,127,Marion County,37,30,7
40,Oklahoma,29,Missouri,131,Miller County,0,19,-19
40,Oklahoma,29,Missouri,133,Mississippi County,0,22,-22
40,Oklahoma,29,Missouri,135,Moniteau County,0,4,-4
40,Oklahoma,29,Missouri,137,Monroe County,0,65,-65
40,Oklahoma,29,Missouri,145,Newton County,187,508,-321
40,Oklahoma,29,Missouri,147,Nodaway County,18,0,18
40,Oklahoma,29,Missouri,151,Osage County,0,2,-2
40,Oklahoma,29,Missouri,155,Pemiscot County,0,9,-9
40,Oklahoma,29,Missouri,159,Pettis County,8,111,-103
40,Oklahoma,29,Missouri,161,Phelps County,65,47,18
40,Oklahoma,29,Missouri,165,Platte County,20,41,-21
40,Oklahoma,29,Missouri,167,Polk County,40,49,-9
40,Oklahoma,29,Missouri,169,Pulaski County,247,201,46
40,Oklahoma,29,Missouri,173,Ralls County,13,0,13
40,Oklahoma,29,Missouri,175,Randolph County,0,10,-10
40,Oklahoma,29,Missouri,177,Ray County,0,3,-3
40,Oklahoma,29,Missouri,179,Reynolds County,11,0,11
40,Oklahoma,29,Missouri,181,Ripley County,48,0,48
40,Oklahoma,29,Missouri,183,St. Charles County,16,0,16
40,Oklahoma,29,Missouri,185,St. Clair County,0,5,-5
40,Oklahoma,29,Missouri,189,St. Louis County,270,375,-105
40,Oklahoma,29,Missouri,195,Saline County,0,21,-21
40,Oklahoma,29,Missouri,209,Stone County,48,84,-36
40,Oklahoma,29,Missouri,213,Taney County,185,513,-328
40,Oklahoma,29,Missouri,215,Texas County,10,0,10
40,Oklahoma,29,Missouri,217,Vernon County,19,50,-31
40,Oklahoma,29,Missouri,225,Webster County,7,3,4
40,Oklahoma,29,Missouri,229,Wright County,0,7,-7
40,Oklahoma,29,Missouri,510,St. Louis city,444,88,356
40,Oklahoma,30,Montana,3,Big Horn County,13,0,13
40,Oklahoma,30,Montana,5,Blaine County,0,2,-2
40,Oklahoma,30,Montana,13,Cascade County,7,30,-23
40,Oklahoma,30,Montana,17,Custer County,0,23,-23
40,Oklahoma,30,Montana,27,Fergus County,4,0,4
40,Oklahoma,30,Montana,29,Flathead County,21,0,21
40,Oklahoma,30,Montana,31,Gallatin County,39,22,17
40,Oklahoma,30,Montana,41,Hill County,0,6,-6
40,Oklahoma,30,Montana,43,Jefferson County,15,19,-4
40,Oklahoma,30,Montana,47,Lake County,14,0,14
40,Oklahoma,30,Montana,49,Lewis and Clark County,75,2,73
40,Oklahoma,30,Montana,53,Lincoln County,0,7,-7
40,Oklahoma,30,Montana,63,Missoula County,70,74,-4
40,Oklahoma,30,Montana,93,Silver Bow County,0,59,-59
40,Oklahoma,30,Montana,99,Teton County,0,2,-2
40,Oklahoma,30,Montana,101,Toole County,0,3,-3
40,Oklahoma,30,Montana,111,Yellowstone County,116,52,64
40,Oklahoma,31,Nebraska,1,Adams County,37,0,37
40,Oklahoma,31,Nebraska,11,Boone County,0,16,-16
40,Oklahoma,31,Nebraska,19,Buffalo County,12,29,-17
40,Oklahoma,31,Nebraska,23,Butler County,0,2,-2
40,Oklahoma,31,Nebraska,25,Cass County,14,0,14
40,Oklahoma,31,Nebraska,35,Clay County,0,9,-9
40,Oklahoma,31,Nebraska,37,Colfax County,0,25,-25
40,Oklahoma,31,Nebraska,43,Dakota County,0,2,-2
40,Oklahoma,31,Nebraska,47,Dawson County,1,10,-9
40,Oklahoma,31,Nebraska,49,Deuel County,0,3,-3
40,Oklahoma,31,Nebraska,55,Douglas County,125,194,-69
40,Oklahoma,31,Nebraska,59,Fillmore County,0,16,-16
40,Oklahoma,31,Nebraska,61,Franklin County,0,12,-12
40,Oklahoma,31,Nebraska,65,Furnas County,8,0,8
40,Oklahoma,31,Nebraska,67,Gage County,2,12,-10
40,Oklahoma,31,Nebraska,73,Gosper County,24,0,24
40,Oklahoma,31,Nebraska,79,Hall County,0,40,-40
40,Oklahoma,31,Nebraska,81,Hamilton County,65,0,65
40,Oklahoma,31,Nebraska,83,Harlan County,0,1,-1
40,Oklahoma,31,Nebraska,85,Hayes County,0,18,-18
40,Oklahoma,31,Nebraska,89,Holt County,0,4,-4
40,Oklahoma,31,Nebraska,93,Howard County,25,0,25
40,Oklahoma,31,Nebraska,95,Jefferson County,0,1,-1
40,Oklahoma,31,Nebraska,99,Kearney County,20,0,20
40,Oklahoma,31,Nebraska,109,Lancaster County,106,237,-131
40,Oklahoma,31,Nebraska,111,Lincoln County,11,6,5
40,Oklahoma,31,Nebraska,119,Madison County,0,17,-17
40,Oklahoma,31,Nebraska,123,Morrill County,0,11,-11
40,Oklahoma,31,Nebraska,133,Pawnee County,0,2,-2
40,Oklahoma,31,Nebraska,141,Platte County,2,13,-11
40,Oklahoma,31,Nebraska,143,Polk County,0,4,-4
40,Oklahoma,31,Nebraska,145,Red Willow County,0,133,-133
40,Oklahoma,31,Nebraska,153,Sarpy County,104,58,46
40,Oklahoma,31,Nebraska,155,Saunders County,76,0,76
40,Oklahoma,31,Nebraska,157,Scotts Bluff County,0,30,-30
40,Oklahoma,31,Nebraska,159,Seward County,0,4,-4
40,Oklahoma,31,Nebraska,161,Sheridan County,0,1,-1
40,Oklahoma,31,Nebraska,171,Thomas County,4,0,4
40,Oklahoma,31,Nebraska,173,Thurston County,15,23,-8
40,Oklahoma,31,Nebraska,181,Webster County,0,1,-1
40,Oklahoma,31,Nebraska,185,York County,0,8,-8
40,Oklahoma,32,Nevada,3,Clark County,536,454,82
40,Oklahoma,32,Nevada,5,Douglas County,16,0,16
40,Oklahoma,32,Nevada,7,Elko County,20,0,20
40,Oklahoma,32,Nevada,19,Lyon County,21,0,21
40,Oklahoma,32,Nevada,23,Nye County,13,3,10
40,Oklahoma,32,Nevada,29,Storey County,0,20,-20
40,Oklahoma,32,Nevada,31,Washoe County,148,27,121
40,Oklahoma,32,Nevada,33,White Pine County,5,0,5
40,Oklahoma,32,Nevada,510,Carson City,71,0,71
40,Oklahoma,33,New Hampshire,1,Belknap County,5,0,5
40,Oklahoma,33,New Hampshire,9,Grafton County,65,71,-6
40,Oklahoma,33,New Hampshire,11,Hillsborough County,80,39,41
40,Oklahoma,33,New Hampshire,13,Merrimack County,8,0,8
40,Oklahoma,33,New Hampshire,15,Rockingham County,14,0,14
40,Oklahoma,33,New Hampshire,17,Strafford County,2,0,2
40,Oklahoma,34,New Jersey,3,Bergen County,27,11,16
40,Oklahoma,34,New Jersey,5,Burlington County,110,0,110
40,Oklahoma,34,New Jersey,7,Camden County,4,49,-45
40,Oklahoma,34,New Jersey,13,Essex County,111,13,98
40,Oklahoma,34,New Jersey,17,Hudson County,26,34,-8
40,Oklahoma,34,New Jersey,19,Hunterdon County,0,49,-49
40,Oklahoma,34,New Jersey,21,Mercer County,0,17,-17
40,Oklahoma,34,New Jersey,23,Middlesex County,7,17,-10
40,Oklahoma,34,New Jersey,25,Monmouth County,28,6,22
40,Oklahoma,34,New Jersey,27,Morris County,93,0,93
40,Oklahoma,34,New Jersey,29,Ocean County,53,0,53
40,Oklahoma,34,New Jersey,31,Passaic County,21,0,21
40,Oklahoma,34,New Jersey,35,Somerset County,33,27,6
40,Oklahoma,34,New Jersey,37,Sussex County,6,0,6
40,Oklahoma,34,New Jersey,39,Union County,16,0,16
40,Oklahoma,35,New Mexico,1,Bernalillo County,272,472,-200
40,Oklahoma,35,New Mexico,3,Catron County,34,0,34
40,Oklahoma,35,New Mexico,5,Chaves County,70,136,-66
40,Oklahoma,35,New Mexico,7,Colfax County,25,11,14
40,Oklahoma,35,New Mexico,9,Curry County,67,271,-204
40,Oklahoma,35,New Mexico,13,Doña Ana County,144,65,79
40,Oklahoma,35,New Mexico,15,Eddy County,25,27,-2
40,Oklahoma,35,New Mexico,23,Hidalgo County,0,3,-3
40,Oklahoma,35,New Mexico,25,Lea County,90,233,-143
40,Oklahoma,35,New Mexico,27,Lincoln County,11,0,11
40,Oklahoma,35,New Mexico,29,Luna County,0,13,-13
40,Oklahoma,35,New Mexico,31,McKinley County,13,10,3
40,Oklahoma,35,New Mexico,35,Otero County,316,28,288
40,Oklahoma,35,New Mexico,37,Quay County,23,0,23
40,Oklahoma,35,New Mexico,39,Rio Arriba County,2,0,2
40,Oklahoma,35,New Mexico,41,Roosevelt County,116,0,116
40,Oklahoma,35,New Mexico,43,Sandoval County,11,65,-54
40,Oklahoma,35,New Mexico,45,San Juan County,102,31,71
40,Oklahoma,35,New Mexico,47,San Miguel County,6,0,6
40,Oklahoma,35,New Mexico,49,Santa Fe County,54,169,-115
40,Oklahoma,35,New Mexico,53,Socorro County,4,15,-11
40,Oklahoma,35,New Mexico,55,Taos County,18,7,11
40,Oklahoma,35,New Mexico,59,Union County,4,63,-59
40,Oklahoma,35,New Mexico,61,Valencia County,4,0,4
40,Oklahoma,36,New York,1,Albany County,0,36,-36
40,Oklahoma,36,New York,3,Allegany County,44,17,27
40,Oklahoma,36,New York,5,Bronx County,46,1,45
40,Oklahoma,36,New York,7,Broome County,63,114,-51
40,Oklahoma,36,New York,9,Cattaraugus County,0,6,-6
40,Oklahoma,36,New York,11,Cayuga County,0,4,-4
40,Oklahoma,36,New York,13,Chautauqua County,30,38,-8
40,Oklahoma,36,New York,15,Chemung County,29,29,0
40,Oklahoma,36,New York,17,Chenango County,0,11,-11
40,Oklahoma,36,New York,19,Clinton County,8,0,8
40,Oklahoma,36,New York,25,Delaware County,16,0,16
40,Oklahoma,36,New York,27,Dutchess County,155,0,155
40,Oklahoma,36,New York,29,Erie County,37,32,5
40,Oklahoma,36,New York,31,Essex County,19,0,19
40,Oklahoma,36,New York,33,Franklin County,0,7,-7
40,Oklahoma,36,New York,35,Fulton County,36,0,36
40,Oklahoma,36,New York,37,Genesee County,0,1,-1
40,Oklahoma,36,New York,45,Jefferson County,124,98,26
40,Oklahoma,36,New York,47,Kings County,262,149,113
40,Oklahoma,36,New York,49,Lewis County,0,2,-2
40,Oklahoma,36,New York,51,Livingston County,5,0,5
40,Oklahoma,36,New York,53,Madison County,3,0,3
40,Oklahoma,36,New York,55,Monroe County,66,19,47
40,Oklahoma,36,New York,57,Montgomery County,0,8,-8
40,Oklahoma,36,New York,59,Nassau County,31,1,30
40,Oklahoma,36,New York,61,New York County,39,127,-88
40,Oklahoma,36,New York,63,Niagara County,16,16,0
40,Oklahoma,36,New York,65,Oneida County,84,30,54
40,Oklahoma,36,New York,67,Onondaga County,0,95,-95
40,Oklahoma,36,New York,69,Ontario County,59,0,59
40,Oklahoma,36,New York,71,Orange County,71,46,25
40,Oklahoma,36,New York,75,Oswego County,41,0,41
40,Oklahoma,36,New York,77,Otsego County,13,34,-21
40,Oklahoma,36,New York,79,Putnam County,13,11,2
40,Oklahoma,36,New York,81,Queens County,485,42,443
40,Oklahoma,36,New York,83,Rensselaer County,21,0,21
40,Oklahoma,36,New York,85,Richmond County,38,31,7
40,Oklahoma,36,New York,87,Rockland County,83,0,83
40,Oklahoma,36,New York,89,St. Lawrence County,3,0,3
40,Oklahoma,36,New York,91,Saratoga County,35,13,22
40,Oklahoma,36,New York,93,Schenectady County,12,0,12
40,Oklahoma,36,New York,99,Seneca County,0,56,-56
40,Oklahoma,36,New York,101,Steuben County,44,4,40
40,Oklahoma,36,New York,103,Suffolk County,65,188,-123
40,Oklahoma,36,New York,111,Ulster County,19,0,19
40,Oklahoma,36,New York,113,Warren County,0,109,-109
40,Oklahoma,36,New York,117,Wayne County,7,8,-1
40,Oklahoma,36,New York,119,Westchester County,21,53,-32
40,Oklahoma,37,North Carolina,3,Alexander County,16,0,16
40,Oklahoma,37,North Carolina,11,Avery County,0,3,-3
40,Oklahoma,37,North Carolina,19,Brunswick County,16,0,16
40,Oklahoma,37,North Carolina,21,Buncombe County,35,4,31
40,Oklahoma,37,North Carolina,23,Burke County,20,0,20
40,Oklahoma,37,North Carolina,25,Cabarrus County,5,0,5
40,Oklahoma,37,North Carolina,31,Carteret County,0,16,-16
40,Oklahoma,37,North Carolina,45,Cleveland County,4,43,-39
40,Oklahoma,37,North Carolina,49,Craven County,57,17,40
40,Oklahoma,37,North Carolina,51,Cumberland County,365,226,139
40,Oklahoma,37,North Carolina,55,Dare County,9,0,9
40,Oklahoma,37,North Carolina,57,Davidson County,0,38,-38
40,Oklahoma,37,North Carolina,63,Durham County,17,54,-37
40,Oklahoma,37,North Carolina,67,Forsyth County,53,122,-69
40,Oklahoma,37,North Carolina,71,Gaston County,47,1,46
40,Oklahoma,37,North Carolina,77,Granville County,11,0,11
40,Oklahoma,37,North Carolina,81,Guilford County,72,12,60
40,Oklahoma,37,North Carolina,85,Harnett County,129,25,104
40,Oklahoma,37,North Carolina,87,Haywood County,36,0,36
40,Oklahoma,37,North Carolina,89,Henderson County,16,0,16
40,Oklahoma,37,North Carolina,93,Hoke County,59,48,11
40,Oklahoma,37,North Carolina,97,Iredell County,0,165,-165
40,Oklahoma,37,North Carolina,99,Jackson County,8,0,8
40,Oklahoma,37,North Carolina,101,Johnston County,99,43,56
40,Oklahoma,37,North Carolina,107,Lenoir County,0,12,-12
40,Oklahoma,37,North Carolina,109,Lincoln County,0,82,-82
40,Oklahoma,37,North Carolina,111,McDowell County,0,8,-8
40,Oklahoma,37,North Carolina,119,Mecklenburg County,91,244,-153
40,Oklahoma,37,North Carolina,125,Moore County,62,16,46
40,Oklahoma,37,North Carolina,129,New Hanover County,79,16,63
40,Oklahoma,37,North Carolina,133,Onslow County,116,206,-90
40,Oklahoma,37,North Carolina,135,Orange County,48,0,48
40,Oklahoma,37,North Carolina,139,Pasquotank County,14,0,14
40,Oklahoma,37,North Carolina,141,Pender County,169,1,168
40,Oklahoma,37,North Carolina,147,Pitt County,29,0,29
40,Oklahoma,37,North Carolina,151,Randolph County,37,9,28
40,Oklahoma,37,North Carolina,161,Rutherford County,5,0,5
40,Oklahoma,37,North Carolina,165,Scotland County,0,17,-17
40,Oklahoma,37,North Carolina,167,Stanly County,19,0,19
40,Oklahoma,37,North Carolina,171,Surry County,2,16,-14
40,Oklahoma,37,North Carolina,175,Transylvania County,11,0,11
40,Oklahoma,37,North Carolina,179,Union County,0,14,-14
40,Oklahoma,37,North Carolina,183,Wake County,89,113,-24
40,Oklahoma,37,North Carolina,185,Warren County,38,0,38
40,Oklahoma,37,North Carolina,189,Watauga County,19,0,19
40,Oklahoma,37,North Carolina,191,Wayne County,4,2,2
40,Oklahoma,37,North Carolina,193,Wilkes County,9,0,9
40,Oklahoma,38,North Dakota,9,Bottineau County,0,22,-22
40,Oklahoma,38,North Dakota,15,Burleigh County,45,0,45
40,Oklahoma,38,North Dakota,17,Cass County,53,0,53
40,Oklahoma,38,North Dakota,23,Divide County,0,20,-20
40,Oklahoma,38,North Dakota,25,Dunn County,0,13,-13
40,Oklahoma,38,North Dakota,33,Golden Valley County,0,21,-21
40,Oklahoma,38,North Dakota,35,Grand Forks County,0,50,-50
40,Oklahoma,38,North Dakota,37,Grant County,1,0,1
40,Oklahoma,38,North Dakota,53,McKenzie County,24,0,24
40,Oklahoma,38,North Dakota,61,Mountrail County,22,0,22
40,Oklahoma,38,North Dakota,69,Pierce County,0,4,-4
40,Oklahoma,38,North Dakota,77,Richland County,0,3,-3
40,Oklahoma,38,North Dakota,79,Rolette County,87,0,87
40,Oklahoma,38,North Dakota,85,Sioux County,6,0,6
40,Oklahoma,38,North Dakota,89,Stark County,12,32,-20
40,Oklahoma,38,North Dakota,93,Stutsman County,6,11,-5
40,Oklahoma,38,North Dakota,97,Traill County,0,13,-13
40,Oklahoma,38,North Dakota,101,Ward County,85,54,31
40,Oklahoma,38,North Dakota,103,Wells County,0,1,-1
40,Oklahoma,39,Ohio,3,Allen County,2,38,-36
40,Oklahoma,39,Ohio,7,Ashtabula County,28,0,28
40,Oklahoma,39,Ohio,9,Athens County,16,0,16
40,Oklahoma,39,Ohio,13,Belmont County,0,33,-33
40,Oklahoma,39,Ohio,15,Brown County,0,48,-48
40,Oklahoma,39,Ohio,17,Butler County,85,0,85
40,Oklahoma,39,Ohio,21,Champaign County,0,15,-15
40,Oklahoma,39,Ohio,23,Clark County,0,26,-26
40,Oklahoma,39,Ohio,25,Clermont County,3,0,3
40,Oklahoma,39,Ohio,29,Columbiana County,47,0,47
40,Oklahoma,39,Ohio,31,Coshocton County,26,0,26
40,Oklahoma,39,Ohio,35,Cuyahoga County,131,43,88
40,Oklahoma,39,Ohio,39,Defiance County,4,0,4
40,Oklahoma,39,Ohio,41,Delaware County,7,37,-30
40,Oklahoma,39,Ohio,43,Erie County,45,0,45
40,Oklahoma,39,Ohio,45,Fairfield County,0,17,-17
40,Oklahoma,39,Ohio,49,Franklin County,140,135,5
40,Oklahoma,39,Ohio,55,Geauga County,7,15,-8
40,Oklahoma,39,Ohio,57,Greene County,39,19,20
40,Oklahoma,39,Ohio,61,Hamilton County,55,24,31
40,Oklahoma,39,Ohio,63,Hancock County,14,0,14
40,Oklahoma,39,Ohio,73,Hocking County,2,0,2
40,Oklahoma,39,Ohio,79,Jackson County,0,37,-37
40,Oklahoma,39,Ohio,83,Knox County,0,8,-8
40,Oklahoma,39,Ohio,85,Lake County,0,139,-139
40,Oklahoma,39,Ohio,87,Lawrence County,95,0,95
40,Oklahoma,39,Ohio,89,Licking County,6,10,-4
40,Oklahoma,39,Ohio,91,Logan County,1,0,1
40,Oklahoma,39,Ohio,93,Lorain County,0,29,-29
40,Oklahoma,39,Ohio,95,Lucas County,49,113,-64
40,Oklahoma,39,Ohio,99,Mahoning County,54,141,-87
40,Oklahoma,39,Ohio,103,Medina County,0,14,-14
40,Oklahoma,39,Ohio,105,Meigs County,7,0,7
40,Oklahoma,39,Ohio,109,Miami County,21,2,19
40,Oklahoma,39,Ohio,113,Montgomery County,46,153,-107
40,Oklahoma,39,Ohio,129,Pickaway County,5,0,5
40,Oklahoma,39,Ohio,131,Pike County,5,4,1
40,Oklahoma,39,Ohio,133,Portage County,9,8,1
40,Oklahoma,39,Ohio,135,Preble County,78,0,78
40,Oklahoma,39,Ohio,143,Sandusky County,10,0,10
40,Oklahoma,39,Ohio,145,Scioto County,20,0,20
40,Oklahoma,39,Ohio,147,Seneca County,17,0,17
40,Oklahoma,39,Ohio,151,Stark County,195,35,160
40,Oklahoma,39,Ohio,153,Summit County,25,40,-15
40,Oklahoma,39,Ohio,155,Trumbull County,58,11,47
40,Oklahoma,39,Ohio,157,Tuscarawas County,0,69,-69
40,Oklahoma,39,Ohio,161,Van Wert County,0,8,-8
40,Oklahoma,39,Ohio,165,Warren County,10,10,0
40,Oklahoma,39,Ohio,169,Wayne County,25,0,25
40,Oklahoma,39,Ohio,173,Wood County,21,0,21
40,Oklahoma,4,Arizona,1,Apache County,57,17,40
40,Oklahoma,4,Arizona,3,Cochise County,152,8,144
40,Oklahoma,4,Arizona,5,Coconino County,56,57,-1
40,Oklahoma,4,Arizona,7,Gila County,10,0,10
40,Oklahoma,4,Arizona,9,Graham County,37,11,26
40,Oklahoma,4,Arizona,11,Greenlee County,0,19,-19
40,Oklahoma,4,Arizona,12,La Paz County,124,0,124
40,Oklahoma,4,Arizona,13,Maricopa County,1397,1465,-68
40,Oklahoma,4,Arizona,15,Mohave County,130,72,58
40,Oklahoma,4,Arizona,17,Navajo County,60,209,-149
40,Oklahoma,4,Arizona,19,Pima County,490,509,-19
40,Oklahoma,4,Arizona,21,Pinal County,162,812,-650
40,Oklahoma,4,Arizona,25,Yavapai County,46,799,-753
40,Oklahoma,4,Arizona,27,Yuma County,40,280,-240
40,Oklahoma,40,Oklahoma,1,Adair County,1171,340,831
40,Oklahoma,40,Oklahoma,3,Alfalfa County,406,386,20
40,Oklahoma,40,Oklahoma,5,Atoka County,1037,1163,-126
40,Oklahoma,40,Oklahoma,7,Beaver County,189,137,52
40,Oklahoma,40,Oklahoma,9,Beckham County,1576,1397,179
40,Oklahoma,40,Oklahoma,11,Blaine County,943,468,475
40,Oklahoma,40,Oklahoma,13,Bryan County,1161,888,273
40,Oklahoma,40,Oklahoma,15,Caddo County,1490,1201,289
40,Oklahoma,40,Oklahoma,17,Canadian County,5613,7041,-1428
40,Oklahoma,40,Oklahoma,19,Carter County,1681,1241,440
40,Oklahoma,40,Oklahoma,21,Cherokee County,1842,2245,-403
40,Oklahoma,40,Oklahoma,23,Choctaw County,527,431,96
40,Oklahoma,40,Oklahoma,25,Cimarron County,63,46,17
40,Oklahoma,40,Oklahoma,27,Cleveland County,13807,18472,-4665
40,Oklahoma,40,Oklahoma,29,Coal County,311,209,102
40,Oklahoma,40,Oklahoma,31,Comanche County,4057,4367,-310
40,Oklahoma,40,Oklahoma,33,Cotton County,342,275,67
40,Oklahoma,40,Oklahoma,35,Craig County,699,1149,-450
40,Oklahoma,40,Oklahoma,37,Creek County,3441,2218,1223
40,Oklahoma,40,Oklahoma,39,Custer County,1776,1885,-109
40,Oklahoma,40,Oklahoma,41,Delaware County,1439,1187,252
40,Oklahoma,40,Oklahoma,43,Dewey County,531,347,184
40,Oklahoma,40,Oklahoma,45,Ellis County,159,276,-117
40,Oklahoma,40,Oklahoma,47,Garfield County,2097,1934,163
40,Oklahoma,40,Oklahoma,49,Garvin County,1140,607,533
40,Oklahoma,40,Oklahoma,51,Grady County,2822,2240,582
40,Oklahoma,40,Oklahoma,53,Grant County,329,158,171
40,Oklahoma,40,Oklahoma,55,Greer County,808,718,90
40,Oklahoma,40,Oklahoma,57,Harmon County,120,89,31
40,Oklahoma,40,Oklahoma,59,Harper County,138,228,-90
40,Oklahoma,40,Oklahoma,61,Haskell County,633,461,172
40,Oklahoma,40,Oklahoma,63,Hughes County,1184,769,415
40,Oklahoma,40,Oklahoma,65,Jackson County,1150,933,217
40,Oklahoma,40,Oklahoma,67,Jefferson County,328,453,-125
40,Oklahoma,40,Oklahoma,69,Johnston County,563,417,146
40,Oklahoma,40,Oklahoma,71,Kay County,1564,1859,-295
40,Oklahoma,40,Oklahoma,73,Kingfisher County,464,269,195
40,Oklahoma,40,Oklahoma,75,Kiowa County,429,494,-65
40,Oklahoma,40,Oklahoma,77,Latimer County,432,477,-45
40,Oklahoma,40,Oklahoma,79,Le Flore County,1663,1141,522
40,Oklahoma,40,Oklahoma,81,Lincoln County,1358,1266,92
40,Oklahoma,40,Oklahoma,83,Logan County,2646,2757,-111
40,Oklahoma,40,Oklahoma,85,Love County,281,248,33
40,Oklahoma,40,Oklahoma,87,McClain County,2002,3381,-1379
40,Oklahoma,40,Oklahoma,89,McCurtain County,1126,461,665
40,Oklahoma,40,Oklahoma,91,McIntosh County,1089,565,524
40,Oklahoma,40,Oklahoma,93,Major County,417,323,94
40,Oklahoma,40,Oklahoma,95,Marshall County,853,668,185
40,Oklahoma,40,Oklahoma,97,Mayes County,1891,1216,675
40,Oklahoma,40,Oklahoma,99,Murray County,601,550,51
40,Oklahoma,40,Oklahoma,101,Muskogee County,3224,4224,-1000
40,Oklahoma,40,Oklahoma,103,Noble County,693,591,102
40,Oklahoma,40,Oklahoma,105,Nowata County,589,431,158
40,Oklahoma,40,Oklahoma,107,Okfuskee County,790,444,346
40,Oklahoma,40,Oklahoma,109,Oklahoma County,27399,25885,1514
40,Oklahoma,40,Oklahoma,111,Okmulgee County,2441,2124,317
40,Oklahoma,40,Oklahoma,113,Osage County,3144,2851,293
40,Oklahoma,40,Oklahoma,115,Ottawa County,1786,1085,701
40,Oklahoma,40,Oklahoma,117,Pawnee County,1020,776,244
40,Oklahoma,40,Oklahoma,119,Payne County,4365,7175,-2810
40,Oklahoma,40,Oklahoma,121,Pittsburg County,1654,2477,-823
40,Oklahoma,40,Oklahoma,123,Pontotoc County,1436,1663,-227
40,Oklahoma,40,Oklahoma,125,Pottawatomie County,3131,3995,-864
40,Oklahoma,40,Oklahoma,127,Pushmataha County,585,392,193
40,Oklahoma,40,Oklahoma,129,Roger Mills County,112,103,9
40,Oklahoma,40,Oklahoma,131,Rogers County,5587,4663,924
40,Oklahoma,40,Oklahoma,133,Seminole County,1292,1389,-97
40,Oklahoma,40,Oklahoma,135,Sequoyah County,1120,1159,-39
40,Oklahoma,40,Oklahoma,137,Stephens County,2222,1729,493
40,Oklahoma,40,Oklahoma,139,Texas County,617,240,377
40,Oklahoma,40,Oklahoma,141,Tillman County,434,385,49
40,Oklahoma,40,Oklahoma,143,Tulsa County,18895,19038,-143
40,Oklahoma,40,Oklahoma,145,Wagoner County,4975,5387,-412
40,Oklahoma,40,Oklahoma,147,Washington County,1623,2035,-412
40,Oklahoma,40,Oklahoma,149,Washita County,760,435,325
40,Oklahoma,40,Oklahoma,151,Woods County,834,774,60
40,Oklahoma,40,Oklahoma,153,Woodward County,1300,916,384
40,Oklahoma,41,Oregon,3,Benton County,0,3,-3
40,Oklahoma,41,Oregon,5,Clackamas County,39,0,39
40,Oklahoma,41,Oregon,7,Clatsop County,25,0,25
40,Oklahoma,41,Oregon,9,Columbia County,11,53,-42
40,Oklahoma,41,Oregon,13,Crook County,3,0,3
40,Oklahoma,41,Oregon,15,Curry County,5,0,5
40,Oklahoma,41,Oregon,17,Deschutes County,9,58,-49
40,Oklahoma,41,Oregon,29,Jackson County,27,229,-202
40,Oklahoma,41,Oregon,31,Jefferson County,6,25,-19
40,Oklahoma,41,Oregon,33,Josephine County,0,78,-78
40,Oklahoma,41,Oregon,35,Klamath County,0,38,-38
40,Oklahoma,41,Oregon,39,Lane County,55,34,21
40,Oklahoma,41,Oregon,41,Lincoln County,0,16,-16
40,Oklahoma,41,Oregon,43,Linn County,86,55,31
40,Oklahoma,41,Oregon,45,Malheur County,0,27,-27
40,Oklahoma,41,Oregon,47,Marion County,9,0,9
40,Oklahoma,41,Oregon,51,Multnomah County,145,363,-218
40,Oklahoma,41,Oregon,57,Tillamook County,0,34,-34
40,Oklahoma,41,Oregon,59,Umatilla County,0,94,-94
40,Oklahoma,41,Oregon,61,Union County,0,59,-59
40,Oklahoma,41,Oregon,65,Wasco County,0,8,-8
40,Oklahoma,41,Oregon,67,Washington County,82,118,-36
40,Oklahoma,41,Oregon,71,Yamhill County,0,107,-107
40,Oklahoma,42,Pennsylvania,1,Adams County,0,21,-21
40,Oklahoma,42,Pennsylvania,3,Allegheny County,274,89,185
40,Oklahoma,42,Pennsylvania,7,Beaver County,38,0,38
40,Oklahoma,42,Pennsylvania,11,Berks County,6,10,-4
40,Oklahoma,42,Pennsylvania,13,Blair County,8,0,8
40,Oklahoma,42,Pennsylvania,15,Bradford County,0,7,-7
40,Oklahoma,42,Pennsylvania,17,Bucks County,22,0,22
40,Oklahoma,42,Pennsylvania,19,Butler County,109,1,108
40,Oklahoma,42,Pennsylvania,21,Cambria County,13,39,-26
40,Oklahoma,42,Pennsylvania,27,Centre County,48,110,-62
40,Oklahoma,42,Pennsylvania,29,Chester County,32,131,-99
40,Oklahoma,42,Pennsylvania,31,Clarion County,11,0,11
40,Oklahoma,42,Pennsylvania,33,Clearfield County,0,20,-20
40,Oklahoma,42,Pennsylvania,41,Cumberland County,30,12,18
40,Oklahoma,42,Pennsylvania,43,Dauphin County,19,0,19
40,Oklahoma,42,Pennsylvania,45,Delaware County,9,52,-43
40,Oklahoma,42,Pennsylvania,49,Erie County,4,28,-24
40,Oklahoma,42,Pennsylvania,53,Forest County,14,0,14
40,Oklahoma,42,Pennsylvania,65,Jefferson County,19,7,12
40,Oklahoma,42,Pennsylvania,69,Lackawanna County,26,0,26
40,Oklahoma,42,Pennsylvania,71,Lancaster County,45,189,-144
40,Oklahoma,42,Pennsylvania,73,Lawrence County,30,53,-23
40,Oklahoma,42,Pennsylvania,75,Lebanon County,29,14,15
40,Oklahoma,42,Pennsylvania,77,Lehigh County,71,38,33
40,Oklahoma,42,Pennsylvania,79,Luzerne County,31,0,31
40,Oklahoma,42,Pennsylvania,81,Lycoming County,4,0,4
40,Oklahoma,42,Pennsylvania,83,McKean County,0,4,-4
40,Oklahoma,42,Pennsylvania,85,Mercer County,0,35,-35
40,Oklahoma,42,Pennsylvania,87,Mifflin County,0,5,-5
40,Oklahoma,42,Pennsylvania,89,Monroe County,59,10,49
40,Oklahoma,42,Pennsylvania,91,Montgomery County,34,20,14
40,Oklahoma,42,Pennsylvania,95,Northampton County,27,0,27
40,Oklahoma,42,Pennsylvania,97,Northumberland County,0,20,-20
40,Oklahoma,42,Pennsylvania,101,Philadelphia County,157,92,65
40,Oklahoma,42,Pennsylvania,111,Somerset County,0,24,-24
40,Oklahoma,42,Pennsylvania,121,Venango County,28,0,28
40,Oklahoma,42,Pennsylvania,125,Washington County,42,0,42
40,Oklahoma,42,Pennsylvania,131,Wyoming County,0,62,-62
40,Oklahoma,42,Pennsylvania,133,York County,53,17,36
40,Oklahoma,44,Rhode Island,3,Kent County,11,0,11
40,Oklahoma,44,Rhode Island,5,Newport County,0,14,-14
40,Oklahoma,44,Rhode Island,7,Providence County,199,0,199
40,Oklahoma,44,Rhode Island,9,Washington County,15,0,15
40,Oklahoma,45,South Carolina,3,Aiken County,26,0,26
40,Oklahoma,45,South Carolina,7,Anderson County,10,33,-23
40,Oklahoma,45,South Carolina,13,Beaufort County,125,336,-211
40,Oklahoma,45,South Carolina,15,Berkeley County,77,65,12
40,Oklahoma,45,South Carolina,19,Charleston County,87,222,-135
40,Oklahoma,45,South Carolina,25,Chesterfield County,27,0,27
40,Oklahoma,45,South Carolina,35,Dorchester County,173,0,173
40,Oklahoma,45,South Carolina,39,Fairfield County,10,0,10
40,Oklahoma,45,South Carolina,41,Florence County,10,0,10
40,Oklahoma,45,South Carolina,43,Georgetown County,16,0,16
40,Oklahoma,45,South Carolina,45,Greenville County,82,33,49
40,Oklahoma,45,South Carolina,49,Hampton County,9,0,9
40,Oklahoma,45,South Carolina,51,Horry County,10,44,-34
40,Oklahoma,45,South Carolina,57,Lancaster County,19,0,19
40,Oklahoma,45,South Carolina,63,Lexington County,82,32,50
40,Oklahoma,45,South Carolina,73,Oconee County,0,14,-14
40,Oklahoma,45,South Carolina,75,Orangeburg County,0,18,-18
40,Oklahoma,45,South Carolina,77,Pickens County,44,0,44
40,Oklahoma,45,South Carolina,79,Richland County,161,252,-91
40,Oklahoma,45,South Carolina,81,Saluda County,0,15,-15
40,Oklahoma,45,South Carolina,83,Spartanburg County,0,29,-29
40,Oklahoma,45,South Carolina,85,Sumter County,42,35,7
40,Oklahoma,45,South Carolina,91,York County,8,18,-10
40,Oklahoma,46,South Dakota,11,Brookings County,22,0,22
40,Oklahoma,46,South Dakota,13,Brown County,7,0,7
40,Oklahoma,46,South Dakota,19,Butte County,0,4,-4
40,Oklahoma,46,South Dakota,27,Clay County,73,0,73
40,Oklahoma,46,South Dakota,35,Davison County,6,0,6
40,Oklahoma,46,South Dakota,47,Fall River County,0,7,-7
40,Oklahoma,46,South Dakota,59,Hand County,0,13,-13
40,Oklahoma,46,South Dakota,61,Hanson County,0,21,-21
40,Oklahoma,46,South Dakota,79,Lake County,2,62,-60
40,Oklahoma,46,South Dakota,91,Marshall County,0,9,-9
40,Oklahoma,46,South Dakota,99,Minnehaha County,65,74,-9
40,Oklahoma,46,South Dakota,103,Pennington County,55,4,51
40,Oklahoma,46,South Dakota,125,Turner County,0,5,-5
40,Oklahoma,46,South Dakota,135,Yankton County,2,68,-66
40,Oklahoma,47,Tennessee,3,Bedford County,22,0,22
40,Oklahoma,47,Tennessee,9,Blount County,25,55,-30
40,Oklahoma,47,Tennessee,11,Bradley County,0,63,-63
40,Oklahoma,47,Tennessee,13,Campbell County,0,12,-12
40,Oklahoma,47,Tennessee,19,Carter County,0,179,-179
40,Oklahoma,47,Tennessee,23,Chester County,12,0,12
40,Oklahoma,47,Tennessee,31,Coffee County,52,0,52
40,Oklahoma,47,Tennessee,37,Davidson County,187,143,44
40,Oklahoma,47,Tennessee,43,Dickson County,0,59,-59
40,Oklahoma,47,Tennessee,47,Fayette County,21,0,21
40,Oklahoma,47,Tennessee,51,Franklin County,7,0,7
40,Oklahoma,47,Tennessee,53,Gibson County,0,27,-27
40,Oklahoma,47,Tennessee,55,Giles County,16,0,16
40,Oklahoma,47,Tennessee,65,Hamilton County,74,70,4
40,Oklahoma,47,Tennessee,73,Hawkins County,0,20,-20
40,Oklahoma,47,Tennessee,79,Henry County,0,7,-7
40,Oklahoma,47,Tennessee,85,Humphreys County,3,0,3
40,Oklahoma,47,Tennessee,93,Knox County,28,129,-101
40,Oklahoma,47,Tennessee,99,Lawrence County,5,0,5
40,Oklahoma,47,Tennessee,107,McMinn County,16,7,9
40,Oklahoma,47,Tennessee,113,Madison County,38,8,30
40,Oklahoma,47,Tennessee,115,Marion County,0,3,-3
40,Oklahoma,47,Tennessee,117,Marshall County,0,20,-20
40,Oklahoma,47,Tennessee,119,Maury County,16,65,-49
40,Oklahoma,47,Tennessee,123,Monroe County,0,89,-89
40,Oklahoma,47,Tennessee,125,Montgomery County,391,385,6
40,Oklahoma,47,Tennessee,131,Obion County,10,0,10
40,Oklahoma,47,Tennessee,141,Putnam County,44,10,34
40,Oklahoma,47,Tennessee,147,Robertson County,0,36,-36
40,Oklahoma,47,Tennessee,149,Rutherford County,74,0,74
40,Oklahoma,47,Tennessee,151,Scott County,8,0,8
40,Oklahoma,47,Tennessee,155,Sevier County,87,0,87
40,Oklahoma,47,Tennessee,157,Shelby County,305,206,99
40,Oklahoma,47,Tennessee,159,Smith County,27,0,27
40,Oklahoma,47,Tennessee,161,Stewart County,16,0,16
40,Oklahoma,47,Tennessee,163,Sullivan County,26,2,24
40,Oklahoma,47,Tennessee,165,Sumner County,9,109,-100
40,Oklahoma,47,Tennessee,167,Tipton County,0,20,-20
40,Oklahoma,47,Tennessee,169,Trousdale County,0,71,-71
40,Oklahoma,47,Tennessee,175,Van Buren County,4,0,4
40,Oklahoma,47,Tennessee,179,Washington County,28,0,28
40,Oklahoma,47,Tennessee,187,Williamson County,7,0,7
40,Oklahoma,47,Tennessee,189,Wilson County,101,168,-67
40,Oklahoma,48,Texas,1,Anderson County,95,16,79
40,Oklahoma,48,Texas,3,Andrews County,32,0,32
40,Oklahoma,48,Texas,5,Angelina County,91,86,5
40,Oklahoma,48,Texas,7,Aransas County,51,0,51
40,Oklahoma,48,Texas,9,Archer County,25,0,25
40,Oklahoma,48,Texas,13,Atascosa County,12,348,-336
40,Oklahoma,48,Texas,15,Austin County,5,1,4
40,Oklahoma,48,Texas,19,Bandera County,0,17,-17
40,Oklahoma,48,Texas,21,Bastrop County,14,16,-2
40,Oklahoma,48,Texas,23,Baylor County,33,0,33
40,Oklahoma,48,Texas,25,Bee County,0,3,-3
40,Oklahoma,48,Texas,27,Bell County,525,475,50
40,Oklahoma,48,Texas,29,Bexar County,1180,909,271
40,Oklahoma,48,Texas,31,Blanco County,9,0,9
40,Oklahoma,48,Texas,37,Bowie County,82,172,-90
40,Oklahoma,48,Texas,39,Brazoria County,260,245,15
40,Oklahoma,48,Texas,41,Brazos County,316,195,121
40,Oklahoma,48,Texas,49,Brown County,41,0,41
40,Oklahoma,48,Texas,51,Burleson County,0,13,-13
40,Oklahoma,48,Texas,53,Burnet County,62,20,42
40,Oklahoma,48,Texas,55,Caldwell County,12,0,12
40,Oklahoma,48,Texas,57,Calhoun County,0,18,-18
40,Oklahoma,48,Texas,59,Callahan County,0,26,-26
40,Oklahoma,48,Texas,61,Cameron County,149,58,91
40,Oklahoma,48,Texas,63,Camp County,9,47,-38
40,Oklahoma,48,Texas,65,Carson County,0,148,-148
40,Oklahoma,48,Texas,67,Cass County,60,0,60
40,Oklahoma,48,Texas,69,Castro County,22,4,18
40,Oklahoma,48,Texas,73,Cherokee County,53,3,50
40,Oklahoma,48,Texas,75,Childress County,84,15,69
40,Oklahoma,48,Texas,77,Clay County,39,54,-15
40,Oklahoma,48,Texas,79,Cochran County,0,14,-14
40,Oklahoma,48,Texas,85,Collin County,1700,1220,480
40,Oklahoma,48,Texas,87,Collingsworth County,11,25,-14
40,Oklahoma,48,Texas,91,Comal County,136,67,69
40,Oklahoma,48,Texas,93,Comanche County,15,0,15
40,Oklahoma,48,Texas,97,Cooke County,158,285,-127
40,Oklahoma,48,Texas,99,Coryell County,199,96,103
40,Oklahoma,48,Texas,101,Cottle County,2,6,-4
40,Oklahoma,48,Texas,103,Crane County,26,0,26
40,Oklahoma,48,Texas,107,Crosby County,0,7,-7
40,Oklahoma,48,Texas,111,Dallam County,0,42,-42
40,Oklahoma,48,Texas,113,Dallas County,2910,2582,328
40,Oklahoma,48,Texas,117,Deaf Smith County,13,161,-148
40,Oklahoma,48,Texas,119,Delta County,0,11,-11
40,Oklahoma,48,Texas,121,Denton County,1876,1560,316
40,Oklahoma,48,Texas,123,DeWitt County,30,13,17
40,Oklahoma,48,Texas,129,Donley County,2,27,-25
40,Oklahoma,48,Texas,133,Eastland County,0,90,-90
40,Oklahoma,48,Texas,135,Ector County,209,37,172
40,Oklahoma,48,Texas,137,Edwards County,8,1,7
40,Oklahoma,48,Texas,139,Ellis County,208,76,132
40,Oklahoma,48,Texas,141,El Paso County,1181,748,433
40,Oklahoma,48,Texas,143,Erath County,47,27,20
40,Oklahoma,48,Texas,145,Falls County,6,5,1
40,Oklahoma,48,Texas,147,Fannin County,114,96,18
40,Oklahoma,48,Texas,157,Fort Bend County,533,182,351
40,Oklahoma,48,Texas,159,Franklin County,0,14,-14
40,Oklahoma,48,Texas,161,Freestone County,6,9,-3
40,Oklahoma,48,Texas,167,Galveston County,170,376,-206
40,Oklahoma,48,Texas,169,Garza County,3,16,-13
40,Oklahoma,48,Texas,171,Gillespie County,27,0,27
40,Oklahoma,48,Texas,175,Goliad County,0,56,-56
40,Oklahoma,48,Texas,177,Gonzales County,11,0,11
40,Oklahoma,48,Texas,179,Gray County,128,79,49
40,Oklahoma,48,Texas,181,Grayson County,1002,1061,-59
40,Oklahoma,48,Texas,183,Gregg County,176,77,99
40,Oklahoma,48,Texas,187,Guadalupe County,35,79,-44
40,Oklahoma,48,Texas,189,Hale County,13,0,13
40,Oklahoma,48,Texas,191,Hall County,9,59,-50
40,Oklahoma,48,Texas,193,Hamilton County,10,0,10
40,Oklahoma,48,Texas,197,Hardeman County,7,12,-5
40,Oklahoma,48,Texas,199,Hardin County,57,126,-69
40,Oklahoma,48,Texas,201,Harris County,2282,3052,-770
40,Oklahoma,48,Texas,203,Harrison County,5,9,-4
40,Oklahoma,48,Texas,205,Hartley County,16,0,16
40,Oklahoma,48,Texas,207,Haskell County,0,32,-32
40,Oklahoma,48,Texas,209,Hays County,96,114,-18
40,Oklahoma,48,Texas,211,Hemphill County,17,8,9
40,Oklahoma,48,Texas,213,Henderson County,84,214,-130
40,Oklahoma,48,Texas,215,Hidalgo County,197,131,66
40,Oklahoma,48,Texas,217,Hill County,2,19,-17
40,Oklahoma,48,Texas,219,Hockley County,12,3,9
40,Oklahoma,48,Texas,221,Hood County,62,0,62
40,Oklahoma,48,Texas,223,Hopkins County,36,104,-68
40,Oklahoma,48,Texas,225,Houston County,0,1,-1
40,Oklahoma,48,Texas,227,Howard County,71,36,35
40,Oklahoma,48,Texas,229,Hudspeth County,0,11,-11
40,Oklahoma,48,Texas,231,Hunt County,94,131,-37
40,Oklahoma,48,Texas,233,Hutchinson County,18,51,-33
40,Oklahoma,48,Texas,235,Irion County,8,0,8
40,Oklahoma,48,Texas,237,Jack County,12,0,12
40,Oklahoma,48,Texas,239,Jackson County,8,18,-10
40,Oklahoma,48,Texas,241,Jasper County,8,0,8
40,Oklahoma,48,Texas,245,Jefferson County,57,134,-77
40,Oklahoma,48,Texas,249,Jim Wells County,71,0,71
40,Oklahoma,48,Texas,251,Johnson County,225,60,165
40,Oklahoma,48,Texas,253,Jones County,41,10,31
40,Oklahoma,48,Texas,257,Kaufman County,70,195,-125
40,Oklahoma,48,Texas,259,Kendall County,15,0,15
40,Oklahoma,48,Texas,265,Kerr County,85,0,85
40,Oklahoma,48,Texas,267,Kimble County,0,12,-12
40,Oklahoma,48,Texas,269,King County,5,0,5
40,Oklahoma,48,Texas,271,Kinney County,0,91,-91
40,Oklahoma,48,Texas,273,Kleberg County,14,31,-17
40,Oklahoma,48,Texas,277,Lamar County,181,333,-152
40,Oklahoma,48,Texas,281,Lampasas County,18,0,18
40,Oklahoma,48,Texas,287,Lee County,2,0,2
40,Oklahoma,48,Texas,289,Leon County,36,6,30
40,Oklahoma,48,Texas,291,Liberty County,21,65,-44
40,Oklahoma,48,Texas,293,Limestone County,13,3,10
40,Oklahoma,48,Texas,295,Lipscomb County,49,22,27
40,Oklahoma,48,Texas,297,Live Oak County,5,42,-37
40,Oklahoma,48,Texas,299,Llano County,26,0,26
40,Oklahoma,48,Texas,303,Lubbock County,643,340,303
40,Oklahoma,48,Texas,305,Lynn County,0,11,-11
40,Oklahoma,48,Texas,307,McCulloch County,31,0,31
40,Oklahoma,48,Texas,309,McLennan County,223,215,8
40,Oklahoma,48,Texas,311,McMullen County,37,0,37
40,Oklahoma,48,Texas,313,Madison County,3,27,-24
40,Oklahoma,48,Texas,315,Marion County,8,0,8
40,Oklahoma,48,Texas,317,Martin County,48,0,48
40,Oklahoma,48,Texas,321,Matagorda County,0,38,-38
40,Oklahoma,48,Texas,323,Maverick County,33,58,-25
40,Oklahoma,48,Texas,325,Medina County,28,0,28
40,Oklahoma,48,Texas,329,Midland County,120,329,-209
40,Oklahoma,48,Texas,337,Montague County,120,16,104
40,Oklahoma,48,Texas,339,Montgomery County,387,215,172
40,Oklahoma,48,Texas,341,Moore County,89,41,48
40,Oklahoma,48,Texas,347,Nacogdoches County,46,8,38
40,Oklahoma,48,Texas,349,Navarro County,30,107,-77
40,Oklahoma,48,Texas,351,Newton County,36,0,36
40,Oklahoma,48,Texas,353,Nolan County,64,0,64
40,Oklahoma,48,Texas,355,Nueces County,400,429,-29
40,Oklahoma,48,Texas,357,Ochiltree County,34,46,-12
40,Oklahoma,48,Texas,363,Palo Pinto County,96,38,58
40,Oklahoma,48,Texas,365,Panola County,63,0,63
40,Oklahoma,48,Texas,367,Parker County,115,259,-144
40,Oklahoma,48,Texas,369,Parmer County,0,19,-19
40,Oklahoma,48,Texas,371,Pecos County,0,6,-6
40,Oklahoma,48,Texas,373,Polk County,64,0,64
40,Oklahoma,48,Texas,375,Potter County,438,225,213
40,Oklahoma,48,Texas,379,Rains County,45,0,45
40,Oklahoma,48,Texas,381,Randall County,328,290,38
40,Oklahoma,48,Texas,387,Red River County,10,40,-30
40,Oklahoma,48,Texas,389,Reeves County,0,27,-27
40,Oklahoma,48,Texas,395,Robertson County,0,39,-39
40,Oklahoma,48,Texas,397,Rockwall County,80,242,-162
40,Oklahoma,48,Texas,401,Rusk County,46,14,32
40,Oklahoma,48,Texas,403,Sabine County,0,2,-2
40,Oklahoma,48,Texas,407,San Jacinto County,9,0,9
40,Oklahoma,48,Texas,409,San Patricio County,55,61,-6
40,Oklahoma,48,Texas,411,San Saba County,31,9,22
40,Oklahoma,48,Texas,419,Shelby County,4,7,-3
40,Oklahoma,48,Texas,421,Sherman County,15,5,10
40,Oklahoma,48,Texas,423,Smith County,185,127,58
40,Oklahoma,48,Texas,425,Somervell County,4,0,4
40,Oklahoma,48,Texas,429,Stephens County,50,0,50
40,Oklahoma,48,Texas,439,Tarrant County,2978,2707,271
40,Oklahoma,48,Texas,441,Taylor County,223,273,-50
40,Oklahoma,48,Texas,447,Throckmorton County,0,3,-3
40,Oklahoma,48,Texas,449,Titus County,83,8,75
40,Oklahoma,48,Texas,451,Tom Green County,94,225,-131
40,Oklahoma,48,Texas,453,Travis County,505,735,-230
40,Oklahoma,48,Texas,455,Trinity County,0,48,-48
40,Oklahoma,48,Texas,457,Tyler County,23,0,23
40,Oklahoma,48,Texas,459,Upshur County,9,48,-39
40,Oklahoma,48,Texas,463,Uvalde County,7,3,4
40,Oklahoma,48,Texas,465,Val Verde County,113,39,74
40,Oklahoma,48,Texas,467,Van Zandt County,45,84,-39
40,Oklahoma,48,Texas,469,Victoria County,85,6,79
40,Oklahoma,48,Texas,471,Walker County,36,87,-51
40,Oklahoma,48,Texas,473,Waller County,24,32,-8
40,Oklahoma,48,Texas,475,Ward County,48,2,46
40,Oklahoma,48,Texas,477,Washington County,15,0,15
40,Oklahoma,48,Texas,479,Webb County,96,73,23
40,Oklahoma,48,Texas,483,Wheeler County,0,83,-83
40,Oklahoma,48,Texas,485,Wichita County,924,483,441
40,Oklahoma,48,Texas,487,Wilbarger County,103,158,-55
40,Oklahoma,48,Texas,489,Willacy County,15,0,15
40,Oklahoma,48,Texas,491,Williamson County,446,271,175
40,Oklahoma,48,Texas,493,Wilson County,21,13,8
40,Oklahoma,48,Texas,495,Winkler County,28,7,21
40,Oklahoma,48,Texas,497,Wise County,308,75,233
40,Oklahoma,48,Texas,499,Wood County,18,14,4
40,Oklahoma,48,Texas,501,Yoakum County,63,0,63
40,Oklahoma,48,Texas,503,Young County,97,0,97
40,Oklahoma,48,Texas,507,Zavala County,0,191,-191
40,Oklahoma,49,Utah,1,Beaver County,0,12,-12
40,Oklahoma,49,Utah,5,Cache County,0,65,-65
40,Oklahoma,49,Utah,7,Carbon County,0,42,-42
40,Oklahoma,49,Utah,11,Davis County,93,146,-53
40,Oklahoma,49,Utah,17,Garfield County,9,0,9
40,Oklahoma,49,Utah,21,Iron County,33,36,-3
40,Oklahoma,49,Utah,25,Kane County,0,27,-27
40,Oklahoma,49,Utah,29,Morgan County,33,0,33
40,Oklahoma,49,Utah,35,Salt Lake County,159,302,-143
40,Oklahoma,49,Utah,39,Sanpete County,64,0,64
40,Oklahoma,49,Utah,41,Sevier County,0,1,-1
40,Oklahoma,49,Utah,43,Summit County,0,13,-13
40,Oklahoma,49,Utah,45,Tooele County,148,0,148
40,Oklahoma,49,Utah,47,Uintah County,8,0,8
40,Oklahoma,49,Utah,49,Utah County,74,183,-109
40,Oklahoma,49,Utah,51,Wasatch County,0,30,-30
40,Oklahoma,49,Utah,53,Washington County,51,103,-52
40,Oklahoma,49,Utah,57,Weber County,59,58,1
40,Oklahoma,5,Arkansas,1,Arkansas County,0,25,-25
40,Oklahoma,5,Arkansas,3,Ashley County,9,5,4
40,Oklahoma,5,Arkansas,5,Baxter County,26,45,-19
40,Oklahoma,5,Arkansas,7,Benton County,1369,1171,198
40,Oklahoma,5,Arkansas,9,Boone County,25,134,-109
40,Oklahoma,5,Arkansas,11,Bradley County,1,0,1
40,Oklahoma,5,Arkansas,15,Carroll County,9,66,-57
40,Oklahoma,5,Arkansas,17,Chicot County,0,8,-8
40,Oklahoma,5,Arkansas,19,Clark County,4,36,-32
40,Oklahoma,5,Arkansas,21,Clay County,12,4,8
40,Oklahoma,5,Arkansas,23,Cleburne County,0,3,-3
40,Oklahoma,5,Arkansas,27,Columbia County,0,12,-12
40,Oklahoma,5,Arkansas,29,Conway County,83,4,79
40,Oklahoma,5,Arkansas,31,Craighead County,213,37,176
40,Oklahoma,5,Arkansas,33,Crawford County,318,614,-296
40,Oklahoma,5,Arkansas,35,Crittenden County,34,5,29
40,Oklahoma,5,Arkansas,37,Cross County,6,0,6
40,Oklahoma,5,Arkansas,39,Dallas County,2,0,2
40,Oklahoma,5,Arkansas,41,Desha County,0,44,-44
40,Oklahoma,5,Arkansas,43,Drew County,11,2,9
40,Oklahoma,5,Arkansas,45,Faulkner County,461,90,371
40,Oklahoma,5,Arkansas,47,Franklin County,161,54,107
40,Oklahoma,5,Arkansas,51,Garland County,78,120,-42
40,Oklahoma,5,Arkansas,53,Grant County,12,0,12
40,Oklahoma,5,Arkansas,55,Greene County,23,143,-120
40,Oklahoma,5,Arkansas,57,Hempstead County,103,57,46
40,Oklahoma,5,Arkansas,59,Hot Spring County,34,1,33
40,Oklahoma,5,Arkansas,61,Howard County,40,22,18
40,Oklahoma,5,Arkansas,63,Independence County,0,54,-54
40,Oklahoma,5,Arkansas,65,Izard County,5,5,0
40,Oklahoma,5,Arkansas,67,Jackson County,19,141,-122
40,Oklahoma,5,Arkansas,69,Jefferson County,91,10,81
40,Oklahoma,5,Arkansas,71,Johnson County,33,47,-14
40,Oklahoma,5,Arkansas,75,Lawrence County,189,3,186
40,Oklahoma,5,Arkansas,77,Lee County,4,0,4
40,Oklahoma,5,Arkansas,79,Lincoln County,15,103,-88
40,Oklahoma,5,Arkansas,81,Little River County,49,29,20
40,Oklahoma,5,Arkansas,83,Logan County,115,16,99
40,Oklahoma,5,Arkansas,85,Lonoke County,126,44,82
40,Oklahoma,5,Arkansas,87,Madison County,0,4,-4
40,Oklahoma,5,Arkansas,89,Marion County,14,49,-35
40,Oklahoma,5,Arkansas,91,Miller County,138,99,39
40,Oklahoma,5,Arkansas,93,Mississippi County,80,26,54
40,Oklahoma,5,Arkansas,95,Monroe County,0,13,-13
40,Oklahoma,5,Arkansas,97,Montgomery County,6,5,1
40,Oklahoma,5,Arkansas,101,Newton County,6,13,-7
40,Oklahoma,5,Arkansas,103,Ouachita County,138,0,138
40,Oklahoma,5,Arkansas,105,Perry County,0,10,-10
40,Oklahoma,5,Arkansas,109,Pike County,11,0,11
40,Oklahoma,5,Arkansas,111,Poinsett County,0,57,-57
40,Oklahoma,5,Arkansas,113,Polk County,72,30,42
40,Oklahoma,5,Arkansas,115,Pope County,159,98,61
40,Oklahoma,5,Arkansas,117,Prairie County,6,0,6
40,Oklahoma,5,Arkansas,119,Pulaski County,277,418,-141
40,Oklahoma,5,Arkansas,121,Randolph County,7,23,-16
40,Oklahoma,5,Arkansas,123,St. Francis County,0,56,-56
40,Oklahoma,5,Arkansas,125,Saline County,89,186,-97
40,Oklahoma,5,Arkansas,127,Scott County,18,95,-77
40,Oklahoma,5,Arkansas,129,Searcy County,9,4,5
40,Oklahoma,5,Arkansas,131,Sebastian County,1257,946,311
40,Oklahoma,5,Arkansas,133,Sevier County,48,80,-32
40,Oklahoma,5,Arkansas,135,Sharp County,24,17,7
40,Oklahoma,5,Arkansas,137,Stone County,10,24,-14
40,Oklahoma,5,Arkansas,139,Union County,0,180,-180
40,Oklahoma,5,Arkansas,141,Van Buren County,0,8,-8
40,Oklahoma,5,Arkansas,143,Washington County,1113,1463,-350
40,Oklahoma,5,Arkansas,145,White County,249,86,163
40,Oklahoma,5,Arkansas,149,Yell County,0,17,-17
40,Oklahoma,50,Vermont,7,Chittenden County,9,0,9
40,Oklahoma,50,Vermont,15,Lamoille County,0,6,-6
40,Oklahoma,50,Vermont,19,Orleans County,9,3,6
40,Oklahoma,50,Vermont,23,Washington County,49,0,49
40,Oklahoma,50,Vermont,25,Windham County,10,0,10
40,Oklahoma,51,Virginia,3,Albemarle County,13,87,-74
40,Oklahoma,51,Virginia,9,Amherst County,50,0,50
40,Oklahoma,51,Virginia,13,Arlington County,45,74,-29
40,Oklahoma,51,Virginia,15,Augusta County,37,0,37
40,Oklahoma,51,Virginia,23,Botetourt County,27,0,27
40,Oklahoma,51,Virginia,31,Campbell County,0,41,-41
40,Oklahoma,51,Virginia,35,Carroll County,0,4,-4
40,Oklahoma,51,Virginia,41,Chesterfield County,42,38,4
40,Oklahoma,51,Virginia,47,Culpeper County,0,12,-12
40,Oklahoma,51,Virginia,59,Fairfax County,92,391,-299
40,Oklahoma,51,Virginia,61,Fauquier County,0,15,-15
40,Oklahoma,51,Virginia,67,Franklin County,26,42,-16
40,Oklahoma,51,Virginia,69,Frederick County,0,28,-28
40,Oklahoma,51,Virginia,71,Giles County,48,0,48
40,Oklahoma,51,Virginia,73,Gloucester County,11,0,11
40,Oklahoma,51,Virginia,85,Hanover County,0,11,-11
40,Oklahoma,51,Virginia,87,Henrico County,28,11,17
40,Oklahoma,51,Virginia,89,Henry County,15,0,15
40,Oklahoma,51,Virginia,93,Isle of Wight County,26,0,26
40,Oklahoma,51,Virginia,95,James City County,8,14,-6
40,Oklahoma,51,Virginia,99,King George County,24,0,24
40,Oklahoma,51,Virginia,103,Lancaster County,0,6,-6
40,Oklahoma,51,Virginia,105,Lee County,16,0,16
40,Oklahoma,51,Virginia,107,Loudoun County,17,49,-32
40,Oklahoma,51,Virginia,121,Montgomery County,0,260,-260
40,Oklahoma,51,Virginia,127,New Kent County,6,0,6
40,Oklahoma,51,Virginia,141,Patrick County,2,0,2
40,Oklahoma,51,Virginia,143,Pittsylvania County,0,7,-7
40,Oklahoma,51,Virginia,149,Prince George County,141,64,77
40,Oklahoma,51,Virginia,153,Prince William County,114,155,-41
40,Oklahoma,51,Virginia,173,Smyth County,19,0,19
40,Oklahoma,51,Virginia,177,Spotsylvania County,27,13,14
40,Oklahoma,51,Virginia,179,Stafford County,11,72,-61
40,Oklahoma,51,Virginia,185,Tazewell County,10,0,10
40,Oklahoma,51,Virginia,187,Warren County,7,9,-2
40,Oklahoma,51,Virginia,195,Wise County,13,0,13
40,Oklahoma,51,Virginia,199,York County,83,0,83
40,Oklahoma,51,Virginia,510,Alexandria city,34,86,-52
40,Oklahoma,51,Virginia,540,Charlottesville city,41,5,36
40,Oklahoma,51,Virginia,550,Chesapeake city,13,56,-43
40,Oklahoma,51,Virginia,610,Falls Church city,31,0,31
40,Oklahoma,51,Virginia,630,Fredericksburg city,7,0,7
40,Oklahoma,51,Virginia,650,Hampton city,42,37,5
40,Oklahoma,51,Virginia,660,Harrisonburg city,4,40,-36
40,Oklahoma,51,Virginia,678,Lexington city,0,20,-20
40,Oklahoma,51,Virginia,683,Manassas city,8,0,8
40,Oklahoma,51,Virginia,700,Newport News city,88,222,-134
40,Oklahoma,51,Virginia,710,Norfolk city,11,47,-36
40,Oklahoma,51,Virginia,730,Petersburg city,54,0,54
40,Oklahoma,51,Virginia,740,Portsmouth city,18,2,16
40,Oklahoma,51,Virginia,760,Richmond city,26,25,1
40,Oklahoma,51,Virginia,770,Roanoke city,0,20,-20
40,Oklahoma,51,Virginia,810,Virginia Beach city,68,149,-81
40,Oklahoma,53,Washington,5,Benton County,146,55,91
40,Oklahoma,53,Washington,7,Chelan County,55,12,43
40,Oklahoma,53,Washington,9,Clallam County,4,111,-107
40,Oklahoma,53,Washington,11,Clark County,96,153,-57
40,Oklahoma,53,Washington,13,Columbia County,0,6,-6
40,Oklahoma,53,Washington,15,Cowlitz County,14,0,14
40,Oklahoma,53,Washington,25,Grant County,0,144,-144
40,Oklahoma,53,Washington,27,Grays Harbor County,0,3,-3
40,Oklahoma,53,Washington,29,Island County,48,77,-29
40,Oklahoma,53,Washington,31,Jefferson County,26,262,-236
40,Oklahoma,53,Washington,33,King County,343,522,-179
40,Oklahoma,53,Washington,35,Kitsap County,43,82,-39
40,Oklahoma,53,Washington,39,Klickitat County,34,0,34
40,Oklahoma,53,Washington,41,Lewis County,0,8,-8
40,Oklahoma,53,Washington,43,Lincoln County,0,3,-3
40,Oklahoma,53,Washington,45,Mason County,20,0,20
40,Oklahoma,53,Washington,49,Pacific County,4,0,4
40,Oklahoma,53,Washington,53,Pierce County,219,747,-528
40,Oklahoma,53,Washington,57,Skagit County,25,42,-17
40,Oklahoma,53,Washington,59,Skamania County,2,0,2
40,Oklahoma,53,Washington,61,Snohomish County,226,257,-31
40,Oklahoma,53,Washington,63,Spokane County,91,85,6
40,Oklahoma,53,Washington,65,Stevens County,12,0,12
40,Oklahoma,53,Washington,67,Thurston County,297,108,189
40,Oklahoma,53,Washington,71,Walla Walla County,0,46,-46
40,Oklahoma,53,Washington,73,Whatcom County,38,60,-22
40,Oklahoma,53,Washington,75,Whitman County,12,11,1
40,Oklahoma,53,Washington,77,Yakima County,73,28,45
40,Oklahoma,54,West Virginia,1,Barbour County,29,0,29
40,Oklahoma,54,West Virginia,3,Berkeley County,50,0,50
40,Oklahoma,54,West Virginia,11,Cabell County,3,0,3
40,Oklahoma,54,West Virginia,15,Clay County,12,0,12
40,Oklahoma,54,West Virginia,17,Doddridge County,0,7,-7
40,Oklahoma,54,West Virginia,19,Fayette County,62,0,62
40,Oklahoma,54,West Virginia,21,Gilmer County,0,9,-9
40,Oklahoma,54,West Virginia,29,Hancock County,0,32,-32
40,Oklahoma,54,West Virginia,33,Harrison County,0,45,-45
40,Oklahoma,54,West Virginia,41,Lewis County,2,0,2
40,Oklahoma,54,West Virginia,49,Marion County,90,0,90
40,Oklahoma,54,West Virginia,61,Monongalia County,48,26,22
40,Oklahoma,54,West Virginia,75,Pocahontas County,0,13,-13
40,Oklahoma,54,West Virginia,77,Preston County,0,10,-10
40,Oklahoma,54,West Virginia,107,Wood County,0,23,-23
40,Oklahoma,55,Wisconsin,1,Adams County,0,9,-9
40,Oklahoma,55,Wisconsin,5,Barron County,20,0,20
40,Oklahoma,55,Wisconsin,9,Brown County,118,3,115
40,Oklahoma,55,Wisconsin,13,Burnett County,0,5,-5
40,Oklahoma,55,Wisconsin,17,Chippewa County,0,15,-15
40,Oklahoma,55,Wisconsin,25,Dane County,57,243,-186
40,Oklahoma,55,Wisconsin,27,Dodge County,0,40,-40
40,Oklahoma,55,Wisconsin,29,Door County,0,1,-1
40,Oklahoma,55,Wisconsin,31,Douglas County,0,58,-58
40,Oklahoma,55,Wisconsin,39,Fond du Lac County,13,2,11
40,Oklahoma,55,Wisconsin,43,Grant County,9,0,9
40,Oklahoma,55,Wisconsin,45,Green County,34,8,26
40,Oklahoma,55,Wisconsin,49,Iowa County,15,0,15
40,Oklahoma,55,Wisconsin,55,Jefferson County,4,2,2
40,Oklahoma,55,Wisconsin,59,Kenosha County,25,6,19
40,Oklahoma,55,Wisconsin,63,La Crosse County,10,32,-22
40,Oklahoma,55,Wisconsin,67,Langlade County,0,2,-2
40,Oklahoma,55,Wisconsin,69,Lincoln County,0,3,-3
40,Oklahoma,55,Wisconsin,71,Manitowoc County,38,9,29
40,Oklahoma,55,Wisconsin,73,Marathon County,29,43,-14
40,Oklahoma,55,Wisconsin,79,Milwaukee County,207,70,137
40,Oklahoma,55,Wisconsin,81,Monroe County,24,8,16
40,Oklahoma,55,Wisconsin,87,Outagamie County,13,60,-47
40,Oklahoma,55,Wisconsin,89,Ozaukee County,0,29,-29
40,Oklahoma,55,Wisconsin,91,Pepin County,0,6,-6
40,Oklahoma,55,Wisconsin,93,Pierce County,20,18,2
40,Oklahoma,55,Wisconsin,95,Polk County,0,15,-15
40,Oklahoma,55,Wisconsin,97,Portage County,9,2,7
40,Oklahoma,55,Wisconsin,101,Racine County,27,31,-4
40,Oklahoma,55,Wisconsin,105,Rock County,0,53,-53
40,Oklahoma,55,Wisconsin,107,Rusk County,0,15,-15
40,Oklahoma,55,Wisconsin,109,St. Croix County,0,16,-16
40,Oklahoma,55,Wisconsin,111,Sauk County,0,3,-3
40,Oklahoma,55,Wisconsin,115,Shawano County,0,8,-8
40,Oklahoma,55,Wisconsin,117,Sheboygan County,46,8,38
40,Oklahoma,55,Wisconsin,119,Taylor County,0,5,-5
40,Oklahoma,55,Wisconsin,127,Walworth County,0,18,-18
40,Oklahoma,55,Wisconsin,129,Washburn County,22,5,17
40,Oklahoma,55,Wisconsin,131,Washington County,16,103,-87
40,Oklahoma,55,Wisconsin,133,Waukesha County,58,0,58
40,Oklahoma,55,Wisconsin,135,Waupaca County,9,5,4
40,Oklahoma,55,Wisconsin,139,Winnebago County,78,31,47
40,Oklahoma,56,Wyoming,1,Albany County,30,0,30
40,Oklahoma,56,Wyoming,5,Campbell County,39,24,15
40,Oklahoma,56,Wyoming,7,Carbon County,0,7,-7
40,Oklahoma,56,Wyoming,9,Converse County,9,0,9
40,Oklahoma,56,Wyoming,13,Fremont County,25,32,-7
40,Oklahoma,56,Wyoming,21,Laramie County,132,67,65
40,Oklahoma,56,Wyoming,23,Lincoln County,36,25,11
40,Oklahoma,56,Wyoming,25,Natrona County,71,0,71
40,Oklahoma,56,Wyoming,27,Niobrara County,0,3,-3
40,Oklahoma,56,Wyoming,29,Park County,20,0,20
40,Oklahoma,56,Wyoming,31,Platte County,8,110,-102
40,Oklahoma,56,Wyoming,33,Sheridan County,11,0,11
40,Oklahoma,56,Wyoming,37,Sweetwater County,10,0,10
40,Oklahoma,56,Wyoming,39,Teton County,0,8,-8
40,Oklahoma,56,Wyoming,41,Uinta County,0,5,-5
40,Oklahoma,6,California,1,Alameda County,218,90,128
40,Oklahoma,6,California,5,Amador County,3,4,-1
40,Oklahoma,6,California,7,Butte County,24,19,5
40,Oklahoma,6,California,9,Calaveras County,0,24,-24
40,Oklahoma,6,California,11,Colusa County,4,0,4
40,Oklahoma,6,California,13,Contra Costa County,513,230,283
40,Oklahoma,6,California,15,Del Norte County,0,2,-2
40,Oklahoma,6,California,17,El Dorado County,10,0,10
40,Oklahoma,6,California,19,Fresno County,138,58,80
40,Oklahoma,6,California,21,Glenn County,29,0,29
40,Oklahoma,6,California,23,Humboldt County,22,15,7
40,Oklahoma,6,California,25,Imperial County,59,35,24
40,Oklahoma,6,California,29,Kern County,343,213,130
40,Oklahoma,6,California,31,Kings County,45,58,-13
40,Oklahoma,6,California,33,Lake County,83,0,83
40,Oklahoma,6,California,35,Lassen County,48,49,-1
40,Oklahoma,6,California,37,Los Angeles County,1689,1269,420
40,Oklahoma,6,California,39,Madera County,25,9,16
40,Oklahoma,6,California,41,Marin County,21,25,-4
40,Oklahoma,6,California,43,Mariposa County,7,0,7
40,Oklahoma,6,California,45,Mendocino County,7,48,-41
40,Oklahoma,6,California,47,Merced County,58,0,58
40,Oklahoma,6,California,49,Modoc County,0,3,-3
40,Oklahoma,6,California,53,Monterey County,343,29,314
40,Oklahoma,6,California,55,Napa County,6,0,6
40,Oklahoma,6,California,57,Nevada County,31,4,27
40,Oklahoma,6,California,59,Orange County,603,395,208
40,Oklahoma,6,California,61,Placer County,50,27,23
40,Oklahoma,6,California,63,Plumas County,0,22,-22
40,Oklahoma,6,California,65,Riverside County,594,330,264
40,Oklahoma,6,California,67,Sacramento County,276,108,168
40,Oklahoma,6,California,69,San Benito County,79,0,79
40,Oklahoma,6,California,71,San Bernardino County,427,1005,-578
40,Oklahoma,6,California,73,San Diego County,1099,573,526
40,Oklahoma,6,California,75,San Francisco County,24,57,-33
40,Oklahoma,6,California,77,San Joaquin County,159,196,-37
40,Oklahoma,6,California,79,San Luis Obispo County,186,6,180
40,Oklahoma,6,California,81,San Mateo County,31,0,31
40,Oklahoma,6,California,83,Santa Barbara County,81,86,-5
40,Oklahoma,6,California,85,Santa Clara County,72,207,-135
40,Oklahoma,6,California,87,Santa Cruz County,58,5,53
40,Oklahoma,6,California,89,Shasta County,139,127,12
40,Oklahoma,6,California,93,Siskiyou County,0,13,-13
40,Oklahoma,6,California,95,Solano County,34,91,-57
40,Oklahoma,6,California,97,Sonoma County,24,23,1
40,Oklahoma,6,California,99,Stanislaus County,196,36,160
40,Oklahoma,6,California,101,Sutter County,0,8,-8
40,Oklahoma,6,California,103,Tehama County,12,84,-72
40,Oklahoma,6,California,107,Tulare County,155,32,123
40,Oklahoma,6,California,109,Tuolumne County,7,20,-13
40,Oklahoma,6,California,111,Ventura County,220,48,172
40,Oklahoma,6,California,113,Yolo County,71,13,58
40,Oklahoma,6,California,115,Yuba County,25,8,17
40,Oklahoma,72,Puerto Rico,3,Aguada Municipio,18,0,18
40,Oklahoma,72,Puerto Rico,5,Aguadilla Municipio,0,5,-5
40,Oklahoma,72,Puerto Rico,11,Añasco Municipio,0,5,-5
40,Oklahoma,72,Puerto Rico,13,Arecibo Municipio,6,0,6
40,Oklahoma,72,Puerto Rico,21,Bayamón Municipio,25,49,-24
40,Oklahoma,72,Puerto Rico,37,Ceiba Municipio,0,15,-15
40,Oklahoma,72,Puerto Rico,39,Ciales Municipio,0,22,-22
40,Oklahoma,72,Puerto Rico,43,Coamo Municipio,11,0,11
40,Oklahoma,72,Puerto Rico,69,Humacao Municipio,17,0,17
40,Oklahoma,72,Puerto Rico,97,Mayagüez Municipio,5,0,5
40,Oklahoma,72,Puerto Rico,103,Naguabo Municipio,12,0,12
40,Oklahoma,72,Puerto Rico,105,Naranjito Municipio,60,0,60
40,Oklahoma,72,Puerto Rico,113,Ponce Municipio,9,15,-6
40,Oklahoma,72,Puerto Rico,121,Sabana Grande Municipio,22,0,22
40,Oklahoma,72,Puerto Rico,127,San Juan Municipio,136,0,136
40,Oklahoma,72,Puerto Rico,137,Toa Baja Municipio,7,0,7
40,Oklahoma,72,Puerto Rico,139,Trujillo Alto Municipio,4,0,4
40,Oklahoma,72,Puerto Rico,147,Vieques Municipio,35,0,35
40,Oklahoma,8,Colorado,1,Adams County,169,96,73
40,Oklahoma,8,Colorado,3,Alamosa County,42,104,-62
40,Oklahoma,8,Colorado,5,Arapahoe County,596,544,52
40,Oklahoma,8,Colorado,7,Archuleta County,55,35,20
40,Oklahoma,8,Colorado,9,Baca County,18,13,5
40,Oklahoma,8,Colorado,11,Bent County,19,0,19
40,Oklahoma,8,Colorado,13,Boulder County,81,297,-216
40,Oklahoma,8,Colorado,14,Broomfield County,11,49,-38
40,Oklahoma,8,Colorado,15,Chaffee County,67,0,67
40,Oklahoma,8,Colorado,21,Conejos County,0,2,-2
40,Oklahoma,8,Colorado,23,Costilla County,1,0,1
40,Oklahoma,8,Colorado,27,Custer County,60,0,60
40,Oklahoma,8,Colorado,29,Delta County,0,163,-163
40,Oklahoma,8,Colorado,31,Denver County,213,145,68
40,Oklahoma,8,Colorado,35,Douglas County,271,412,-141
40,Oklahoma,8,Colorado,37,Eagle County,30,13,17
40,Oklahoma,8,Colorado,39,Elbert County,4,12,-8
40,Oklahoma,8,Colorado,41,El Paso County,787,979,-192
40,Oklahoma,8,Colorado,43,Fremont County,15,14,1
40,Oklahoma,8,Colorado,45,Garfield County,0,65,-65
40,Oklahoma,8,Colorado,51,Gunnison County,48,41,7
40,Oklahoma,8,Colorado,59,Jefferson County,273,289,-16
40,Oklahoma,8,Colorado,61,Kiowa County,5,2,3
40,Oklahoma,8,Colorado,63,Kit Carson County,31,0,31
40,Oklahoma,8,Colorado,65,Lake County,0,7,-7
40,Oklahoma,8,Colorado,67,La Plata County,19,78,-59
40,Oklahoma,8,Colorado,69,Larimer County,185,389,-204
40,Oklahoma,8,Colorado,71,Las Animas County,18,6,12
40,Oklahoma,8,Colorado,73,Lincoln County,15,1,14
40,Oklahoma,8,Colorado,75,Logan County,3,0,3
40,Oklahoma,8,Colorado,77,Mesa County,212,211,1
40,Oklahoma,8,Colorado,81,Moffat County,11,0,11
40,Oklahoma,8,Colorado,83,Montezuma County,48,234,-186
40,Oklahoma,8,Colorado,85,Montrose County,120,0,120
40,Oklahoma,8,Colorado,87,Morgan County,20,42,-22
40,Oklahoma,8,Colorado,89,Otero County,76,0,76
40,Oklahoma,8,Colorado,91,Ouray County,0,13,-13
40,Oklahoma,8,Colorado,93,Park County,0,59,-59
40,Oklahoma,8,Colorado,97,Pitkin County,0,85,-85
40,Oklahoma,8,Colorado,99,Prowers County,9,157,-148
40,Oklahoma,8,Colorado,101,Pueblo County,171,124,47
40,Oklahoma,8,Colorado,103,Rio Blanco County,0,8,-8
40,Oklahoma,8,Colorado,107,Routt County,0,19,-19
40,Oklahoma,8,Colorado,109,Saguache County,0,3,-3
40,Oklahoma,8,Colorado,113,San Miguel County,0,4,-4
40,Oklahoma,8,Colorado,115,Sedgwick County,0,37,-37
40,Oklahoma,8,Colorado,117,Summit County,0,9,-9
40,Oklahoma,8,Colorado,119,Teller County,13,36,-23
40,Oklahoma,8,Colorado,121,Washington County,0,40,-40
40,Oklahoma,8,Colorado,123,Weld County,285,413,-128
40,Oklahoma,8,Colorado,125,Yuma County,0,22,-22
40,Oklahoma,9,Connecticut,1,Fairfield County,87,0,87
40,Oklahoma,9,Connecticut,3,Hartford County,39,76,-37
40,Oklahoma,9,Connecticut,7,Middlesex County,0,31,-31
40,Oklahoma,9,Connecticut,9,New Haven County,88,32,56
40,Oklahoma,9,Connecticut,11,New London County,7,27,-20
40,Oklahoma,9,Connecticut,13,Tolland County,0,27,-27
40,Oklahoma,9,Connecticut,15,Windham County,6,0,6
40,Oklahoma,AFR,Africa,,-,707,0,0
40,Oklahoma,ASI,Asia,,-,7223,0,0
40,Oklahoma,CAM,Central America,,-,3577,0,0
40,Oklahoma,CAR,Caribbean,,-,230,0,0
40,Oklahoma,EUR,Europe,,-,2381,0,0
40,Oklahoma,ISL,U.S. Island Areas,,-,426,0,0
40,Oklahoma,NAM,Northern America,,-,308,0,0
40,Oklahoma,OCE,Oceania and At Sea,,-,411,0,0
40,Oklahoma,SAM,South America,,-,862,0,0
41,Oregon,1,Alabama,1,Autauga County,0,12,-12
41,Oregon,1,Alabama,3,Baldwin County,3,12,-9
41,Oregon,1,Alabama,15,Calhoun County,77,0,77
41,Oregon,1,Alabama,31,Coffee County,0,9,-9
41,Oregon,1,Alabama,45,Dale County,10,24,-14
41,Oregon,1,Alabama,57,Fayette County,0,25,-25
41,Oregon,1,Alabama,59,Franklin County,0,10,-10
41,Oregon,1,Alabama,69,Houston County,0,12,-12
41,Oregon,1,Alabama,73,Jefferson County,114,36,78
41,Oregon,1,Alabama,77,Lauderdale County,0,13,-13
41,Oregon,1,Alabama,81,Lee County,0,17,-17
41,Oregon,1,Alabama,83,Limestone County,36,0,36
41,Oregon,1,Alabama,87,Macon County,0,1,-1
41,Oregon,1,Alabama,89,Madison County,21,226,-205
41,Oregon,1,Alabama,95,Marshall County,0,4,-4
41,Oregon,1,Alabama,97,Mobile County,0,19,-19
41,Oregon,1,Alabama,101,Montgomery County,0,9,-9
41,Oregon,1,Alabama,103,Morgan County,0,10,-10
41,Oregon,1,Alabama,117,Shelby County,30,0,30
41,Oregon,1,Alabama,121,Talladega County,0,5,-5
41,Oregon,1,Alabama,127,Walker County,0,3,-3
41,Oregon,1,Alabama,129,Washington County,6,0,6
41,Oregon,10,Delaware,3,New Castle County,159,56,103
41,Oregon,10,Delaware,5,Sussex County,15,2,13
41,Oregon,11,District of Columbia,1,District of Columbia,398,134,264
41,Oregon,12,Florida,1,Alachua County,334,60,274
41,Oregon,12,Florida,5,Bay County,24,0,24
41,Oregon,12,Florida,9,Brevard County,125,72,53
41,Oregon,12,Florida,11,Broward County,110,25,85
41,Oregon,12,Florida,15,Charlotte County,0,13,-13
41,Oregon,12,Florida,17,Citrus County,105,0,105
41,Oregon,12,Florida,19,Clay County,38,0,38
41,Oregon,12,Florida,21,Collier County,0,9,-9
41,Oregon,12,Florida,31,Duval County,236,122,114
41,Oregon,12,Florida,33,Escambia County,0,199,-199
41,Oregon,12,Florida,35,Flagler County,92,0,92
41,Oregon,12,Florida,37,Franklin County,22,0,22
41,Oregon,12,Florida,53,Hernando County,0,13,-13
41,Oregon,12,Florida,57,Hillsborough County,90,145,-55
41,Oregon,12,Florida,61,Indian River County,38,18,20
41,Oregon,12,Florida,63,Jackson County,25,0,25
41,Oregon,12,Florida,69,Lake County,99,0,99
41,Oregon,12,Florida,71,Lee County,178,235,-57
41,Oregon,12,Florida,73,Leon County,7,4,3
41,Oregon,12,Florida,81,Manatee County,90,10,80
41,Oregon,12,Florida,86,Miami-Dade County,199,62,137
41,Oregon,12,Florida,87,Monroe County,10,64,-54
41,Oregon,12,Florida,91,Okaloosa County,76,71,5
41,Oregon,12,Florida,95,Orange County,61,265,-204
41,Oregon,12,Florida,97,Osceola County,18,0,18
41,Oregon,12,Florida,99,Palm Beach County,338,157,181
41,Oregon,12,Florida,101,Pasco County,41,14,27
41,Oregon,12,Florida,103,Pinellas County,116,121,-5
41,Oregon,12,Florida,105,Polk County,61,29,32
41,Oregon,12,Florida,109,St. Johns County,20,51,-31
41,Oregon,12,Florida,111,St. Lucie County,15,62,-47
41,Oregon,12,Florida,113,Santa Rosa County,123,0,123
41,Oregon,12,Florida,115,Sarasota County,74,13,61
41,Oregon,12,Florida,117,Seminole County,148,23,125
41,Oregon,12,Florida,119,Sumter County,0,14,-14
41,Oregon,12,Florida,127,Volusia County,0,158,-158
41,Oregon,12,Florida,131,Walton County,5,0,5
41,Oregon,13,Georgia,21,Bibb County,0,19,-19
41,Oregon,13,Georgia,27,Brooks County,78,0,78
41,Oregon,13,Georgia,47,Catoosa County,7,0,7
41,Oregon,13,Georgia,51,Chatham County,119,154,-35
41,Oregon,13,Georgia,53,Chattahoochee County,41,26,15
41,Oregon,13,Georgia,57,Cherokee County,110,0,110
41,Oregon,13,Georgia,59,Clarke County,0,28,-28
41,Oregon,13,Georgia,67,Cobb County,28,74,-46
41,Oregon,13,Georgia,77,Coweta County,16,49,-33
41,Oregon,13,Georgia,87,Decatur County,0,17,-17
41,Oregon,13,Georgia,89,DeKalb County,60,80,-20
41,Oregon,13,Georgia,95,Dougherty County,0,64,-64
41,Oregon,13,Georgia,117,Forsyth County,65,57,8
41,Oregon,13,Georgia,121,Fulton County,266,169,97
41,Oregon,13,Georgia,127,Glynn County,20,0,20
41,Oregon,13,Georgia,135,Gwinnett County,56,0,56
41,Oregon,13,Georgia,139,Hall County,0,10,-10
41,Oregon,13,Georgia,153,Houston County,50,0,50
41,Oregon,13,Georgia,157,Jackson County,12,11,1
41,Oregon,13,Georgia,163,Jefferson County,0,2,-2
41,Oregon,13,Georgia,179,Liberty County,24,29,-5
41,Oregon,13,Georgia,185,Lowndes County,0,14,-14
41,Oregon,13,Georgia,197,Marion County,0,23,-23
41,Oregon,13,Georgia,215,Muscogee County,7,17,-10
41,Oregon,13,Georgia,217,Newton County,13,0,13
41,Oregon,13,Georgia,219,Oconee County,11,0,11
41,Oregon,13,Georgia,245,Richmond County,13,0,13
41,Oregon,13,Georgia,261,Sumter County,0,39,-39
41,Oregon,13,Georgia,295,Walker County,0,54,-54
41,Oregon,13,Georgia,305,Wayne County,0,12,-12
41,Oregon,13,Georgia,309,Wheeler County,0,10,-10
41,Oregon,15,Hawaii,1,Hawaii County,417,280,137
41,Oregon,15,Hawaii,3,Honolulu County,1724,660,1064
41,Oregon,15,Hawaii,7,Kauai County,180,114,66
41,Oregon,15,Hawaii,9,Maui County,549,180,369
41,Oregon,16,Idaho,1,Ada County,1616,1583,33
41,Oregon,16,Idaho,3,Adams County,24,29,-5
41,Oregon,16,Idaho,5,Bannock County,111,180,-69
41,Oregon,16,Idaho,7,Bear Lake County,0,8,-8
41,Oregon,16,Idaho,9,Benewah County,0,16,-16
41,Oregon,16,Idaho,11,Bingham County,52,140,-88
41,Oregon,16,Idaho,13,Blaine County,0,52,-52
41,Oregon,16,Idaho,15,Boise County,11,6,5
41,Oregon,16,Idaho,17,Bonner County,141,180,-39
41,Oregon,16,Idaho,19,Bonneville County,389,15,374
41,Oregon,16,Idaho,21,Boundary County,67,10,57
41,Oregon,16,Idaho,23,Butte County,0,24,-24
41,Oregon,16,Idaho,25,Camas County,0,3,-3
41,Oregon,16,Idaho,27,Canyon County,927,729,198
41,Oregon,16,Idaho,31,Cassia County,17,47,-30
41,Oregon,16,Idaho,35,Clearwater County,27,9,18
41,Oregon,16,Idaho,37,Custer County,3,0,3
41,Oregon,16,Idaho,39,Elmore County,343,21,322
41,Oregon,16,Idaho,41,Franklin County,15,1,14
41,Oregon,16,Idaho,43,Fremont County,0,3,-3
41,Oregon,16,Idaho,45,Gem County,69,13,56
41,Oregon,16,Idaho,47,Gooding County,42,58,-16
41,Oregon,16,Idaho,49,Idaho County,53,69,-16
41,Oregon,16,Idaho,51,Jefferson County,0,51,-51
41,Oregon,16,Idaho,53,Jerome County,6,0,6
41,Oregon,16,Idaho,55,Kootenai County,290,155,135
41,Oregon,16,Idaho,57,Latah County,351,237,114
41,Oregon,16,Idaho,59,Lemhi County,6,19,-13
41,Oregon,16,Idaho,61,Lewis County,6,0,6
41,Oregon,16,Idaho,63,Lincoln County,22,0,22
41,Oregon,16,Idaho,65,Madison County,177,164,13
41,Oregon,16,Idaho,67,Minidoka County,146,7,139
41,Oregon,16,Idaho,69,Nez Perce County,128,59,69
41,Oregon,16,Idaho,71,Oneida County,0,35,-35
41,Oregon,16,Idaho,73,Owyhee County,23,16,7
41,Oregon,16,Idaho,75,Payette County,596,245,351
41,Oregon,16,Idaho,77,Power County,6,0,6
41,Oregon,16,Idaho,79,Shoshone County,46,15,31
41,Oregon,16,Idaho,81,Teton County,0,19,-19
41,Oregon,16,Idaho,83,Twin Falls County,38,225,-187
41,Oregon,16,Idaho,85,Valley County,52,167,-115
41,Oregon,16,Idaho,87,Washington County,39,7,32
41,Oregon,17,Illinois,1,Adams County,32,0,32
41,Oregon,17,Illinois,7,Boone County,49,0,49
41,Oregon,17,Illinois,11,Bureau County,0,2,-2
41,Oregon,17,Illinois,19,Champaign County,84,22,62
41,Oregon,17,Illinois,29,Coles County,36,43,-7
41,Oregon,17,Illinois,31,Cook County,1002,668,334
41,Oregon,17,Illinois,37,DeKalb County,0,8,-8
41,Oregon,17,Illinois,43,DuPage County,51,93,-42
41,Oregon,17,Illinois,49,Effingham County,17,0,17
41,Oregon,17,Illinois,73,Henry County,14,0,14
41,Oregon,17,Illinois,77,Jackson County,95,15,80
41,Oregon,17,Illinois,81,Jefferson County,11,0,11
41,Oregon,17,Illinois,89,Kane County,110,23,87
41,Oregon,17,Illinois,93,Kendall County,0,9,-9
41,Oregon,17,Illinois,97,Lake County,82,181,-99
41,Oregon,17,Illinois,99,LaSalle County,18,141,-123
41,Oregon,17,Illinois,105,Livingston County,99,0,99
41,Oregon,17,Illinois,111,McHenry County,88,0,88
41,Oregon,17,Illinois,113,McLean County,74,0,74
41,Oregon,17,Illinois,115,Macon County,30,0,30
41,Oregon,17,Illinois,119,Madison County,15,0,15
41,Oregon,17,Illinois,143,Peoria County,13,7,6
41,Oregon,17,Illinois,145,Perry County,0,26,-26
41,Oregon,17,Illinois,161,Rock Island County,76,49,27
41,Oregon,17,Illinois,163,St. Clair County,7,2,5
41,Oregon,17,Illinois,167,Sangamon County,50,115,-65
41,Oregon,17,Illinois,179,Tazewell County,42,0,42
41,Oregon,17,Illinois,183,Vermilion County,19,0,19
41,Oregon,17,Illinois,197,Will County,14,2,12
41,Oregon,17,Illinois,201,Winnebago County,73,0,73
41,Oregon,18,Indiana,3,Allen County,33,254,-221
41,Oregon,18,Indiana,7,Benton County,0,14,-14
41,Oregon,18,Indiana,11,Boone County,0,11,-11
41,Oregon,18,Indiana,19,Clark County,84,36,48
41,Oregon,18,Indiana,33,DeKalb County,0,1,-1
41,Oregon,18,Indiana,35,Delaware County,31,0,31
41,Oregon,18,Indiana,39,Elkhart County,38,43,-5
41,Oregon,18,Indiana,45,Fountain County,15,0,15
41,Oregon,18,Indiana,53,Grant County,0,7,-7
41,Oregon,18,Indiana,57,Hamilton County,24,0,24
41,Oregon,18,Indiana,59,Hancock County,10,0,10
41,Oregon,18,Indiana,63,Hendricks County,33,7,26
41,Oregon,18,Indiana,81,Johnson County,30,0,30
41,Oregon,18,Indiana,83,Knox County,0,14,-14
41,Oregon,18,Indiana,85,Kosciusko County,15,11,4
41,Oregon,18,Indiana,89,Lake County,0,9,-9
41,Oregon,18,Indiana,97,Marion County,152,229,-77
41,Oregon,18,Indiana,99,Marshall County,0,9,-9
41,Oregon,18,Indiana,101,Martin County,13,0,13
41,Oregon,18,Indiana,105,Monroe County,155,60,95
41,Oregon,18,Indiana,127,Porter County,0,8,-8
41,Oregon,18,Indiana,141,St. Joseph County,62,141,-79
41,Oregon,18,Indiana,149,Starke County,11,0,11
41,Oregon,18,Indiana,157,Tippecanoe County,62,145,-83
41,Oregon,18,Indiana,163,Vanderburgh County,64,0,64
41,Oregon,18,Indiana,167,Vigo County,10,60,-50
41,Oregon,18,Indiana,169,Wabash County,2,0,2
41,Oregon,18,Indiana,177,Wayne County,8,0,8
41,Oregon,18,Indiana,181,White County,29,0,29
41,Oregon,19,Iowa,13,Black Hawk County,74,27,47
41,Oregon,19,Iowa,17,Bremer County,0,3,-3
41,Oregon,19,Iowa,21,Buena Vista County,0,7,-7
41,Oregon,19,Iowa,35,Cherokee County,0,1,-1
41,Oregon,19,Iowa,41,Clay County,5,0,5
41,Oregon,19,Iowa,49,Dallas County,8,0,8
41,Oregon,19,Iowa,61,Dubuque County,0,35,-35
41,Oregon,19,Iowa,77,Guthrie County,17,0,17
41,Oregon,19,Iowa,101,Jefferson County,20,0,20
41,Oregon,19,Iowa,103,Johnson County,237,67,170
41,Oregon,19,Iowa,105,Jones County,0,2,-2
41,Oregon,19,Iowa,109,Kossuth County,0,12,-12
41,Oregon,19,Iowa,111,Lee County,0,6,-6
41,Oregon,19,Iowa,113,Linn County,16,38,-22
41,Oregon,19,Iowa,125,Marion County,0,12,-12
41,Oregon,19,Iowa,133,Monona County,13,0,13
41,Oregon,19,Iowa,145,Page County,0,3,-3
41,Oregon,19,Iowa,151,Pocahontas County,0,3,-3
41,Oregon,19,Iowa,153,Polk County,130,48,82
41,Oregon,19,Iowa,155,Pottawattamie County,0,80,-80
41,Oregon,19,Iowa,163,Scott County,87,52,35
41,Oregon,19,Iowa,169,Story County,33,0,33
41,Oregon,19,Iowa,181,Warren County,0,88,-88
41,Oregon,19,Iowa,193,Woodbury County,24,0,24
41,Oregon,2,Alaska,13,Aleutians East Borough,0,3,-3
41,Oregon,2,Alaska,16,Aleutians West Census Area,0,14,-14
41,Oregon,2,Alaska,20,Anchorage Municipality,914,327,587
41,Oregon,2,Alaska,50,Bethel Census Area,22,0,22
41,Oregon,2,Alaska,60,Bristol Bay Borough,5,4,1
41,Oregon,2,Alaska,70,Dillingham Census Area,0,12,-12
41,Oregon,2,Alaska,90,Fairbanks North Star Borough,281,77,204
41,Oregon,2,Alaska,100,Haines Borough,3,1,2
41,Oregon,2,Alaska,105,Hoonah-Angoon Census Area,5,8,-3
41,Oregon,2,Alaska,110,Juneau City and Borough,100,34,66
41,Oregon,2,Alaska,122,Kenai Peninsula Borough,240,267,-27
41,Oregon,2,Alaska,130,Ketchikan Gateway Borough,108,92,16
41,Oregon,2,Alaska,150,Kodiak Island Borough,134,106,28
41,Oregon,2,Alaska,158,Kusilvak Census Area,0,3,-3
41,Oregon,2,Alaska,164,Lake and Peninsula Borough,0,2,-2
41,Oregon,2,Alaska,170,Matanuska-Susitna Borough,385,165,220
41,Oregon,2,Alaska,180,Nome Census Area,18,34,-16
41,Oregon,2,Alaska,185,North Slope Borough,0,47,-47
41,Oregon,2,Alaska,188,Northwest Arctic Borough,9,25,-16
41,Oregon,2,Alaska,195,Petersburg Borough,128,3,125
41,Oregon,2,Alaska,198,Prince of Wales-Hyder Census Area,0,50,-50
41,Oregon,2,Alaska,220,Sitka City and Borough,117,48,69
41,Oregon,2,Alaska,230,Skagway Municipality,0,8,-8
41,Oregon,2,Alaska,240,Southeast Fairbanks Census Area,0,25,-25
41,Oregon,2,Alaska,261,Valdez-Cordova Census Area,51,84,-33
41,Oregon,2,Alaska,275,Wrangell City and Borough,39,3,36
41,Oregon,2,Alaska,282,Yakutat City and Borough,0,7,-7
41,Oregon,20,Kansas,7,Barber County,7,3,4
41,Oregon,20,Kansas,9,Barton County,133,0,133
41,Oregon,20,Kansas,15,Butler County,16,0,16
41,Oregon,20,Kansas,21,Cherokee County,28,0,28
41,Oregon,20,Kansas,41,Dickinson County,0,54,-54
41,Oregon,20,Kansas,43,Doniphan County,2,1,1
41,Oregon,20,Kansas,45,Douglas County,128,41,87
41,Oregon,20,Kansas,47,Edwards County,51,0,51
41,Oregon,20,Kansas,49,Elk County,0,5,-5
41,Oregon,20,Kansas,51,Ellis County,34,0,34
41,Oregon,20,Kansas,61,Geary County,0,20,-20
41,Oregon,20,Kansas,75,Hamilton County,24,0,24
41,Oregon,20,Kansas,79,Harvey County,0,65,-65
41,Oregon,20,Kansas,83,Hodgeman County,17,0,17
41,Oregon,20,Kansas,89,Jewell County,0,18,-18
41,Oregon,20,Kansas,91,Johnson County,58,93,-35
41,Oregon,20,Kansas,99,Labette County,37,0,37
41,Oregon,20,Kansas,103,Leavenworth County,27,0,27
41,Oregon,20,Kansas,105,Lincoln County,98,0,98
41,Oregon,20,Kansas,107,Linn County,0,5,-5
41,Oregon,20,Kansas,113,McPherson County,7,0,7
41,Oregon,20,Kansas,137,Norton County,0,9,-9
41,Oregon,20,Kansas,139,Osage County,37,0,37
41,Oregon,20,Kansas,155,Reno County,0,42,-42
41,Oregon,20,Kansas,159,Rice County,42,0,42
41,Oregon,20,Kansas,161,Riley County,87,66,21
41,Oregon,20,Kansas,167,Russell County,13,0,13
41,Oregon,20,Kansas,169,Saline County,0,11,-11
41,Oregon,20,Kansas,173,Sedgwick County,160,99,61
41,Oregon,20,Kansas,175,Seward County,12,0,12
41,Oregon,20,Kansas,177,Shawnee County,28,75,-47
41,Oregon,20,Kansas,183,Smith County,0,1,-1
41,Oregon,20,Kansas,185,Stafford County,1,0,1
41,Oregon,20,Kansas,209,Wyandotte County,10,0,10
41,Oregon,21,Kentucky,19,Boyd County,0,45,-45
41,Oregon,21,Kentucky,29,Bullitt County,25,0,25
41,Oregon,21,Kentucky,37,Campbell County,23,0,23
41,Oregon,21,Kentucky,47,Christian County,90,14,76
41,Oregon,21,Kentucky,59,Daviess County,0,5,-5
41,Oregon,21,Kentucky,67,Fayette County,84,170,-86
41,Oregon,21,Kentucky,93,Hardin County,31,13,18
41,Oregon,21,Kentucky,111,Jefferson County,48,109,-61
41,Oregon,21,Kentucky,117,Kenton County,0,55,-55
41,Oregon,21,Kentucky,141,Logan County,0,13,-13
41,Oregon,21,Kentucky,185,Oldham County,62,20,42
41,Oregon,21,Kentucky,205,Rowan County,0,6,-6
41,Oregon,21,Kentucky,209,Scott County,0,8,-8
41,Oregon,21,Kentucky,227,Warren County,0,8,-8
41,Oregon,22,Louisiana,5,Ascension Parish,11,0,11
41,Oregon,22,Louisiana,13,Bienville Parish,1,0,1
41,Oregon,22,Louisiana,17,Caddo Parish,142,0,142
41,Oregon,22,Louisiana,19,Calcasieu Parish,102,0,102
41,Oregon,22,Louisiana,33,East Baton Rouge Parish,72,89,-17
41,Oregon,22,Louisiana,45,Iberia Parish,0,27,-27
41,Oregon,22,Louisiana,51,Jefferson Parish,79,12,67
41,Oregon,22,Louisiana,57,Lafourche Parish,30,0,30
41,Oregon,22,Louisiana,61,Lincoln Parish,96,0,96
41,Oregon,22,Louisiana,63,Livingston Parish,103,498,-395
41,Oregon,22,Louisiana,71,Orleans Parish,161,129,32
41,Oregon,22,Louisiana,73,Ouachita Parish,0,28,-28
41,Oregon,22,Louisiana,75,Plaquemines Parish,40,0,40
41,Oregon,22,Louisiana,79,Rapides Parish,16,0,16
41,Oregon,22,Louisiana,97,St. Landry Parish,66,0,66
41,Oregon,22,Louisiana,103,St. Tammany Parish,23,36,-13
41,Oregon,22,Louisiana,109,Terrebonne Parish,58,24,34
41,Oregon,22,Louisiana,111,Union Parish,0,8,-8
41,Oregon,22,Louisiana,115,Vernon Parish,59,12,47
41,Oregon,22,Louisiana,117,Washington Parish,7,0,7
41,Oregon,22,Louisiana,119,Webster Parish,102,0,102
41,Oregon,23,Maine,1,Androscoggin County,0,4,-4
41,Oregon,23,Maine,3,Aroostook County,6,4,2
41,Oregon,23,Maine,5,Cumberland County,90,93,-3
41,Oregon,23,Maine,9,Hancock County,16,15,1
41,Oregon,23,Maine,11,Kennebec County,26,37,-11
41,Oregon,23,Maine,15,Lincoln County,15,0,15
41,Oregon,23,Maine,19,Penobscot County,0,13,-13
41,Oregon,23,Maine,23,Sagadahoc County,9,2,7
41,Oregon,23,Maine,27,Waldo County,22,39,-17
41,Oregon,23,Maine,29,Washington County,0,4,-4
41,Oregon,23,Maine,31,York County,46,0,46
41,Oregon,24,Maryland,3,Anne Arundel County,39,0,39
41,Oregon,24,Maryland,5,Baltimore County,273,129,144
41,Oregon,24,Maryland,9,Calvert County,24,0,24
41,Oregon,24,Maryland,13,Carroll County,30,0,30
41,Oregon,24,Maryland,17,Charles County,69,0,69
41,Oregon,24,Maryland,21,Frederick County,0,32,-32
41,Oregon,24,Maryland,25,Harford County,8,0,8
41,Oregon,24,Maryland,27,Howard County,55,57,-2
41,Oregon,24,Maryland,31,Montgomery County,207,56,151
41,Oregon,24,Maryland,33,Prince George's County,28,35,-7
41,Oregon,24,Maryland,37,St. Mary's County,9,88,-79
41,Oregon,24,Maryland,43,Washington County,20,0,20
41,Oregon,24,Maryland,45,Wicomico County,16,0,16
41,Oregon,24,Maryland,47,Worcester County,26,0,26
41,Oregon,24,Maryland,510,Baltimore city,168,42,126
41,Oregon,25,Massachusetts,1,Barnstable County,60,44,16
41,Oregon,25,Massachusetts,3,Berkshire County,8,0,8
41,Oregon,25,Massachusetts,5,Bristol County,19,17,2
41,Oregon,25,Massachusetts,7,Dukes County,0,10,-10
41,Oregon,25,Massachusetts,9,Essex County,133,74,59
41,Oregon,25,Massachusetts,11,Franklin County,9,0,9
41,Oregon,25,Massachusetts,13,Hampden County,10,0,10
41,Oregon,25,Massachusetts,15,Hampshire County,53,109,-56
41,Oregon,25,Massachusetts,17,Middlesex County,615,67,548
41,Oregon,25,Massachusetts,19,Nantucket County,0,36,-36
41,Oregon,25,Massachusetts,21,Norfolk County,253,73,180
41,Oregon,25,Massachusetts,23,Plymouth County,22,0,22
41,Oregon,25,Massachusetts,25,Suffolk County,165,186,-21
41,Oregon,25,Massachusetts,27,Worcester County,41,80,-39
41,Oregon,26,Michigan,1,Alcona County,0,3,-3
41,Oregon,26,Michigan,3,Alger County,0,5,-5
41,Oregon,26,Michigan,5,Allegan County,0,2,-2
41,Oregon,26,Michigan,9,Antrim County,0,15,-15
41,Oregon,26,Michigan,17,Bay County,23,0,23
41,Oregon,26,Michigan,19,Benzie County,0,6,-6
41,Oregon,26,Michigan,21,Berrien County,0,114,-114
41,Oregon,26,Michigan,25,Calhoun County,11,62,-51
41,Oregon,26,Michigan,27,Cass County,0,6,-6
41,Oregon,26,Michigan,29,Charlevoix County,0,7,-7
41,Oregon,26,Michigan,31,Cheboygan County,0,4,-4
41,Oregon,26,Michigan,33,Chippewa County,0,18,-18
41,Oregon,26,Michigan,35,Clare County,0,3,-3
41,Oregon,26,Michigan,37,Clinton County,0,12,-12
41,Oregon,26,Michigan,43,Dickinson County,0,10,-10
41,Oregon,26,Michigan,45,Eaton County,52,0,52
41,Oregon,26,Michigan,49,Genesee County,45,42,3
41,Oregon,26,Michigan,55,Grand Traverse County,47,0,47
41,Oregon,26,Michigan,59,Hillsdale County,0,24,-24
41,Oregon,26,Michigan,65,Ingham County,45,24,21
41,Oregon,26,Michigan,69,Iosco County,0,14,-14
41,Oregon,26,Michigan,73,Isabella County,24,0,24
41,Oregon,26,Michigan,75,Jackson County,0,3,-3
41,Oregon,26,Michigan,77,Kalamazoo County,33,70,-37
41,Oregon,26,Michigan,81,Kent County,310,52,258
41,Oregon,26,Michigan,85,Lake County,23,0,23
41,Oregon,26,Michigan,89,Leelanau County,0,1,-1
41,Oregon,26,Michigan,93,Livingston County,0,6,-6
41,Oregon,26,Michigan,99,Macomb County,2,18,-16
41,Oregon,26,Michigan,101,Manistee County,15,3,12
41,Oregon,26,Michigan,103,Marquette County,45,10,35
41,Oregon,26,Michigan,111,Midland County,0,18,-18
41,Oregon,26,Michigan,113,Missaukee County,0,2,-2
41,Oregon,26,Michigan,121,Muskegon County,0,65,-65
41,Oregon,26,Michigan,125,Oakland County,144,53,91
41,Oregon,26,Michigan,137,Otsego County,0,4,-4
41,Oregon,26,Michigan,139,Ottawa County,32,0,32
41,Oregon,26,Michigan,141,Presque Isle County,0,2,-2
41,Oregon,26,Michigan,143,Roscommon County,0,7,-7
41,Oregon,26,Michigan,147,St. Clair County,0,10,-10
41,Oregon,26,Michigan,149,St. Joseph County,26,0,26
41,Oregon,26,Michigan,161,Washtenaw County,175,162,13
41,Oregon,26,Michigan,163,Wayne County,195,48,147
41,Oregon,27,Minnesota,3,Anoka County,14,40,-26
41,Oregon,27,Minnesota,7,Beltrami County,4,10,-6
41,Oregon,27,Minnesota,9,Benton County,10,0,10
41,Oregon,27,Minnesota,13,Blue Earth County,64,22,42
41,Oregon,27,Minnesota,17,Carlton County,0,2,-2
41,Oregon,27,Minnesota,19,Carver County,147,0,147
41,Oregon,27,Minnesota,21,Cass County,0,9,-9
41,Oregon,27,Minnesota,27,Clay County,5,0,5
41,Oregon,27,Minnesota,29,Clearwater County,0,12,-12
41,Oregon,27,Minnesota,31,Cook County,0,10,-10
41,Oregon,27,Minnesota,35,Crow Wing County,118,24,94
41,Oregon,27,Minnesota,37,Dakota County,177,23,154
41,Oregon,27,Minnesota,43,Faribault County,31,0,31
41,Oregon,27,Minnesota,45,Fillmore County,0,7,-7
41,Oregon,27,Minnesota,53,Hennepin County,512,475,37
41,Oregon,27,Minnesota,55,Houston County,23,0,23
41,Oregon,27,Minnesota,57,Hubbard County,0,10,-10
41,Oregon,27,Minnesota,59,Isanti County,0,17,-17
41,Oregon,27,Minnesota,61,Itasca County,0,11,-11
41,Oregon,27,Minnesota,65,Kanabec County,0,16,-16
41,Oregon,27,Minnesota,67,Kandiyohi County,32,0,32
41,Oregon,27,Minnesota,83,Lyon County,19,0,19
41,Oregon,27,Minnesota,91,Martin County,0,2,-2
41,Oregon,27,Minnesota,93,Meeker County,0,4,-4
41,Oregon,27,Minnesota,97,Morrison County,0,2,-2
41,Oregon,27,Minnesota,99,Mower County,15,9,6
41,Oregon,27,Minnesota,103,Nicollet County,0,26,-26
41,Oregon,27,Minnesota,109,Olmsted County,6,28,-22
41,Oregon,27,Minnesota,111,Otter Tail County,0,1,-1
41,Oregon,27,Minnesota,115,Pine County,3,5,-2
41,Oregon,27,Minnesota,119,Polk County,49,0,49
41,Oregon,27,Minnesota,123,Ramsey County,309,162,147
41,Oregon,27,Minnesota,129,Renville County,0,8,-8
41,Oregon,27,Minnesota,131,Rice County,0,146,-146
41,Oregon,27,Minnesota,137,St. Louis County,75,32,43
41,Oregon,27,Minnesota,139,Scott County,8,54,-46
41,Oregon,27,Minnesota,145,Stearns County,0,29,-29
41,Oregon,27,Minnesota,149,Stevens County,0,16,-16
41,Oregon,27,Minnesota,163,Washington County,33,34,-1
41,Oregon,27,Minnesota,171,Wright County,55,21,34
41,Oregon,28,Mississippi,27,Coahoma County,55,0,55
41,Oregon,28,Mississippi,33,DeSoto County,0,19,-19
41,Oregon,28,Mississippi,47,Harrison County,73,72,1
41,Oregon,28,Mississippi,49,Hinds County,0,72,-72
41,Oregon,28,Mississippi,51,Holmes County,0,14,-14
41,Oregon,28,Mississippi,73,Lamar County,0,20,-20
41,Oregon,28,Mississippi,87,Lowndes County,11,0,11
41,Oregon,28,Mississippi,101,Newton County,315,0,315
41,Oregon,28,Mississippi,163,Yazoo County,0,18,-18
41,Oregon,29,Missouri,1,Adair County,8,8,0
41,Oregon,29,Missouri,9,Barry County,12,0,12
41,Oregon,29,Missouri,19,Boone County,16,65,-49
41,Oregon,29,Missouri,21,Buchanan County,0,17,-17
41,Oregon,29,Missouri,29,Camden County,0,49,-49
41,Oregon,29,Missouri,31,Cape Girardeau County,0,26,-26
41,Oregon,29,Missouri,43,Christian County,0,48,-48
41,Oregon,29,Missouri,47,Clay County,29,81,-52
41,Oregon,29,Missouri,49,Clinton County,0,5,-5
41,Oregon,29,Missouri,63,DeKalb County,0,262,-262
41,Oregon,29,Missouri,71,Franklin County,0,4,-4
41,Oregon,29,Missouri,77,Greene County,49,87,-38
41,Oregon,29,Missouri,95,Jackson County,141,171,-30
41,Oregon,29,Missouri,97,Jasper County,26,100,-74
41,Oregon,29,Missouri,101,Johnson County,20,0,20
41,Oregon,29,Missouri,107,Lafayette County,0,14,-14
41,Oregon,29,Missouri,109,Lawrence County,0,123,-123
41,Oregon,29,Missouri,117,Livingston County,0,3,-3
41,Oregon,29,Missouri,131,Miller County,30,12,18
41,Oregon,29,Missouri,141,Morgan County,0,10,-10
41,Oregon,29,Missouri,147,Nodaway County,0,2,-2
41,Oregon,29,Missouri,149,Oregon County,0,5,-5
41,Oregon,29,Missouri,159,Pettis County,0,4,-4
41,Oregon,29,Missouri,161,Phelps County,20,8,12
41,Oregon,29,Missouri,169,Pulaski County,7,123,-116
41,Oregon,29,Missouri,181,Ripley County,0,8,-8
41,Oregon,29,Missouri,183,St. Charles County,33,103,-70
41,Oregon,29,Missouri,187,St. Francois County,64,10,54
41,Oregon,29,Missouri,189,St. Louis County,208,408,-200
41,Oregon,29,Missouri,201,Scott County,0,6,-6
41,Oregon,29,Missouri,213,Taney County,56,0,56
41,Oregon,29,Missouri,217,Vernon County,0,3,-3
41,Oregon,29,Missouri,221,Washington County,0,23,-23
41,Oregon,29,Missouri,225,Webster County,0,13,-13
41,Oregon,29,Missouri,510,St. Louis city,261,90,171
41,Oregon,30,Montana,1,Beaverhead County,82,28,54
41,Oregon,30,Montana,3,Big Horn County,9,0,9
41,Oregon,30,Montana,5,Blaine County,0,12,-12
41,Oregon,30,Montana,11,Carter County,0,1,-1
41,Oregon,30,Montana,13,Cascade County,129,181,-52
41,Oregon,30,Montana,17,Custer County,0,34,-34
41,Oregon,30,Montana,21,Dawson County,19,6,13
41,Oregon,30,Montana,23,Deer Lodge County,46,11,35
41,Oregon,30,Montana,27,Fergus County,131,0,131
41,Oregon,30,Montana,29,Flathead County,192,353,-161
41,Oregon,30,Montana,31,Gallatin County,253,63,190
41,Oregon,30,Montana,35,Glacier County,0,53,-53
41,Oregon,30,Montana,41,Hill County,34,15,19
41,Oregon,30,Montana,43,Jefferson County,40,68,-28
41,Oregon,30,Montana,47,Lake County,0,40,-40
41,Oregon,30,Montana,49,Lewis and Clark County,112,138,-26
41,Oregon,30,Montana,51,Liberty County,0,13,-13
41,Oregon,30,Montana,53,Lincoln County,203,6,197
41,Oregon,30,Montana,57,Madison County,0,13,-13
41,Oregon,30,Montana,59,Meagher County,0,4,-4
41,Oregon,30,Montana,61,Mineral County,19,10,9
41,Oregon,30,Montana,63,Missoula County,238,217,21
41,Oregon,30,Montana,67,Park County,0,11,-11
41,Oregon,30,Montana,73,Pondera County,19,5,14
41,Oregon,30,Montana,75,Powder River County,33,0,33
41,Oregon,30,Montana,77,Powell County,140,1,139
41,Oregon,30,Montana,81,Ravalli County,78,66,12
41,Oregon,30,Montana,83,Richland County,3,7,-4
41,Oregon,30,Montana,85,Roosevelt County,17,0,17
41,Oregon,30,Montana,89,Sanders County,238,0,238
41,Oregon,30,Montana,93,Silver Bow County,58,14,44
41,Oregon,30,Montana,95,Stillwater County,11,9,2
41,Oregon,30,Montana,97,Sweet Grass County,0,7,-7
41,Oregon,30,Montana,101,Toole County,22,48,-26
41,Oregon,30,Montana,107,Wheatland County,0,3,-3
41,Oregon,30,Montana,111,Yellowstone County,191,175,16
41,Oregon,31,Nebraska,17,Brown County,0,2,-2
41,Oregon,31,Nebraska,19,Buffalo County,40,12,28
41,Oregon,31,Nebraska,25,Cass County,6,0,6
41,Oregon,31,Nebraska,37,Colfax County,346,0,346
41,Oregon,31,Nebraska,45,Dawes County,8,0,8
41,Oregon,31,Nebraska,47,Dawson County,23,0,23
41,Oregon,31,Nebraska,55,Douglas County,189,106,83
41,Oregon,31,Nebraska,67,Gage County,0,6,-6
41,Oregon,31,Nebraska,89,Holt County,13,0,13
41,Oregon,31,Nebraska,99,Kearney County,0,10,-10
41,Oregon,31,Nebraska,109,Lancaster County,112,27,85
41,Oregon,31,Nebraska,111,Lincoln County,0,15,-15
41,Oregon,31,Nebraska,119,Madison County,0,77,-77
41,Oregon,31,Nebraska,123,Morrill County,0,14,-14
41,Oregon,31,Nebraska,125,Nance County,9,0,9
41,Oregon,31,Nebraska,153,Sarpy County,9,53,-44
41,Oregon,31,Nebraska,161,Sheridan County,28,0,28
41,Oregon,31,Nebraska,175,Valley County,0,1,-1
41,Oregon,32,Nevada,1,Churchill County,49,54,-5
41,Oregon,32,Nevada,3,Clark County,1471,1676,-205
41,Oregon,32,Nevada,5,Douglas County,6,138,-132
41,Oregon,32,Nevada,7,Elko County,51,26,25
41,Oregon,32,Nevada,9,Esmeralda County,0,4,-4
41,Oregon,32,Nevada,11,Eureka County,24,0,24
41,Oregon,32,Nevada,13,Humboldt County,200,101,99
41,Oregon,32,Nevada,15,Lander County,33,0,33
41,Oregon,32,Nevada,17,Lincoln County,15,0,15
41,Oregon,32,Nevada,19,Lyon County,11,68,-57
41,Oregon,32,Nevada,23,Nye County,72,25,47
41,Oregon,32,Nevada,31,Washoe County,569,380,189
41,Oregon,32,Nevada,510,Carson City,110,32,78
41,Oregon,33,New Hampshire,1,Belknap County,9,0,9
41,Oregon,33,New Hampshire,3,Carroll County,29,22,7
41,Oregon,33,New Hampshire,5,Cheshire County,0,50,-50
41,Oregon,33,New Hampshire,9,Grafton County,212,0,212
41,Oregon,33,New Hampshire,11,Hillsborough County,7,58,-51
41,Oregon,33,New Hampshire,13,Merrimack County,10,1,9
41,Oregon,33,New Hampshire,15,Rockingham County,38,0,38
41,Oregon,33,New Hampshire,17,Strafford County,0,36,-36
41,Oregon,34,New Jersey,1,Atlantic County,81,30,51
41,Oregon,34,New Jersey,3,Bergen County,141,35,106
41,Oregon,34,New Jersey,5,Burlington County,10,78,-68
41,Oregon,34,New Jersey,7,Camden County,68,21,47
41,Oregon,34,New Jersey,9,Cape May County,0,32,-32
41,Oregon,34,New Jersey,11,Cumberland County,0,14,-14
41,Oregon,34,New Jersey,13,Essex County,144,15,129
41,Oregon,34,New Jersey,15,Gloucester County,0,34,-34
41,Oregon,34,New Jersey,17,Hudson County,101,0,101
41,Oregon,34,New Jersey,19,Hunterdon County,0,25,-25
41,Oregon,34,New Jersey,21,Mercer County,0,60,-60
41,Oregon,34,New Jersey,23,Middlesex County,71,45,26
41,Oregon,34,New Jersey,25,Monmouth County,3,50,-47
41,Oregon,34,New Jersey,27,Morris County,11,32,-21
41,Oregon,34,New Jersey,31,Passaic County,0,17,-17
41,Oregon,34,New Jersey,35,Somerset County,0,89,-89
41,Oregon,34,New Jersey,39,Union County,18,0,18
41,Oregon,35,New Mexico,1,Bernalillo County,602,527,75
41,Oregon,35,New Mexico,5,Chaves County,62,17,45
41,Oregon,35,New Mexico,6,Cibola County,39,9,30
41,Oregon,35,New Mexico,7,Colfax County,61,0,61
41,Oregon,35,New Mexico,9,Curry County,32,0,32
41,Oregon,35,New Mexico,13,Doña Ana County,150,0,150
41,Oregon,35,New Mexico,17,Grant County,0,13,-13
41,Oregon,35,New Mexico,27,Lincoln County,3,0,3
41,Oregon,35,New Mexico,28,Los Alamos County,24,0,24
41,Oregon,35,New Mexico,29,Luna County,7,0,7
41,Oregon,35,New Mexico,31,McKinley County,17,36,-19
41,Oregon,35,New Mexico,35,Otero County,14,36,-22
41,Oregon,35,New Mexico,37,Quay County,0,27,-27
41,Oregon,35,New Mexico,39,Rio Arriba County,39,13,26
41,Oregon,35,New Mexico,43,Sandoval County,202,3,199
41,Oregon,35,New Mexico,45,San Juan County,23,18,5
41,Oregon,35,New Mexico,49,Santa Fe County,169,62,107
41,Oregon,35,New Mexico,51,Sierra County,0,98,-98
41,Oregon,35,New Mexico,53,Socorro County,52,86,-34
41,Oregon,35,New Mexico,55,Taos County,28,16,12
41,Oregon,35,New Mexico,57,Torrance County,0,4,-4
41,Oregon,35,New Mexico,59,Union County,0,14,-14
41,Oregon,35,New Mexico,61,Valencia County,22,0,22
41,Oregon,36,New York,1,Albany County,86,0,86
41,Oregon,36,New York,3,Allegany County,0,3,-3
41,Oregon,36,New York,5,Bronx County,128,110,18
41,Oregon,36,New York,7,Broome County,27,44,-17
41,Oregon,36,New York,9,Cattaraugus County,0,30,-30
41,Oregon,36,New York,11,Cayuga County,15,0,15
41,Oregon,36,New York,13,Chautauqua County,0,10,-10
41,Oregon,36,New York,15,Chemung County,11,0,11
41,Oregon,36,New York,21,Columbia County,0,8,-8
41,Oregon,36,New York,23,Cortland County,0,3,-3
41,Oregon,36,New York,27,Dutchess County,152,30,122
41,Oregon,36,New York,29,Erie County,59,15,44
41,Oregon,36,New York,31,Essex County,0,4,-4
41,Oregon,36,New York,37,Genesee County,0,21,-21
41,Oregon,36,New York,41,Hamilton County,17,0,17
41,Oregon,36,New York,45,Jefferson County,26,2,24
41,Oregon,36,New York,47,Kings County,590,515,75
41,Oregon,36,New York,51,Livingston County,0,2,-2
41,Oregon,36,New York,53,Madison County,7,57,-50
41,Oregon,36,New York,55,Monroe County,37,79,-42
41,Oregon,36,New York,59,Nassau County,61,0,61
41,Oregon,36,New York,61,New York County,406,254,152
41,Oregon,36,New York,63,Niagara County,11,14,-3
41,Oregon,36,New York,67,Onondaga County,78,9,69
41,Oregon,36,New York,69,Ontario County,259,0,259
41,Oregon,36,New York,75,Oswego County,0,12,-12
41,Oregon,36,New York,79,Putnam County,13,0,13
41,Oregon,36,New York,81,Queens County,145,36,109
41,Oregon,36,New York,83,Rensselaer County,0,42,-42
41,Oregon,36,New York,85,Richmond County,0,13,-13
41,Oregon,36,New York,87,Rockland County,41,76,-35
41,Oregon,36,New York,91,Saratoga County,87,161,-74
41,Oregon,36,New York,93,Schenectady County,0,3,-3
41,Oregon,36,New York,97,Schuyler County,0,8,-8
41,Oregon,36,New York,101,Steuben County,0,4,-4
41,Oregon,36,New York,103,Suffolk County,49,32,17
41,Oregon,36,New York,107,Tioga County,17,0,17
41,Oregon,36,New York,109,Tompkins County,50,84,-34
41,Oregon,36,New York,111,Ulster County,47,11,36
41,Oregon,36,New York,117,Wayne County,7,0,7
41,Oregon,36,New York,119,Westchester County,28,35,-7
41,Oregon,37,North Carolina,1,Alamance County,0,16,-16
41,Oregon,37,North Carolina,17,Bladen County,9,0,9
41,Oregon,37,North Carolina,19,Brunswick County,17,8,9
41,Oregon,37,North Carolina,21,Buncombe County,47,93,-46
41,Oregon,37,North Carolina,23,Burke County,0,14,-14
41,Oregon,37,North Carolina,25,Cabarrus County,0,38,-38
41,Oregon,37,North Carolina,49,Craven County,32,40,-8
41,Oregon,37,North Carolina,51,Cumberland County,10,62,-52
41,Oregon,37,North Carolina,53,Currituck County,0,24,-24
41,Oregon,37,North Carolina,55,Dare County,0,26,-26
41,Oregon,37,North Carolina,63,Durham County,86,136,-50
41,Oregon,37,North Carolina,67,Forsyth County,24,11,13
41,Oregon,37,North Carolina,71,Gaston County,0,95,-95
41,Oregon,37,North Carolina,81,Guilford County,32,39,-7
41,Oregon,37,North Carolina,85,Harnett County,0,11,-11
41,Oregon,37,North Carolina,87,Haywood County,0,87,-87
41,Oregon,37,North Carolina,89,Henderson County,31,22,9
41,Oregon,37,North Carolina,97,Iredell County,0,18,-18
41,Oregon,37,North Carolina,99,Jackson County,0,69,-69
41,Oregon,37,North Carolina,105,Lee County,0,69,-69
41,Oregon,37,North Carolina,109,Lincoln County,64,0,64
41,Oregon,37,North Carolina,113,Macon County,0,10,-10
41,Oregon,37,North Carolina,119,Mecklenburg County,256,60,196
41,Oregon,37,North Carolina,125,Moore County,0,12,-12
41,Oregon,37,North Carolina,129,New Hanover County,10,65,-55
41,Oregon,37,North Carolina,133,Onslow County,126,27,99
41,Oregon,37,North Carolina,135,Orange County,91,90,1
41,Oregon,37,North Carolina,139,Pasquotank County,89,0,89
41,Oregon,37,North Carolina,147,Pitt County,34,0,34
41,Oregon,37,North Carolina,159,Rowan County,24,0,24
41,Oregon,37,North Carolina,161,Rutherford County,0,13,-13
41,Oregon,37,North Carolina,163,Sampson County,0,28,-28
41,Oregon,37,North Carolina,171,Surry County,13,0,13
41,Oregon,37,North Carolina,175,Transylvania County,0,7,-7
41,Oregon,37,North Carolina,179,Union County,0,28,-28
41,Oregon,37,North Carolina,183,Wake County,485,56,429
41,Oregon,37,North Carolina,189,Watauga County,25,25,0
41,Oregon,37,North Carolina,199,Yancey County,19,0,19
41,Oregon,38,North Dakota,3,Barnes County,0,2,-2
41,Oregon,38,North Dakota,15,Burleigh County,174,18,156
41,Oregon,38,North Dakota,17,Cass County,111,182,-71
41,Oregon,38,North Dakota,25,Dunn County,0,30,-30
41,Oregon,38,North Dakota,27,Eddy County,0,8,-8
41,Oregon,38,North Dakota,35,Grand Forks County,0,79,-79
41,Oregon,38,North Dakota,37,Grant County,0,5,-5
41,Oregon,38,North Dakota,41,Hettinger County,0,2,-2
41,Oregon,38,North Dakota,53,McKenzie County,36,0,36
41,Oregon,38,North Dakota,57,Mercer County,40,64,-24
41,Oregon,38,North Dakota,71,Ramsey County,31,0,31
41,Oregon,38,North Dakota,79,Rolette County,0,3,-3
41,Oregon,38,North Dakota,89,Stark County,36,2,34
41,Oregon,38,North Dakota,93,Stutsman County,5,10,-5
41,Oregon,38,North Dakota,101,Ward County,58,1,57
41,Oregon,38,North Dakota,105,Williams County,146,79,67
41,Oregon,39,Ohio,3,Allen County,0,17,-17
41,Oregon,39,Ohio,9,Athens County,4,12,-8
41,Oregon,39,Ohio,13,Belmont County,29,44,-15
41,Oregon,39,Ohio,17,Butler County,57,0,57
41,Oregon,39,Ohio,19,Carroll County,0,17,-17
41,Oregon,39,Ohio,25,Clermont County,0,74,-74
41,Oregon,39,Ohio,27,Clinton County,1,0,1
41,Oregon,39,Ohio,29,Columbiana County,21,0,21
41,Oregon,39,Ohio,35,Cuyahoga County,93,134,-41
41,Oregon,39,Ohio,39,Defiance County,15,0,15
41,Oregon,39,Ohio,41,Delaware County,9,87,-78
41,Oregon,39,Ohio,43,Erie County,10,8,2
41,Oregon,39,Ohio,49,Franklin County,261,86,175
41,Oregon,39,Ohio,55,Geauga County,30,16,14
41,Oregon,39,Ohio,57,Greene County,4,141,-137
41,Oregon,39,Ohio,61,Hamilton County,29,156,-127
41,Oregon,39,Ohio,63,Hancock County,21,1,20
41,Oregon,39,Ohio,65,Hardin County,0,18,-18
41,Oregon,39,Ohio,71,Highland County,37,0,37
41,Oregon,39,Ohio,83,Knox County,0,8,-8
41,Oregon,39,Ohio,85,Lake County,0,12,-12
41,Oregon,39,Ohio,89,Licking County,0,31,-31
41,Oregon,39,Ohio,93,Lorain County,0,35,-35
41,Oregon,39,Ohio,95,Lucas County,29,44,-15
41,Oregon,39,Ohio,103,Medina County,0,11,-11
41,Oregon,39,Ohio,105,Meigs County,21,0,21
41,Oregon,39,Ohio,109,Miami County,0,10,-10
41,Oregon,39,Ohio,113,Montgomery County,30,9,21
41,Oregon,39,Ohio,125,Paulding County,17,0,17
41,Oregon,39,Ohio,133,Portage County,0,31,-31
41,Oregon,39,Ohio,135,Preble County,30,0,30
41,Oregon,39,Ohio,139,Richland County,0,5,-5
41,Oregon,39,Ohio,143,Sandusky County,0,18,-18
41,Oregon,39,Ohio,147,Seneca County,66,0,66
41,Oregon,39,Ohio,151,Stark County,18,36,-18
41,Oregon,39,Ohio,153,Summit County,116,69,47
41,Oregon,39,Ohio,155,Trumbull County,0,15,-15
41,Oregon,39,Ohio,165,Warren County,0,45,-45
41,Oregon,39,Ohio,167,Washington County,5,24,-19
41,Oregon,39,Ohio,169,Wayne County,82,14,68
41,Oregon,39,Ohio,171,Williams County,0,72,-72
41,Oregon,4,Arizona,1,Apache County,13,14,-1
41,Oregon,4,Arizona,3,Cochise County,85,90,-5
41,Oregon,4,Arizona,5,Coconino County,221,120,101
41,Oregon,4,Arizona,7,Gila County,41,61,-20
41,Oregon,4,Arizona,9,Graham County,0,145,-145
41,Oregon,4,Arizona,11,Greenlee County,0,27,-27
41,Oregon,4,Arizona,12,La Paz County,0,28,-28
41,Oregon,4,Arizona,13,Maricopa County,3628,4432,-804
41,Oregon,4,Arizona,15,Mohave County,752,482,270
41,Oregon,4,Arizona,17,Navajo County,73,114,-41
41,Oregon,4,Arizona,19,Pima County,1228,1230,-2
41,Oregon,4,Arizona,21,Pinal County,440,1443,-1003
41,Oregon,4,Arizona,23,Santa Cruz County,33,0,33
41,Oregon,4,Arizona,25,Yavapai County,439,409,30
41,Oregon,4,Arizona,27,Yuma County,272,311,-39
41,Oregon,40,Oklahoma,9,Beckham County,25,0,25
41,Oregon,40,Oklahoma,13,Bryan County,0,6,-6
41,Oregon,40,Oklahoma,15,Caddo County,22,0,22
41,Oregon,40,Oklahoma,27,Cleveland County,74,72,2
41,Oregon,40,Oklahoma,29,Coal County,0,5,-5
41,Oregon,40,Oklahoma,31,Comanche County,0,21,-21
41,Oregon,40,Oklahoma,47,Garfield County,0,15,-15
41,Oregon,40,Oklahoma,49,Garvin County,18,0,18
41,Oregon,40,Oklahoma,55,Greer County,0,12,-12
41,Oregon,40,Oklahoma,65,Jackson County,19,7,12
41,Oregon,40,Oklahoma,75,Kiowa County,0,2,-2
41,Oregon,40,Oklahoma,79,Le Flore County,245,0,245
41,Oregon,40,Oklahoma,87,McClain County,0,4,-4
41,Oregon,40,Oklahoma,101,Muskogee County,22,0,22
41,Oregon,40,Oklahoma,109,Oklahoma County,154,155,-1
41,Oregon,40,Oklahoma,111,Okmulgee County,58,22,36
41,Oregon,40,Oklahoma,115,Ottawa County,20,9,11
41,Oregon,40,Oklahoma,119,Payne County,122,41,81
41,Oregon,40,Oklahoma,123,Pontotoc County,0,12,-12
41,Oregon,40,Oklahoma,125,Pottawatomie County,174,0,174
41,Oregon,40,Oklahoma,131,Rogers County,0,7,-7
41,Oregon,40,Oklahoma,135,Sequoyah County,0,4,-4
41,Oregon,40,Oklahoma,137,Stephens County,18,5,13
41,Oregon,40,Oklahoma,139,Texas County,0,5,-5
41,Oregon,40,Oklahoma,143,Tulsa County,265,77,188
41,Oregon,40,Oklahoma,145,Wagoner County,129,19,110
41,Oregon,40,Oklahoma,147,Washington County,17,2,15
41,Oregon,40,Oklahoma,153,Woodward County,17,0,17
41,Oregon,41,Oregon,1,Baker County,1463,834,629
41,Oregon,41,Oregon,3,Benton County,6278,6836,-558
41,Oregon,41,Oregon,5,Clackamas County,17700,19144,-1444
41,Oregon,41,Oregon,7,Clatsop County,1207,1820,-613
41,Oregon,41,Oregon,9,Columbia County,1760,2356,-596
41,Oregon,41,Oregon,11,Coos County,2474,1426,1048
41,Oregon,41,Oregon,13,Crook County,1051,1602,-551
41,Oregon,41,Oregon,15,Curry County,610,626,-16
41,Oregon,41,Oregon,17,Deschutes County,5634,4539,1095
41,Oregon,41,Oregon,19,Douglas County,3349,2782,567
41,Oregon,41,Oregon,21,Gilliam County,34,58,-24
41,Oregon,41,Oregon,23,Grant County,362,209,153
41,Oregon,41,Oregon,25,Harney County,268,469,-201
41,Oregon,41,Oregon,27,Hood River County,592,275,317
41,Oregon,41,Oregon,29,Jackson County,5597,5006,591
41,Oregon,41,Oregon,31,Jefferson County,1277,1625,-348
41,Oregon,41,Oregon,33,Josephine County,2462,2496,-34
41,Oregon,41,Oregon,35,Klamath County,2295,1821,474
41,Oregon,41,Oregon,37,Lake County,719,479,240
41,Oregon,41,Oregon,39,Lane County,8753,10283,-1530
41,Oregon,41,Oregon,41,Lincoln County,1719,1732,-13
41,Oregon,41,Oregon,43,Linn County,5882,6037,-155
41,Oregon,41,Oregon,45,Malheur County,1032,1447,-415
41,Oregon,41,Oregon,47,Marion County,12921,13854,-933
41,Oregon,41,Oregon,49,Morrow County,314,514,-200
41,Oregon,41,Oregon,51,Multnomah County,28173,24678,3495
41,Oregon,41,Oregon,53,Polk County,5744,6229,-485
41,Oregon,41,Oregon,55,Sherman County,155,99,56
41,Oregon,41,Oregon,57,Tillamook County,930,986,-56
41,Oregon,41,Oregon,59,Umatilla County,2115,2601,-486
41,Oregon,41,Oregon,61,Union County,682,1071,-389
41,Oregon,41,Oregon,63,Wallowa County,275,208,67
41,Oregon,41,Oregon,65,Wasco County,972,823,149
41,Oregon,41,Oregon,67,Washington County,20605,19833,772
41,Oregon,41,Oregon,69,Wheeler County,20,95,-75
41,Oregon,41,Oregon,71,Yamhill County,4473,5004,-531
41,Oregon,42,Pennsylvania,1,Adams County,0,6,-6
41,Oregon,42,Pennsylvania,3,Allegheny County,388,128,260
41,Oregon,42,Pennsylvania,5,Armstrong County,0,29,-29
41,Oregon,42,Pennsylvania,7,Beaver County,25,0,25
41,Oregon,42,Pennsylvania,9,Bedford County,0,15,-15
41,Oregon,42,Pennsylvania,11,Berks County,53,14,39
41,Oregon,42,Pennsylvania,17,Bucks County,30,101,-71
41,Oregon,42,Pennsylvania,19,Butler County,4,53,-49
41,Oregon,42,Pennsylvania,27,Centre County,69,22,47
41,Oregon,42,Pennsylvania,29,Chester County,0,98,-98
41,Oregon,42,Pennsylvania,33,Clearfield County,8,0,8
41,Oregon,42,Pennsylvania,41,Cumberland County,21,18,3
41,Oregon,42,Pennsylvania,43,Dauphin County,0,23,-23
41,Oregon,42,Pennsylvania,45,Delaware County,53,94,-41
41,Oregon,42,Pennsylvania,49,Erie County,23,112,-89
41,Oregon,42,Pennsylvania,51,Fayette County,0,4,-4
41,Oregon,42,Pennsylvania,59,Greene County,10,0,10
41,Oregon,42,Pennsylvania,63,Indiana County,13,0,13
41,Oregon,42,Pennsylvania,69,Lackawanna County,33,1,32
41,Oregon,42,Pennsylvania,71,Lancaster County,105,85,20
41,Oregon,42,Pennsylvania,73,Lawrence County,14,5,9
41,Oregon,42,Pennsylvania,77,Lehigh County,176,0,176
41,Oregon,42,Pennsylvania,79,Luzerne County,42,13,29
41,Oregon,42,Pennsylvania,81,Lycoming County,8,0,8
41,Oregon,42,Pennsylvania,87,Mifflin County,0,6,-6
41,Oregon,42,Pennsylvania,91,Montgomery County,41,102,-61
41,Oregon,42,Pennsylvania,93,Montour County,0,5,-5
41,Oregon,42,Pennsylvania,95,Northampton County,98,77,21
41,Oregon,42,Pennsylvania,101,Philadelphia County,234,221,13
41,Oregon,42,Pennsylvania,103,Pike County,0,26,-26
41,Oregon,42,Pennsylvania,107,Schuylkill County,0,10,-10
41,Oregon,42,Pennsylvania,111,Somerset County,0,19,-19
41,Oregon,42,Pennsylvania,117,Tioga County,95,0,95
41,Oregon,42,Pennsylvania,119,Union County,15,42,-27
41,Oregon,42,Pennsylvania,123,Warren County,153,0,153
41,Oregon,42,Pennsylvania,129,Westmoreland County,91,0,91
41,Oregon,42,Pennsylvania,133,York County,0,74,-74
41,Oregon,44,Rhode Island,1,Bristol County,53,0,53
41,Oregon,44,Rhode Island,3,Kent County,33,44,-11
41,Oregon,44,Rhode Island,5,Newport County,2,0,2
41,Oregon,44,Rhode Island,7,Providence County,65,37,28
41,Oregon,44,Rhode Island,9,Washington County,0,7,-7
41,Oregon,45,South Carolina,3,Aiken County,0,13,-13
41,Oregon,45,South Carolina,13,Beaufort County,4,18,-14
41,Oregon,45,South Carolina,15,Berkeley County,109,86,23
41,Oregon,45,South Carolina,19,Charleston County,58,43,15
41,Oregon,45,South Carolina,29,Colleton County,0,8,-8
41,Oregon,45,South Carolina,33,Dillon County,24,0,24
41,Oregon,45,South Carolina,41,Florence County,113,0,113
41,Oregon,45,South Carolina,45,Greenville County,73,83,-10
41,Oregon,45,South Carolina,63,Lexington County,0,49,-49
41,Oregon,45,South Carolina,79,Richland County,35,211,-176
41,Oregon,45,South Carolina,85,Sumter County,60,20,40
41,Oregon,45,South Carolina,87,Union County,0,15,-15
41,Oregon,45,South Carolina,91,York County,155,0,155
41,Oregon,46,South Dakota,19,Butte County,5,0,5
41,Oregon,46,South Dakota,29,Codington County,0,15,-15
41,Oregon,46,South Dakota,33,Custer County,0,13,-13
41,Oregon,46,South Dakota,35,Davison County,0,24,-24
41,Oregon,46,South Dakota,39,Deuel County,0,19,-19
41,Oregon,46,South Dakota,41,Dewey County,0,8,-8
41,Oregon,46,South Dakota,53,Gregory County,0,12,-12
41,Oregon,46,South Dakota,71,Jackson County,0,5,-5
41,Oregon,46,South Dakota,81,Lawrence County,9,0,9
41,Oregon,46,South Dakota,83,Lincoln County,8,15,-7
41,Oregon,46,South Dakota,93,Meade County,19,0,19
41,Oregon,46,South Dakota,99,Minnehaha County,26,3,23
41,Oregon,46,South Dakota,103,Pennington County,77,0,77
41,Oregon,46,South Dakota,105,Perkins County,0,4,-4
41,Oregon,46,South Dakota,109,Roberts County,7,0,7
41,Oregon,46,South Dakota,125,Turner County,79,0,79
41,Oregon,46,South Dakota,135,Yankton County,156,14,142
41,Oregon,47,Tennessee,21,Cheatham County,0,18,-18
41,Oregon,47,Tennessee,23,Chester County,22,0,22
41,Oregon,47,Tennessee,31,Coffee County,0,14,-14
41,Oregon,47,Tennessee,37,Davidson County,306,194,112
41,Oregon,47,Tennessee,65,Hamilton County,28,79,-51
41,Oregon,47,Tennessee,77,Henderson County,84,0,84
41,Oregon,47,Tennessee,79,Henry County,29,0,29
41,Oregon,47,Tennessee,89,Jefferson County,30,0,30
41,Oregon,47,Tennessee,93,Knox County,0,22,-22
41,Oregon,47,Tennessee,103,Lincoln County,0,98,-98
41,Oregon,47,Tennessee,119,Maury County,0,16,-16
41,Oregon,47,Tennessee,123,Monroe County,0,8,-8
41,Oregon,47,Tennessee,125,Montgomery County,97,98,-1
41,Oregon,47,Tennessee,131,Obion County,0,2,-2
41,Oregon,47,Tennessee,141,Putnam County,0,14,-14
41,Oregon,47,Tennessee,143,Rhea County,0,11,-11
41,Oregon,47,Tennessee,149,Rutherford County,30,33,-3
41,Oregon,47,Tennessee,157,Shelby County,308,109,199
41,Oregon,47,Tennessee,163,Sullivan County,0,25,-25
41,Oregon,47,Tennessee,167,Tipton County,4,0,4
41,Oregon,47,Tennessee,177,Warren County,0,19,-19
41,Oregon,47,Tennessee,179,Washington County,0,9,-9
41,Oregon,47,Tennessee,187,Williamson County,50,28,22
41,Oregon,47,Tennessee,189,Wilson County,41,0,41
41,Oregon,48,Texas,15,Austin County,17,0,17
41,Oregon,48,Texas,19,Bandera County,18,0,18
41,Oregon,48,Texas,27,Bell County,426,63,363
41,Oregon,48,Texas,29,Bexar County,410,332,78
41,Oregon,48,Texas,39,Brazoria County,79,2,77
41,Oregon,48,Texas,41,Brazos County,121,5,116
41,Oregon,48,Texas,43,Brewster County,0,13,-13
41,Oregon,48,Texas,45,Briscoe County,0,9,-9
41,Oregon,48,Texas,49,Brown County,0,4,-4
41,Oregon,48,Texas,55,Caldwell County,0,52,-52
41,Oregon,48,Texas,61,Cameron County,11,13,-2
41,Oregon,48,Texas,85,Collin County,263,193,70
41,Oregon,48,Texas,91,Comal County,0,39,-39
41,Oregon,48,Texas,99,Coryell County,25,0,25
41,Oregon,48,Texas,111,Dallam County,26,0,26
41,Oregon,48,Texas,113,Dallas County,477,361,116
41,Oregon,48,Texas,117,Deaf Smith County,48,0,48
41,Oregon,48,Texas,121,Denton County,520,238,282
41,Oregon,48,Texas,123,DeWitt County,0,8,-8
41,Oregon,48,Texas,125,Dickens County,0,14,-14
41,Oregon,48,Texas,135,Ector County,168,10,158
41,Oregon,48,Texas,139,Ellis County,5,29,-24
41,Oregon,48,Texas,141,El Paso County,164,151,13
41,Oregon,48,Texas,143,Erath County,14,0,14
41,Oregon,48,Texas,145,Falls County,0,14,-14
41,Oregon,48,Texas,157,Fort Bend County,28,18,10
41,Oregon,48,Texas,167,Galveston County,0,23,-23
41,Oregon,48,Texas,181,Grayson County,34,26,8
41,Oregon,48,Texas,187,Guadalupe County,77,0,77
41,Oregon,48,Texas,189,Hale County,0,9,-9
41,Oregon,48,Texas,201,Harris County,597,623,-26
41,Oregon,48,Texas,209,Hays County,0,110,-110
41,Oregon,48,Texas,213,Henderson County,11,0,11
41,Oregon,48,Texas,215,Hidalgo County,96,30,66
41,Oregon,48,Texas,217,Hill County,0,96,-96
41,Oregon,48,Texas,221,Hood County,62,11,51
41,Oregon,48,Texas,245,Jefferson County,0,16,-16
41,Oregon,48,Texas,249,Jim Wells County,0,37,-37
41,Oregon,48,Texas,251,Johnson County,0,10,-10
41,Oregon,48,Texas,257,Kaufman County,0,23,-23
41,Oregon,48,Texas,267,Kimble County,10,0,10
41,Oregon,48,Texas,273,Kleberg County,45,0,45
41,Oregon,48,Texas,277,Lamar County,0,6,-6
41,Oregon,48,Texas,291,Liberty County,36,0,36
41,Oregon,48,Texas,299,Llano County,19,12,7
41,Oregon,48,Texas,303,Lubbock County,95,0,95
41,Oregon,48,Texas,309,McLennan County,68,43,25
41,Oregon,48,Texas,329,Midland County,10,53,-43
41,Oregon,48,Texas,339,Montgomery County,36,53,-17
41,Oregon,48,Texas,355,Nueces County,0,46,-46
41,Oregon,48,Texas,363,Palo Pinto County,0,15,-15
41,Oregon,48,Texas,367,Parker County,50,205,-155
41,Oregon,48,Texas,375,Potter County,24,93,-69
41,Oregon,48,Texas,381,Randall County,0,12,-12
41,Oregon,48,Texas,389,Reeves County,66,11,55
41,Oregon,48,Texas,397,Rockwall County,0,40,-40
41,Oregon,48,Texas,401,Rusk County,0,33,-33
41,Oregon,48,Texas,409,San Patricio County,36,16,20
41,Oregon,48,Texas,423,Smith County,162,0,162
41,Oregon,48,Texas,439,Tarrant County,512,127,385
41,Oregon,48,Texas,441,Taylor County,31,14,17
41,Oregon,48,Texas,451,Tom Green County,99,43,56
41,Oregon,48,Texas,453,Travis County,956,466,490
41,Oregon,48,Texas,457,Tyler County,0,8,-8
41,Oregon,48,Texas,469,Victoria County,5,42,-37
41,Oregon,48,Texas,471,Walker County,32,0,32
41,Oregon,48,Texas,477,Washington County,0,1,-1
41,Oregon,48,Texas,479,Webb County,0,40,-40
41,Oregon,48,Texas,485,Wichita County,30,0,30
41,Oregon,48,Texas,491,Williamson County,295,33,262
41,Oregon,48,Texas,497,Wise County,190,0,190
41,Oregon,49,Utah,1,Beaver County,0,21,-21
41,Oregon,49,Utah,3,Box Elder County,0,7,-7
41,Oregon,49,Utah,5,Cache County,224,57,167
41,Oregon,49,Utah,7,Carbon County,137,23,114
41,Oregon,49,Utah,11,Davis County,135,297,-162
41,Oregon,49,Utah,13,Duchesne County,0,10,-10
41,Oregon,49,Utah,15,Emery County,41,0,41
41,Oregon,49,Utah,19,Grand County,26,3,23
41,Oregon,49,Utah,21,Iron County,43,91,-48
41,Oregon,49,Utah,23,Juab County,0,12,-12
41,Oregon,49,Utah,25,Kane County,14,49,-35
41,Oregon,49,Utah,35,Salt Lake County,1329,926,403
41,Oregon,49,Utah,39,Sanpete County,45,43,2
41,Oregon,49,Utah,43,Summit County,54,17,37
41,Oregon,49,Utah,45,Tooele County,93,32,61
41,Oregon,49,Utah,47,Uintah County,0,15,-15
41,Oregon,49,Utah,49,Utah County,579,661,-82
41,Oregon,49,Utah,51,Wasatch County,0,46,-46
41,Oregon,49,Utah,53,Washington County,122,283,-161
41,Oregon,49,Utah,57,Weber County,205,146,59
41,Oregon,5,Arkansas,7,Benton County,36,21,15
41,Oregon,5,Arkansas,15,Carroll County,46,0,46
41,Oregon,5,Arkansas,19,Clark County,101,0,101
41,Oregon,5,Arkansas,31,Craighead County,21,0,21
41,Oregon,5,Arkansas,33,Crawford County,8,0,8
41,Oregon,5,Arkansas,35,Crittenden County,12,0,12
41,Oregon,5,Arkansas,45,Faulkner County,22,0,22
41,Oregon,5,Arkansas,49,Fulton County,19,0,19
41,Oregon,5,Arkansas,51,Garland County,29,24,5
41,Oregon,5,Arkansas,55,Greene County,16,3,13
41,Oregon,5,Arkansas,65,Izard County,0,16,-16
41,Oregon,5,Arkansas,69,Jefferson County,25,0,25
41,Oregon,5,Arkansas,83,Logan County,11,0,11
41,Oregon,5,Arkansas,85,Lonoke County,0,25,-25
41,Oregon,5,Arkansas,87,Madison County,0,5,-5
41,Oregon,5,Arkansas,91,Miller County,13,0,13
41,Oregon,5,Arkansas,119,Pulaski County,102,47,55
41,Oregon,5,Arkansas,125,Saline County,53,58,-5
41,Oregon,5,Arkansas,131,Sebastian County,66,89,-23
41,Oregon,5,Arkansas,135,Sharp County,0,48,-48
41,Oregon,5,Arkansas,143,Washington County,8,19,-11
41,Oregon,5,Arkansas,145,White County,52,66,-14
41,Oregon,50,Vermont,1,Addison County,0,16,-16
41,Oregon,50,Vermont,3,Bennington County,0,27,-27
41,Oregon,50,Vermont,5,Caledonia County,20,0,20
41,Oregon,50,Vermont,7,Chittenden County,101,151,-50
41,Oregon,50,Vermont,15,Lamoille County,8,0,8
41,Oregon,50,Vermont,17,Orange County,0,14,-14
41,Oregon,50,Vermont,21,Rutland County,30,0,30
41,Oregon,50,Vermont,23,Washington County,8,66,-58
41,Oregon,50,Vermont,25,Windham County,31,9,22
41,Oregon,50,Vermont,27,Windsor County,25,8,17
41,Oregon,51,Virginia,1,Accomack County,68,0,68
41,Oregon,51,Virginia,3,Albemarle County,30,60,-30
41,Oregon,51,Virginia,13,Arlington County,106,18,88
41,Oregon,51,Virginia,19,Bedford County,0,19,-19
41,Oregon,51,Virginia,41,Chesterfield County,34,16,18
41,Oregon,51,Virginia,47,Culpeper County,10,0,10
41,Oregon,51,Virginia,59,Fairfax County,686,131,555
41,Oregon,51,Virginia,69,Frederick County,0,4,-4
41,Oregon,51,Virginia,87,Henrico County,29,8,21
41,Oregon,51,Virginia,95,James City County,0,31,-31
41,Oregon,51,Virginia,107,Loudoun County,28,11,17
41,Oregon,51,Virginia,121,Montgomery County,53,0,53
41,Oregon,51,Virginia,147,Prince Edward County,79,0,79
41,Oregon,51,Virginia,149,Prince George County,31,0,31
41,Oregon,51,Virginia,153,Prince William County,29,0,29
41,Oregon,51,Virginia,165,Rockingham County,48,0,48
41,Oregon,51,Virginia,169,Scott County,5,0,5
41,Oregon,51,Virginia,171,Shenandoah County,0,13,-13
41,Oregon,51,Virginia,179,Stafford County,0,77,-77
41,Oregon,51,Virginia,187,Warren County,4,0,4
41,Oregon,51,Virginia,199,York County,23,12,11
41,Oregon,51,Virginia,510,Alexandria city,128,50,78
41,Oregon,51,Virginia,540,Charlottesville city,39,8,31
41,Oregon,51,Virginia,550,Chesapeake city,0,17,-17
41,Oregon,51,Virginia,590,Danville city,15,6,9
41,Oregon,51,Virginia,600,Fairfax city,94,0,94
41,Oregon,51,Virginia,630,Fredericksburg city,19,0,19
41,Oregon,51,Virginia,650,Hampton city,15,47,-32
41,Oregon,51,Virginia,660,Harrisonburg city,167,20,147
41,Oregon,51,Virginia,680,Lynchburg city,59,30,29
41,Oregon,51,Virginia,700,Newport News city,0,30,-30
41,Oregon,51,Virginia,710,Norfolk city,173,10,163
41,Oregon,51,Virginia,740,Portsmouth city,53,0,53
41,Oregon,51,Virginia,760,Richmond city,57,15,42
41,Oregon,51,Virginia,770,Roanoke city,152,0,152
41,Oregon,51,Virginia,800,Suffolk city,0,20,-20
41,Oregon,51,Virginia,810,Virginia Beach city,491,80,411
41,Oregon,51,Virginia,830,Williamsburg city,4,0,4
41,Oregon,53,Washington,1,Adams County,14,15,-1
41,Oregon,53,Washington,3,Asotin County,64,138,-74
41,Oregon,53,Washington,5,Benton County,658,1114,-456
41,Oregon,53,Washington,7,Chelan County,208,97,111
41,Oregon,53,Washington,9,Clallam County,216,227,-11
41,Oregon,53,Washington,11,Clark County,8149,10328,-2179
41,Oregon,53,Washington,13,Columbia County,64,25,39
41,Oregon,53,Washington,15,Cowlitz County,1027,1120,-93
41,Oregon,53,Washington,17,Douglas County,224,28,196
41,Oregon,53,Washington,19,Ferry County,89,21,68
41,Oregon,53,Washington,21,Franklin County,83,312,-229
41,Oregon,53,Washington,23,Garfield County,0,23,-23
41,Oregon,53,Washington,25,Grant County,323,231,92
41,Oregon,53,Washington,27,Grays Harbor County,449,173,276
41,Oregon,53,Washington,29,Island County,224,74,150
41,Oregon,53,Washington,31,Jefferson County,65,136,-71
41,Oregon,53,Washington,33,King County,4573,5032,-459
41,Oregon,53,Washington,35,Kitsap County,452,596,-144
41,Oregon,53,Washington,37,Kittitas County,180,117,63
41,Oregon,53,Washington,39,Klickitat County,526,544,-18
41,Oregon,53,Washington,41,Lewis County,202,379,-177
41,Oregon,53,Washington,43,Lincoln County,0,6,-6
41,Oregon,53,Washington,45,Mason County,148,192,-44
41,Oregon,53,Washington,47,Okanogan County,92,68,24
41,Oregon,53,Washington,49,Pacific County,137,241,-104
41,Oregon,53,Washington,51,Pend Oreille County,0,2,-2
41,Oregon,53,Washington,53,Pierce County,1643,1470,173
41,Oregon,53,Washington,55,San Juan County,115,131,-16
41,Oregon,53,Washington,57,Skagit County,264,156,108
41,Oregon,53,Washington,59,Skamania County,111,255,-144
41,Oregon,53,Washington,61,Snohomish County,1625,1799,-174
41,Oregon,53,Washington,63,Spokane County,740,1279,-539
41,Oregon,53,Washington,65,Stevens County,178,28,150
41,Oregon,53,Washington,67,Thurston County,886,494,392
41,Oregon,53,Washington,69,Wahkiakum County,4,6,-2
41,Oregon,53,Washington,71,Walla Walla County,249,847,-598
41,Oregon,53,Washington,73,Whatcom County,546,306,240
41,Oregon,53,Washington,75,Whitman County,155,214,-59
41,Oregon,53,Washington,77,Yakima County,698,646,52
41,Oregon,54,West Virginia,3,Berkeley County,0,25,-25
41,Oregon,54,West Virginia,19,Fayette County,0,12,-12
41,Oregon,54,West Virginia,29,Hancock County,0,7,-7
41,Oregon,54,West Virginia,33,Harrison County,0,3,-3
41,Oregon,54,West Virginia,39,Kanawha County,8,7,1
41,Oregon,54,West Virginia,49,Marion County,0,1,-1
41,Oregon,54,West Virginia,61,Monongalia County,65,34,31
41,Oregon,54,West Virginia,63,Monroe County,0,2,-2
41,Oregon,54,West Virginia,85,Ritchie County,9,0,9
41,Oregon,55,Wisconsin,5,Barron County,0,7,-7
41,Oregon,55,Wisconsin,9,Brown County,36,0,36
41,Oregon,55,Wisconsin,13,Burnett County,0,1,-1
41,Oregon,55,Wisconsin,19,Clark County,0,9,-9
41,Oregon,55,Wisconsin,21,Columbia County,0,59,-59
41,Oregon,55,Wisconsin,25,Dane County,477,188,289
41,Oregon,55,Wisconsin,27,Dodge County,0,2,-2
41,Oregon,55,Wisconsin,31,Douglas County,0,4,-4
41,Oregon,55,Wisconsin,35,Eau Claire County,0,1,-1
41,Oregon,55,Wisconsin,39,Fond du Lac County,44,17,27
41,Oregon,55,Wisconsin,43,Grant County,0,46,-46
41,Oregon,55,Wisconsin,45,Green County,0,7,-7
41,Oregon,55,Wisconsin,47,Green Lake County,0,2,-2
41,Oregon,55,Wisconsin,49,Iowa County,0,2,-2
41,Oregon,55,Wisconsin,53,Jackson County,9,0,9
41,Oregon,55,Wisconsin,57,Juneau County,18,1,17
41,Oregon,55,Wisconsin,59,Kenosha County,29,40,-11
41,Oregon,55,Wisconsin,63,La Crosse County,66,16,50
41,Oregon,55,Wisconsin,69,Lincoln County,0,16,-16
41,Oregon,55,Wisconsin,71,Manitowoc County,0,8,-8
41,Oregon,55,Wisconsin,75,Marinette County,0,4,-4
41,Oregon,55,Wisconsin,79,Milwaukee County,261,138,123
41,Oregon,55,Wisconsin,81,Monroe County,0,5,-5
41,Oregon,55,Wisconsin,87,Outagamie County,55,32,23
41,Oregon,55,Wisconsin,95,Polk County,0,3,-3
41,Oregon,55,Wisconsin,97,Portage County,20,42,-22
41,Oregon,55,Wisconsin,101,Racine County,0,45,-45
41,Oregon,55,Wisconsin,105,Rock County,0,10,-10
41,Oregon,55,Wisconsin,107,Rusk County,0,1,-1
41,Oregon,55,Wisconsin,109,St. Croix County,28,0,28
41,Oregon,55,Wisconsin,111,Sauk County,0,5,-5
41,Oregon,55,Wisconsin,115,Shawano County,0,2,-2
41,Oregon,55,Wisconsin,119,Taylor County,0,6,-6
41,Oregon,55,Wisconsin,125,Vilas County,0,7,-7
41,Oregon,55,Wisconsin,127,Walworth County,0,3,-3
41,Oregon,55,Wisconsin,129,Washburn County,21,0,21
41,Oregon,55,Wisconsin,133,Waukesha County,83,6,77
41,Oregon,55,Wisconsin,135,Waupaca County,0,6,-6
41,Oregon,55,Wisconsin,139,Winnebago County,0,1,-1
41,Oregon,55,Wisconsin,141,Wood County,14,10,4
41,Oregon,56,Wyoming,1,Albany County,160,7,153
41,Oregon,56,Wyoming,3,Big Horn County,21,0,21
41,Oregon,56,Wyoming,5,Campbell County,4,244,-240
41,Oregon,56,Wyoming,7,Carbon County,23,0,23
41,Oregon,56,Wyoming,13,Fremont County,115,55,60
41,Oregon,56,Wyoming,15,Goshen County,0,1,-1
41,Oregon,56,Wyoming,21,Laramie County,211,107,104
41,Oregon,56,Wyoming,25,Natrona County,27,86,-59
41,Oregon,56,Wyoming,27,Niobrara County,19,0,19
41,Oregon,56,Wyoming,29,Park County,15,1,14
41,Oregon,56,Wyoming,33,Sheridan County,72,71,1
41,Oregon,56,Wyoming,35,Sublette County,5,0,5
41,Oregon,56,Wyoming,37,Sweetwater County,33,136,-103
41,Oregon,56,Wyoming,39,Teton County,208,22,186
41,Oregon,56,Wyoming,41,Uinta County,21,28,-7
41,Oregon,6,California,1,Alameda County,1814,622,1192
41,Oregon,6,California,5,Amador County,33,14,19
41,Oregon,6,California,7,Butte County,974,253,721
41,Oregon,6,California,9,Calaveras County,162,31,131
41,Oregon,6,California,11,Colusa County,0,43,-43
41,Oregon,6,California,13,Contra Costa County,974,659,315
41,Oregon,6,California,15,Del Norte County,398,238,160
41,Oregon,6,California,17,El Dorado County,395,55,340
41,Oregon,6,California,19,Fresno County,1303,364,939
41,Oregon,6,California,21,Glenn County,0,7,-7
41,Oregon,6,California,23,Humboldt County,355,534,-179
41,Oregon,6,California,25,Imperial County,293,4,289
41,Oregon,6,California,27,Inyo County,36,10,26
41,Oregon,6,California,29,Kern County,648,99,549
41,Oregon,6,California,31,Kings County,76,34,42
41,Oregon,6,California,33,Lake County,310,72,238
41,Oregon,6,California,35,Lassen County,129,25,104
41,Oregon,6,California,37,Los Angeles County,6592,2698,3894
41,Oregon,6,California,39,Madera County,66,2,64
41,Oregon,6,California,41,Marin County,244,175,69
41,Oregon,6,California,43,Mariposa County,104,11,93
41,Oregon,6,California,45,Mendocino County,486,55,431
41,Oregon,6,California,47,Merced County,218,201,17
41,Oregon,6,California,49,Modoc County,148,64,84
41,Oregon,6,California,51,Mono County,16,0,16
41,Oregon,6,California,53,Monterey County,866,575,291
41,Oregon,6,California,55,Napa County,291,208,83
41,Oregon,6,California,57,Nevada County,208,108,100
41,Oregon,6,California,59,Orange County,1789,923,866
41,Oregon,6,California,61,Placer County,626,225,401
41,Oregon,6,California,63,Plumas County,32,36,-4
41,Oregon,6,California,65,Riverside County,2052,1054,998
41,Oregon,6,California,67,Sacramento County,1720,1340,380
41,Oregon,6,California,69,San Benito County,58,37,21
41,Oregon,6,California,71,San Bernardino County,1439,724,715
41,Oregon,6,California,73,San Diego County,3030,2134,896
41,Oregon,6,California,75,San Francisco County,1663,744,919
41,Oregon,6,California,77,San Joaquin County,372,352,20
41,Oregon,6,California,79,San Luis Obispo County,318,443,-125
41,Oregon,6,California,81,San Mateo County,535,219,316
41,Oregon,6,California,83,Santa Barbara County,524,408,116
41,Oregon,6,California,85,Santa Clara County,1964,1071,893
41,Oregon,6,California,87,Santa Cruz County,584,59,525
41,Oregon,6,California,89,Shasta County,648,501,147
41,Oregon,6,California,93,Siskiyou County,432,206,226
41,Oregon,6,California,95,Solano County,378,308,70
41,Oregon,6,California,97,Sonoma County,445,865,-420
41,Oregon,6,California,99,Stanislaus County,629,145,484
41,Oregon,6,California,101,Sutter County,195,45,150
41,Oregon,6,California,103,Tehama County,164,122,42
41,Oregon,6,California,105,Trinity County,173,27,146
41,Oregon,6,California,107,Tulare County,284,79,205
41,Oregon,6,California,109,Tuolumne County,88,162,-74
41,Oregon,6,California,111,Ventura County,873,247,626
41,Oregon,6,California,113,Yolo County,418,191,227
41,Oregon,6,California,115,Yuba County,28,194,-166
41,Oregon,72,Puerto Rico,21,Bayamón Municipio,10,0,10
41,Oregon,72,Puerto Rico,127,San Juan Municipio,25,14,11
41,Oregon,8,Colorado,1,Adams County,157,170,-13
41,Oregon,8,Colorado,3,Alamosa County,38,34,4
41,Oregon,8,Colorado,5,Arapahoe County,199,338,-139
41,Oregon,8,Colorado,11,Bent County,0,9,-9
41,Oregon,8,Colorado,13,Boulder County,296,515,-219
41,Oregon,8,Colorado,14,Broomfield County,75,0,75
41,Oregon,8,Colorado,15,Chaffee County,20,0,20
41,Oregon,8,Colorado,19,Clear Creek County,15,0,15
41,Oregon,8,Colorado,29,Delta County,20,0,20
41,Oregon,8,Colorado,31,Denver County,755,599,156
41,Oregon,8,Colorado,35,Douglas County,111,222,-111
41,Oregon,8,Colorado,37,Eagle County,21,27,-6
41,Oregon,8,Colorado,41,El Paso County,589,491,98
41,Oregon,8,Colorado,43,Fremont County,14,0,14
41,Oregon,8,Colorado,45,Garfield County,129,1,128
41,Oregon,8,Colorado,47,Gilpin County,45,14,31
41,Oregon,8,Colorado,51,Gunnison County,11,3,8
41,Oregon,8,Colorado,59,Jefferson County,407,327,80
41,Oregon,8,Colorado,67,La Plata County,304,10,294
41,Oregon,8,Colorado,69,Larimer County,242,195,47
41,Oregon,8,Colorado,75,Logan County,14,19,-5
41,Oregon,8,Colorado,77,Mesa County,85,76,9
41,Oregon,8,Colorado,83,Montezuma County,15,14,1
41,Oregon,8,Colorado,85,Montrose County,9,71,-62
41,Oregon,8,Colorado,87,Morgan County,0,9,-9
41,Oregon,8,Colorado,91,Ouray County,49,0,49
41,Oregon,8,Colorado,93,Park County,0,8,-8
41,Oregon,8,Colorado,95,Phillips County,0,60,-60
41,Oregon,8,Colorado,97,Pitkin County,30,1,29
41,Oregon,8,Colorado,99,Prowers County,0,1,-1
41,Oregon,8,Colorado,101,Pueblo County,75,47,28
41,Oregon,8,Colorado,103,Rio Blanco County,14,0,14
41,Oregon,8,Colorado,107,Routt County,120,36,84
41,Oregon,8,Colorado,117,Summit County,0,31,-31
41,Oregon,8,Colorado,119,Teller County,39,4,35
41,Oregon,8,Colorado,121,Washington County,0,8,-8
41,Oregon,8,Colorado,123,Weld County,283,29,254
41,Oregon,9,Connecticut,1,Fairfield County,190,0,190
41,Oregon,9,Connecticut,3,Hartford County,141,177,-36
41,Oregon,9,Connecticut,5,Litchfield County,9,0,9
41,Oregon,9,Connecticut,7,Middlesex County,0,29,-29
41,Oregon,9,Connecticut,9,New Haven County,196,98,98
41,Oregon,9,Connecticut,11,New London County,48,26,22
41,Oregon,9,Connecticut,13,Tolland County,25,24,1
41,Oregon,AFR,Africa,,-,1551,0,0
41,Oregon,ASI,Asia,,-,10440,0,0
41,Oregon,CAM,Central America,,-,2740,0,0
41,Oregon,CAR,Caribbean,,-,371,0,0
41,Oregon,EUR,Europe,,-,4800,0,0
41,Oregon,ISL,U.S. Island Areas,,-,381,0,0
41,Oregon,NAM,Northern America,,-,915,0,0
41,Oregon,OCE,Oceania and At Sea,,-,635,0,0
41,Oregon,SAM,South America,,-,1056,0,0
42,Pennsylvania,1,Alabama,1,Autauga County,0,7,-7
42,Pennsylvania,1,Alabama,3,Baldwin County,20,81,-61
42,Pennsylvania,1,Alabama,9,Blount County,31,0,31
42,Pennsylvania,1,Alabama,15,Calhoun County,145,37,108
42,Pennsylvania,1,Alabama,17,Chambers County,0,58,-58
42,Pennsylvania,1,Alabama,21,Chilton County,5,0,5
42,Pennsylvania,1,Alabama,31,Coffee County,45,113,-68
42,Pennsylvania,1,Alabama,33,Colbert County,0,2,-2
42,Pennsylvania,1,Alabama,43,Cullman County,0,15,-15
42,Pennsylvania,1,Alabama,45,Dale County,156,0,156
42,Pennsylvania,1,Alabama,49,DeKalb County,0,1,-1
42,Pennsylvania,1,Alabama,51,Elmore County,5,28,-23
42,Pennsylvania,1,Alabama,55,Etowah County,0,26,-26
42,Pennsylvania,1,Alabama,67,Henry County,32,0,32
42,Pennsylvania,1,Alabama,69,Houston County,176,12,164
42,Pennsylvania,1,Alabama,73,Jefferson County,172,51,121
42,Pennsylvania,1,Alabama,81,Lee County,62,124,-62
42,Pennsylvania,1,Alabama,83,Limestone County,48,0,48
42,Pennsylvania,1,Alabama,89,Madison County,193,210,-17
42,Pennsylvania,1,Alabama,95,Marshall County,21,42,-21
42,Pennsylvania,1,Alabama,97,Mobile County,116,125,-9
42,Pennsylvania,1,Alabama,101,Montgomery County,28,67,-39
42,Pennsylvania,1,Alabama,103,Morgan County,0,3,-3
42,Pennsylvania,1,Alabama,107,Pickens County,0,11,-11
42,Pennsylvania,1,Alabama,113,Russell County,4,105,-101
42,Pennsylvania,1,Alabama,117,Shelby County,87,38,49
42,Pennsylvania,1,Alabama,123,Tallapoosa County,67,26,41
42,Pennsylvania,1,Alabama,125,Tuscaloosa County,19,258,-239
42,Pennsylvania,10,Delaware,1,Kent County,414,948,-534
42,Pennsylvania,10,Delaware,3,New Castle County,5590,7811,-2221
42,Pennsylvania,10,Delaware,5,Sussex County,826,1720,-894
42,Pennsylvania,11,District of Columbia,1,District of Columbia,1897,2113,-216
42,Pennsylvania,12,Florida,1,Alachua County,315,574,-259
42,Pennsylvania,12,Florida,5,Bay County,169,90,79
42,Pennsylvania,12,Florida,9,Brevard County,676,1005,-329
42,Pennsylvania,12,Florida,11,Broward County,1038,1623,-585
42,Pennsylvania,12,Florida,13,Calhoun County,0,27,-27
42,Pennsylvania,12,Florida,15,Charlotte County,45,397,-352
42,Pennsylvania,12,Florida,17,Citrus County,58,203,-145
42,Pennsylvania,12,Florida,19,Clay County,35,80,-45
42,Pennsylvania,12,Florida,21,Collier County,243,433,-190
42,Pennsylvania,12,Florida,23,Columbia County,0,25,-25
42,Pennsylvania,12,Florida,27,DeSoto County,14,47,-33
42,Pennsylvania,12,Florida,31,Duval County,948,1516,-568
42,Pennsylvania,12,Florida,33,Escambia County,136,519,-383
42,Pennsylvania,12,Florida,35,Flagler County,79,161,-82
42,Pennsylvania,12,Florida,39,Gadsden County,7,0,7
42,Pennsylvania,12,Florida,41,Gilchrist County,0,9,-9
42,Pennsylvania,12,Florida,43,Glades County,21,0,21
42,Pennsylvania,12,Florida,47,Hamilton County,12,0,12
42,Pennsylvania,12,Florida,53,Hernando County,198,328,-130
42,Pennsylvania,12,Florida,55,Highlands County,63,170,-107
42,Pennsylvania,12,Florida,57,Hillsborough County,1012,1953,-941
42,Pennsylvania,12,Florida,59,Holmes County,0,9,-9
42,Pennsylvania,12,Florida,61,Indian River County,114,408,-294
42,Pennsylvania,12,Florida,63,Jackson County,0,32,-32
42,Pennsylvania,12,Florida,65,Jefferson County,61,18,43
42,Pennsylvania,12,Florida,69,Lake County,361,878,-517
42,Pennsylvania,12,Florida,71,Lee County,539,1367,-828
42,Pennsylvania,12,Florida,73,Leon County,173,54,119
42,Pennsylvania,12,Florida,75,Levy County,49,18,31
42,Pennsylvania,12,Florida,79,Madison County,0,21,-21
42,Pennsylvania,12,Florida,81,Manatee County,315,803,-488
42,Pennsylvania,12,Florida,83,Marion County,235,562,-327
42,Pennsylvania,12,Florida,85,Martin County,126,365,-239
42,Pennsylvania,12,Florida,86,Miami-Dade County,994,1194,-200
42,Pennsylvania,12,Florida,87,Monroe County,158,165,-7
42,Pennsylvania,12,Florida,89,Nassau County,50,83,-33
42,Pennsylvania,12,Florida,91,Okaloosa County,50,79,-29
42,Pennsylvania,12,Florida,93,Okeechobee County,0,20,-20
42,Pennsylvania,12,Florida,95,Orange County,1128,2244,-1116
42,Pennsylvania,12,Florida,97,Osceola County,380,752,-372
42,Pennsylvania,12,Florida,99,Palm Beach County,795,2141,-1346
42,Pennsylvania,12,Florida,101,Pasco County,358,912,-554
42,Pennsylvania,12,Florida,103,Pinellas County,763,2072,-1309
42,Pennsylvania,12,Florida,105,Polk County,859,818,41
42,Pennsylvania,12,Florida,107,Putnam County,21,44,-23
42,Pennsylvania,12,Florida,109,St. Johns County,38,1104,-1066
42,Pennsylvania,12,Florida,111,St. Lucie County,399,918,-519
42,Pennsylvania,12,Florida,113,Santa Rosa County,174,79,95
42,Pennsylvania,12,Florida,115,Sarasota County,297,794,-497
42,Pennsylvania,12,Florida,117,Seminole County,582,786,-204
42,Pennsylvania,12,Florida,119,Sumter County,65,645,-580
42,Pennsylvania,12,Florida,127,Volusia County,523,1235,-712
42,Pennsylvania,12,Florida,129,Wakulla County,20,0,20
42,Pennsylvania,12,Florida,131,Walton County,63,75,-12
42,Pennsylvania,13,Georgia,7,Baker County,0,2,-2
42,Pennsylvania,13,Georgia,9,Baldwin County,0,51,-51
42,Pennsylvania,13,Georgia,15,Bartow County,5,37,-32
42,Pennsylvania,13,Georgia,21,Bibb County,127,65,62
42,Pennsylvania,13,Georgia,25,Brantley County,0,14,-14
42,Pennsylvania,13,Georgia,27,Brooks County,0,118,-118
42,Pennsylvania,13,Georgia,31,Bulloch County,15,0,15
42,Pennsylvania,13,Georgia,39,Camden County,89,17,72
42,Pennsylvania,13,Georgia,45,Carroll County,71,16,55
42,Pennsylvania,13,Georgia,47,Catoosa County,14,0,14
42,Pennsylvania,13,Georgia,51,Chatham County,313,259,54
42,Pennsylvania,13,Georgia,53,Chattahoochee County,47,213,-166
42,Pennsylvania,13,Georgia,57,Cherokee County,67,570,-503
42,Pennsylvania,13,Georgia,59,Clarke County,226,62,164
42,Pennsylvania,13,Georgia,63,Clayton County,14,434,-420
42,Pennsylvania,13,Georgia,67,Cobb County,605,562,43
42,Pennsylvania,13,Georgia,73,Columbia County,91,46,45
42,Pennsylvania,13,Georgia,75,Cook County,0,9,-9
42,Pennsylvania,13,Georgia,79,Crawford County,8,14,-6
42,Pennsylvania,13,Georgia,83,Dade County,0,20,-20
42,Pennsylvania,13,Georgia,85,Dawson County,40,42,-2
42,Pennsylvania,13,Georgia,89,DeKalb County,662,478,184
42,Pennsylvania,13,Georgia,95,Dougherty County,159,6,153
42,Pennsylvania,13,Georgia,97,Douglas County,0,102,-102
42,Pennsylvania,13,Georgia,107,Emanuel County,0,22,-22
42,Pennsylvania,13,Georgia,113,Fayette County,67,95,-28
42,Pennsylvania,13,Georgia,115,Floyd County,182,1,181
42,Pennsylvania,13,Georgia,117,Forsyth County,88,130,-42
42,Pennsylvania,13,Georgia,121,Fulton County,868,979,-111
42,Pennsylvania,13,Georgia,123,Gilmer County,40,0,40
42,Pennsylvania,13,Georgia,127,Glynn County,0,11,-11
42,Pennsylvania,13,Georgia,129,Gordon County,0,254,-254
42,Pennsylvania,13,Georgia,133,Greene County,0,9,-9
42,Pennsylvania,13,Georgia,135,Gwinnett County,358,493,-135
42,Pennsylvania,13,Georgia,139,Hall County,86,166,-80
42,Pennsylvania,13,Georgia,145,Harris County,0,2,-2
42,Pennsylvania,13,Georgia,147,Hart County,9,0,9
42,Pennsylvania,13,Georgia,149,Heard County,0,5,-5
42,Pennsylvania,13,Georgia,151,Henry County,32,400,-368
42,Pennsylvania,13,Georgia,153,Houston County,247,45,202
42,Pennsylvania,13,Georgia,157,Jackson County,0,16,-16
42,Pennsylvania,13,Georgia,167,Johnson County,0,77,-77
42,Pennsylvania,13,Georgia,169,Jones County,0,12,-12
42,Pennsylvania,13,Georgia,173,Lanier County,44,1,43
42,Pennsylvania,13,Georgia,179,Liberty County,0,33,-33
42,Pennsylvania,13,Georgia,183,Long County,108,43,65
42,Pennsylvania,13,Georgia,185,Lowndes County,7,88,-81
42,Pennsylvania,13,Georgia,187,Lumpkin County,0,65,-65
42,Pennsylvania,13,Georgia,191,McIntosh County,0,14,-14
42,Pennsylvania,13,Georgia,193,Macon County,15,0,15
42,Pennsylvania,13,Georgia,195,Madison County,0,4,-4
42,Pennsylvania,13,Georgia,201,Miller County,0,7,-7
42,Pennsylvania,13,Georgia,207,Monroe County,6,0,6
42,Pennsylvania,13,Georgia,215,Muscogee County,321,197,124
42,Pennsylvania,13,Georgia,217,Newton County,56,275,-219
42,Pennsylvania,13,Georgia,223,Paulding County,11,130,-119
42,Pennsylvania,13,Georgia,225,Peach County,0,33,-33
42,Pennsylvania,13,Georgia,235,Pulaski County,0,12,-12
42,Pennsylvania,13,Georgia,237,Putnam County,151,18,133
42,Pennsylvania,13,Georgia,245,Richmond County,149,69,80
42,Pennsylvania,13,Georgia,247,Rockdale County,4,15,-11
42,Pennsylvania,13,Georgia,257,Stephens County,23,0,23
42,Pennsylvania,13,Georgia,275,Thomas County,0,6,-6
42,Pennsylvania,13,Georgia,279,Toombs County,0,104,-104
42,Pennsylvania,13,Georgia,281,Towns County,6,0,6
42,Pennsylvania,13,Georgia,285,Troup County,5,49,-44
42,Pennsylvania,13,Georgia,291,Union County,15,0,15
42,Pennsylvania,13,Georgia,295,Walker County,0,34,-34
42,Pennsylvania,13,Georgia,299,Ware County,0,65,-65
42,Pennsylvania,13,Georgia,317,Wilkes County,19,0,19
42,Pennsylvania,13,Georgia,319,Wilkinson County,0,2,-2
42,Pennsylvania,13,Georgia,321,Worth County,0,6,-6
42,Pennsylvania,15,Hawaii,1,Hawaii County,26,150,-124
42,Pennsylvania,15,Hawaii,3,Honolulu County,655,653,2
42,Pennsylvania,15,Hawaii,7,Kauai County,39,12,27
42,Pennsylvania,15,Hawaii,9,Maui County,5,35,-30
42,Pennsylvania,16,Idaho,1,Ada County,78,137,-59
42,Pennsylvania,16,Idaho,5,Bannock County,0,47,-47
42,Pennsylvania,16,Idaho,9,Benewah County,0,14,-14
42,Pennsylvania,16,Idaho,13,Blaine County,7,5,2
42,Pennsylvania,16,Idaho,15,Boise County,0,1,-1
42,Pennsylvania,16,Idaho,17,Bonner County,0,20,-20
42,Pennsylvania,16,Idaho,19,Bonneville County,40,48,-8
42,Pennsylvania,16,Idaho,27,Canyon County,74,50,24
42,Pennsylvania,16,Idaho,39,Elmore County,0,49,-49
42,Pennsylvania,16,Idaho,53,Jerome County,0,5,-5
42,Pennsylvania,16,Idaho,55,Kootenai County,70,28,42
42,Pennsylvania,16,Idaho,57,Latah County,4,37,-33
42,Pennsylvania,16,Idaho,65,Madison County,172,10,162
42,Pennsylvania,16,Idaho,69,Nez Perce County,0,10,-10
42,Pennsylvania,16,Idaho,71,Oneida County,41,0,41
42,Pennsylvania,16,Idaho,73,Owyhee County,0,1,-1
42,Pennsylvania,16,Idaho,79,Shoshone County,0,16,-16
42,Pennsylvania,16,Idaho,83,Twin Falls County,11,0,11
42,Pennsylvania,16,Idaho,85,Valley County,0,13,-13
42,Pennsylvania,17,Illinois,1,Adams County,0,20,-20
42,Pennsylvania,17,Illinois,11,Bureau County,2,0,2
42,Pennsylvania,17,Illinois,19,Champaign County,64,190,-126
42,Pennsylvania,17,Illinois,23,Clark County,4,0,4
42,Pennsylvania,17,Illinois,27,Clinton County,27,0,27
42,Pennsylvania,17,Illinois,29,Coles County,0,302,-302
42,Pennsylvania,17,Illinois,31,Cook County,1963,2292,-329
42,Pennsylvania,17,Illinois,37,DeKalb County,31,20,11
42,Pennsylvania,17,Illinois,39,De Witt County,28,0,28
42,Pennsylvania,17,Illinois,41,Douglas County,0,4,-4
42,Pennsylvania,17,Illinois,43,DuPage County,288,529,-241
42,Pennsylvania,17,Illinois,49,Effingham County,0,2,-2
42,Pennsylvania,17,Illinois,63,Grundy County,0,51,-51
42,Pennsylvania,17,Illinois,71,Henderson County,84,34,50
42,Pennsylvania,17,Illinois,73,Henry County,0,16,-16
42,Pennsylvania,17,Illinois,77,Jackson County,31,21,10
42,Pennsylvania,17,Illinois,83,Jersey County,0,10,-10
42,Pennsylvania,17,Illinois,85,Jo Daviess County,8,0,8
42,Pennsylvania,17,Illinois,87,Johnson County,0,18,-18
42,Pennsylvania,17,Illinois,89,Kane County,20,55,-35
42,Pennsylvania,17,Illinois,91,Kankakee County,0,59,-59
42,Pennsylvania,17,Illinois,93,Kendall County,11,2,9
42,Pennsylvania,17,Illinois,97,Lake County,345,447,-102
42,Pennsylvania,17,Illinois,99,LaSalle County,10,0,10
42,Pennsylvania,17,Illinois,101,Lawrence County,10,0,10
42,Pennsylvania,17,Illinois,107,Logan County,0,31,-31
42,Pennsylvania,17,Illinois,111,McHenry County,86,75,11
42,Pennsylvania,17,Illinois,113,McLean County,198,61,137
42,Pennsylvania,17,Illinois,115,Macon County,0,33,-33
42,Pennsylvania,17,Illinois,119,Madison County,32,51,-19
42,Pennsylvania,17,Illinois,121,Marion County,24,0,24
42,Pennsylvania,17,Illinois,123,Marshall County,13,0,13
42,Pennsylvania,17,Illinois,129,Menard County,16,0,16
42,Pennsylvania,17,Illinois,137,Morgan County,0,4,-4
42,Pennsylvania,17,Illinois,143,Peoria County,62,42,20
42,Pennsylvania,17,Illinois,147,Piatt County,26,0,26
42,Pennsylvania,17,Illinois,157,Randolph County,0,2,-2
42,Pennsylvania,17,Illinois,161,Rock Island County,35,5,30
42,Pennsylvania,17,Illinois,163,St. Clair County,91,230,-139
42,Pennsylvania,17,Illinois,165,Saline County,32,0,32
42,Pennsylvania,17,Illinois,167,Sangamon County,82,99,-17
42,Pennsylvania,17,Illinois,173,Shelby County,0,26,-26
42,Pennsylvania,17,Illinois,177,Stephenson County,63,0,63
42,Pennsylvania,17,Illinois,179,Tazewell County,21,8,13
42,Pennsylvania,17,Illinois,181,Union County,0,5,-5
42,Pennsylvania,17,Illinois,183,Vermilion County,22,14,8
42,Pennsylvania,17,Illinois,187,Warren County,0,3,-3
42,Pennsylvania,17,Illinois,191,Wayne County,0,43,-43
42,Pennsylvania,17,Illinois,193,White County,40,7,33
42,Pennsylvania,17,Illinois,197,Will County,182,101,81
42,Pennsylvania,17,Illinois,199,Williamson County,36,0,36
42,Pennsylvania,17,Illinois,201,Winnebago County,19,42,-23
42,Pennsylvania,17,Illinois,203,Woodford County,15,9,6
42,Pennsylvania,18,Indiana,1,Adams County,0,57,-57
42,Pennsylvania,18,Indiana,3,Allen County,69,67,2
42,Pennsylvania,18,Indiana,5,Bartholomew County,19,24,-5
42,Pennsylvania,18,Indiana,11,Boone County,5,17,-12
42,Pennsylvania,18,Indiana,13,Brown County,0,2,-2
42,Pennsylvania,18,Indiana,17,Cass County,0,22,-22
42,Pennsylvania,18,Indiana,19,Clark County,0,23,-23
42,Pennsylvania,18,Indiana,33,DeKalb County,10,6,4
42,Pennsylvania,18,Indiana,35,Delaware County,221,24,197
42,Pennsylvania,18,Indiana,39,Elkhart County,56,36,20
42,Pennsylvania,18,Indiana,41,Fayette County,10,0,10
42,Pennsylvania,18,Indiana,43,Floyd County,10,10,0
42,Pennsylvania,18,Indiana,51,Gibson County,10,0,10
42,Pennsylvania,18,Indiana,53,Grant County,13,0,13
42,Pennsylvania,18,Indiana,55,Greene County,0,5,-5
42,Pennsylvania,18,Indiana,57,Hamilton County,107,160,-53
42,Pennsylvania,18,Indiana,59,Hancock County,19,34,-15
42,Pennsylvania,18,Indiana,61,Harrison County,0,52,-52
42,Pennsylvania,18,Indiana,63,Hendricks County,111,23,88
42,Pennsylvania,18,Indiana,65,Henry County,0,7,-7
42,Pennsylvania,18,Indiana,67,Howard County,46,0,46
42,Pennsylvania,18,Indiana,69,Huntington County,0,32,-32
42,Pennsylvania,18,Indiana,73,Jasper County,0,2,-2
42,Pennsylvania,18,Indiana,75,Jay County,0,6,-6
42,Pennsylvania,18,Indiana,77,Jefferson County,10,0,10
42,Pennsylvania,18,Indiana,83,Knox County,0,9,-9
42,Pennsylvania,18,Indiana,85,Kosciusko County,44,81,-37
42,Pennsylvania,18,Indiana,87,LaGrange County,0,25,-25
42,Pennsylvania,18,Indiana,89,Lake County,225,35,190
42,Pennsylvania,18,Indiana,91,LaPorte County,11,151,-140
42,Pennsylvania,18,Indiana,95,Madison County,24,25,-1
42,Pennsylvania,18,Indiana,97,Marion County,400,230,170
42,Pennsylvania,18,Indiana,99,Marshall County,153,3,150
42,Pennsylvania,18,Indiana,103,Miami County,11,66,-55
42,Pennsylvania,18,Indiana,105,Monroe County,160,217,-57
42,Pennsylvania,18,Indiana,107,Montgomery County,0,32,-32
42,Pennsylvania,18,Indiana,109,Morgan County,0,10,-10
42,Pennsylvania,18,Indiana,123,Perry County,0,2,-2
42,Pennsylvania,18,Indiana,127,Porter County,26,5,21
42,Pennsylvania,18,Indiana,133,Putnam County,0,17,-17
42,Pennsylvania,18,Indiana,135,Randolph County,16,0,16
42,Pennsylvania,18,Indiana,137,Ripley County,0,5,-5
42,Pennsylvania,18,Indiana,139,Rush County,0,9,-9
42,Pennsylvania,18,Indiana,141,St. Joseph County,110,219,-109
42,Pennsylvania,18,Indiana,145,Shelby County,0,1,-1
42,Pennsylvania,18,Indiana,155,Switzerland County,0,2,-2
42,Pennsylvania,18,Indiana,157,Tippecanoe County,185,106,79
42,Pennsylvania,18,Indiana,163,Vanderburgh County,0,71,-71
42,Pennsylvania,18,Indiana,167,Vigo County,100,70,30
42,Pennsylvania,18,Indiana,169,Wabash County,0,4,-4
42,Pennsylvania,18,Indiana,173,Warrick County,8,0,8
42,Pennsylvania,18,Indiana,175,Washington County,0,32,-32
42,Pennsylvania,18,Indiana,177,Wayne County,2,15,-13
42,Pennsylvania,18,Indiana,179,Wells County,0,29,-29
42,Pennsylvania,18,Indiana,183,Whitley County,0,3,-3
42,Pennsylvania,19,Iowa,13,Black Hawk County,46,40,6
42,Pennsylvania,19,Iowa,15,Boone County,0,11,-11
42,Pennsylvania,19,Iowa,21,Buena Vista County,0,15,-15
42,Pennsylvania,19,Iowa,25,Calhoun County,0,1,-1
42,Pennsylvania,19,Iowa,27,Carroll County,11,0,11
42,Pennsylvania,19,Iowa,29,Cass County,4,3,1
42,Pennsylvania,19,Iowa,33,Cerro Gordo County,0,7,-7
42,Pennsylvania,19,Iowa,41,Clay County,0,44,-44
42,Pennsylvania,19,Iowa,45,Clinton County,8,0,8
42,Pennsylvania,19,Iowa,47,Crawford County,0,4,-4
42,Pennsylvania,19,Iowa,49,Dallas County,15,10,5
42,Pennsylvania,19,Iowa,53,Decatur County,0,10,-10
42,Pennsylvania,19,Iowa,57,Des Moines County,0,14,-14
42,Pennsylvania,19,Iowa,61,Dubuque County,0,22,-22
42,Pennsylvania,19,Iowa,65,Fayette County,12,0,12
42,Pennsylvania,19,Iowa,99,Jasper County,4,0,4
42,Pennsylvania,19,Iowa,101,Jefferson County,17,0,17
42,Pennsylvania,19,Iowa,103,Johnson County,300,171,129
42,Pennsylvania,19,Iowa,111,Lee County,0,10,-10
42,Pennsylvania,19,Iowa,113,Linn County,71,263,-192
42,Pennsylvania,19,Iowa,115,Louisa County,0,11,-11
42,Pennsylvania,19,Iowa,121,Madison County,23,0,23
42,Pennsylvania,19,Iowa,125,Marion County,15,0,15
42,Pennsylvania,19,Iowa,143,Osceola County,0,17,-17
42,Pennsylvania,19,Iowa,151,Pocahontas County,0,17,-17
42,Pennsylvania,19,Iowa,153,Polk County,69,358,-289
42,Pennsylvania,19,Iowa,155,Pottawattamie County,0,9,-9
42,Pennsylvania,19,Iowa,157,Poweshiek County,12,0,12
42,Pennsylvania,19,Iowa,163,Scott County,30,28,2
42,Pennsylvania,19,Iowa,169,Story County,91,50,41
42,Pennsylvania,19,Iowa,171,Tama County,9,0,9
42,Pennsylvania,19,Iowa,173,Taylor County,0,19,-19
42,Pennsylvania,19,Iowa,175,Union County,0,11,-11
42,Pennsylvania,19,Iowa,179,Wapello County,0,4,-4
42,Pennsylvania,19,Iowa,181,Warren County,27,0,27
42,Pennsylvania,19,Iowa,183,Washington County,9,0,9
42,Pennsylvania,19,Iowa,187,Webster County,0,17,-17
42,Pennsylvania,19,Iowa,189,Winnebago County,18,0,18
42,Pennsylvania,2,Alaska,20,Anchorage Municipality,763,159,604
42,Pennsylvania,2,Alaska,50,Bethel Census Area,0,2,-2
42,Pennsylvania,2,Alaska,68,Denali Borough,0,10,-10
42,Pennsylvania,2,Alaska,90,Fairbanks North Star Borough,0,150,-150
42,Pennsylvania,2,Alaska,110,Juneau City and Borough,22,40,-18
42,Pennsylvania,2,Alaska,122,Kenai Peninsula Borough,27,20,7
42,Pennsylvania,2,Alaska,130,Ketchikan Gateway Borough,0,10,-10
42,Pennsylvania,2,Alaska,150,Kodiak Island Borough,0,38,-38
42,Pennsylvania,2,Alaska,164,Lake and Peninsula Borough,0,1,-1
42,Pennsylvania,2,Alaska,170,Matanuska-Susitna Borough,46,59,-13
42,Pennsylvania,2,Alaska,180,Nome Census Area,0,4,-4
42,Pennsylvania,2,Alaska,220,Sitka City and Borough,16,4,12
42,Pennsylvania,2,Alaska,240,Southeast Fairbanks Census Area,2,0,2
42,Pennsylvania,20,Kansas,9,Barton County,0,3,-3
42,Pennsylvania,20,Kansas,15,Butler County,139,3,136
42,Pennsylvania,20,Kansas,31,Coffey County,0,3,-3
42,Pennsylvania,20,Kansas,41,Dickinson County,31,0,31
42,Pennsylvania,20,Kansas,43,Doniphan County,0,4,-4
42,Pennsylvania,20,Kansas,45,Douglas County,30,53,-23
42,Pennsylvania,20,Kansas,53,Ellsworth County,0,16,-16
42,Pennsylvania,20,Kansas,55,Finney County,8,46,-38
42,Pennsylvania,20,Kansas,57,Ford County,10,0,10
42,Pennsylvania,20,Kansas,61,Geary County,77,56,21
42,Pennsylvania,20,Kansas,79,Harvey County,0,12,-12
42,Pennsylvania,20,Kansas,85,Jackson County,0,13,-13
42,Pennsylvania,20,Kansas,91,Johnson County,111,68,43
42,Pennsylvania,20,Kansas,97,Kiowa County,14,0,14
42,Pennsylvania,20,Kansas,99,Labette County,39,76,-37
42,Pennsylvania,20,Kansas,103,Leavenworth County,18,64,-46
42,Pennsylvania,20,Kansas,113,McPherson County,7,31,-24
42,Pennsylvania,20,Kansas,117,Marshall County,0,4,-4
42,Pennsylvania,20,Kansas,121,Miami County,31,0,31
42,Pennsylvania,20,Kansas,125,Montgomery County,17,17,0
42,Pennsylvania,20,Kansas,127,Morris County,0,1,-1
42,Pennsylvania,20,Kansas,133,Neosho County,35,0,35
42,Pennsylvania,20,Kansas,155,Reno County,19,9,10
42,Pennsylvania,20,Kansas,159,Rice County,0,4,-4
42,Pennsylvania,20,Kansas,161,Riley County,147,63,84
42,Pennsylvania,20,Kansas,163,Rooks County,0,4,-4
42,Pennsylvania,20,Kansas,173,Sedgwick County,76,155,-79
42,Pennsylvania,20,Kansas,177,Shawnee County,33,28,5
42,Pennsylvania,20,Kansas,191,Sumner County,5,0,5
42,Pennsylvania,20,Kansas,193,Thomas County,0,6,-6
42,Pennsylvania,20,Kansas,209,Wyandotte County,48,7,41
42,Pennsylvania,21,Kentucky,3,Allen County,0,14,-14
42,Pennsylvania,21,Kentucky,9,Barren County,6,0,6
42,Pennsylvania,21,Kentucky,11,Bath County,0,87,-87
42,Pennsylvania,21,Kentucky,15,Boone County,84,31,53
42,Pennsylvania,21,Kentucky,19,Boyd County,27,25,2
42,Pennsylvania,21,Kentucky,21,Boyle County,13,0,13
42,Pennsylvania,21,Kentucky,29,Bullitt County,49,0,49
42,Pennsylvania,21,Kentucky,33,Caldwell County,8,2,6
42,Pennsylvania,21,Kentucky,37,Campbell County,11,21,-10
42,Pennsylvania,21,Kentucky,41,Carroll County,9,0,9
42,Pennsylvania,21,Kentucky,43,Carter County,0,2,-2
42,Pennsylvania,21,Kentucky,45,Casey County,0,40,-40
42,Pennsylvania,21,Kentucky,47,Christian County,103,14,89
42,Pennsylvania,21,Kentucky,49,Clark County,7,111,-104
42,Pennsylvania,21,Kentucky,51,Clay County,0,12,-12
42,Pennsylvania,21,Kentucky,59,Daviess County,17,0,17
42,Pennsylvania,21,Kentucky,61,Edmonson County,0,14,-14
42,Pennsylvania,21,Kentucky,67,Fayette County,472,355,117
42,Pennsylvania,21,Kentucky,69,Fleming County,30,0,30
42,Pennsylvania,21,Kentucky,73,Franklin County,0,17,-17
42,Pennsylvania,21,Kentucky,77,Gallatin County,15,0,15
42,Pennsylvania,21,Kentucky,81,Grant County,4,0,4
42,Pennsylvania,21,Kentucky,83,Graves County,2,8,-6
42,Pennsylvania,21,Kentucky,87,Green County,0,12,-12
42,Pennsylvania,21,Kentucky,89,Greenup County,3,25,-22
42,Pennsylvania,21,Kentucky,93,Hardin County,63,111,-48
42,Pennsylvania,21,Kentucky,99,Hart County,10,0,10
42,Pennsylvania,21,Kentucky,101,Henderson County,24,0,24
42,Pennsylvania,21,Kentucky,103,Henry County,0,23,-23
42,Pennsylvania,21,Kentucky,107,Hopkins County,16,0,16
42,Pennsylvania,21,Kentucky,111,Jefferson County,187,272,-85
42,Pennsylvania,21,Kentucky,113,Jessamine County,14,0,14
42,Pennsylvania,21,Kentucky,115,Johnson County,16,2,14
42,Pennsylvania,21,Kentucky,117,Kenton County,58,143,-85
42,Pennsylvania,21,Kentucky,121,Knox County,0,8,-8
42,Pennsylvania,21,Kentucky,125,Laurel County,0,9,-9
42,Pennsylvania,21,Kentucky,141,Logan County,14,2,12
42,Pennsylvania,21,Kentucky,143,Lyon County,0,3,-3
42,Pennsylvania,21,Kentucky,147,McCreary County,9,6,3
42,Pennsylvania,21,Kentucky,155,Marion County,7,11,-4
42,Pennsylvania,21,Kentucky,159,Martin County,31,10,21
42,Pennsylvania,21,Kentucky,161,Mason County,0,9,-9
42,Pennsylvania,21,Kentucky,169,Metcalfe County,9,0,9
42,Pennsylvania,21,Kentucky,173,Montgomery County,0,2,-2
42,Pennsylvania,21,Kentucky,177,Muhlenberg County,0,2,-2
42,Pennsylvania,21,Kentucky,181,Nicholas County,0,28,-28
42,Pennsylvania,21,Kentucky,185,Oldham County,18,22,-4
42,Pennsylvania,21,Kentucky,187,Owen County,17,0,17
42,Pennsylvania,21,Kentucky,195,Pike County,8,0,8
42,Pennsylvania,21,Kentucky,197,Powell County,8,2,6
42,Pennsylvania,21,Kentucky,199,Pulaski County,15,13,2
42,Pennsylvania,21,Kentucky,209,Scott County,0,48,-48
42,Pennsylvania,21,Kentucky,211,Shelby County,5,0,5
42,Pennsylvania,21,Kentucky,213,Simpson County,0,12,-12
42,Pennsylvania,21,Kentucky,217,Taylor County,6,98,-92
42,Pennsylvania,21,Kentucky,219,Todd County,153,0,153
42,Pennsylvania,21,Kentucky,221,Trigg County,2,0,2
42,Pennsylvania,21,Kentucky,225,Union County,0,38,-38
42,Pennsylvania,21,Kentucky,227,Warren County,50,256,-206
42,Pennsylvania,21,Kentucky,229,Washington County,58,10,48
42,Pennsylvania,21,Kentucky,235,Whitley County,3,0,3
42,Pennsylvania,21,Kentucky,239,Woodford County,6,0,6
42,Pennsylvania,22,Louisiana,3,Allen Parish,0,18,-18
42,Pennsylvania,22,Louisiana,5,Ascension Parish,19,18,1
42,Pennsylvania,22,Louisiana,7,Assumption Parish,14,0,14
42,Pennsylvania,22,Louisiana,15,Bossier Parish,5,25,-20
42,Pennsylvania,22,Louisiana,17,Caddo Parish,55,0,55
42,Pennsylvania,22,Louisiana,19,Calcasieu Parish,41,57,-16
42,Pennsylvania,22,Louisiana,25,Catahoula Parish,0,7,-7
42,Pennsylvania,22,Louisiana,33,East Baton Rouge Parish,127,119,8
42,Pennsylvania,22,Louisiana,39,Evangeline Parish,30,0,30
42,Pennsylvania,22,Louisiana,41,Franklin Parish,37,0,37
42,Pennsylvania,22,Louisiana,51,Jefferson Parish,55,102,-47
42,Pennsylvania,22,Louisiana,55,Lafayette Parish,0,11,-11
42,Pennsylvania,22,Louisiana,63,Livingston Parish,13,0,13
42,Pennsylvania,22,Louisiana,67,Morehouse Parish,75,0,75
42,Pennsylvania,22,Louisiana,69,Natchitoches Parish,0,10,-10
42,Pennsylvania,22,Louisiana,71,Orleans Parish,193,227,-34
42,Pennsylvania,22,Louisiana,73,Ouachita Parish,60,129,-69
42,Pennsylvania,22,Louisiana,75,Plaquemines Parish,0,33,-33
42,Pennsylvania,22,Louisiana,79,Rapides Parish,0,34,-34
42,Pennsylvania,22,Louisiana,83,Richland Parish,0,6,-6
42,Pennsylvania,22,Louisiana,91,St. Helena Parish,15,0,15
42,Pennsylvania,22,Louisiana,101,St. Mary Parish,3,0,3
42,Pennsylvania,22,Louisiana,103,St. Tammany Parish,74,25,49
42,Pennsylvania,22,Louisiana,109,Terrebonne Parish,17,16,1
42,Pennsylvania,22,Louisiana,111,Union Parish,16,0,16
42,Pennsylvania,22,Louisiana,115,Vernon Parish,79,64,15
42,Pennsylvania,22,Louisiana,127,Winn Parish,13,0,13
42,Pennsylvania,23,Maine,1,Androscoggin County,223,16,207
42,Pennsylvania,23,Maine,3,Aroostook County,23,62,-39
42,Pennsylvania,23,Maine,5,Cumberland County,311,526,-215
42,Pennsylvania,23,Maine,7,Franklin County,2,32,-30
42,Pennsylvania,23,Maine,9,Hancock County,55,99,-44
42,Pennsylvania,23,Maine,11,Kennebec County,69,103,-34
42,Pennsylvania,23,Maine,13,Knox County,40,25,15
42,Pennsylvania,23,Maine,15,Lincoln County,50,180,-130
42,Pennsylvania,23,Maine,17,Oxford County,36,50,-14
42,Pennsylvania,23,Maine,19,Penobscot County,83,68,15
42,Pennsylvania,23,Maine,21,Piscataquis County,8,0,8
42,Pennsylvania,23,Maine,23,Sagadahoc County,0,1,-1
42,Pennsylvania,23,Maine,25,Somerset County,10,88,-78
42,Pennsylvania,23,Maine,27,Waldo County,7,61,-54
42,Pennsylvania,23,Maine,29,Washington County,0,28,-28
42,Pennsylvania,23,Maine,31,York County,257,435,-178
42,Pennsylvania,24,Maryland,1,Allegany County,296,189,107
42,Pennsylvania,24,Maryland,3,Anne Arundel County,1375,1104,271
42,Pennsylvania,24,Maryland,5,Baltimore County,3335,1558,1777
42,Pennsylvania,24,Maryland,9,Calvert County,259,122,137
42,Pennsylvania,24,Maryland,11,Caroline County,94,31,63
42,Pennsylvania,24,Maryland,13,Carroll County,1086,571,515
42,Pennsylvania,24,Maryland,15,Cecil County,493,686,-193
42,Pennsylvania,24,Maryland,17,Charles County,195,75,120
42,Pennsylvania,24,Maryland,19,Dorchester County,35,5,30
42,Pennsylvania,24,Maryland,21,Frederick County,1199,793,406
42,Pennsylvania,24,Maryland,23,Garrett County,86,101,-15
42,Pennsylvania,24,Maryland,25,Harford County,1157,590,567
42,Pennsylvania,24,Maryland,27,Howard County,564,439,125
42,Pennsylvania,24,Maryland,29,Kent County,41,305,-264
42,Pennsylvania,24,Maryland,31,Montgomery County,2285,2343,-58
42,Pennsylvania,24,Maryland,33,Prince George's County,1018,974,44
42,Pennsylvania,24,Maryland,35,Queen Anne's County,79,74,5
42,Pennsylvania,24,Maryland,37,St. Mary's County,170,168,2
42,Pennsylvania,24,Maryland,39,Somerset County,106,105,1
42,Pennsylvania,24,Maryland,41,Talbot County,49,137,-88
42,Pennsylvania,24,Maryland,43,Washington County,1235,720,515
42,Pennsylvania,24,Maryland,45,Wicomico County,313,124,189
42,Pennsylvania,24,Maryland,47,Worcester County,279,235,44
42,Pennsylvania,24,Maryland,510,Baltimore city,3132,1943,1189
42,Pennsylvania,25,Massachusetts,1,Barnstable County,108,77,31
42,Pennsylvania,25,Massachusetts,3,Berkshire County,47,66,-19
42,Pennsylvania,25,Massachusetts,5,Bristol County,598,154,444
42,Pennsylvania,25,Massachusetts,9,Essex County,563,471,92
42,Pennsylvania,25,Massachusetts,11,Franklin County,81,56,25
42,Pennsylvania,25,Massachusetts,13,Hampden County,300,601,-301
42,Pennsylvania,25,Massachusetts,15,Hampshire County,251,257,-6
42,Pennsylvania,25,Massachusetts,17,Middlesex County,1783,2279,-496
42,Pennsylvania,25,Massachusetts,19,Nantucket County,51,0,51
42,Pennsylvania,25,Massachusetts,21,Norfolk County,556,399,157
42,Pennsylvania,25,Massachusetts,23,Plymouth County,129,105,24
42,Pennsylvania,25,Massachusetts,25,Suffolk County,1212,1472,-260
42,Pennsylvania,25,Massachusetts,27,Worcester County,818,413,405
42,Pennsylvania,26,Michigan,5,Allegan County,16,8,8
42,Pennsylvania,26,Michigan,9,Antrim County,11,10,1
42,Pennsylvania,26,Michigan,17,Bay County,14,0,14
42,Pennsylvania,26,Michigan,19,Benzie County,0,6,-6
42,Pennsylvania,26,Michigan,21,Berrien County,0,29,-29
42,Pennsylvania,26,Michigan,23,Branch County,0,35,-35
42,Pennsylvania,26,Michigan,25,Calhoun County,21,27,-6
42,Pennsylvania,26,Michigan,31,Cheboygan County,9,55,-46
42,Pennsylvania,26,Michigan,33,Chippewa County,0,26,-26
42,Pennsylvania,26,Michigan,35,Clare County,6,18,-12
42,Pennsylvania,26,Michigan,37,Clinton County,82,0,82
42,Pennsylvania,26,Michigan,39,Crawford County,0,11,-11
42,Pennsylvania,26,Michigan,43,Dickinson County,4,143,-139
42,Pennsylvania,26,Michigan,45,Eaton County,22,0,22
42,Pennsylvania,26,Michigan,47,Emmet County,5,9,-4
42,Pennsylvania,26,Michigan,49,Genesee County,182,104,78
42,Pennsylvania,26,Michigan,55,Grand Traverse County,14,45,-31
42,Pennsylvania,26,Michigan,57,Gratiot County,3,0,3
42,Pennsylvania,26,Michigan,63,Huron County,0,5,-5
42,Pennsylvania,26,Michigan,65,Ingham County,218,200,18
42,Pennsylvania,26,Michigan,67,Ionia County,3,0,3
42,Pennsylvania,26,Michigan,69,Iosco County,44,35,9
42,Pennsylvania,26,Michigan,73,Isabella County,85,55,30
42,Pennsylvania,26,Michigan,75,Jackson County,100,32,68
42,Pennsylvania,26,Michigan,77,Kalamazoo County,178,163,15
42,Pennsylvania,26,Michigan,79,Kalkaska County,10,0,10
42,Pennsylvania,26,Michigan,81,Kent County,170,286,-116
42,Pennsylvania,26,Michigan,85,Lake County,118,10,108
42,Pennsylvania,26,Michigan,87,Lapeer County,0,11,-11
42,Pennsylvania,26,Michigan,91,Lenawee County,39,25,14
42,Pennsylvania,26,Michigan,93,Livingston County,6,20,-14
42,Pennsylvania,26,Michigan,95,Luce County,0,13,-13
42,Pennsylvania,26,Michigan,97,Mackinac County,0,5,-5
42,Pennsylvania,26,Michigan,99,Macomb County,192,133,59
42,Pennsylvania,26,Michigan,101,Manistee County,4,5,-1
42,Pennsylvania,26,Michigan,103,Marquette County,17,10,7
42,Pennsylvania,26,Michigan,105,Mason County,10,4,6
42,Pennsylvania,26,Michigan,109,Menominee County,0,4,-4
42,Pennsylvania,26,Michigan,111,Midland County,85,74,11
42,Pennsylvania,26,Michigan,115,Monroe County,6,143,-137
42,Pennsylvania,26,Michigan,121,Muskegon County,12,24,-12
42,Pennsylvania,26,Michigan,123,Newaygo County,0,7,-7
42,Pennsylvania,26,Michigan,125,Oakland County,600,733,-133
42,Pennsylvania,26,Michigan,127,Oceana County,0,4,-4
42,Pennsylvania,26,Michigan,129,Ogemaw County,0,11,-11
42,Pennsylvania,26,Michigan,131,Ontonagon County,4,0,4
42,Pennsylvania,26,Michigan,133,Osceola County,0,51,-51
42,Pennsylvania,26,Michigan,135,Oscoda County,2,0,2
42,Pennsylvania,26,Michigan,137,Otsego County,110,20,90
42,Pennsylvania,26,Michigan,139,Ottawa County,68,24,44
42,Pennsylvania,26,Michigan,141,Presque Isle County,4,1,3
42,Pennsylvania,26,Michigan,143,Roscommon County,0,13,-13
42,Pennsylvania,26,Michigan,145,Saginaw County,9,42,-33
42,Pennsylvania,26,Michigan,147,St. Clair County,18,39,-21
42,Pennsylvania,26,Michigan,149,St. Joseph County,12,94,-82
42,Pennsylvania,26,Michigan,151,Sanilac County,10,21,-11
42,Pennsylvania,26,Michigan,153,Schoolcraft County,0,14,-14
42,Pennsylvania,26,Michigan,157,Tuscola County,14,1,13
42,Pennsylvania,26,Michigan,161,Washtenaw County,552,368,184
42,Pennsylvania,26,Michigan,163,Wayne County,449,545,-96
42,Pennsylvania,26,Michigan,165,Wexford County,3,0,3
42,Pennsylvania,27,Minnesota,1,Aitkin County,0,3,-3
42,Pennsylvania,27,Minnesota,3,Anoka County,73,97,-24
42,Pennsylvania,27,Minnesota,7,Beltrami County,0,8,-8
42,Pennsylvania,27,Minnesota,13,Blue Earth County,16,0,16
42,Pennsylvania,27,Minnesota,19,Carver County,50,52,-2
42,Pennsylvania,27,Minnesota,25,Chisago County,2,6,-4
42,Pennsylvania,27,Minnesota,37,Dakota County,35,9,26
42,Pennsylvania,27,Minnesota,41,Douglas County,0,4,-4
42,Pennsylvania,27,Minnesota,49,Goodhue County,6,0,6
42,Pennsylvania,27,Minnesota,51,Grant County,0,31,-31
42,Pennsylvania,27,Minnesota,53,Hennepin County,725,452,273
42,Pennsylvania,27,Minnesota,57,Hubbard County,0,4,-4
42,Pennsylvania,27,Minnesota,59,Isanti County,0,6,-6
42,Pennsylvania,27,Minnesota,65,Kanabec County,0,3,-3
42,Pennsylvania,27,Minnesota,67,Kandiyohi County,0,17,-17
42,Pennsylvania,27,Minnesota,79,Le Sueur County,8,0,8
42,Pennsylvania,27,Minnesota,83,Lyon County,6,0,6
42,Pennsylvania,27,Minnesota,85,McLeod County,2,17,-15
42,Pennsylvania,27,Minnesota,87,Mahnomen County,0,2,-2
42,Pennsylvania,27,Minnesota,109,Olmsted County,51,42,9
42,Pennsylvania,27,Minnesota,111,Otter Tail County,0,20,-20
42,Pennsylvania,27,Minnesota,113,Pennington County,0,48,-48
42,Pennsylvania,27,Minnesota,115,Pine County,0,3,-3
42,Pennsylvania,27,Minnesota,117,Pipestone County,0,10,-10
42,Pennsylvania,27,Minnesota,121,Pope County,0,17,-17
42,Pennsylvania,27,Minnesota,123,Ramsey County,171,153,18
42,Pennsylvania,27,Minnesota,129,Renville County,0,1,-1
42,Pennsylvania,27,Minnesota,131,Rice County,14,0,14
42,Pennsylvania,27,Minnesota,135,Roseau County,15,0,15
42,Pennsylvania,27,Minnesota,137,St. Louis County,20,67,-47
42,Pennsylvania,27,Minnesota,139,Scott County,18,17,1
42,Pennsylvania,27,Minnesota,141,Sherburne County,14,0,14
42,Pennsylvania,27,Minnesota,145,Stearns County,16,9,7
42,Pennsylvania,27,Minnesota,147,Steele County,45,0,45
42,Pennsylvania,27,Minnesota,153,Todd County,0,22,-22
42,Pennsylvania,27,Minnesota,161,Waseca County,3,0,3
42,Pennsylvania,27,Minnesota,163,Washington County,51,7,44
42,Pennsylvania,27,Minnesota,169,Winona County,0,2,-2
42,Pennsylvania,27,Minnesota,171,Wright County,64,17,47
42,Pennsylvania,28,Mississippi,3,Alcorn County,25,0,25
42,Pennsylvania,28,Mississippi,27,Coahoma County,9,0,9
42,Pennsylvania,28,Mississippi,29,Copiah County,0,5,-5
42,Pennsylvania,28,Mississippi,33,DeSoto County,32,6,26
42,Pennsylvania,28,Mississippi,35,Forrest County,16,12,4
42,Pennsylvania,28,Mississippi,47,Harrison County,138,171,-33
42,Pennsylvania,28,Mississippi,49,Hinds County,44,25,19
42,Pennsylvania,28,Mississippi,57,Itawamba County,0,7,-7
42,Pennsylvania,28,Mississippi,59,Jackson County,145,15,130
42,Pennsylvania,28,Mississippi,67,Jones County,29,0,29
42,Pennsylvania,28,Mississippi,71,Lafayette County,12,111,-99
42,Pennsylvania,28,Mississippi,73,Lamar County,41,0,41
42,Pennsylvania,28,Mississippi,75,Lauderdale County,6,65,-59
42,Pennsylvania,28,Mississippi,81,Lee County,18,42,-24
42,Pennsylvania,28,Mississippi,83,Leflore County,0,5,-5
42,Pennsylvania,28,Mississippi,87,Lowndes County,0,8,-8
42,Pennsylvania,28,Mississippi,89,Madison County,28,0,28
42,Pennsylvania,28,Mississippi,105,Oktibbeha County,22,34,-12
42,Pennsylvania,28,Mississippi,115,Pontotoc County,0,55,-55
42,Pennsylvania,28,Mississippi,121,Rankin County,29,39,-10
42,Pennsylvania,28,Mississippi,123,Scott County,8,0,8
42,Pennsylvania,28,Mississippi,127,Simpson County,11,0,11
42,Pennsylvania,28,Mississippi,133,Sunflower County,5,12,-7
42,Pennsylvania,28,Mississippi,147,Walthall County,0,74,-74
42,Pennsylvania,28,Mississippi,149,Warren County,32,13,19
42,Pennsylvania,28,Mississippi,155,Webster County,0,10,-10
42,Pennsylvania,28,Mississippi,159,Winston County,11,0,11
42,Pennsylvania,28,Mississippi,161,Yalobusha County,0,2,-2
42,Pennsylvania,28,Mississippi,163,Yazoo County,0,73,-73
42,Pennsylvania,29,Missouri,1,Adair County,31,14,17
42,Pennsylvania,29,Missouri,11,Barton County,0,4,-4
42,Pennsylvania,29,Missouri,17,Bollinger County,10,0,10
42,Pennsylvania,29,Missouri,19,Boone County,80,230,-150
42,Pennsylvania,29,Missouri,21,Buchanan County,75,0,75
42,Pennsylvania,29,Missouri,23,Butler County,6,0,6
42,Pennsylvania,29,Missouri,27,Callaway County,18,0,18
42,Pennsylvania,29,Missouri,31,Cape Girardeau County,6,8,-2
42,Pennsylvania,29,Missouri,37,Cass County,54,8,46
42,Pennsylvania,29,Missouri,43,Christian County,0,27,-27
42,Pennsylvania,29,Missouri,47,Clay County,19,209,-190
42,Pennsylvania,29,Missouri,65,Dent County,0,37,-37
42,Pennsylvania,29,Missouri,75,Gentry County,0,1,-1
42,Pennsylvania,29,Missouri,77,Greene County,191,118,73
42,Pennsylvania,29,Missouri,81,Harrison County,0,1,-1
42,Pennsylvania,29,Missouri,89,Howard County,0,11,-11
42,Pennsylvania,29,Missouri,95,Jackson County,69,439,-370
42,Pennsylvania,29,Missouri,97,Jasper County,0,9,-9
42,Pennsylvania,29,Missouri,99,Jefferson County,10,45,-35
42,Pennsylvania,29,Missouri,101,Johnson County,32,85,-53
42,Pennsylvania,29,Missouri,109,Lawrence County,0,12,-12
42,Pennsylvania,29,Missouri,129,Mercer County,0,1,-1
42,Pennsylvania,29,Missouri,135,Moniteau County,0,8,-8
42,Pennsylvania,29,Missouri,141,Morgan County,11,0,11
42,Pennsylvania,29,Missouri,145,Newton County,0,17,-17
42,Pennsylvania,29,Missouri,147,Nodaway County,7,0,7
42,Pennsylvania,29,Missouri,149,Oregon County,1,1,0
42,Pennsylvania,29,Missouri,153,Ozark County,0,13,-13
42,Pennsylvania,29,Missouri,159,Pettis County,7,4,3
42,Pennsylvania,29,Missouri,161,Phelps County,0,2,-2
42,Pennsylvania,29,Missouri,165,Platte County,17,86,-69
42,Pennsylvania,29,Missouri,167,Polk County,0,85,-85
42,Pennsylvania,29,Missouri,169,Pulaski County,66,227,-161
42,Pennsylvania,29,Missouri,175,Randolph County,16,0,16
42,Pennsylvania,29,Missouri,179,Reynolds County,0,3,-3
42,Pennsylvania,29,Missouri,181,Ripley County,31,0,31
42,Pennsylvania,29,Missouri,183,St. Charles County,25,103,-78
42,Pennsylvania,29,Missouri,185,St. Clair County,0,5,-5
42,Pennsylvania,29,Missouri,187,St. Francois County,0,74,-74
42,Pennsylvania,29,Missouri,189,St. Louis County,376,439,-63
42,Pennsylvania,29,Missouri,199,Scotland County,0,6,-6
42,Pennsylvania,29,Missouri,207,Stoddard County,0,5,-5
42,Pennsylvania,29,Missouri,209,Stone County,8,0,8
42,Pennsylvania,29,Missouri,215,Texas County,48,20,28
42,Pennsylvania,29,Missouri,219,Warren County,32,0,32
42,Pennsylvania,29,Missouri,229,Wright County,0,6,-6
42,Pennsylvania,29,Missouri,510,St. Louis city,259,298,-39
42,Pennsylvania,30,Montana,7,Broadwater County,0,17,-17
42,Pennsylvania,30,Montana,9,Carbon County,0,2,-2
42,Pennsylvania,30,Montana,13,Cascade County,84,40,44
42,Pennsylvania,30,Montana,17,Custer County,9,0,9
42,Pennsylvania,30,Montana,25,Fallon County,0,38,-38
42,Pennsylvania,30,Montana,29,Flathead County,76,16,60
42,Pennsylvania,30,Montana,31,Gallatin County,42,34,8
42,Pennsylvania,30,Montana,35,Glacier County,0,17,-17
42,Pennsylvania,30,Montana,41,Hill County,5,0,5
42,Pennsylvania,30,Montana,47,Lake County,0,20,-20
42,Pennsylvania,30,Montana,49,Lewis and Clark County,0,31,-31
42,Pennsylvania,30,Montana,51,Liberty County,0,14,-14
42,Pennsylvania,30,Montana,61,Mineral County,1,0,1
42,Pennsylvania,30,Montana,63,Missoula County,0,99,-99
42,Pennsylvania,30,Montana,67,Park County,20,17,3
42,Pennsylvania,30,Montana,77,Powell County,0,9,-9
42,Pennsylvania,30,Montana,93,Silver Bow County,0,23,-23
42,Pennsylvania,30,Montana,99,Teton County,0,6,-6
42,Pennsylvania,30,Montana,105,Valley County,0,63,-63
42,Pennsylvania,30,Montana,111,Yellowstone County,35,97,-62
42,Pennsylvania,31,Nebraska,1,Adams County,38,0,38
42,Pennsylvania,31,Nebraska,3,Antelope County,0,1,-1
42,Pennsylvania,31,Nebraska,11,Boone County,38,0,38
42,Pennsylvania,31,Nebraska,19,Buffalo County,0,32,-32
42,Pennsylvania,31,Nebraska,47,Dawson County,0,5,-5
42,Pennsylvania,31,Nebraska,55,Douglas County,98,252,-154
42,Pennsylvania,31,Nebraska,67,Gage County,3,24,-21
42,Pennsylvania,31,Nebraska,79,Hall County,3,0,3
42,Pennsylvania,31,Nebraska,93,Howard County,3,0,3
42,Pennsylvania,31,Nebraska,97,Johnson County,0,16,-16
42,Pennsylvania,31,Nebraska,109,Lancaster County,54,198,-144
42,Pennsylvania,31,Nebraska,111,Lincoln County,49,0,49
42,Pennsylvania,31,Nebraska,113,Logan County,9,0,9
42,Pennsylvania,31,Nebraska,119,Madison County,5,0,5
42,Pennsylvania,31,Nebraska,127,Nemaha County,0,9,-9
42,Pennsylvania,31,Nebraska,131,Otoe County,24,0,24
42,Pennsylvania,31,Nebraska,135,Perkins County,0,2,-2
42,Pennsylvania,31,Nebraska,137,Phelps County,0,1,-1
42,Pennsylvania,31,Nebraska,141,Platte County,0,41,-41
42,Pennsylvania,31,Nebraska,153,Sarpy County,26,36,-10
42,Pennsylvania,31,Nebraska,155,Saunders County,6,0,6
42,Pennsylvania,31,Nebraska,161,Sheridan County,0,5,-5
42,Pennsylvania,32,Nevada,1,Churchill County,3,0,3
42,Pennsylvania,32,Nevada,3,Clark County,718,1326,-608
42,Pennsylvania,32,Nevada,5,Douglas County,0,20,-20
42,Pennsylvania,32,Nevada,7,Elko County,36,0,36
42,Pennsylvania,32,Nevada,19,Lyon County,9,12,-3
42,Pennsylvania,32,Nevada,23,Nye County,25,81,-56
42,Pennsylvania,32,Nevada,31,Washoe County,134,296,-162
42,Pennsylvania,33,New Hampshire,1,Belknap County,42,21,21
42,Pennsylvania,33,New Hampshire,3,Carroll County,123,61,62
42,Pennsylvania,33,New Hampshire,5,Cheshire County,102,53,49
42,Pennsylvania,33,New Hampshire,7,Coos County,62,40,22
42,Pennsylvania,33,New Hampshire,9,Grafton County,81,103,-22
42,Pennsylvania,33,New Hampshire,11,Hillsborough County,336,613,-277
42,Pennsylvania,33,New Hampshire,13,Merrimack County,53,116,-63
42,Pennsylvania,33,New Hampshire,15,Rockingham County,278,261,17
42,Pennsylvania,33,New Hampshire,17,Strafford County,91,88,3
42,Pennsylvania,33,New Hampshire,19,Sullivan County,68,40,28
42,Pennsylvania,34,New Jersey,1,Atlantic County,1328,1427,-99
42,Pennsylvania,34,New Jersey,3,Bergen County,1965,607,1358
42,Pennsylvania,34,New Jersey,5,Burlington County,4055,2714,1341
42,Pennsylvania,34,New Jersey,7,Camden County,4556,3763,793
42,Pennsylvania,34,New Jersey,9,Cape May County,568,1138,-570
42,Pennsylvania,34,New Jersey,11,Cumberland County,856,405,451
42,Pennsylvania,34,New Jersey,13,Essex County,1924,814,1110
42,Pennsylvania,34,New Jersey,15,Gloucester County,2177,1627,550
42,Pennsylvania,34,New Jersey,17,Hudson County,1452,658,794
42,Pennsylvania,34,New Jersey,19,Hunterdon County,1547,483,1064
42,Pennsylvania,34,New Jersey,21,Mercer County,3435,1210,2225
42,Pennsylvania,34,New Jersey,23,Middlesex County,2379,1190,1189
42,Pennsylvania,34,New Jersey,25,Monmouth County,1786,716,1070
42,Pennsylvania,34,New Jersey,27,Morris County,2358,673,1685
42,Pennsylvania,34,New Jersey,29,Ocean County,1299,938,361
42,Pennsylvania,34,New Jersey,31,Passaic County,960,271,689
42,Pennsylvania,34,New Jersey,33,Salem County,192,359,-167
42,Pennsylvania,34,New Jersey,35,Somerset County,1795,721,1074
42,Pennsylvania,34,New Jersey,37,Sussex County,898,362,536
42,Pennsylvania,34,New Jersey,39,Union County,1461,583,878
42,Pennsylvania,34,New Jersey,41,Warren County,1822,927,895
42,Pennsylvania,35,New Mexico,1,Bernalillo County,133,272,-139
42,Pennsylvania,35,New Mexico,5,Chaves County,36,5,31
42,Pennsylvania,35,New Mexico,6,Cibola County,35,0,35
42,Pennsylvania,35,New Mexico,9,Curry County,0,8,-8
42,Pennsylvania,35,New Mexico,13,Doña Ana County,32,59,-27
42,Pennsylvania,35,New Mexico,15,Eddy County,12,48,-36
42,Pennsylvania,35,New Mexico,23,Hidalgo County,0,50,-50
42,Pennsylvania,35,New Mexico,25,Lea County,0,75,-75
42,Pennsylvania,35,New Mexico,28,Los Alamos County,35,11,24
42,Pennsylvania,35,New Mexico,31,McKinley County,42,0,42
42,Pennsylvania,35,New Mexico,35,Otero County,74,1,73
42,Pennsylvania,35,New Mexico,41,Roosevelt County,13,0,13
42,Pennsylvania,35,New Mexico,43,Sandoval County,0,22,-22
42,Pennsylvania,35,New Mexico,45,San Juan County,20,65,-45
42,Pennsylvania,35,New Mexico,49,Santa Fe County,53,45,8
42,Pennsylvania,35,New Mexico,51,Sierra County,0,7,-7
42,Pennsylvania,35,New Mexico,55,Taos County,4,0,4
42,Pennsylvania,35,New Mexico,59,Union County,0,6,-6
42,Pennsylvania,35,New Mexico,61,Valencia County,17,0,17
42,Pennsylvania,36,New York,1,Albany County,300,126,174
42,Pennsylvania,36,New York,3,Allegany County,145,246,-101
42,Pennsylvania,36,New York,5,Bronx County,3980,1957,2023
42,Pennsylvania,36,New York,7,Broome County,932,594,338
42,Pennsylvania,36,New York,9,Cattaraugus County,506,333,173
42,Pennsylvania,36,New York,11,Cayuga County,55,83,-28
42,Pennsylvania,36,New York,13,Chautauqua County,746,521,225
42,Pennsylvania,36,New York,15,Chemung County,512,246,266
42,Pennsylvania,36,New York,17,Chenango County,78,33,45
42,Pennsylvania,36,New York,19,Clinton County,108,29,79
42,Pennsylvania,36,New York,21,Columbia County,33,17,16
42,Pennsylvania,36,New York,23,Cortland County,6,62,-56
42,Pennsylvania,36,New York,25,Delaware County,83,63,20
42,Pennsylvania,36,New York,27,Dutchess County,278,631,-353
42,Pennsylvania,36,New York,29,Erie County,1504,954,550
42,Pennsylvania,36,New York,31,Essex County,3,77,-74
42,Pennsylvania,36,New York,33,Franklin County,27,48,-21
42,Pennsylvania,36,New York,35,Fulton County,0,85,-85
42,Pennsylvania,36,New York,37,Genesee County,31,7,24
42,Pennsylvania,36,New York,39,Greene County,53,0,53
42,Pennsylvania,36,New York,41,Hamilton County,0,4,-4
42,Pennsylvania,36,New York,43,Herkimer County,28,16,12
42,Pennsylvania,36,New York,45,Jefferson County,411,325,86
42,Pennsylvania,36,New York,47,Kings County,5251,2298,2953
42,Pennsylvania,36,New York,49,Lewis County,38,0,38
42,Pennsylvania,36,New York,51,Livingston County,39,32,7
42,Pennsylvania,36,New York,53,Madison County,86,58,28
42,Pennsylvania,36,New York,55,Monroe County,1200,1574,-374
42,Pennsylvania,36,New York,57,Montgomery County,71,261,-190
42,Pennsylvania,36,New York,59,Nassau County,2019,616,1403
42,Pennsylvania,36,New York,61,New York County,3662,4661,-999
42,Pennsylvania,36,New York,63,Niagara County,178,123,55
42,Pennsylvania,36,New York,65,Oneida County,285,435,-150
42,Pennsylvania,36,New York,67,Onondaga County,592,975,-383
42,Pennsylvania,36,New York,69,Ontario County,134,266,-132
42,Pennsylvania,36,New York,71,Orange County,1176,589,587
42,Pennsylvania,36,New York,73,Orleans County,14,8,6
42,Pennsylvania,36,New York,75,Oswego County,232,55,177
42,Pennsylvania,36,New York,77,Otsego County,76,58,18
42,Pennsylvania,36,New York,79,Putnam County,328,57,271
42,Pennsylvania,36,New York,81,Queens County,3548,1338,2210
42,Pennsylvania,36,New York,83,Rensselaer County,133,104,29
42,Pennsylvania,36,New York,85,Richmond County,942,272,670
42,Pennsylvania,36,New York,87,Rockland County,530,102,428
42,Pennsylvania,36,New York,89,St. Lawrence County,132,48,84
42,Pennsylvania,36,New York,91,Saratoga County,100,365,-265
42,Pennsylvania,36,New York,93,Schenectady County,61,23,38
42,Pennsylvania,36,New York,95,Schoharie County,46,3,43
42,Pennsylvania,36,New York,97,Schuyler County,37,26,11
42,Pennsylvania,36,New York,99,Seneca County,72,59,13
42,Pennsylvania,36,New York,101,Steuben County,326,371,-45
42,Pennsylvania,36,New York,103,Suffolk County,1777,379,1398
42,Pennsylvania,36,New York,105,Sullivan County,149,99,50
42,Pennsylvania,36,New York,107,Tioga County,300,399,-99
42,Pennsylvania,36,New York,109,Tompkins County,157,735,-578
42,Pennsylvania,36,New York,111,Ulster County,108,149,-41
42,Pennsylvania,36,New York,113,Warren County,113,25,88
42,Pennsylvania,36,New York,115,Washington County,0,31,-31
42,Pennsylvania,36,New York,117,Wayne County,21,42,-21
42,Pennsylvania,36,New York,119,Westchester County,1403,503,900
42,Pennsylvania,36,New York,121,Wyoming County,24,72,-48
42,Pennsylvania,36,New York,123,Yates County,164,74,90
42,Pennsylvania,37,North Carolina,1,Alamance County,133,153,-20
42,Pennsylvania,37,North Carolina,3,Alexander County,0,29,-29
42,Pennsylvania,37,North Carolina,5,Alleghany County,0,16,-16
42,Pennsylvania,37,North Carolina,9,Ashe County,0,21,-21
42,Pennsylvania,37,North Carolina,13,Beaufort County,18,18,0
42,Pennsylvania,37,North Carolina,19,Brunswick County,187,605,-418
42,Pennsylvania,37,North Carolina,21,Buncombe County,410,467,-57
42,Pennsylvania,37,North Carolina,23,Burke County,6,20,-14
42,Pennsylvania,37,North Carolina,25,Cabarrus County,93,343,-250
42,Pennsylvania,37,North Carolina,27,Caldwell County,4,0,4
42,Pennsylvania,37,North Carolina,31,Carteret County,104,148,-44
42,Pennsylvania,37,North Carolina,35,Catawba County,90,84,6
42,Pennsylvania,37,North Carolina,37,Chatham County,6,43,-37
42,Pennsylvania,37,North Carolina,39,Cherokee County,45,0,45
42,Pennsylvania,37,North Carolina,41,Chowan County,0,112,-112
42,Pennsylvania,37,North Carolina,43,Clay County,20,31,-11
42,Pennsylvania,37,North Carolina,45,Cleveland County,23,66,-43
42,Pennsylvania,37,North Carolina,47,Columbus County,28,21,7
42,Pennsylvania,37,North Carolina,49,Craven County,124,180,-56
42,Pennsylvania,37,North Carolina,51,Cumberland County,530,585,-55
42,Pennsylvania,37,North Carolina,53,Currituck County,18,49,-31
42,Pennsylvania,37,North Carolina,55,Dare County,124,21,103
42,Pennsylvania,37,North Carolina,57,Davidson County,76,38,38
42,Pennsylvania,37,North Carolina,59,Davie County,2,53,-51
42,Pennsylvania,37,North Carolina,61,Duplin County,0,12,-12
42,Pennsylvania,37,North Carolina,63,Durham County,700,619,81
42,Pennsylvania,37,North Carolina,67,Forsyth County,591,283,308
42,Pennsylvania,37,North Carolina,69,Franklin County,55,45,10
42,Pennsylvania,37,North Carolina,71,Gaston County,26,62,-36
42,Pennsylvania,37,North Carolina,75,Graham County,23,0,23
42,Pennsylvania,37,North Carolina,77,Granville County,40,84,-44
42,Pennsylvania,37,North Carolina,79,Greene County,0,24,-24
42,Pennsylvania,37,North Carolina,81,Guilford County,331,385,-54
42,Pennsylvania,37,North Carolina,83,Halifax County,7,7,0
42,Pennsylvania,37,North Carolina,85,Harnett County,27,243,-216
42,Pennsylvania,37,North Carolina,87,Haywood County,0,5,-5
42,Pennsylvania,37,North Carolina,89,Henderson County,21,97,-76
42,Pennsylvania,37,North Carolina,91,Hertford County,0,23,-23
42,Pennsylvania,37,North Carolina,93,Hoke County,16,5,11
42,Pennsylvania,37,North Carolina,97,Iredell County,210,232,-22
42,Pennsylvania,37,North Carolina,99,Jackson County,9,2,7
42,Pennsylvania,37,North Carolina,101,Johnston County,139,87,52
42,Pennsylvania,37,North Carolina,103,Jones County,8,0,8
42,Pennsylvania,37,North Carolina,105,Lee County,12,12,0
42,Pennsylvania,37,North Carolina,107,Lenoir County,0,31,-31
42,Pennsylvania,37,North Carolina,109,Lincoln County,56,44,12
42,Pennsylvania,37,North Carolina,113,Macon County,0,13,-13
42,Pennsylvania,37,North Carolina,115,Madison County,0,15,-15
42,Pennsylvania,37,North Carolina,119,Mecklenburg County,1022,2086,-1064
42,Pennsylvania,37,North Carolina,123,Montgomery County,21,7,14
42,Pennsylvania,37,North Carolina,125,Moore County,56,175,-119
42,Pennsylvania,37,North Carolina,127,Nash County,39,5,34
42,Pennsylvania,37,North Carolina,129,New Hanover County,173,383,-210
42,Pennsylvania,37,North Carolina,131,Northampton County,0,83,-83
42,Pennsylvania,37,North Carolina,133,Onslow County,465,913,-448
42,Pennsylvania,37,North Carolina,135,Orange County,203,721,-518
42,Pennsylvania,37,North Carolina,137,Pamlico County,0,5,-5
42,Pennsylvania,37,North Carolina,139,Pasquotank County,10,16,-6
42,Pennsylvania,37,North Carolina,141,Pender County,71,58,13
42,Pennsylvania,37,North Carolina,145,Person County,28,4,24
42,Pennsylvania,37,North Carolina,147,Pitt County,141,166,-25
42,Pennsylvania,37,North Carolina,149,Polk County,6,24,-18
42,Pennsylvania,37,North Carolina,151,Randolph County,14,18,-4
42,Pennsylvania,37,North Carolina,153,Richmond County,13,39,-26
42,Pennsylvania,37,North Carolina,155,Robeson County,0,90,-90
42,Pennsylvania,37,North Carolina,157,Rockingham County,30,0,30
42,Pennsylvania,37,North Carolina,159,Rowan County,25,180,-155
42,Pennsylvania,37,North Carolina,161,Rutherford County,9,0,9
42,Pennsylvania,37,North Carolina,163,Sampson County,1,77,-76
42,Pennsylvania,37,North Carolina,165,Scotland County,0,17,-17
42,Pennsylvania,37,North Carolina,167,Stanly County,15,13,2
42,Pennsylvania,37,North Carolina,169,Stokes County,0,43,-43
42,Pennsylvania,37,North Carolina,171,Surry County,0,11,-11
42,Pennsylvania,37,North Carolina,173,Swain County,21,13,8
42,Pennsylvania,37,North Carolina,175,Transylvania County,0,2,-2
42,Pennsylvania,37,North Carolina,177,Tyrrell County,1,0,1
42,Pennsylvania,37,North Carolina,179,Union County,294,332,-38
42,Pennsylvania,37,North Carolina,181,Vance County,0,22,-22
42,Pennsylvania,37,North Carolina,183,Wake County,1136,1410,-274
42,Pennsylvania,37,North Carolina,187,Washington County,63,39,24
42,Pennsylvania,37,North Carolina,189,Watauga County,0,27,-27
42,Pennsylvania,37,North Carolina,191,Wayne County,26,112,-86
42,Pennsylvania,37,North Carolina,193,Wilkes County,0,65,-65
42,Pennsylvania,37,North Carolina,195,Wilson County,44,6,38
42,Pennsylvania,37,North Carolina,197,Yadkin County,0,14,-14
42,Pennsylvania,37,North Carolina,199,Yancey County,0,24,-24
42,Pennsylvania,38,North Dakota,3,Barnes County,0,40,-40
42,Pennsylvania,38,North Dakota,17,Cass County,74,147,-73
42,Pennsylvania,38,North Dakota,21,Dickey County,25,0,25
42,Pennsylvania,38,North Dakota,35,Grand Forks County,77,169,-92
42,Pennsylvania,38,North Dakota,93,Stutsman County,8,2,6
42,Pennsylvania,38,North Dakota,99,Walsh County,12,0,12
42,Pennsylvania,38,North Dakota,101,Ward County,47,102,-55
42,Pennsylvania,38,North Dakota,103,Wells County,1,0,1
42,Pennsylvania,38,North Dakota,105,Williams County,17,0,17
42,Pennsylvania,39,Ohio,3,Allen County,19,94,-75
42,Pennsylvania,39,Ohio,5,Ashland County,13,119,-106
42,Pennsylvania,39,Ohio,7,Ashtabula County,393,193,200
42,Pennsylvania,39,Ohio,9,Athens County,76,219,-143
42,Pennsylvania,39,Ohio,11,Auglaize County,0,20,-20
42,Pennsylvania,39,Ohio,13,Belmont County,115,80,35
42,Pennsylvania,39,Ohio,15,Brown County,29,14,15
42,Pennsylvania,39,Ohio,17,Butler County,193,236,-43
42,Pennsylvania,39,Ohio,19,Carroll County,145,86,59
42,Pennsylvania,39,Ohio,23,Clark County,62,68,-6
42,Pennsylvania,39,Ohio,25,Clermont County,61,40,21
42,Pennsylvania,39,Ohio,27,Clinton County,0,45,-45
42,Pennsylvania,39,Ohio,29,Columbiana County,370,751,-381
42,Pennsylvania,39,Ohio,31,Coshocton County,12,12,0
42,Pennsylvania,39,Ohio,33,Crawford County,29,18,11
42,Pennsylvania,39,Ohio,35,Cuyahoga County,1673,1563,110
42,Pennsylvania,39,Ohio,37,Darke County,5,6,-1
42,Pennsylvania,39,Ohio,39,Defiance County,0,49,-49
42,Pennsylvania,39,Ohio,41,Delaware County,113,252,-139
42,Pennsylvania,39,Ohio,43,Erie County,0,70,-70
42,Pennsylvania,39,Ohio,45,Fairfield County,142,99,43
42,Pennsylvania,39,Ohio,47,Fayette County,0,13,-13
42,Pennsylvania,39,Ohio,49,Franklin County,1426,1731,-305
42,Pennsylvania,39,Ohio,51,Fulton County,10,0,10
42,Pennsylvania,39,Ohio,55,Geauga County,80,112,-32
42,Pennsylvania,39,Ohio,57,Greene County,52,374,-322
42,Pennsylvania,39,Ohio,59,Guernsey County,21,4,17
42,Pennsylvania,39,Ohio,61,Hamilton County,405,475,-70
42,Pennsylvania,39,Ohio,63,Hancock County,45,278,-233
42,Pennsylvania,39,Ohio,65,Hardin County,12,43,-31
42,Pennsylvania,39,Ohio,67,Harrison County,45,7,38
42,Pennsylvania,39,Ohio,69,Henry County,16,0,16
42,Pennsylvania,39,Ohio,71,Highland County,0,5,-5
42,Pennsylvania,39,Ohio,75,Holmes County,32,4,28
42,Pennsylvania,39,Ohio,77,Huron County,18,12,6
42,Pennsylvania,39,Ohio,79,Jackson County,0,14,-14
42,Pennsylvania,39,Ohio,81,Jefferson County,153,392,-239
42,Pennsylvania,39,Ohio,83,Knox County,9,85,-76
42,Pennsylvania,39,Ohio,85,Lake County,359,442,-83
42,Pennsylvania,39,Ohio,87,Lawrence County,4,0,4
42,Pennsylvania,39,Ohio,89,Licking County,70,63,7
42,Pennsylvania,39,Ohio,91,Logan County,22,21,1
42,Pennsylvania,39,Ohio,93,Lorain County,438,268,170
42,Pennsylvania,39,Ohio,95,Lucas County,236,410,-174
42,Pennsylvania,39,Ohio,97,Madison County,18,105,-87
42,Pennsylvania,39,Ohio,99,Mahoning County,1184,1195,-11
42,Pennsylvania,39,Ohio,101,Marion County,0,9,-9
42,Pennsylvania,39,Ohio,103,Medina County,192,325,-133
42,Pennsylvania,39,Ohio,107,Mercer County,0,29,-29
42,Pennsylvania,39,Ohio,109,Miami County,41,114,-73
42,Pennsylvania,39,Ohio,111,Monroe County,21,0,21
42,Pennsylvania,39,Ohio,113,Montgomery County,232,638,-406
42,Pennsylvania,39,Ohio,117,Morrow County,28,0,28
42,Pennsylvania,39,Ohio,119,Muskingum County,97,27,70
42,Pennsylvania,39,Ohio,121,Noble County,22,90,-68
42,Pennsylvania,39,Ohio,123,Ottawa County,0,32,-32
42,Pennsylvania,39,Ohio,127,Perry County,9,0,9
42,Pennsylvania,39,Ohio,129,Pickaway County,7,16,-9
42,Pennsylvania,39,Ohio,131,Pike County,0,80,-80
42,Pennsylvania,39,Ohio,133,Portage County,375,435,-60
42,Pennsylvania,39,Ohio,135,Preble County,35,110,-75
42,Pennsylvania,39,Ohio,137,Putnam County,5,0,5
42,Pennsylvania,39,Ohio,139,Richland County,64,107,-43
42,Pennsylvania,39,Ohio,141,Ross County,2,0,2
42,Pennsylvania,39,Ohio,143,Sandusky County,9,17,-8
42,Pennsylvania,39,Ohio,145,Scioto County,0,14,-14
42,Pennsylvania,39,Ohio,147,Seneca County,129,23,106
42,Pennsylvania,39,Ohio,149,Shelby County,6,9,-3
42,Pennsylvania,39,Ohio,151,Stark County,434,390,44
42,Pennsylvania,39,Ohio,153,Summit County,626,981,-355
42,Pennsylvania,39,Ohio,155,Trumbull County,639,611,28
42,Pennsylvania,39,Ohio,157,Tuscarawas County,98,88,10
42,Pennsylvania,39,Ohio,159,Union County,29,11,18
42,Pennsylvania,39,Ohio,161,Van Wert County,0,29,-29
42,Pennsylvania,39,Ohio,165,Warren County,57,106,-49
42,Pennsylvania,39,Ohio,167,Washington County,76,89,-13
42,Pennsylvania,39,Ohio,169,Wayne County,168,38,130
42,Pennsylvania,39,Ohio,171,Williams County,8,0,8
42,Pennsylvania,39,Ohio,173,Wood County,201,279,-78
42,Pennsylvania,39,Ohio,175,Wyandot County,21,4,17
42,Pennsylvania,4,Arizona,1,Apache County,30,0,30
42,Pennsylvania,4,Arizona,3,Cochise County,127,105,22
42,Pennsylvania,4,Arizona,5,Coconino County,16,84,-68
42,Pennsylvania,4,Arizona,9,Graham County,30,0,30
42,Pennsylvania,4,Arizona,11,Greenlee County,14,0,14
42,Pennsylvania,4,Arizona,13,Maricopa County,1365,3231,-1866
42,Pennsylvania,4,Arizona,15,Mohave County,75,98,-23
42,Pennsylvania,4,Arizona,19,Pima County,587,543,44
42,Pennsylvania,4,Arizona,21,Pinal County,137,852,-715
42,Pennsylvania,4,Arizona,25,Yavapai County,72,163,-91
42,Pennsylvania,4,Arizona,27,Yuma County,191,115,76
42,Pennsylvania,40,Oklahoma,13,Bryan County,9,8,1
42,Pennsylvania,40,Oklahoma,19,Carter County,38,2,36
42,Pennsylvania,40,Oklahoma,27,Cleveland County,80,111,-31
42,Pennsylvania,40,Oklahoma,31,Comanche County,352,319,33
42,Pennsylvania,40,Oklahoma,33,Cotton County,93,0,93
42,Pennsylvania,40,Oklahoma,35,Craig County,0,20,-20
42,Pennsylvania,40,Oklahoma,37,Creek County,0,7,-7
42,Pennsylvania,40,Oklahoma,45,Ellis County,0,13,-13
42,Pennsylvania,40,Oklahoma,47,Garfield County,7,11,-4
42,Pennsylvania,40,Oklahoma,51,Grady County,0,5,-5
42,Pennsylvania,40,Oklahoma,61,Haskell County,0,20,-20
42,Pennsylvania,40,Oklahoma,65,Jackson County,17,7,10
42,Pennsylvania,40,Oklahoma,71,Kay County,18,3,15
42,Pennsylvania,40,Oklahoma,77,Latimer County,0,18,-18
42,Pennsylvania,40,Oklahoma,79,Le Flore County,0,12,-12
42,Pennsylvania,40,Oklahoma,87,McClain County,10,0,10
42,Pennsylvania,40,Oklahoma,97,Mayes County,0,35,-35
42,Pennsylvania,40,Oklahoma,101,Muskogee County,0,36,-36
42,Pennsylvania,40,Oklahoma,109,Oklahoma County,292,245,47
42,Pennsylvania,40,Oklahoma,113,Osage County,0,8,-8
42,Pennsylvania,40,Oklahoma,119,Payne County,0,39,-39
42,Pennsylvania,40,Oklahoma,121,Pittsburg County,0,4,-4
42,Pennsylvania,40,Oklahoma,123,Pontotoc County,8,21,-13
42,Pennsylvania,40,Oklahoma,125,Pottawatomie County,39,7,32
42,Pennsylvania,40,Oklahoma,131,Rogers County,0,12,-12
42,Pennsylvania,40,Oklahoma,133,Seminole County,0,12,-12
42,Pennsylvania,40,Oklahoma,143,Tulsa County,72,95,-23
42,Pennsylvania,40,Oklahoma,145,Wagoner County,72,10,62
42,Pennsylvania,40,Oklahoma,147,Washington County,0,154,-154
42,Pennsylvania,40,Oklahoma,149,Washita County,0,28,-28
42,Pennsylvania,40,Oklahoma,151,Woods County,0,30,-30
42,Pennsylvania,40,Oklahoma,153,Woodward County,3,0,3
42,Pennsylvania,41,Oregon,3,Benton County,124,202,-78
42,Pennsylvania,41,Oregon,5,Clackamas County,58,28,30
42,Pennsylvania,41,Oregon,7,Clatsop County,32,11,21
42,Pennsylvania,41,Oregon,11,Coos County,29,0,29
42,Pennsylvania,41,Oregon,17,Deschutes County,0,167,-167
42,Pennsylvania,41,Oregon,19,Douglas County,46,0,46
42,Pennsylvania,41,Oregon,29,Jackson County,104,35,69
42,Pennsylvania,41,Oregon,33,Josephine County,15,5,10
42,Pennsylvania,41,Oregon,35,Klamath County,0,19,-19
42,Pennsylvania,41,Oregon,39,Lane County,103,29,74
42,Pennsylvania,41,Oregon,41,Lincoln County,40,28,12
42,Pennsylvania,41,Oregon,43,Linn County,49,0,49
42,Pennsylvania,41,Oregon,45,Malheur County,8,4,4
42,Pennsylvania,41,Oregon,47,Marion County,11,126,-115
42,Pennsylvania,41,Oregon,51,Multnomah County,542,722,-180
42,Pennsylvania,41,Oregon,53,Polk County,0,148,-148
42,Pennsylvania,41,Oregon,59,Umatilla County,0,22,-22
42,Pennsylvania,41,Oregon,63,Wallowa County,0,4,-4
42,Pennsylvania,41,Oregon,65,Wasco County,0,9,-9
42,Pennsylvania,41,Oregon,67,Washington County,216,199,17
42,Pennsylvania,41,Oregon,71,Yamhill County,26,44,-18
42,Pennsylvania,42,Pennsylvania,1,Adams County,4482,2442,2040
42,Pennsylvania,42,Pennsylvania,3,Allegheny County,23451,22375,1076
42,Pennsylvania,42,Pennsylvania,5,Armstrong County,2049,1822,227
42,Pennsylvania,42,Pennsylvania,7,Beaver County,4068,4262,-194
42,Pennsylvania,42,Pennsylvania,9,Bedford County,1217,669,548
42,Pennsylvania,42,Pennsylvania,11,Berks County,9918,10333,-415
42,Pennsylvania,42,Pennsylvania,13,Blair County,3108,3266,-158
42,Pennsylvania,42,Pennsylvania,15,Bradford County,1259,539,720
42,Pennsylvania,42,Pennsylvania,17,Bucks County,15671,13609,2062
42,Pennsylvania,42,Pennsylvania,19,Butler County,5366,7159,-1793
42,Pennsylvania,42,Pennsylvania,21,Cambria County,4480,3987,493
42,Pennsylvania,42,Pennsylvania,23,Cameron County,251,246,5
42,Pennsylvania,42,Pennsylvania,25,Carbon County,2558,1773,785
42,Pennsylvania,42,Pennsylvania,27,Centre County,4635,12796,-8161
42,Pennsylvania,42,Pennsylvania,29,Chester County,15087,14775,312
42,Pennsylvania,42,Pennsylvania,31,Clarion County,1388,1933,-545
42,Pennsylvania,42,Pennsylvania,33,Clearfield County,2329,3095,-766
42,Pennsylvania,42,Pennsylvania,35,Clinton County,1320,2031,-711
42,Pennsylvania,42,Pennsylvania,37,Columbia County,2634,3099,-465
42,Pennsylvania,42,Pennsylvania,39,Crawford County,2693,2609,84
42,Pennsylvania,42,Pennsylvania,41,Cumberland County,8229,13297,-5068
42,Pennsylvania,42,Pennsylvania,43,Dauphin County,11239,9804,1435
42,Pennsylvania,42,Pennsylvania,45,Delaware County,13854,14857,-1003
42,Pennsylvania,42,Pennsylvania,47,Elk County,883,288,595
42,Pennsylvania,42,Pennsylvania,49,Erie County,5079,5677,-598
42,Pennsylvania,42,Pennsylvania,51,Fayette County,3586,3060,526
42,Pennsylvania,42,Pennsylvania,53,Forest County,552,957,-405
42,Pennsylvania,42,Pennsylvania,55,Franklin County,3902,2673,1229
42,Pennsylvania,42,Pennsylvania,57,Fulton County,518,587,-69
42,Pennsylvania,42,Pennsylvania,59,Greene County,1124,1149,-25
42,Pennsylvania,42,Pennsylvania,61,Huntingdon County,1177,1718,-541
42,Pennsylvania,42,Pennsylvania,63,Indiana County,2330,6621,-4291
42,Pennsylvania,42,Pennsylvania,65,Jefferson County,2163,1378,785
42,Pennsylvania,42,Pennsylvania,67,Juniata County,850,795,55
42,Pennsylvania,42,Pennsylvania,69,Lackawanna County,5283,5526,-243
42,Pennsylvania,42,Pennsylvania,71,Lancaster County,10894,11624,-730
42,Pennsylvania,42,Pennsylvania,73,Lawrence County,1818,1711,107
42,Pennsylvania,42,Pennsylvania,75,Lebanon County,3979,4483,-504
42,Pennsylvania,42,Pennsylvania,77,Lehigh County,11306,10253,1053
42,Pennsylvania,42,Pennsylvania,79,Luzerne County,6945,6388,557
42,Pennsylvania,42,Pennsylvania,81,Lycoming County,3430,3380,50
42,Pennsylvania,42,Pennsylvania,83,McKean County,944,826,118
42,Pennsylvania,42,Pennsylvania,85,Mercer County,2903,2932,-29
42,Pennsylvania,42,Pennsylvania,87,Mifflin County,936,1250,-314
42,Pennsylvania,42,Pennsylvania,89,Monroe County,4779,3935,844
42,Pennsylvania,42,Pennsylvania,91,Montgomery County,25232,26753,-1521
42,Pennsylvania,42,Pennsylvania,93,Montour County,957,1115,-158
42,Pennsylvania,42,Pennsylvania,95,Northampton County,8931,8056,875
42,Pennsylvania,42,Pennsylvania,97,Northumberland County,3293,3269,24
42,Pennsylvania,42,Pennsylvania,99,Perry County,1828,1528,300
42,Pennsylvania,42,Pennsylvania,101,Philadelphia County,36142,26386,9756
42,Pennsylvania,42,Pennsylvania,103,Pike County,1676,1171,505
42,Pennsylvania,42,Pennsylvania,105,Potter County,451,418,33
42,Pennsylvania,42,Pennsylvania,107,Schuylkill County,4143,2998,1145
42,Pennsylvania,42,Pennsylvania,109,Snyder County,1156,1021,135
42,Pennsylvania,42,Pennsylvania,111,Somerset County,2151,1768,383
42,Pennsylvania,42,Pennsylvania,113,Sullivan County,104,382,-278
42,Pennsylvania,42,Pennsylvania,115,Susquehanna County,986,923,63
42,Pennsylvania,42,Pennsylvania,117,Tioga County,955,930,25
42,Pennsylvania,42,Pennsylvania,119,Union County,1493,2114,-621
42,Pennsylvania,42,Pennsylvania,121,Venango County,1395,1708,-313
42,Pennsylvania,42,Pennsylvania,123,Warren County,1003,721,282
42,Pennsylvania,42,Pennsylvania,125,Washington County,5650,6424,-774
42,Pennsylvania,42,Pennsylvania,127,Wayne County,1377,1868,-491
42,Pennsylvania,42,Pennsylvania,129,Westmoreland County,10119,8940,1179
42,Pennsylvania,42,Pennsylvania,131,Wyoming County,1194,1054,140
42,Pennsylvania,42,Pennsylvania,133,York County,9164,8531,633
42,Pennsylvania,44,Rhode Island,1,Bristol County,61,46,15
42,Pennsylvania,44,Rhode Island,3,Kent County,152,20,132
42,Pennsylvania,44,Rhode Island,5,Newport County,132,105,27
42,Pennsylvania,44,Rhode Island,7,Providence County,640,619,21
42,Pennsylvania,44,Rhode Island,9,Washington County,100,107,-7
42,Pennsylvania,45,South Carolina,3,Aiken County,73,105,-32
42,Pennsylvania,45,South Carolina,7,Anderson County,18,155,-137
42,Pennsylvania,45,South Carolina,9,Bamberg County,0,6,-6
42,Pennsylvania,45,South Carolina,13,Beaufort County,348,757,-409
42,Pennsylvania,45,South Carolina,15,Berkeley County,214,199,15
42,Pennsylvania,45,South Carolina,17,Calhoun County,4,0,4
42,Pennsylvania,45,South Carolina,19,Charleston County,311,732,-421
42,Pennsylvania,45,South Carolina,21,Cherokee County,0,43,-43
42,Pennsylvania,45,South Carolina,23,Chester County,21,14,7
42,Pennsylvania,45,South Carolina,25,Chesterfield County,0,26,-26
42,Pennsylvania,45,South Carolina,31,Darlington County,135,8,127
42,Pennsylvania,45,South Carolina,33,Dillon County,4,0,4
42,Pennsylvania,45,South Carolina,35,Dorchester County,157,180,-23
42,Pennsylvania,45,South Carolina,37,Edgefield County,0,24,-24
42,Pennsylvania,45,South Carolina,39,Fairfield County,0,1,-1
42,Pennsylvania,45,South Carolina,41,Florence County,70,27,43
42,Pennsylvania,45,South Carolina,43,Georgetown County,0,170,-170
42,Pennsylvania,45,South Carolina,45,Greenville County,280,1129,-849
42,Pennsylvania,45,South Carolina,47,Greenwood County,10,52,-42
42,Pennsylvania,45,South Carolina,49,Hampton County,0,21,-21
42,Pennsylvania,45,South Carolina,51,Horry County,373,928,-555
42,Pennsylvania,45,South Carolina,53,Jasper County,0,67,-67
42,Pennsylvania,45,South Carolina,55,Kershaw County,0,38,-38
42,Pennsylvania,45,South Carolina,57,Lancaster County,133,40,93
42,Pennsylvania,45,South Carolina,59,Laurens County,60,115,-55
42,Pennsylvania,45,South Carolina,61,Lee County,0,33,-33
42,Pennsylvania,45,South Carolina,63,Lexington County,72,292,-220
42,Pennsylvania,45,South Carolina,65,McCormick County,15,53,-38
42,Pennsylvania,45,South Carolina,67,Marion County,0,134,-134
42,Pennsylvania,45,South Carolina,69,Marlboro County,0,12,-12
42,Pennsylvania,45,South Carolina,71,Newberry County,0,41,-41
42,Pennsylvania,45,South Carolina,73,Oconee County,90,203,-113
42,Pennsylvania,45,South Carolina,75,Orangeburg County,59,26,33
42,Pennsylvania,45,South Carolina,77,Pickens County,125,219,-94
42,Pennsylvania,45,South Carolina,79,Richland County,330,1150,-820
42,Pennsylvania,45,South Carolina,83,Spartanburg County,105,325,-220
42,Pennsylvania,45,South Carolina,85,Sumter County,34,211,-177
42,Pennsylvania,45,South Carolina,89,Williamsburg County,0,10,-10
42,Pennsylvania,45,South Carolina,91,York County,124,399,-275
42,Pennsylvania,46,South Dakota,9,Bon Homme County,0,41,-41
42,Pennsylvania,46,South Dakota,11,Brookings County,32,17,15
42,Pennsylvania,46,South Dakota,15,Brule County,19,1,18
42,Pennsylvania,46,South Dakota,99,Minnehaha County,215,35,180
42,Pennsylvania,46,South Dakota,101,Moody County,5,0,5
42,Pennsylvania,46,South Dakota,103,Pennington County,29,32,-3
42,Pennsylvania,46,South Dakota,121,Todd County,13,0,13
42,Pennsylvania,46,South Dakota,135,Yankton County,9,5,4
42,Pennsylvania,46,South Dakota,137,Ziebach County,58,0,58
42,Pennsylvania,47,Tennessee,1,Anderson County,0,204,-204
42,Pennsylvania,47,Tennessee,3,Bedford County,0,63,-63
42,Pennsylvania,47,Tennessee,9,Blount County,44,27,17
42,Pennsylvania,47,Tennessee,11,Bradley County,59,36,23
42,Pennsylvania,47,Tennessee,17,Carroll County,14,0,14
42,Pennsylvania,47,Tennessee,19,Carter County,0,8,-8
42,Pennsylvania,47,Tennessee,21,Cheatham County,0,19,-19
42,Pennsylvania,47,Tennessee,23,Chester County,3,0,3
42,Pennsylvania,47,Tennessee,25,Claiborne County,0,21,-21
42,Pennsylvania,47,Tennessee,29,Cocke County,0,21,-21
42,Pennsylvania,47,Tennessee,35,Cumberland County,0,54,-54
42,Pennsylvania,47,Tennessee,37,Davidson County,488,670,-182
42,Pennsylvania,47,Tennessee,41,DeKalb County,23,0,23
42,Pennsylvania,47,Tennessee,47,Fayette County,0,25,-25
42,Pennsylvania,47,Tennessee,51,Franklin County,0,10,-10
42,Pennsylvania,47,Tennessee,55,Giles County,0,11,-11
42,Pennsylvania,47,Tennessee,63,Hamblen County,15,0,15
42,Pennsylvania,47,Tennessee,65,Hamilton County,294,44,250
42,Pennsylvania,47,Tennessee,73,Hawkins County,14,72,-58
42,Pennsylvania,47,Tennessee,79,Henry County,44,0,44
42,Pennsylvania,47,Tennessee,81,Hickman County,15,0,15
42,Pennsylvania,47,Tennessee,89,Jefferson County,23,50,-27
42,Pennsylvania,47,Tennessee,93,Knox County,181,203,-22
42,Pennsylvania,47,Tennessee,97,Lauderdale County,0,8,-8
42,Pennsylvania,47,Tennessee,103,Lincoln County,0,39,-39
42,Pennsylvania,47,Tennessee,105,Loudon County,14,64,-50
42,Pennsylvania,47,Tennessee,107,McMinn County,12,7,5
42,Pennsylvania,47,Tennessee,113,Madison County,0,22,-22
42,Pennsylvania,47,Tennessee,115,Marion County,0,24,-24
42,Pennsylvania,47,Tennessee,119,Maury County,0,13,-13
42,Pennsylvania,47,Tennessee,121,Meigs County,0,8,-8
42,Pennsylvania,47,Tennessee,123,Monroe County,0,25,-25
42,Pennsylvania,47,Tennessee,125,Montgomery County,151,84,67
42,Pennsylvania,47,Tennessee,131,Obion County,11,12,-1
42,Pennsylvania,47,Tennessee,135,Perry County,0,2,-2
42,Pennsylvania,47,Tennessee,139,Polk County,0,5,-5
42,Pennsylvania,47,Tennessee,143,Rhea County,39,124,-85
42,Pennsylvania,47,Tennessee,145,Roane County,0,21,-21
42,Pennsylvania,47,Tennessee,149,Rutherford County,294,90,204
42,Pennsylvania,47,Tennessee,155,Sevier County,38,21,17
42,Pennsylvania,47,Tennessee,157,Shelby County,488,363,125
42,Pennsylvania,47,Tennessee,161,Stewart County,42,0,42
42,Pennsylvania,47,Tennessee,163,Sullivan County,61,74,-13
42,Pennsylvania,47,Tennessee,165,Sumner County,31,99,-68
42,Pennsylvania,47,Tennessee,167,Tipton County,0,1,-1
42,Pennsylvania,47,Tennessee,173,Union County,0,22,-22
42,Pennsylvania,47,Tennessee,179,Washington County,63,56,7
42,Pennsylvania,47,Tennessee,181,Wayne County,5,0,5
42,Pennsylvania,47,Tennessee,183,Weakley County,61,11,50
42,Pennsylvania,47,Tennessee,187,Williamson County,240,250,-10
42,Pennsylvania,47,Tennessee,189,Wilson County,68,122,-54
42,Pennsylvania,48,Texas,1,Anderson County,15,9,6
42,Pennsylvania,48,Texas,13,Atascosa County,0,260,-260
42,Pennsylvania,48,Texas,21,Bastrop County,0,16,-16
42,Pennsylvania,48,Texas,27,Bell County,268,185,83
42,Pennsylvania,48,Texas,29,Bexar County,669,607,62
42,Pennsylvania,48,Texas,37,Bowie County,0,87,-87
42,Pennsylvania,48,Texas,39,Brazoria County,105,63,42
42,Pennsylvania,48,Texas,41,Brazos County,82,102,-20
42,Pennsylvania,48,Texas,49,Brown County,5,0,5
42,Pennsylvania,48,Texas,51,Burleson County,4,6,-2
42,Pennsylvania,48,Texas,53,Burnet County,0,96,-96
42,Pennsylvania,48,Texas,55,Caldwell County,10,6,4
42,Pennsylvania,48,Texas,61,Cameron County,34,40,-6
42,Pennsylvania,48,Texas,81,Coke County,97,0,97
42,Pennsylvania,48,Texas,85,Collin County,260,840,-580
42,Pennsylvania,48,Texas,91,Comal County,22,57,-35
42,Pennsylvania,48,Texas,93,Comanche County,0,1,-1
42,Pennsylvania,48,Texas,97,Cooke County,0,4,-4
42,Pennsylvania,48,Texas,99,Coryell County,136,118,18
42,Pennsylvania,48,Texas,113,Dallas County,1018,1213,-195
42,Pennsylvania,48,Texas,121,Denton County,326,629,-303
42,Pennsylvania,48,Texas,135,Ector County,52,19,33
42,Pennsylvania,48,Texas,139,Ellis County,73,18,55
42,Pennsylvania,48,Texas,141,El Paso County,608,322,286
42,Pennsylvania,48,Texas,145,Falls County,0,15,-15
42,Pennsylvania,48,Texas,147,Fannin County,0,4,-4
42,Pennsylvania,48,Texas,157,Fort Bend County,271,337,-66
42,Pennsylvania,48,Texas,161,Freestone County,35,0,35
42,Pennsylvania,48,Texas,167,Galveston County,43,155,-112
42,Pennsylvania,48,Texas,169,Garza County,9,0,9
42,Pennsylvania,48,Texas,171,Gillespie County,5,0,5
42,Pennsylvania,48,Texas,175,Goliad County,11,0,11
42,Pennsylvania,48,Texas,181,Grayson County,2,34,-32
42,Pennsylvania,48,Texas,183,Gregg County,2,1,1
42,Pennsylvania,48,Texas,187,Guadalupe County,164,41,123
42,Pennsylvania,48,Texas,199,Hardin County,83,6,77
42,Pennsylvania,48,Texas,201,Harris County,1299,1867,-568
42,Pennsylvania,48,Texas,209,Hays County,54,29,25
42,Pennsylvania,48,Texas,215,Hidalgo County,61,0,61
42,Pennsylvania,48,Texas,217,Hill County,0,37,-37
42,Pennsylvania,48,Texas,219,Hockley County,0,2,-2
42,Pennsylvania,48,Texas,221,Hood County,44,0,44
42,Pennsylvania,48,Texas,223,Hopkins County,0,164,-164
42,Pennsylvania,48,Texas,225,Houston County,6,16,-10
42,Pennsylvania,48,Texas,227,Howard County,14,0,14
42,Pennsylvania,48,Texas,231,Hunt County,0,12,-12
42,Pennsylvania,48,Texas,233,Hutchinson County,1,0,1
42,Pennsylvania,48,Texas,241,Jasper County,2,0,2
42,Pennsylvania,48,Texas,245,Jefferson County,194,27,167
42,Pennsylvania,48,Texas,249,Jim Wells County,0,35,-35
42,Pennsylvania,48,Texas,251,Johnson County,2,9,-7
42,Pennsylvania,48,Texas,253,Jones County,15,9,6
42,Pennsylvania,48,Texas,257,Kaufman County,0,4,-4
42,Pennsylvania,48,Texas,259,Kendall County,0,13,-13
42,Pennsylvania,48,Texas,265,Kerr County,4,0,4
42,Pennsylvania,48,Texas,273,Kleberg County,12,21,-9
42,Pennsylvania,48,Texas,283,La Salle County,0,6,-6
42,Pennsylvania,48,Texas,287,Lee County,27,0,27
42,Pennsylvania,48,Texas,291,Liberty County,9,0,9
42,Pennsylvania,48,Texas,293,Limestone County,13,0,13
42,Pennsylvania,48,Texas,299,Llano County,0,7,-7
42,Pennsylvania,48,Texas,303,Lubbock County,77,89,-12
42,Pennsylvania,48,Texas,309,McLennan County,13,42,-29
42,Pennsylvania,48,Texas,323,Maverick County,3,0,3
42,Pennsylvania,48,Texas,329,Midland County,14,21,-7
42,Pennsylvania,48,Texas,331,Milam County,0,8,-8
42,Pennsylvania,48,Texas,339,Montgomery County,239,309,-70
42,Pennsylvania,48,Texas,349,Navarro County,3,0,3
42,Pennsylvania,48,Texas,355,Nueces County,275,272,3
42,Pennsylvania,48,Texas,361,Orange County,12,0,12
42,Pennsylvania,48,Texas,363,Palo Pinto County,0,103,-103
42,Pennsylvania,48,Texas,367,Parker County,53,0,53
42,Pennsylvania,48,Texas,369,Parmer County,21,0,21
42,Pennsylvania,48,Texas,371,Pecos County,12,0,12
42,Pennsylvania,48,Texas,375,Potter County,15,54,-39
42,Pennsylvania,48,Texas,381,Randall County,13,38,-25
42,Pennsylvania,48,Texas,395,Robertson County,16,0,16
42,Pennsylvania,48,Texas,397,Rockwall County,0,26,-26
42,Pennsylvania,48,Texas,399,Runnels County,0,1,-1
42,Pennsylvania,48,Texas,401,Rusk County,7,0,7
42,Pennsylvania,48,Texas,407,San Jacinto County,0,75,-75
42,Pennsylvania,48,Texas,409,San Patricio County,10,19,-9
42,Pennsylvania,48,Texas,415,Scurry County,3,0,3
42,Pennsylvania,48,Texas,419,Shelby County,0,53,-53
42,Pennsylvania,48,Texas,423,Smith County,25,135,-110
42,Pennsylvania,48,Texas,439,Tarrant County,566,1043,-477
42,Pennsylvania,48,Texas,441,Taylor County,2,42,-40
42,Pennsylvania,48,Texas,451,Tom Green County,44,61,-17
42,Pennsylvania,48,Texas,453,Travis County,886,1414,-528
42,Pennsylvania,48,Texas,455,Trinity County,8,0,8
42,Pennsylvania,48,Texas,459,Upshur County,29,0,29
42,Pennsylvania,48,Texas,465,Val Verde County,14,23,-9
42,Pennsylvania,48,Texas,467,Van Zandt County,0,15,-15
42,Pennsylvania,48,Texas,469,Victoria County,5,0,5
42,Pennsylvania,48,Texas,473,Waller County,0,13,-13
42,Pennsylvania,48,Texas,475,Ward County,14,21,-7
42,Pennsylvania,48,Texas,479,Webb County,32,6,26
42,Pennsylvania,48,Texas,485,Wichita County,202,130,72
42,Pennsylvania,48,Texas,491,Williamson County,84,222,-138
42,Pennsylvania,48,Texas,497,Wise County,5,0,5
42,Pennsylvania,48,Texas,503,Young County,0,35,-35
42,Pennsylvania,48,Texas,507,Zavala County,0,73,-73
42,Pennsylvania,49,Utah,3,Box Elder County,0,62,-62
42,Pennsylvania,49,Utah,5,Cache County,76,48,28
42,Pennsylvania,49,Utah,7,Carbon County,0,2,-2
42,Pennsylvania,49,Utah,11,Davis County,80,95,-15
42,Pennsylvania,49,Utah,13,Duchesne County,0,2,-2
42,Pennsylvania,49,Utah,21,Iron County,41,6,35
42,Pennsylvania,49,Utah,27,Millard County,19,0,19
42,Pennsylvania,49,Utah,29,Morgan County,0,27,-27
42,Pennsylvania,49,Utah,35,Salt Lake County,519,722,-203
42,Pennsylvania,49,Utah,39,Sanpete County,0,13,-13
42,Pennsylvania,49,Utah,43,Summit County,0,13,-13
42,Pennsylvania,49,Utah,47,Uintah County,0,18,-18
42,Pennsylvania,49,Utah,49,Utah County,527,225,302
42,Pennsylvania,49,Utah,57,Weber County,96,251,-155
42,Pennsylvania,5,Arkansas,7,Benton County,151,50,101
42,Pennsylvania,5,Arkansas,9,Boone County,2,0,2
42,Pennsylvania,5,Arkansas,25,Cleveland County,11,0,11
42,Pennsylvania,5,Arkansas,31,Craighead County,72,0,72
42,Pennsylvania,5,Arkansas,33,Crawford County,61,162,-101
42,Pennsylvania,5,Arkansas,37,Cross County,0,11,-11
42,Pennsylvania,5,Arkansas,45,Faulkner County,141,29,112
42,Pennsylvania,5,Arkansas,51,Garland County,0,43,-43
42,Pennsylvania,5,Arkansas,55,Greene County,0,3,-3
42,Pennsylvania,5,Arkansas,69,Jefferson County,0,45,-45
42,Pennsylvania,5,Arkansas,83,Logan County,0,46,-46
42,Pennsylvania,5,Arkansas,85,Lonoke County,93,0,93
42,Pennsylvania,5,Arkansas,89,Marion County,0,41,-41
42,Pennsylvania,5,Arkansas,91,Miller County,0,40,-40
42,Pennsylvania,5,Arkansas,97,Montgomery County,0,6,-6
42,Pennsylvania,5,Arkansas,99,Nevada County,0,27,-27
42,Pennsylvania,5,Arkansas,103,Ouachita County,8,33,-25
42,Pennsylvania,5,Arkansas,105,Perry County,0,13,-13
42,Pennsylvania,5,Arkansas,111,Poinsett County,0,5,-5
42,Pennsylvania,5,Arkansas,115,Pope County,20,0,20
42,Pennsylvania,5,Arkansas,119,Pulaski County,246,121,125
42,Pennsylvania,5,Arkansas,125,Saline County,0,89,-89
42,Pennsylvania,5,Arkansas,131,Sebastian County,0,52,-52
42,Pennsylvania,5,Arkansas,143,Washington County,36,14,22
42,Pennsylvania,5,Arkansas,145,White County,21,1,20
42,Pennsylvania,50,Vermont,1,Addison County,38,32,6
42,Pennsylvania,50,Vermont,3,Bennington County,46,3,43
42,Pennsylvania,50,Vermont,5,Caledonia County,30,42,-12
42,Pennsylvania,50,Vermont,7,Chittenden County,300,395,-95
42,Pennsylvania,50,Vermont,9,Essex County,0,4,-4
42,Pennsylvania,50,Vermont,11,Franklin County,37,0,37
42,Pennsylvania,50,Vermont,13,Grand Isle County,9,10,-1
42,Pennsylvania,50,Vermont,15,Lamoille County,56,57,-1
42,Pennsylvania,50,Vermont,17,Orange County,0,20,-20
42,Pennsylvania,50,Vermont,19,Orleans County,71,6,65
42,Pennsylvania,50,Vermont,21,Rutland County,123,103,20
42,Pennsylvania,50,Vermont,23,Washington County,45,26,19
42,Pennsylvania,50,Vermont,25,Windham County,63,38,25
42,Pennsylvania,50,Vermont,27,Windsor County,24,57,-33
42,Pennsylvania,51,Virginia,1,Accomack County,7,59,-52
42,Pennsylvania,51,Virginia,3,Albemarle County,191,256,-65
42,Pennsylvania,51,Virginia,5,Alleghany County,0,25,-25
42,Pennsylvania,51,Virginia,7,Amelia County,0,20,-20
42,Pennsylvania,51,Virginia,9,Amherst County,0,22,-22
42,Pennsylvania,51,Virginia,11,Appomattox County,0,67,-67
42,Pennsylvania,51,Virginia,13,Arlington County,823,834,-11
42,Pennsylvania,51,Virginia,15,Augusta County,55,59,-4
42,Pennsylvania,51,Virginia,19,Bedford County,75,152,-77
42,Pennsylvania,51,Virginia,23,Botetourt County,13,149,-136
42,Pennsylvania,51,Virginia,25,Brunswick County,0,3,-3
42,Pennsylvania,51,Virginia,31,Campbell County,4,93,-89
42,Pennsylvania,51,Virginia,33,Caroline County,69,27,42
42,Pennsylvania,51,Virginia,35,Carroll County,14,11,3
42,Pennsylvania,51,Virginia,37,Charlotte County,0,2,-2
42,Pennsylvania,51,Virginia,41,Chesterfield County,140,405,-265
42,Pennsylvania,51,Virginia,43,Clarke County,19,15,4
42,Pennsylvania,51,Virginia,47,Culpeper County,41,21,20
42,Pennsylvania,51,Virginia,51,Dickenson County,34,0,34
42,Pennsylvania,51,Virginia,53,Dinwiddie County,7,3,4
42,Pennsylvania,51,Virginia,57,Essex County,0,7,-7
42,Pennsylvania,51,Virginia,59,Fairfax County,2129,2246,-117
42,Pennsylvania,51,Virginia,61,Fauquier County,180,97,83
42,Pennsylvania,51,Virginia,65,Fluvanna County,51,30,21
42,Pennsylvania,51,Virginia,67,Franklin County,0,7,-7
42,Pennsylvania,51,Virginia,69,Frederick County,123,61,62
42,Pennsylvania,51,Virginia,71,Giles County,0,32,-32
42,Pennsylvania,51,Virginia,73,Gloucester County,78,7,71
42,Pennsylvania,51,Virginia,75,Goochland County,0,23,-23
42,Pennsylvania,51,Virginia,77,Grayson County,0,10,-10
42,Pennsylvania,51,Virginia,79,Greene County,0,23,-23
42,Pennsylvania,51,Virginia,83,Halifax County,0,2,-2
42,Pennsylvania,51,Virginia,85,Hanover County,92,56,36
42,Pennsylvania,51,Virginia,87,Henrico County,189,387,-198
42,Pennsylvania,51,Virginia,93,Isle of Wight County,45,93,-48
42,Pennsylvania,51,Virginia,95,James City County,110,305,-195
42,Pennsylvania,51,Virginia,99,King George County,6,46,-40
42,Pennsylvania,51,Virginia,101,King William County,9,34,-25
42,Pennsylvania,51,Virginia,103,Lancaster County,34,25,9
42,Pennsylvania,51,Virginia,105,Lee County,40,21,19
42,Pennsylvania,51,Virginia,107,Loudoun County,574,364,210
42,Pennsylvania,51,Virginia,109,Louisa County,28,117,-89
42,Pennsylvania,51,Virginia,111,Lunenburg County,0,3,-3
42,Pennsylvania,51,Virginia,113,Madison County,4,0,4
42,Pennsylvania,51,Virginia,117,Mecklenburg County,40,70,-30
42,Pennsylvania,51,Virginia,119,Middlesex County,30,9,21
42,Pennsylvania,51,Virginia,121,Montgomery County,189,270,-81
42,Pennsylvania,51,Virginia,125,Nelson County,0,13,-13
42,Pennsylvania,51,Virginia,127,New Kent County,0,3,-3
42,Pennsylvania,51,Virginia,131,Northampton County,8,0,8
42,Pennsylvania,51,Virginia,137,Orange County,169,37,132
42,Pennsylvania,51,Virginia,139,Page County,111,11,100
42,Pennsylvania,51,Virginia,143,Pittsylvania County,83,23,60
42,Pennsylvania,51,Virginia,145,Powhatan County,0,12,-12
42,Pennsylvania,51,Virginia,149,Prince George County,14,35,-21
42,Pennsylvania,51,Virginia,153,Prince William County,750,508,242
42,Pennsylvania,51,Virginia,159,Richmond County,0,8,-8
42,Pennsylvania,51,Virginia,161,Roanoke County,8,33,-25
42,Pennsylvania,51,Virginia,163,Rockbridge County,58,16,42
42,Pennsylvania,51,Virginia,165,Rockingham County,6,113,-107
42,Pennsylvania,51,Virginia,167,Russell County,0,3,-3
42,Pennsylvania,51,Virginia,169,Scott County,14,8,6
42,Pennsylvania,51,Virginia,171,Shenandoah County,27,0,27
42,Pennsylvania,51,Virginia,177,Spotsylvania County,130,125,5
42,Pennsylvania,51,Virginia,179,Stafford County,182,248,-66
42,Pennsylvania,51,Virginia,185,Tazewell County,0,68,-68
42,Pennsylvania,51,Virginia,187,Warren County,67,23,44
42,Pennsylvania,51,Virginia,191,Washington County,52,25,27
42,Pennsylvania,51,Virginia,193,Westmoreland County,13,0,13
42,Pennsylvania,51,Virginia,195,Wise County,3,0,3
42,Pennsylvania,51,Virginia,199,York County,98,245,-147
42,Pennsylvania,51,Virginia,510,Alexandria city,272,477,-205
42,Pennsylvania,51,Virginia,520,Bristol city,0,12,-12
42,Pennsylvania,51,Virginia,540,Charlottesville city,280,178,102
42,Pennsylvania,51,Virginia,550,Chesapeake city,160,410,-250
42,Pennsylvania,51,Virginia,590,Danville city,34,54,-20
42,Pennsylvania,51,Virginia,600,Fairfax city,37,30,7
42,Pennsylvania,51,Virginia,610,Falls Church city,18,0,18
42,Pennsylvania,51,Virginia,630,Fredericksburg city,88,121,-33
42,Pennsylvania,51,Virginia,650,Hampton city,243,165,78
42,Pennsylvania,51,Virginia,660,Harrisonburg city,101,496,-395
42,Pennsylvania,51,Virginia,678,Lexington city,15,57,-42
42,Pennsylvania,51,Virginia,680,Lynchburg city,78,435,-357
42,Pennsylvania,51,Virginia,683,Manassas city,0,59,-59
42,Pennsylvania,51,Virginia,685,Manassas Park city,43,0,43
42,Pennsylvania,51,Virginia,690,Martinsville city,5,25,-20
42,Pennsylvania,51,Virginia,700,Newport News city,304,416,-112
42,Pennsylvania,51,Virginia,710,Norfolk city,443,442,1
42,Pennsylvania,51,Virginia,720,Norton city,0,8,-8
42,Pennsylvania,51,Virginia,730,Petersburg city,79,29,50
42,Pennsylvania,51,Virginia,740,Portsmouth city,197,165,32
42,Pennsylvania,51,Virginia,750,Radford city,12,4,8
42,Pennsylvania,51,Virginia,760,Richmond city,396,489,-93
42,Pennsylvania,51,Virginia,770,Roanoke city,93,105,-12
42,Pennsylvania,51,Virginia,775,Salem city,26,69,-43
42,Pennsylvania,51,Virginia,790,Staunton city,5,40,-35
42,Pennsylvania,51,Virginia,800,Suffolk city,106,55,51
42,Pennsylvania,51,Virginia,810,Virginia Beach city,269,932,-663
42,Pennsylvania,51,Virginia,820,Waynesboro city,45,0,45
42,Pennsylvania,51,Virginia,830,Williamsburg city,16,90,-74
42,Pennsylvania,51,Virginia,840,Winchester city,46,82,-36
42,Pennsylvania,53,Washington,5,Benton County,15,35,-20
42,Pennsylvania,53,Washington,11,Clark County,166,148,18
42,Pennsylvania,53,Washington,21,Franklin County,0,51,-51
42,Pennsylvania,53,Washington,25,Grant County,5,10,-5
42,Pennsylvania,53,Washington,27,Grays Harbor County,0,21,-21
42,Pennsylvania,53,Washington,29,Island County,96,77,19
42,Pennsylvania,53,Washington,31,Jefferson County,0,1,-1
42,Pennsylvania,53,Washington,33,King County,889,1337,-448
42,Pennsylvania,53,Washington,35,Kitsap County,248,358,-110
42,Pennsylvania,53,Washington,45,Mason County,14,0,14
42,Pennsylvania,53,Washington,51,Pend Oreille County,0,4,-4
42,Pennsylvania,53,Washington,53,Pierce County,543,418,125
42,Pennsylvania,53,Washington,57,Skagit County,0,26,-26
42,Pennsylvania,53,Washington,61,Snohomish County,264,205,59
42,Pennsylvania,53,Washington,63,Spokane County,86,37,49
42,Pennsylvania,53,Washington,65,Stevens County,0,31,-31
42,Pennsylvania,53,Washington,67,Thurston County,76,136,-60
42,Pennsylvania,53,Washington,71,Walla Walla County,14,0,14
42,Pennsylvania,53,Washington,73,Whatcom County,12,19,-7
42,Pennsylvania,53,Washington,75,Whitman County,9,0,9
42,Pennsylvania,53,Washington,77,Yakima County,0,13,-13
42,Pennsylvania,54,West Virginia,1,Barbour County,67,3,64
42,Pennsylvania,54,West Virginia,3,Berkeley County,160,565,-405
42,Pennsylvania,54,West Virginia,9,Brooke County,134,266,-132
42,Pennsylvania,54,West Virginia,11,Cabell County,130,79,51
42,Pennsylvania,54,West Virginia,17,Doddridge County,5,14,-9
42,Pennsylvania,54,West Virginia,21,Gilmer County,31,67,-36
42,Pennsylvania,54,West Virginia,25,Greenbrier County,52,43,9
42,Pennsylvania,54,West Virginia,27,Hampshire County,81,40,41
42,Pennsylvania,54,West Virginia,29,Hancock County,360,433,-73
42,Pennsylvania,54,West Virginia,31,Hardy County,3,0,3
42,Pennsylvania,54,West Virginia,33,Harrison County,182,98,84
42,Pennsylvania,54,West Virginia,35,Jackson County,14,23,-9
42,Pennsylvania,54,West Virginia,37,Jefferson County,207,68,139
42,Pennsylvania,54,West Virginia,39,Kanawha County,77,257,-180
42,Pennsylvania,54,West Virginia,41,Lewis County,49,0,49
42,Pennsylvania,54,West Virginia,45,Logan County,0,2,-2
42,Pennsylvania,54,West Virginia,47,McDowell County,10,0,10
42,Pennsylvania,54,West Virginia,49,Marion County,277,168,109
42,Pennsylvania,54,West Virginia,51,Marshall County,99,0,99
42,Pennsylvania,54,West Virginia,55,Mercer County,10,1,9
42,Pennsylvania,54,West Virginia,57,Mineral County,54,5,49
42,Pennsylvania,54,West Virginia,59,Mingo County,102,3,99
42,Pennsylvania,54,West Virginia,61,Monongalia County,1166,1618,-452
42,Pennsylvania,54,West Virginia,63,Monroe County,0,10,-10
42,Pennsylvania,54,West Virginia,65,Morgan County,150,4,146
42,Pennsylvania,54,West Virginia,67,Nicholas County,7,0,7
42,Pennsylvania,54,West Virginia,69,Ohio County,199,232,-33
42,Pennsylvania,54,West Virginia,71,Pendleton County,44,12,32
42,Pennsylvania,54,West Virginia,75,Pocahontas County,0,9,-9
42,Pennsylvania,54,West Virginia,77,Preston County,139,40,99
42,Pennsylvania,54,West Virginia,79,Putnam County,100,48,52
42,Pennsylvania,54,West Virginia,81,Raleigh County,72,49,23
42,Pennsylvania,54,West Virginia,83,Randolph County,84,45,39
42,Pennsylvania,54,West Virginia,85,Ritchie County,7,0,7
42,Pennsylvania,54,West Virginia,87,Roane County,6,0,6
42,Pennsylvania,54,West Virginia,89,Summers County,0,1,-1
42,Pennsylvania,54,West Virginia,91,Taylor County,11,0,11
42,Pennsylvania,54,West Virginia,93,Tucker County,120,2,118
42,Pennsylvania,54,West Virginia,95,Tyler County,7,6,1
42,Pennsylvania,54,West Virginia,97,Upshur County,62,165,-103
42,Pennsylvania,54,West Virginia,99,Wayne County,4,65,-61
42,Pennsylvania,54,West Virginia,101,Webster County,0,29,-29
42,Pennsylvania,54,West Virginia,103,Wetzel County,13,123,-110
42,Pennsylvania,54,West Virginia,107,Wood County,12,87,-75
42,Pennsylvania,55,Wisconsin,7,Bayfield County,6,0,6
42,Pennsylvania,55,Wisconsin,9,Brown County,9,101,-92
42,Pennsylvania,55,Wisconsin,19,Clark County,14,17,-3
42,Pennsylvania,55,Wisconsin,21,Columbia County,27,0,27
42,Pennsylvania,55,Wisconsin,23,Crawford County,21,0,21
42,Pennsylvania,55,Wisconsin,25,Dane County,502,293,209
42,Pennsylvania,55,Wisconsin,27,Dodge County,2,17,-15
42,Pennsylvania,55,Wisconsin,29,Door County,0,3,-3
42,Pennsylvania,55,Wisconsin,35,Eau Claire County,5,0,5
42,Pennsylvania,55,Wisconsin,41,Forest County,0,14,-14
42,Pennsylvania,55,Wisconsin,43,Grant County,24,76,-52
42,Pennsylvania,55,Wisconsin,49,Iowa County,46,0,46
42,Pennsylvania,55,Wisconsin,53,Jackson County,6,2,4
42,Pennsylvania,55,Wisconsin,55,Jefferson County,8,10,-2
42,Pennsylvania,55,Wisconsin,57,Juneau County,0,6,-6
42,Pennsylvania,55,Wisconsin,59,Kenosha County,32,19,13
42,Pennsylvania,55,Wisconsin,67,Langlade County,0,2,-2
42,Pennsylvania,55,Wisconsin,69,Lincoln County,0,8,-8
42,Pennsylvania,55,Wisconsin,71,Manitowoc County,0,42,-42
42,Pennsylvania,55,Wisconsin,73,Marathon County,14,125,-111
42,Pennsylvania,55,Wisconsin,75,Marinette County,14,6,8
42,Pennsylvania,55,Wisconsin,79,Milwaukee County,462,464,-2
42,Pennsylvania,55,Wisconsin,81,Monroe County,13,4,9
42,Pennsylvania,55,Wisconsin,87,Outagamie County,44,60,-16
42,Pennsylvania,55,Wisconsin,89,Ozaukee County,43,0,43
42,Pennsylvania,55,Wisconsin,97,Portage County,53,12,41
42,Pennsylvania,55,Wisconsin,101,Racine County,17,35,-18
42,Pennsylvania,55,Wisconsin,103,Richland County,0,7,-7
42,Pennsylvania,55,Wisconsin,105,Rock County,41,82,-41
42,Pennsylvania,55,Wisconsin,109,St. Croix County,0,29,-29
42,Pennsylvania,55,Wisconsin,111,Sauk County,6,8,-2
42,Pennsylvania,55,Wisconsin,117,Sheboygan County,21,15,6
42,Pennsylvania,55,Wisconsin,119,Taylor County,0,13,-13
42,Pennsylvania,55,Wisconsin,121,Trempealeau County,0,4,-4
42,Pennsylvania,55,Wisconsin,123,Vernon County,0,12,-12
42,Pennsylvania,55,Wisconsin,125,Vilas County,0,25,-25
42,Pennsylvania,55,Wisconsin,127,Walworth County,0,21,-21
42,Pennsylvania,55,Wisconsin,131,Washington County,28,0,28
42,Pennsylvania,55,Wisconsin,133,Waukesha County,56,93,-37
42,Pennsylvania,55,Wisconsin,139,Winnebago County,37,0,37
42,Pennsylvania,55,Wisconsin,141,Wood County,8,0,8
42,Pennsylvania,56,Wyoming,1,Albany County,11,71,-60
42,Pennsylvania,56,Wyoming,5,Campbell County,0,18,-18
42,Pennsylvania,56,Wyoming,11,Crook County,81,0,81
42,Pennsylvania,56,Wyoming,15,Goshen County,0,4,-4
42,Pennsylvania,56,Wyoming,19,Johnson County,16,0,16
42,Pennsylvania,56,Wyoming,21,Laramie County,43,163,-120
42,Pennsylvania,56,Wyoming,25,Natrona County,86,0,86
42,Pennsylvania,56,Wyoming,29,Park County,14,20,-6
42,Pennsylvania,56,Wyoming,37,Sweetwater County,0,206,-206
42,Pennsylvania,56,Wyoming,39,Teton County,6,3,3
42,Pennsylvania,6,California,1,Alameda County,497,675,-178
42,Pennsylvania,6,California,5,Amador County,16,0,16
42,Pennsylvania,6,California,7,Butte County,55,1,54
42,Pennsylvania,6,California,9,Calaveras County,53,0,53
42,Pennsylvania,6,California,13,Contra Costa County,224,181,43
42,Pennsylvania,6,California,15,Del Norte County,0,8,-8
42,Pennsylvania,6,California,17,El Dorado County,2,49,-47
42,Pennsylvania,6,California,19,Fresno County,66,214,-148
42,Pennsylvania,6,California,23,Humboldt County,24,8,16
42,Pennsylvania,6,California,25,Imperial County,10,94,-84
42,Pennsylvania,6,California,27,Inyo County,6,3,3
42,Pennsylvania,6,California,29,Kern County,96,28,68
42,Pennsylvania,6,California,31,Kings County,0,23,-23
42,Pennsylvania,6,California,33,Lake County,0,6,-6
42,Pennsylvania,6,California,35,Lassen County,4,0,4
42,Pennsylvania,6,California,37,Los Angeles County,2296,2951,-655
42,Pennsylvania,6,California,39,Madera County,30,26,4
42,Pennsylvania,6,California,41,Marin County,59,97,-38
42,Pennsylvania,6,California,43,Mariposa County,4,0,4
42,Pennsylvania,6,California,47,Merced County,44,143,-99
42,Pennsylvania,6,California,49,Modoc County,0,17,-17
42,Pennsylvania,6,California,53,Monterey County,57,146,-89
42,Pennsylvania,6,California,55,Napa County,25,18,7
42,Pennsylvania,6,California,57,Nevada County,35,28,7
42,Pennsylvania,6,California,59,Orange County,912,1537,-625
42,Pennsylvania,6,California,61,Placer County,42,86,-44
42,Pennsylvania,6,California,65,Riverside County,699,474,225
42,Pennsylvania,6,California,67,Sacramento County,246,430,-184
42,Pennsylvania,6,California,69,San Benito County,1,0,1
42,Pennsylvania,6,California,71,San Bernardino County,201,333,-132
42,Pennsylvania,6,California,73,San Diego County,1527,1650,-123
42,Pennsylvania,6,California,75,San Francisco County,618,797,-179
42,Pennsylvania,6,California,77,San Joaquin County,201,59,142
42,Pennsylvania,6,California,79,San Luis Obispo County,21,139,-118
42,Pennsylvania,6,California,81,San Mateo County,125,452,-327
42,Pennsylvania,6,California,83,Santa Barbara County,15,116,-101
42,Pennsylvania,6,California,85,Santa Clara County,747,1492,-745
42,Pennsylvania,6,California,87,Santa Cruz County,52,175,-123
42,Pennsylvania,6,California,89,Shasta County,0,20,-20
42,Pennsylvania,6,California,93,Siskiyou County,41,0,41
42,Pennsylvania,6,California,95,Solano County,121,212,-91
42,Pennsylvania,6,California,97,Sonoma County,15,0,15
42,Pennsylvania,6,California,99,Stanislaus County,150,17,133
42,Pennsylvania,6,California,107,Tulare County,6,13,-7
42,Pennsylvania,6,California,111,Ventura County,222,430,-208
42,Pennsylvania,6,California,113,Yolo County,104,128,-24
42,Pennsylvania,6,California,115,Yuba County,47,8,39
42,Pennsylvania,72,Puerto Rico,1,Adjuntas Municipio,312,0,312
42,Pennsylvania,72,Puerto Rico,3,Aguada Municipio,32,1,31
42,Pennsylvania,72,Puerto Rico,5,Aguadilla Municipio,57,36,21
42,Pennsylvania,72,Puerto Rico,7,Aguas Buenas Municipio,42,0,42
42,Pennsylvania,72,Puerto Rico,9,Aibonito Municipio,0,19,-19
42,Pennsylvania,72,Puerto Rico,11,Añasco Municipio,54,0,54
42,Pennsylvania,72,Puerto Rico,13,Arecibo Municipio,303,65,238
42,Pennsylvania,72,Puerto Rico,15,Arroyo Municipio,242,40,202
42,Pennsylvania,72,Puerto Rico,17,Barceloneta Municipio,78,0,78
42,Pennsylvania,72,Puerto Rico,19,Barranquitas Municipio,58,0,58
42,Pennsylvania,72,Puerto Rico,21,Bayamón Municipio,117,67,50
42,Pennsylvania,72,Puerto Rico,25,Caguas Municipio,155,109,46
42,Pennsylvania,72,Puerto Rico,27,Camuy Municipio,43,2,41
42,Pennsylvania,72,Puerto Rico,29,Canóvanas Municipio,54,58,-4
42,Pennsylvania,72,Puerto Rico,31,Carolina Municipio,561,92,469
42,Pennsylvania,72,Puerto Rico,33,Cataño Municipio,234,8,226
42,Pennsylvania,72,Puerto Rico,35,Cayey Municipio,101,29,72
42,Pennsylvania,72,Puerto Rico,39,Ciales Municipio,114,0,114
42,Pennsylvania,72,Puerto Rico,41,Cidra Municipio,43,18,25
42,Pennsylvania,72,Puerto Rico,43,Coamo Municipio,142,0,142
42,Pennsylvania,72,Puerto Rico,45,Comerío Municipio,0,87,-87
42,Pennsylvania,72,Puerto Rico,51,Dorado Municipio,20,10,10
42,Pennsylvania,72,Puerto Rico,53,Fajardo Municipio,23,19,4
42,Pennsylvania,72,Puerto Rico,55,Guánica Municipio,0,1,-1
42,Pennsylvania,72,Puerto Rico,57,Guayama Municipio,338,17,321
42,Pennsylvania,72,Puerto Rico,59,Guayanilla Municipio,36,7,29
42,Pennsylvania,72,Puerto Rico,61,Guaynabo Municipio,20,40,-20
42,Pennsylvania,72,Puerto Rico,63,Gurabo Municipio,23,70,-47
42,Pennsylvania,72,Puerto Rico,65,Hatillo Municipio,170,0,170
42,Pennsylvania,72,Puerto Rico,67,Hormigueros Municipio,14,0,14
42,Pennsylvania,72,Puerto Rico,69,Humacao Municipio,186,44,142
42,Pennsylvania,72,Puerto Rico,71,Isabela Municipio,33,0,33
42,Pennsylvania,72,Puerto Rico,75,Juana Díaz Municipio,187,46,141
42,Pennsylvania,72,Puerto Rico,77,Juncos Municipio,130,5,125
42,Pennsylvania,72,Puerto Rico,79,Lajas Municipio,0,30,-30
42,Pennsylvania,72,Puerto Rico,81,Lares Municipio,166,74,92
42,Pennsylvania,72,Puerto Rico,83,Las Marías Municipio,74,0,74
42,Pennsylvania,72,Puerto Rico,85,Las Piedras Municipio,207,0,207
42,Pennsylvania,72,Puerto Rico,87,Loíza Municipio,0,19,-19
42,Pennsylvania,72,Puerto Rico,89,Luquillo Municipio,71,50,21
42,Pennsylvania,72,Puerto Rico,91,Manatí Municipio,77,0,77
42,Pennsylvania,72,Puerto Rico,93,Maricao Municipio,0,8,-8
42,Pennsylvania,72,Puerto Rico,97,Mayagüez Municipio,89,111,-22
42,Pennsylvania,72,Puerto Rico,99,Moca Municipio,75,131,-56
42,Pennsylvania,72,Puerto Rico,105,Naranjito Municipio,41,164,-123
42,Pennsylvania,72,Puerto Rico,107,Orocovis Municipio,0,134,-134
42,Pennsylvania,72,Puerto Rico,109,Patillas Municipio,50,13,37
42,Pennsylvania,72,Puerto Rico,111,Peñuelas Municipio,11,5,6
42,Pennsylvania,72,Puerto Rico,113,Ponce Municipio,431,130,301
42,Pennsylvania,72,Puerto Rico,115,Quebradillas Municipio,87,0,87
42,Pennsylvania,72,Puerto Rico,119,Río Grande Municipio,54,72,-18
42,Pennsylvania,72,Puerto Rico,123,Salinas Municipio,190,0,190
42,Pennsylvania,72,Puerto Rico,125,San Germán Municipio,108,53,55
42,Pennsylvania,72,Puerto Rico,127,San Juan Municipio,682,309,373
42,Pennsylvania,72,Puerto Rico,131,San Sebastián Municipio,0,1,-1
42,Pennsylvania,72,Puerto Rico,133,Santa Isabel Municipio,116,0,116
42,Pennsylvania,72,Puerto Rico,135,Toa Alta Municipio,111,9,102
42,Pennsylvania,72,Puerto Rico,137,Toa Baja Municipio,313,25,288
42,Pennsylvania,72,Puerto Rico,139,Trujillo Alto Municipio,0,17,-17
42,Pennsylvania,72,Puerto Rico,141,Utuado Municipio,57,28,29
42,Pennsylvania,72,Puerto Rico,143,Vega Alta Municipio,148,0,148
42,Pennsylvania,72,Puerto Rico,145,Vega Baja Municipio,129,124,5
42,Pennsylvania,72,Puerto Rico,147,Vieques Municipio,0,8,-8
42,Pennsylvania,72,Puerto Rico,149,Villalba Municipio,11,83,-72
42,Pennsylvania,72,Puerto Rico,151,Yabucoa Municipio,324,87,237
42,Pennsylvania,72,Puerto Rico,153,Yauco Municipio,107,16,91
42,Pennsylvania,8,Colorado,1,Adams County,97,142,-45
42,Pennsylvania,8,Colorado,5,Arapahoe County,145,475,-330
42,Pennsylvania,8,Colorado,13,Boulder County,68,562,-494
42,Pennsylvania,8,Colorado,14,Broomfield County,65,97,-32
42,Pennsylvania,8,Colorado,15,Chaffee County,16,31,-15
42,Pennsylvania,8,Colorado,21,Conejos County,0,15,-15
42,Pennsylvania,8,Colorado,25,Crowley County,3,0,3
42,Pennsylvania,8,Colorado,29,Delta County,8,0,8
42,Pennsylvania,8,Colorado,31,Denver County,617,709,-92
42,Pennsylvania,8,Colorado,33,Dolores County,0,5,-5
42,Pennsylvania,8,Colorado,35,Douglas County,109,374,-265
42,Pennsylvania,8,Colorado,37,Eagle County,0,42,-42
42,Pennsylvania,8,Colorado,39,Elbert County,10,2,8
42,Pennsylvania,8,Colorado,41,El Paso County,346,658,-312
42,Pennsylvania,8,Colorado,43,Fremont County,25,109,-84
42,Pennsylvania,8,Colorado,45,Garfield County,0,2,-2
42,Pennsylvania,8,Colorado,51,Gunnison County,97,0,97
42,Pennsylvania,8,Colorado,59,Jefferson County,148,414,-266
42,Pennsylvania,8,Colorado,65,Lake County,48,137,-89
42,Pennsylvania,8,Colorado,67,La Plata County,116,53,63
42,Pennsylvania,8,Colorado,69,Larimer County,380,138,242
42,Pennsylvania,8,Colorado,71,Las Animas County,0,8,-8
42,Pennsylvania,8,Colorado,75,Logan County,10,2,8
42,Pennsylvania,8,Colorado,77,Mesa County,36,41,-5
42,Pennsylvania,8,Colorado,81,Moffat County,0,16,-16
42,Pennsylvania,8,Colorado,85,Montrose County,2,0,2
42,Pennsylvania,8,Colorado,87,Morgan County,0,22,-22
42,Pennsylvania,8,Colorado,89,Otero County,0,7,-7
42,Pennsylvania,8,Colorado,91,Ouray County,0,12,-12
42,Pennsylvania,8,Colorado,97,Pitkin County,10,0,10
42,Pennsylvania,8,Colorado,99,Prowers County,0,12,-12
42,Pennsylvania,8,Colorado,101,Pueblo County,115,85,30
42,Pennsylvania,8,Colorado,107,Routt County,14,123,-109
42,Pennsylvania,8,Colorado,113,San Miguel County,0,8,-8
42,Pennsylvania,8,Colorado,117,Summit County,0,20,-20
42,Pennsylvania,8,Colorado,119,Teller County,76,31,45
42,Pennsylvania,8,Colorado,121,Washington County,9,0,9
42,Pennsylvania,8,Colorado,123,Weld County,90,43,47
42,Pennsylvania,9,Connecticut,1,Fairfield County,1623,799,824
42,Pennsylvania,9,Connecticut,3,Hartford County,697,919,-222
42,Pennsylvania,9,Connecticut,5,Litchfield County,286,111,175
42,Pennsylvania,9,Connecticut,7,Middlesex County,301,332,-31
42,Pennsylvania,9,Connecticut,9,New Haven County,1298,857,441
42,Pennsylvania,9,Connecticut,11,New London County,309,329,-20
42,Pennsylvania,9,Connecticut,13,Tolland County,229,290,-61
42,Pennsylvania,9,Connecticut,15,Windham County,159,93,66
42,Pennsylvania,AFR,Africa,,-,5303,0,0
42,Pennsylvania,ASI,Asia,,-,27773,0,0
42,Pennsylvania,CAM,Central America,,-,3406,0,0
42,Pennsylvania,CAR,Caribbean,,-,3431,0,0
42,Pennsylvania,EUR,Europe,,-,10366,0,0
42,Pennsylvania,ISL,U.S. Island Areas,,-,357,0,0
42,Pennsylvania,NAM,Northern America,,-,1455,0,0
42,Pennsylvania,OCE,Oceania and At Sea,,-,1043,0,0
42,Pennsylvania,SAM,South America,,-,2832,0,0
44,Rhode Island,1,Alabama,3,Baldwin County,0,207,-207
44,Rhode Island,1,Alabama,7,Bibb County,18,0,18
44,Rhode Island,1,Alabama,69,Houston County,0,4,-4
44,Rhode Island,1,Alabama,73,Jefferson County,19,0,19
44,Rhode Island,1,Alabama,81,Lee County,15,0,15
44,Rhode Island,1,Alabama,89,Madison County,55,6,49
44,Rhode Island,1,Alabama,97,Mobile County,60,0,60
44,Rhode Island,1,Alabama,101,Montgomery County,0,16,-16
44,Rhode Island,1,Alabama,115,St. Clair County,17,0,17
44,Rhode Island,1,Alabama,131,Wilcox County,7,0,7
44,Rhode Island,10,Delaware,1,Kent County,43,0,43
44,Rhode Island,10,Delaware,3,New Castle County,39,7,32
44,Rhode Island,11,District of Columbia,1,District of Columbia,26,440,-414
44,Rhode Island,12,Florida,1,Alachua County,27,45,-18
44,Rhode Island,12,Florida,9,Brevard County,36,91,-55
44,Rhode Island,12,Florida,11,Broward County,156,126,30
44,Rhode Island,12,Florida,15,Charlotte County,12,221,-209
44,Rhode Island,12,Florida,17,Citrus County,32,27,5
44,Rhode Island,12,Florida,19,Clay County,56,57,-1
44,Rhode Island,12,Florida,21,Collier County,23,87,-64
44,Rhode Island,12,Florida,31,Duval County,99,215,-116
44,Rhode Island,12,Florida,33,Escambia County,267,175,92
44,Rhode Island,12,Florida,35,Flagler County,92,29,63
44,Rhode Island,12,Florida,43,Glades County,13,0,13
44,Rhode Island,12,Florida,53,Hernando County,0,44,-44
44,Rhode Island,12,Florida,55,Highlands County,0,7,-7
44,Rhode Island,12,Florida,57,Hillsborough County,392,323,69
44,Rhode Island,12,Florida,61,Indian River County,0,16,-16
44,Rhode Island,12,Florida,69,Lake County,0,25,-25
44,Rhode Island,12,Florida,71,Lee County,94,143,-49
44,Rhode Island,12,Florida,73,Leon County,42,0,42
44,Rhode Island,12,Florida,75,Levy County,0,67,-67
44,Rhode Island,12,Florida,81,Manatee County,92,69,23
44,Rhode Island,12,Florida,83,Marion County,0,19,-19
44,Rhode Island,12,Florida,85,Martin County,42,35,7
44,Rhode Island,12,Florida,86,Miami-Dade County,212,76,136
44,Rhode Island,12,Florida,87,Monroe County,32,0,32
44,Rhode Island,12,Florida,89,Nassau County,0,10,-10
44,Rhode Island,12,Florida,91,Okaloosa County,30,2,28
44,Rhode Island,12,Florida,93,Okeechobee County,0,82,-82
44,Rhode Island,12,Florida,95,Orange County,244,117,127
44,Rhode Island,12,Florida,97,Osceola County,0,11,-11
44,Rhode Island,12,Florida,99,Palm Beach County,176,325,-149
44,Rhode Island,12,Florida,101,Pasco County,61,39,22
44,Rhode Island,12,Florida,103,Pinellas County,39,150,-111
44,Rhode Island,12,Florida,105,Polk County,60,190,-130
44,Rhode Island,12,Florida,107,Putnam County,0,11,-11
44,Rhode Island,12,Florida,109,St. Johns County,46,95,-49
44,Rhode Island,12,Florida,111,St. Lucie County,114,91,23
44,Rhode Island,12,Florida,113,Santa Rosa County,37,0,37
44,Rhode Island,12,Florida,115,Sarasota County,92,76,16
44,Rhode Island,12,Florida,117,Seminole County,21,76,-55
44,Rhode Island,12,Florida,119,Sumter County,31,28,3
44,Rhode Island,12,Florida,121,Suwannee County,0,1,-1
44,Rhode Island,12,Florida,127,Volusia County,32,165,-133
44,Rhode Island,13,Georgia,13,Barrow County,72,0,72
44,Rhode Island,13,Georgia,31,Bulloch County,0,4,-4
44,Rhode Island,13,Georgia,39,Camden County,72,56,16
44,Rhode Island,13,Georgia,45,Carroll County,6,12,-6
44,Rhode Island,13,Georgia,49,Charlton County,0,18,-18
44,Rhode Island,13,Georgia,51,Chatham County,136,39,97
44,Rhode Island,13,Georgia,53,Chattahoochee County,0,48,-48
44,Rhode Island,13,Georgia,59,Clarke County,0,23,-23
44,Rhode Island,13,Georgia,67,Cobb County,202,84,118
44,Rhode Island,13,Georgia,77,Coweta County,0,18,-18
44,Rhode Island,13,Georgia,89,DeKalb County,18,15,3
44,Rhode Island,13,Georgia,97,Douglas County,30,0,30
44,Rhode Island,13,Georgia,117,Forsyth County,0,31,-31
44,Rhode Island,13,Georgia,121,Fulton County,105,47,58
44,Rhode Island,13,Georgia,127,Glynn County,0,12,-12
44,Rhode Island,13,Georgia,135,Gwinnett County,34,11,23
44,Rhode Island,13,Georgia,163,Jefferson County,0,3,-3
44,Rhode Island,13,Georgia,179,Liberty County,6,0,6
44,Rhode Island,13,Georgia,185,Lowndes County,0,9,-9
44,Rhode Island,13,Georgia,195,Madison County,0,6,-6
44,Rhode Island,13,Georgia,215,Muscogee County,13,34,-21
44,Rhode Island,13,Georgia,223,Paulding County,6,0,6
44,Rhode Island,13,Georgia,245,Richmond County,10,0,10
44,Rhode Island,13,Georgia,269,Taylor County,0,7,-7
44,Rhode Island,13,Georgia,295,Walker County,9,0,9
44,Rhode Island,15,Hawaii,1,Hawaii County,0,30,-30
44,Rhode Island,15,Hawaii,3,Honolulu County,69,142,-73
44,Rhode Island,15,Hawaii,7,Kauai County,0,9,-9
44,Rhode Island,15,Hawaii,9,Maui County,0,24,-24
44,Rhode Island,16,Idaho,1,Ada County,9,0,9
44,Rhode Island,16,Idaho,17,Bonner County,53,0,53
44,Rhode Island,16,Idaho,57,Latah County,14,0,14
44,Rhode Island,17,Illinois,5,Bond County,0,10,-10
44,Rhode Island,17,Illinois,19,Champaign County,41,9,32
44,Rhode Island,17,Illinois,31,Cook County,217,119,98
44,Rhode Island,17,Illinois,43,DuPage County,70,83,-13
44,Rhode Island,17,Illinois,77,Jackson County,8,0,8
44,Rhode Island,17,Illinois,97,Lake County,9,109,-100
44,Rhode Island,17,Illinois,113,McLean County,0,5,-5
44,Rhode Island,17,Illinois,115,Macon County,4,0,4
44,Rhode Island,17,Illinois,163,St. Clair County,0,1,-1
44,Rhode Island,17,Illinois,167,Sangamon County,0,21,-21
44,Rhode Island,17,Illinois,183,Vermilion County,6,0,6
44,Rhode Island,18,Indiana,11,Boone County,0,33,-33
44,Rhode Island,18,Indiana,55,Greene County,0,8,-8
44,Rhode Island,18,Indiana,57,Hamilton County,21,42,-21
44,Rhode Island,18,Indiana,89,Lake County,7,0,7
44,Rhode Island,18,Indiana,97,Marion County,16,0,16
44,Rhode Island,18,Indiana,105,Monroe County,0,7,-7
44,Rhode Island,18,Indiana,157,Tippecanoe County,6,39,-33
44,Rhode Island,18,Indiana,163,Vanderburgh County,18,0,18
44,Rhode Island,19,Iowa,17,Bremer County,0,5,-5
44,Rhode Island,19,Iowa,83,Hardin County,0,4,-4
44,Rhode Island,19,Iowa,101,Jefferson County,0,4,-4
44,Rhode Island,19,Iowa,153,Polk County,27,62,-35
44,Rhode Island,19,Iowa,163,Scott County,15,0,15
44,Rhode Island,19,Iowa,169,Story County,37,0,37
44,Rhode Island,2,Alaska,20,Anchorage Municipality,45,0,45
44,Rhode Island,2,Alaska,90,Fairbanks North Star Borough,15,0,15
44,Rhode Island,2,Alaska,150,Kodiak Island Borough,0,32,-32
44,Rhode Island,2,Alaska,261,Valdez-Cordova Census Area,0,17,-17
44,Rhode Island,20,Kansas,61,Geary County,0,31,-31
44,Rhode Island,20,Kansas,91,Johnson County,24,0,24
44,Rhode Island,20,Kansas,103,Leavenworth County,54,0,54
44,Rhode Island,21,Kentucky,29,Bullitt County,18,0,18
44,Rhode Island,21,Kentucky,67,Fayette County,18,0,18
44,Rhode Island,21,Kentucky,93,Hardin County,0,7,-7
44,Rhode Island,21,Kentucky,111,Jefferson County,13,9,4
44,Rhode Island,21,Kentucky,173,Montgomery County,0,43,-43
44,Rhode Island,21,Kentucky,179,Nelson County,12,0,12
44,Rhode Island,21,Kentucky,199,Pulaski County,0,27,-27
44,Rhode Island,21,Kentucky,205,Rowan County,38,0,38
44,Rhode Island,22,Louisiana,9,Avoyelles Parish,2,0,2
44,Rhode Island,22,Louisiana,15,Bossier Parish,13,3,10
44,Rhode Island,22,Louisiana,51,Jefferson Parish,0,1,-1
44,Rhode Island,22,Louisiana,55,Lafayette Parish,1,26,-25
44,Rhode Island,22,Louisiana,71,Orleans Parish,120,89,31
44,Rhode Island,22,Louisiana,73,Ouachita Parish,74,0,74
44,Rhode Island,22,Louisiana,97,St. Landry Parish,0,1,-1
44,Rhode Island,22,Louisiana,103,St. Tammany Parish,7,0,7
44,Rhode Island,22,Louisiana,109,Terrebonne Parish,0,1,-1
44,Rhode Island,22,Louisiana,115,Vernon Parish,95,3,92
44,Rhode Island,23,Maine,1,Androscoggin County,7,95,-88
44,Rhode Island,23,Maine,3,Aroostook County,0,47,-47
44,Rhode Island,23,Maine,5,Cumberland County,272,149,123
44,Rhode Island,23,Maine,7,Franklin County,0,19,-19
44,Rhode Island,23,Maine,9,Hancock County,0,21,-21
44,Rhode Island,23,Maine,11,Kennebec County,0,16,-16
44,Rhode Island,23,Maine,13,Knox County,10,0,10
44,Rhode Island,23,Maine,15,Lincoln County,0,30,-30
44,Rhode Island,23,Maine,17,Oxford County,0,44,-44
44,Rhode Island,23,Maine,19,Penobscot County,14,157,-143
44,Rhode Island,23,Maine,21,Piscataquis County,3,2,1
44,Rhode Island,23,Maine,23,Sagadahoc County,10,0,10
44,Rhode Island,23,Maine,25,Somerset County,33,32,1
44,Rhode Island,23,Maine,27,Waldo County,0,5,-5
44,Rhode Island,23,Maine,29,Washington County,11,10,1
44,Rhode Island,23,Maine,31,York County,34,42,-8
44,Rhode Island,24,Maryland,3,Anne Arundel County,56,145,-89
44,Rhode Island,24,Maryland,5,Baltimore County,34,48,-14
44,Rhode Island,24,Maryland,9,Calvert County,0,31,-31
44,Rhode Island,24,Maryland,13,Carroll County,41,0,41
44,Rhode Island,24,Maryland,17,Charles County,7,0,7
44,Rhode Island,24,Maryland,25,Harford County,32,53,-21
44,Rhode Island,24,Maryland,27,Howard County,23,70,-47
44,Rhode Island,24,Maryland,31,Montgomery County,308,92,216
44,Rhode Island,24,Maryland,33,Prince George's County,56,103,-47
44,Rhode Island,24,Maryland,37,St. Mary's County,11,0,11
44,Rhode Island,24,Maryland,43,Washington County,49,1,48
44,Rhode Island,24,Maryland,510,Baltimore city,72,132,-60
44,Rhode Island,25,Massachusetts,1,Barnstable County,195,144,51
44,Rhode Island,25,Massachusetts,3,Berkshire County,180,118,62
44,Rhode Island,25,Massachusetts,5,Bristol County,3017,3097,-80
44,Rhode Island,25,Massachusetts,7,Dukes County,35,207,-172
44,Rhode Island,25,Massachusetts,9,Essex County,516,196,320
44,Rhode Island,25,Massachusetts,11,Franklin County,46,0,46
44,Rhode Island,25,Massachusetts,13,Hampden County,249,35,214
44,Rhode Island,25,Massachusetts,15,Hampshire County,88,253,-165
44,Rhode Island,25,Massachusetts,17,Middlesex County,1491,793,698
44,Rhode Island,25,Massachusetts,19,Nantucket County,36,0,36
44,Rhode Island,25,Massachusetts,21,Norfolk County,1745,919,826
44,Rhode Island,25,Massachusetts,23,Plymouth County,728,529,199
44,Rhode Island,25,Massachusetts,25,Suffolk County,692,1196,-504
44,Rhode Island,25,Massachusetts,27,Worcester County,1317,1073,244
44,Rhode Island,26,Michigan,41,Delta County,0,8,-8
44,Rhode Island,26,Michigan,55,Grand Traverse County,0,18,-18
44,Rhode Island,26,Michigan,75,Jackson County,0,3,-3
44,Rhode Island,26,Michigan,77,Kalamazoo County,14,33,-19
44,Rhode Island,26,Michigan,81,Kent County,31,42,-11
44,Rhode Island,26,Michigan,99,Macomb County,0,59,-59
44,Rhode Island,26,Michigan,103,Marquette County,72,0,72
44,Rhode Island,26,Michigan,115,Monroe County,0,13,-13
44,Rhode Island,26,Michigan,125,Oakland County,73,39,34
44,Rhode Island,26,Michigan,147,St. Clair County,41,17,24
44,Rhode Island,26,Michigan,151,Sanilac County,0,6,-6
44,Rhode Island,26,Michigan,157,Tuscola County,0,3,-3
44,Rhode Island,26,Michigan,159,Van Buren County,0,13,-13
44,Rhode Island,26,Michigan,161,Washtenaw County,0,5,-5
44,Rhode Island,26,Michigan,163,Wayne County,204,51,153
44,Rhode Island,27,Minnesota,3,Anoka County,51,7,44
44,Rhode Island,27,Minnesota,13,Blue Earth County,14,0,14
44,Rhode Island,27,Minnesota,37,Dakota County,0,12,-12
44,Rhode Island,27,Minnesota,47,Freeborn County,72,0,72
44,Rhode Island,27,Minnesota,53,Hennepin County,48,7,41
44,Rhode Island,27,Minnesota,103,Nicollet County,0,26,-26
44,Rhode Island,27,Minnesota,113,Pennington County,0,2,-2
44,Rhode Island,27,Minnesota,123,Ramsey County,0,25,-25
44,Rhode Island,27,Minnesota,131,Rice County,0,15,-15
44,Rhode Island,27,Minnesota,147,Steele County,0,53,-53
44,Rhode Island,28,Mississippi,47,Harrison County,3,7,-4
44,Rhode Island,28,Mississippi,49,Hinds County,36,0,36
44,Rhode Island,28,Mississippi,71,Lafayette County,11,8,3
44,Rhode Island,28,Mississippi,73,Lamar County,23,0,23
44,Rhode Island,28,Mississippi,81,Lee County,93,0,93
44,Rhode Island,29,Missouri,19,Boone County,23,0,23
44,Rhode Island,29,Missouri,29,Camden County,0,5,-5
44,Rhode Island,29,Missouri,37,Cass County,0,1,-1
44,Rhode Island,29,Missouri,39,Cedar County,0,9,-9
44,Rhode Island,29,Missouri,47,Clay County,0,19,-19
44,Rhode Island,29,Missouri,51,Cole County,0,44,-44
44,Rhode Island,29,Missouri,57,Dade County,0,2,-2
44,Rhode Island,29,Missouri,69,Dunklin County,0,6,-6
44,Rhode Island,29,Missouri,77,Greene County,0,9,-9
44,Rhode Island,29,Missouri,95,Jackson County,23,12,11
44,Rhode Island,29,Missouri,97,Jasper County,0,11,-11
44,Rhode Island,29,Missouri,159,Pettis County,0,1,-1
44,Rhode Island,29,Missouri,165,Platte County,9,0,9
44,Rhode Island,29,Missouri,169,Pulaski County,0,87,-87
44,Rhode Island,29,Missouri,171,Putnam County,0,1,-1
44,Rhode Island,29,Missouri,179,Reynolds County,0,5,-5
44,Rhode Island,29,Missouri,189,St. Louis County,59,30,29
44,Rhode Island,29,Missouri,510,St. Louis city,1,13,-12
44,Rhode Island,30,Montana,17,Custer County,0,5,-5
44,Rhode Island,30,Montana,31,Gallatin County,23,10,13
44,Rhode Island,30,Montana,63,Missoula County,100,0,100
44,Rhode Island,31,Nebraska,25,Cass County,31,0,31
44,Rhode Island,31,Nebraska,47,Dawson County,0,133,-133
44,Rhode Island,31,Nebraska,53,Dodge County,0,3,-3
44,Rhode Island,31,Nebraska,55,Douglas County,107,0,107
44,Rhode Island,31,Nebraska,153,Sarpy County,4,76,-72
44,Rhode Island,32,Nevada,3,Clark County,59,77,-18
44,Rhode Island,32,Nevada,31,Washoe County,0,60,-60
44,Rhode Island,33,New Hampshire,1,Belknap County,37,17,20
44,Rhode Island,33,New Hampshire,3,Carroll County,15,75,-60
44,Rhode Island,33,New Hampshire,5,Cheshire County,27,68,-41
44,Rhode Island,33,New Hampshire,7,Coos County,7,19,-12
44,Rhode Island,33,New Hampshire,9,Grafton County,57,97,-40
44,Rhode Island,33,New Hampshire,11,Hillsborough County,256,237,19
44,Rhode Island,33,New Hampshire,13,Merrimack County,114,55,59
44,Rhode Island,33,New Hampshire,15,Rockingham County,279,148,131
44,Rhode Island,33,New Hampshire,17,Strafford County,38,155,-117
44,Rhode Island,33,New Hampshire,19,Sullivan County,15,1,14
44,Rhode Island,34,New Jersey,1,Atlantic County,0,9,-9
44,Rhode Island,34,New Jersey,3,Bergen County,177,44,133
44,Rhode Island,34,New Jersey,5,Burlington County,56,33,23
44,Rhode Island,34,New Jersey,7,Camden County,7,10,-3
44,Rhode Island,34,New Jersey,11,Cumberland County,0,14,-14
44,Rhode Island,34,New Jersey,13,Essex County,197,43,154
44,Rhode Island,34,New Jersey,15,Gloucester County,13,0,13
44,Rhode Island,34,New Jersey,17,Hudson County,127,47,80
44,Rhode Island,34,New Jersey,19,Hunterdon County,75,0,75
44,Rhode Island,34,New Jersey,21,Mercer County,283,40,243
44,Rhode Island,34,New Jersey,23,Middlesex County,30,180,-150
44,Rhode Island,34,New Jersey,25,Monmouth County,191,17,174
44,Rhode Island,34,New Jersey,27,Morris County,101,0,101
44,Rhode Island,34,New Jersey,29,Ocean County,52,36,16
44,Rhode Island,34,New Jersey,31,Passaic County,24,0,24
44,Rhode Island,34,New Jersey,35,Somerset County,55,33,22
44,Rhode Island,34,New Jersey,39,Union County,16,148,-132
44,Rhode Island,35,New Mexico,1,Bernalillo County,11,57,-46
44,Rhode Island,35,New Mexico,45,San Juan County,0,2,-2
44,Rhode Island,36,New York,1,Albany County,111,18,93
44,Rhode Island,36,New York,3,Allegany County,0,5,-5
44,Rhode Island,36,New York,5,Bronx County,382,11,371
44,Rhode Island,36,New York,7,Broome County,62,0,62
44,Rhode Island,36,New York,11,Cayuga County,20,5,15
44,Rhode Island,36,New York,15,Chemung County,14,4,10
44,Rhode Island,36,New York,19,Clinton County,0,14,-14
44,Rhode Island,36,New York,21,Columbia County,0,7,-7
44,Rhode Island,36,New York,27,Dutchess County,52,79,-27
44,Rhode Island,36,New York,29,Erie County,26,79,-53
44,Rhode Island,36,New York,33,Franklin County,0,4,-4
44,Rhode Island,36,New York,35,Fulton County,23,0,23
44,Rhode Island,36,New York,37,Genesee County,13,0,13
44,Rhode Island,36,New York,39,Greene County,0,11,-11
44,Rhode Island,36,New York,45,Jefferson County,13,0,13
44,Rhode Island,36,New York,47,Kings County,430,189,241
44,Rhode Island,36,New York,49,Lewis County,0,6,-6
44,Rhode Island,36,New York,55,Monroe County,25,34,-9
44,Rhode Island,36,New York,57,Montgomery County,38,0,38
44,Rhode Island,36,New York,59,Nassau County,134,30,104
44,Rhode Island,36,New York,61,New York County,456,551,-95
44,Rhode Island,36,New York,65,Oneida County,71,0,71
44,Rhode Island,36,New York,67,Onondaga County,18,138,-120
44,Rhode Island,36,New York,69,Ontario County,0,29,-29
44,Rhode Island,36,New York,71,Orange County,53,21,32
44,Rhode Island,36,New York,75,Oswego County,26,0,26
44,Rhode Island,36,New York,77,Otsego County,9,38,-29
44,Rhode Island,36,New York,79,Putnam County,44,5,39
44,Rhode Island,36,New York,81,Queens County,96,85,11
44,Rhode Island,36,New York,83,Rensselaer County,149,22,127
44,Rhode Island,36,New York,85,Richmond County,24,0,24
44,Rhode Island,36,New York,87,Rockland County,62,14,48
44,Rhode Island,36,New York,89,St. Lawrence County,49,10,39
44,Rhode Island,36,New York,91,Saratoga County,16,0,16
44,Rhode Island,36,New York,93,Schenectady County,30,15,15
44,Rhode Island,36,New York,103,Suffolk County,444,79,365
44,Rhode Island,36,New York,105,Sullivan County,8,0,8
44,Rhode Island,36,New York,109,Tompkins County,21,30,-9
44,Rhode Island,36,New York,111,Ulster County,6,0,6
44,Rhode Island,36,New York,115,Washington County,8,6,2
44,Rhode Island,36,New York,117,Wayne County,0,2,-2
44,Rhode Island,36,New York,119,Westchester County,201,255,-54
44,Rhode Island,36,New York,123,Yates County,6,0,6
44,Rhode Island,37,North Carolina,19,Brunswick County,0,12,-12
44,Rhode Island,37,North Carolina,21,Buncombe County,22,98,-76
44,Rhode Island,37,North Carolina,35,Catawba County,156,0,156
44,Rhode Island,37,North Carolina,49,Craven County,16,0,16
44,Rhode Island,37,North Carolina,51,Cumberland County,14,48,-34
44,Rhode Island,37,North Carolina,53,Currituck County,0,92,-92
44,Rhode Island,37,North Carolina,63,Durham County,59,36,23
44,Rhode Island,37,North Carolina,67,Forsyth County,2,0,2
44,Rhode Island,37,North Carolina,71,Gaston County,0,44,-44
44,Rhode Island,37,North Carolina,81,Guilford County,4,10,-6
44,Rhode Island,37,North Carolina,85,Harnett County,0,19,-19
44,Rhode Island,37,North Carolina,87,Haywood County,0,16,-16
44,Rhode Island,37,North Carolina,97,Iredell County,48,0,48
44,Rhode Island,37,North Carolina,119,Mecklenburg County,167,144,23
44,Rhode Island,37,North Carolina,125,Moore County,33,17,16
44,Rhode Island,37,North Carolina,129,New Hanover County,117,0,117
44,Rhode Island,37,North Carolina,133,Onslow County,125,72,53
44,Rhode Island,37,North Carolina,135,Orange County,155,15,140
44,Rhode Island,37,North Carolina,139,Pasquotank County,19,0,19
44,Rhode Island,37,North Carolina,179,Union County,3,22,-19
44,Rhode Island,37,North Carolina,183,Wake County,17,143,-126
44,Rhode Island,37,North Carolina,189,Watauga County,0,11,-11
44,Rhode Island,38,North Dakota,73,Ransom County,0,5,-5
44,Rhode Island,38,North Dakota,101,Ward County,20,0,20
44,Rhode Island,39,Ohio,17,Butler County,0,4,-4
44,Rhode Island,39,Ohio,25,Clermont County,16,0,16
44,Rhode Island,39,Ohio,35,Cuyahoga County,48,41,7
44,Rhode Island,39,Ohio,41,Delaware County,16,0,16
44,Rhode Island,39,Ohio,49,Franklin County,21,198,-177
44,Rhode Island,39,Ohio,61,Hamilton County,92,195,-103
44,Rhode Island,39,Ohio,83,Knox County,0,8,-8
44,Rhode Island,39,Ohio,87,Lawrence County,0,27,-27
44,Rhode Island,39,Ohio,93,Lorain County,23,0,23
44,Rhode Island,39,Ohio,95,Lucas County,0,15,-15
44,Rhode Island,39,Ohio,151,Stark County,0,1,-1
44,Rhode Island,39,Ohio,153,Summit County,0,34,-34
44,Rhode Island,39,Ohio,155,Trumbull County,8,22,-14
44,Rhode Island,39,Ohio,171,Williams County,17,0,17
44,Rhode Island,4,Arizona,3,Cochise County,0,182,-182
44,Rhode Island,4,Arizona,5,Coconino County,5,0,5
44,Rhode Island,4,Arizona,13,Maricopa County,193,448,-255
44,Rhode Island,4,Arizona,19,Pima County,12,36,-24
44,Rhode Island,4,Arizona,21,Pinal County,22,0,22
44,Rhode Island,4,Arizona,27,Yuma County,0,5,-5
44,Rhode Island,40,Oklahoma,27,Cleveland County,0,6,-6
44,Rhode Island,40,Oklahoma,31,Comanche County,0,31,-31
44,Rhode Island,40,Oklahoma,79,Le Flore County,0,5,-5
44,Rhode Island,40,Oklahoma,95,Marshall County,0,20,-20
44,Rhode Island,40,Oklahoma,109,Oklahoma County,6,128,-122
44,Rhode Island,40,Oklahoma,137,Stephens County,0,35,-35
44,Rhode Island,40,Oklahoma,143,Tulsa County,8,0,8
44,Rhode Island,41,Oregon,3,Benton County,42,0,42
44,Rhode Island,41,Oregon,5,Clackamas County,0,14,-14
44,Rhode Island,41,Oregon,7,Clatsop County,0,1,-1
44,Rhode Island,41,Oregon,9,Columbia County,0,9,-9
44,Rhode Island,41,Oregon,19,Douglas County,0,1,-1
44,Rhode Island,41,Oregon,29,Jackson County,7,0,7
44,Rhode Island,41,Oregon,39,Lane County,2,27,-25
44,Rhode Island,41,Oregon,51,Multnomah County,19,52,-33
44,Rhode Island,41,Oregon,65,Wasco County,0,27,-27
44,Rhode Island,41,Oregon,67,Washington County,18,22,-4
44,Rhode Island,42,Pennsylvania,1,Adams County,0,28,-28
44,Rhode Island,42,Pennsylvania,3,Allegheny County,146,126,20
44,Rhode Island,42,Pennsylvania,7,Beaver County,0,35,-35
44,Rhode Island,42,Pennsylvania,11,Berks County,0,16,-16
44,Rhode Island,42,Pennsylvania,17,Bucks County,18,0,18
44,Rhode Island,42,Pennsylvania,21,Cambria County,9,0,9
44,Rhode Island,42,Pennsylvania,27,Centre County,18,10,8
44,Rhode Island,42,Pennsylvania,29,Chester County,106,38,68
44,Rhode Island,42,Pennsylvania,33,Clearfield County,0,21,-21
44,Rhode Island,42,Pennsylvania,41,Cumberland County,17,0,17
44,Rhode Island,42,Pennsylvania,43,Dauphin County,8,0,8
44,Rhode Island,42,Pennsylvania,45,Delaware County,56,29,27
44,Rhode Island,42,Pennsylvania,49,Erie County,0,69,-69
44,Rhode Island,42,Pennsylvania,55,Franklin County,50,0,50
44,Rhode Island,42,Pennsylvania,63,Indiana County,0,117,-117
44,Rhode Island,42,Pennsylvania,69,Lackawanna County,29,0,29
44,Rhode Island,42,Pennsylvania,71,Lancaster County,0,90,-90
44,Rhode Island,42,Pennsylvania,77,Lehigh County,69,36,33
44,Rhode Island,42,Pennsylvania,79,Luzerne County,21,0,21
44,Rhode Island,42,Pennsylvania,81,Lycoming County,0,11,-11
44,Rhode Island,42,Pennsylvania,87,Mifflin County,22,0,22
44,Rhode Island,42,Pennsylvania,89,Monroe County,6,60,-54
44,Rhode Island,42,Pennsylvania,91,Montgomery County,37,30,7
44,Rhode Island,42,Pennsylvania,95,Northampton County,0,5,-5
44,Rhode Island,42,Pennsylvania,101,Philadelphia County,170,296,-126
44,Rhode Island,42,Pennsylvania,107,Schuylkill County,0,9,-9
44,Rhode Island,42,Pennsylvania,109,Snyder County,18,3,15
44,Rhode Island,42,Pennsylvania,115,Susquehanna County,0,7,-7
44,Rhode Island,42,Pennsylvania,119,Union County,10,14,-4
44,Rhode Island,42,Pennsylvania,123,Warren County,13,0,13
44,Rhode Island,42,Pennsylvania,125,Washington County,21,0,21
44,Rhode Island,42,Pennsylvania,129,Westmoreland County,0,35,-35
44,Rhode Island,42,Pennsylvania,133,York County,53,0,53
44,Rhode Island,44,Rhode Island,1,Bristol County,2026,1163,863
44,Rhode Island,44,Rhode Island,3,Kent County,3977,5614,-1637
44,Rhode Island,44,Rhode Island,5,Newport County,1181,1395,-214
44,Rhode Island,44,Rhode Island,7,Providence County,7428,5370,2058
44,Rhode Island,44,Rhode Island,9,Washington County,2301,3371,-1070
44,Rhode Island,45,South Carolina,7,Anderson County,23,2,21
44,Rhode Island,45,South Carolina,13,Beaufort County,27,99,-72
44,Rhode Island,45,South Carolina,15,Berkeley County,0,11,-11
44,Rhode Island,45,South Carolina,19,Charleston County,81,127,-46
44,Rhode Island,45,South Carolina,23,Chester County,18,0,18
44,Rhode Island,45,South Carolina,25,Chesterfield County,0,15,-15
44,Rhode Island,45,South Carolina,35,Dorchester County,24,0,24
44,Rhode Island,45,South Carolina,41,Florence County,23,29,-6
44,Rhode Island,45,South Carolina,43,Georgetown County,30,6,24
44,Rhode Island,45,South Carolina,45,Greenville County,93,36,57
44,Rhode Island,45,South Carolina,51,Horry County,95,151,-56
44,Rhode Island,45,South Carolina,59,Laurens County,32,0,32
44,Rhode Island,45,South Carolina,63,Lexington County,15,1,14
44,Rhode Island,45,South Carolina,67,Marion County,0,18,-18
44,Rhode Island,45,South Carolina,73,Oconee County,0,2,-2
44,Rhode Island,45,South Carolina,77,Pickens County,0,51,-51
44,Rhode Island,45,South Carolina,79,Richland County,0,139,-139
44,Rhode Island,45,South Carolina,83,Spartanburg County,5,29,-24
44,Rhode Island,45,South Carolina,91,York County,0,1,-1
44,Rhode Island,46,South Dakota,27,Clay County,21,0,21
44,Rhode Island,46,South Dakota,99,Minnehaha County,0,79,-79
44,Rhode Island,47,Tennessee,21,Cheatham County,0,34,-34
44,Rhode Island,47,Tennessee,37,Davidson County,0,15,-15
44,Rhode Island,47,Tennessee,89,Jefferson County,0,19,-19
44,Rhode Island,47,Tennessee,93,Knox County,16,25,-9
44,Rhode Island,47,Tennessee,125,Montgomery County,20,26,-6
44,Rhode Island,47,Tennessee,149,Rutherford County,0,20,-20
44,Rhode Island,47,Tennessee,157,Shelby County,253,62,191
44,Rhode Island,47,Tennessee,165,Sumner County,81,0,81
44,Rhode Island,47,Tennessee,167,Tipton County,15,0,15
44,Rhode Island,47,Tennessee,179,Washington County,0,41,-41
44,Rhode Island,47,Tennessee,183,Weakley County,0,8,-8
44,Rhode Island,47,Tennessee,187,Williamson County,12,0,12
44,Rhode Island,48,Texas,29,Bexar County,22,99,-77
44,Rhode Island,48,Texas,39,Brazoria County,19,23,-4
44,Rhode Island,48,Texas,41,Brazos County,28,0,28
44,Rhode Island,48,Texas,85,Collin County,75,92,-17
44,Rhode Island,48,Texas,93,Comanche County,0,11,-11
44,Rhode Island,48,Texas,113,Dallas County,93,99,-6
44,Rhode Island,48,Texas,141,El Paso County,29,0,29
44,Rhode Island,48,Texas,157,Fort Bend County,21,0,21
44,Rhode Island,48,Texas,201,Harris County,40,314,-274
44,Rhode Island,48,Texas,209,Hays County,0,30,-30
44,Rhode Island,48,Texas,213,Henderson County,0,2,-2
44,Rhode Island,48,Texas,215,Hidalgo County,5,0,5
44,Rhode Island,48,Texas,245,Jefferson County,31,23,8
44,Rhode Island,48,Texas,257,Kaufman County,0,8,-8
44,Rhode Island,48,Texas,309,McLennan County,11,0,11
44,Rhode Island,48,Texas,329,Midland County,16,0,16
44,Rhode Island,48,Texas,331,Milam County,0,15,-15
44,Rhode Island,48,Texas,339,Montgomery County,8,0,8
44,Rhode Island,48,Texas,355,Nueces County,142,14,128
44,Rhode Island,48,Texas,361,Orange County,0,57,-57
44,Rhode Island,48,Texas,373,Polk County,12,0,12
44,Rhode Island,48,Texas,423,Smith County,0,76,-76
44,Rhode Island,48,Texas,439,Tarrant County,164,161,3
44,Rhode Island,48,Texas,441,Taylor County,0,21,-21
44,Rhode Island,48,Texas,453,Travis County,104,74,30
44,Rhode Island,48,Texas,465,Val Verde County,56,0,56
44,Rhode Island,48,Texas,491,Williamson County,6,19,-13
44,Rhode Island,48,Texas,493,Wilson County,12,0,12
44,Rhode Island,49,Utah,7,Carbon County,14,0,14
44,Rhode Island,49,Utah,11,Davis County,39,15,24
44,Rhode Island,49,Utah,35,Salt Lake County,62,142,-80
44,Rhode Island,49,Utah,53,Washington County,17,0,17
44,Rhode Island,5,Arkansas,119,Pulaski County,37,0,37
44,Rhode Island,5,Arkansas,143,Washington County,20,10,10
44,Rhode Island,50,Vermont,1,Addison County,20,10,10
44,Rhode Island,50,Vermont,5,Caledonia County,0,14,-14
44,Rhode Island,50,Vermont,7,Chittenden County,29,237,-208
44,Rhode Island,50,Vermont,15,Lamoille County,0,4,-4
44,Rhode Island,50,Vermont,17,Orange County,169,12,157
44,Rhode Island,50,Vermont,19,Orleans County,0,4,-4
44,Rhode Island,50,Vermont,21,Rutland County,5,23,-18
44,Rhode Island,50,Vermont,23,Washington County,12,23,-11
44,Rhode Island,50,Vermont,25,Windham County,39,5,34
44,Rhode Island,50,Vermont,27,Windsor County,34,62,-28
44,Rhode Island,51,Virginia,3,Albemarle County,42,15,27
44,Rhode Island,51,Virginia,5,Alleghany County,0,12,-12
44,Rhode Island,51,Virginia,13,Arlington County,19,60,-41
44,Rhode Island,51,Virginia,59,Fairfax County,53,310,-257
44,Rhode Island,51,Virginia,95,James City County,0,53,-53
44,Rhode Island,51,Virginia,103,Lancaster County,0,3,-3
44,Rhode Island,51,Virginia,107,Loudoun County,73,27,46
44,Rhode Island,51,Virginia,109,Louisa County,0,12,-12
44,Rhode Island,51,Virginia,143,Pittsylvania County,8,0,8
44,Rhode Island,51,Virginia,149,Prince George County,13,0,13
44,Rhode Island,51,Virginia,153,Prince William County,4,9,-5
44,Rhode Island,51,Virginia,177,Spotsylvania County,0,57,-57
44,Rhode Island,51,Virginia,179,Stafford County,41,0,41
44,Rhode Island,51,Virginia,181,Surry County,0,29,-29
44,Rhode Island,51,Virginia,191,Washington County,0,9,-9
44,Rhode Island,51,Virginia,510,Alexandria city,78,10,68
44,Rhode Island,51,Virginia,540,Charlottesville city,45,11,34
44,Rhode Island,51,Virginia,550,Chesapeake city,24,19,5
44,Rhode Island,51,Virginia,600,Fairfax city,139,0,139
44,Rhode Island,51,Virginia,630,Fredericksburg city,78,0,78
44,Rhode Island,51,Virginia,700,Newport News city,15,63,-48
44,Rhode Island,51,Virginia,710,Norfolk city,17,376,-359
44,Rhode Island,51,Virginia,740,Portsmouth city,0,44,-44
44,Rhode Island,51,Virginia,760,Richmond city,9,15,-6
44,Rhode Island,51,Virginia,770,Roanoke city,20,0,20
44,Rhode Island,51,Virginia,800,Suffolk city,29,83,-54
44,Rhode Island,51,Virginia,810,Virginia Beach city,165,268,-103
44,Rhode Island,53,Washington,11,Clark County,0,20,-20
44,Rhode Island,53,Washington,15,Cowlitz County,0,42,-42
44,Rhode Island,53,Washington,29,Island County,1,0,1
44,Rhode Island,53,Washington,33,King County,120,265,-145
44,Rhode Island,53,Washington,35,Kitsap County,107,125,-18
44,Rhode Island,53,Washington,41,Lewis County,11,0,11
44,Rhode Island,53,Washington,49,Pacific County,0,15,-15
44,Rhode Island,53,Washington,53,Pierce County,193,24,169
44,Rhode Island,53,Washington,57,Skagit County,8,0,8
44,Rhode Island,53,Washington,61,Snohomish County,24,157,-133
44,Rhode Island,54,West Virginia,39,Kanawha County,13,0,13
44,Rhode Island,54,West Virginia,59,Mingo County,0,16,-16
44,Rhode Island,54,West Virginia,61,Monongalia County,0,32,-32
44,Rhode Island,54,West Virginia,77,Preston County,7,0,7
44,Rhode Island,54,West Virginia,83,Randolph County,0,11,-11
44,Rhode Island,55,Wisconsin,25,Dane County,30,57,-27
44,Rhode Island,55,Wisconsin,79,Milwaukee County,0,15,-15
44,Rhode Island,55,Wisconsin,89,Ozaukee County,8,0,8
44,Rhode Island,55,Wisconsin,101,Racine County,40,0,40
44,Rhode Island,55,Wisconsin,117,Sheboygan County,0,4,-4
44,Rhode Island,55,Wisconsin,133,Waukesha County,0,11,-11
44,Rhode Island,55,Wisconsin,141,Wood County,23,0,23
44,Rhode Island,56,Wyoming,1,Albany County,0,1,-1
44,Rhode Island,56,Wyoming,39,Teton County,0,2,-2
44,Rhode Island,6,California,1,Alameda County,44,146,-102
44,Rhode Island,6,California,13,Contra Costa County,33,133,-100
44,Rhode Island,6,California,19,Fresno County,0,36,-36
44,Rhode Island,6,California,23,Humboldt County,13,0,13
44,Rhode Island,6,California,29,Kern County,22,0,22
44,Rhode Island,6,California,31,Kings County,9,0,9
44,Rhode Island,6,California,37,Los Angeles County,376,393,-17
44,Rhode Island,6,California,41,Marin County,41,34,7
44,Rhode Island,6,California,53,Monterey County,252,0,252
44,Rhode Island,6,California,59,Orange County,128,143,-15
44,Rhode Island,6,California,65,Riverside County,28,8,20
44,Rhode Island,6,California,67,Sacramento County,16,24,-8
44,Rhode Island,6,California,71,San Bernardino County,56,15,41
44,Rhode Island,6,California,73,San Diego County,463,460,3
44,Rhode Island,6,California,75,San Francisco County,98,120,-22
44,Rhode Island,6,California,77,San Joaquin County,12,57,-45
44,Rhode Island,6,California,79,San Luis Obispo County,29,0,29
44,Rhode Island,6,California,81,San Mateo County,37,56,-19
44,Rhode Island,6,California,85,Santa Clara County,122,90,32
44,Rhode Island,6,California,87,Santa Cruz County,4,0,4
44,Rhode Island,6,California,101,Sutter County,51,0,51
44,Rhode Island,6,California,111,Ventura County,55,76,-21
44,Rhode Island,72,Puerto Rico,21,Bayamón Municipio,28,13,15
44,Rhode Island,72,Puerto Rico,25,Caguas Municipio,81,0,81
44,Rhode Island,72,Puerto Rico,29,Canóvanas Municipio,0,16,-16
44,Rhode Island,72,Puerto Rico,31,Carolina Municipio,4,35,-31
44,Rhode Island,72,Puerto Rico,57,Guayama Municipio,63,0,63
44,Rhode Island,72,Puerto Rico,61,Guaynabo Municipio,19,0,19
44,Rhode Island,72,Puerto Rico,73,Jayuya Municipio,116,0,116
44,Rhode Island,72,Puerto Rico,75,Juana Díaz Municipio,0,62,-62
44,Rhode Island,72,Puerto Rico,89,Luquillo Municipio,17,0,17
44,Rhode Island,72,Puerto Rico,97,Mayagüez Municipio,0,100,-100
44,Rhode Island,72,Puerto Rico,109,Patillas Municipio,10,0,10
44,Rhode Island,72,Puerto Rico,113,Ponce Municipio,0,38,-38
44,Rhode Island,72,Puerto Rico,127,San Juan Municipio,210,12,198
44,Rhode Island,72,Puerto Rico,129,San Lorenzo Municipio,0,9,-9
44,Rhode Island,72,Puerto Rico,137,Toa Baja Municipio,17,0,17
44,Rhode Island,72,Puerto Rico,145,Vega Baja Municipio,0,46,-46
44,Rhode Island,72,Puerto Rico,149,Villalba Municipio,43,0,43
44,Rhode Island,8,Colorado,1,Adams County,0,150,-150
44,Rhode Island,8,Colorado,13,Boulder County,48,53,-5
44,Rhode Island,8,Colorado,14,Broomfield County,7,0,7
44,Rhode Island,8,Colorado,31,Denver County,116,41,75
44,Rhode Island,8,Colorado,35,Douglas County,5,0,5
44,Rhode Island,8,Colorado,41,El Paso County,32,6,26
44,Rhode Island,8,Colorado,49,Grand County,32,0,32
44,Rhode Island,8,Colorado,59,Jefferson County,16,0,16
44,Rhode Island,8,Colorado,69,Larimer County,0,46,-46
44,Rhode Island,8,Colorado,97,Pitkin County,0,4,-4
44,Rhode Island,8,Colorado,101,Pueblo County,24,0,24
44,Rhode Island,9,Connecticut,1,Fairfield County,373,227,146
44,Rhode Island,9,Connecticut,3,Hartford County,675,290,385
44,Rhode Island,9,Connecticut,5,Litchfield County,94,28,66
44,Rhode Island,9,Connecticut,7,Middlesex County,228,142,86
44,Rhode Island,9,Connecticut,9,New Haven County,494,316,178
44,Rhode Island,9,Connecticut,11,New London County,800,1379,-579
44,Rhode Island,9,Connecticut,13,Tolland County,64,186,-122
44,Rhode Island,9,Connecticut,15,Windham County,556,644,-88
44,Rhode Island,AFR,Africa,,-,580,0,0
44,Rhode Island,ASI,Asia,,-,3068,0,0
44,Rhode Island,CAM,Central America,,-,376,0,0
44,Rhode Island,CAR,Caribbean,,-,599,0,0
44,Rhode Island,EUR,Europe,,-,1304,0,0
44,Rhode Island,ISL,U.S. Island Areas,,-,72,0,0
44,Rhode Island,NAM,Northern America,,-,295,0,0
44,Rhode Island,OCE,Oceania and At Sea,,-,59,0,0
44,Rhode Island,SAM,South America,,-,390,0,0
45,South Carolina,1,Alabama,1,Autauga County,0,155,-155
45,South Carolina,1,Alabama,3,Baldwin County,110,27,83
45,South Carolina,1,Alabama,9,Blount County,43,21,22
45,South Carolina,1,Alabama,15,Calhoun County,35,58,-23
45,South Carolina,1,Alabama,25,Clarke County,0,13,-13
45,South Carolina,1,Alabama,27,Clay County,0,5,-5
45,South Carolina,1,Alabama,29,Cleburne County,0,22,-22
45,South Carolina,1,Alabama,31,Coffee County,0,9,-9
45,South Carolina,1,Alabama,33,Colbert County,10,0,10
45,South Carolina,1,Alabama,39,Covington County,66,6,60
45,South Carolina,1,Alabama,45,Dale County,14,62,-48
45,South Carolina,1,Alabama,49,DeKalb County,16,0,16
45,South Carolina,1,Alabama,51,Elmore County,99,2,97
45,South Carolina,1,Alabama,61,Geneva County,0,8,-8
45,South Carolina,1,Alabama,69,Houston County,3,62,-59
45,South Carolina,1,Alabama,71,Jackson County,17,0,17
45,South Carolina,1,Alabama,73,Jefferson County,605,441,164
45,South Carolina,1,Alabama,77,Lauderdale County,71,23,48
45,South Carolina,1,Alabama,81,Lee County,224,77,147
45,South Carolina,1,Alabama,83,Limestone County,12,53,-41
45,South Carolina,1,Alabama,87,Macon County,1,16,-15
45,South Carolina,1,Alabama,89,Madison County,198,165,33
45,South Carolina,1,Alabama,95,Marshall County,6,42,-36
45,South Carolina,1,Alabama,97,Mobile County,131,116,15
45,South Carolina,1,Alabama,101,Montgomery County,181,46,135
45,South Carolina,1,Alabama,103,Morgan County,103,12,91
45,South Carolina,1,Alabama,111,Randolph County,18,5,13
45,South Carolina,1,Alabama,113,Russell County,11,180,-169
45,South Carolina,1,Alabama,115,St. Clair County,187,165,22
45,South Carolina,1,Alabama,117,Shelby County,104,80,24
45,South Carolina,1,Alabama,121,Talladega County,53,46,7
45,South Carolina,1,Alabama,125,Tuscaloosa County,88,150,-62
45,South Carolina,1,Alabama,127,Walker County,2,0,2
45,South Carolina,1,Alabama,129,Washington County,0,4,-4
45,South Carolina,10,Delaware,1,Kent County,154,174,-20
45,South Carolina,10,Delaware,3,New Castle County,161,161,0
45,South Carolina,10,Delaware,5,Sussex County,36,74,-38
45,South Carolina,11,District of Columbia,1,District of Columbia,630,576,54
45,South Carolina,12,Florida,1,Alachua County,263,142,121
45,South Carolina,12,Florida,3,Baker County,0,15,-15
45,South Carolina,12,Florida,5,Bay County,212,156,56
45,South Carolina,12,Florida,7,Bradford County,0,140,-140
45,South Carolina,12,Florida,9,Brevard County,549,842,-293
45,South Carolina,12,Florida,11,Broward County,1111,523,588
45,South Carolina,12,Florida,13,Calhoun County,0,24,-24
45,South Carolina,12,Florida,15,Charlotte County,119,97,22
45,South Carolina,12,Florida,17,Citrus County,47,59,-12
45,South Carolina,12,Florida,19,Clay County,278,334,-56
45,South Carolina,12,Florida,21,Collier County,222,109,113
45,South Carolina,12,Florida,23,Columbia County,16,44,-28
45,South Carolina,12,Florida,27,DeSoto County,0,6,-6
45,South Carolina,12,Florida,31,Duval County,1389,1330,59
45,South Carolina,12,Florida,33,Escambia County,192,240,-48
45,South Carolina,12,Florida,35,Flagler County,52,294,-242
45,South Carolina,12,Florida,37,Franklin County,0,3,-3
45,South Carolina,12,Florida,39,Gadsden County,6,0,6
45,South Carolina,12,Florida,45,Gulf County,0,47,-47
45,South Carolina,12,Florida,47,Hamilton County,11,5,6
45,South Carolina,12,Florida,49,Hardee County,195,0,195
45,South Carolina,12,Florida,51,Hendry County,11,16,-5
45,South Carolina,12,Florida,53,Hernando County,140,77,63
45,South Carolina,12,Florida,55,Highlands County,59,89,-30
45,South Carolina,12,Florida,57,Hillsborough County,1021,749,272
45,South Carolina,12,Florida,61,Indian River County,147,193,-46
45,South Carolina,12,Florida,63,Jackson County,72,0,72
45,South Carolina,12,Florida,69,Lake County,295,258,37
45,South Carolina,12,Florida,71,Lee County,386,380,6
45,South Carolina,12,Florida,73,Leon County,331,82,249
45,South Carolina,12,Florida,77,Liberty County,0,23,-23
45,South Carolina,12,Florida,79,Madison County,5,0,5
45,South Carolina,12,Florida,81,Manatee County,397,338,59
45,South Carolina,12,Florida,83,Marion County,146,413,-267
45,South Carolina,12,Florida,85,Martin County,120,67,53
45,South Carolina,12,Florida,86,Miami-Dade County,922,370,552
45,South Carolina,12,Florida,87,Monroe County,58,157,-99
45,South Carolina,12,Florida,89,Nassau County,107,94,13
45,South Carolina,12,Florida,91,Okaloosa County,495,480,15
45,South Carolina,12,Florida,93,Okeechobee County,0,16,-16
45,South Carolina,12,Florida,95,Orange County,928,1015,-87
45,South Carolina,12,Florida,97,Osceola County,29,365,-336
45,South Carolina,12,Florida,99,Palm Beach County,860,512,348
45,South Carolina,12,Florida,101,Pasco County,170,150,20
45,South Carolina,12,Florida,103,Pinellas County,749,459,290
45,South Carolina,12,Florida,105,Polk County,348,271,77
45,South Carolina,12,Florida,107,Putnam County,0,21,-21
45,South Carolina,12,Florida,109,St. Johns County,412,364,48
45,South Carolina,12,Florida,111,St. Lucie County,287,467,-180
45,South Carolina,12,Florida,113,Santa Rosa County,132,28,104
45,South Carolina,12,Florida,115,Sarasota County,110,98,12
45,South Carolina,12,Florida,117,Seminole County,181,181,0
45,South Carolina,12,Florida,119,Sumter County,56,52,4
45,South Carolina,12,Florida,121,Suwannee County,99,11,88
45,South Carolina,12,Florida,123,Taylor County,10,0,10
45,South Carolina,12,Florida,125,Union County,0,30,-30
45,South Carolina,12,Florida,127,Volusia County,462,393,69
45,South Carolina,12,Florida,131,Walton County,43,18,25
45,South Carolina,12,Florida,133,Washington County,15,0,15
45,South Carolina,13,Georgia,1,Appling County,17,6,11
45,South Carolina,13,Georgia,5,Bacon County,0,16,-16
45,South Carolina,13,Georgia,9,Baldwin County,28,11,17
45,South Carolina,13,Georgia,13,Barrow County,39,30,9
45,South Carolina,13,Georgia,15,Bartow County,181,70,111
45,South Carolina,13,Georgia,21,Bibb County,144,20,124
45,South Carolina,13,Georgia,23,Bleckley County,31,0,31
45,South Carolina,13,Georgia,25,Brantley County,17,0,17
45,South Carolina,13,Georgia,29,Bryan County,140,198,-58
45,South Carolina,13,Georgia,31,Bulloch County,246,127,119
45,South Carolina,13,Georgia,33,Burke County,23,23,0
45,South Carolina,13,Georgia,35,Butts County,0,45,-45
45,South Carolina,13,Georgia,39,Camden County,279,271,8
45,South Carolina,13,Georgia,45,Carroll County,162,106,56
45,South Carolina,13,Georgia,47,Catoosa County,79,8,71
45,South Carolina,13,Georgia,51,Chatham County,1073,1636,-563
45,South Carolina,13,Georgia,53,Chattahoochee County,28,44,-16
45,South Carolina,13,Georgia,57,Cherokee County,374,30,344
45,South Carolina,13,Georgia,59,Clarke County,203,284,-81
45,South Carolina,13,Georgia,63,Clayton County,226,758,-532
45,South Carolina,13,Georgia,65,Clinch County,0,56,-56
45,South Carolina,13,Georgia,67,Cobb County,896,864,32
45,South Carolina,13,Georgia,69,Coffee County,0,13,-13
45,South Carolina,13,Georgia,71,Colquitt County,0,49,-49
45,South Carolina,13,Georgia,73,Columbia County,1028,1054,-26
45,South Carolina,13,Georgia,75,Cook County,13,10,3
45,South Carolina,13,Georgia,77,Coweta County,122,106,16
45,South Carolina,13,Georgia,79,Crawford County,0,23,-23
45,South Carolina,13,Georgia,81,Crisp County,16,8,8
45,South Carolina,13,Georgia,83,Dade County,0,35,-35
45,South Carolina,13,Georgia,89,DeKalb County,745,918,-173
45,South Carolina,13,Georgia,91,Dodge County,2,0,2
45,South Carolina,13,Georgia,93,Dooly County,0,3,-3
45,South Carolina,13,Georgia,95,Dougherty County,112,91,21
45,South Carolina,13,Georgia,97,Douglas County,16,19,-3
45,South Carolina,13,Georgia,99,Early County,4,0,4
45,South Carolina,13,Georgia,103,Effingham County,270,126,144
45,South Carolina,13,Georgia,105,Elbert County,128,19,109
45,South Carolina,13,Georgia,107,Emanuel County,82,65,17
45,South Carolina,13,Georgia,109,Evans County,4,0,4
45,South Carolina,13,Georgia,111,Fannin County,0,85,-85
45,South Carolina,13,Georgia,113,Fayette County,293,62,231
45,South Carolina,13,Georgia,115,Floyd County,7,16,-9
45,South Carolina,13,Georgia,117,Forsyth County,159,225,-66
45,South Carolina,13,Georgia,119,Franklin County,44,29,15
45,South Carolina,13,Georgia,121,Fulton County,1732,1154,578
45,South Carolina,13,Georgia,123,Gilmer County,25,156,-131
45,South Carolina,13,Georgia,125,Glascock County,9,5,4
45,South Carolina,13,Georgia,127,Glynn County,5,22,-17
45,South Carolina,13,Georgia,131,Grady County,62,0,62
45,South Carolina,13,Georgia,133,Greene County,0,11,-11
45,South Carolina,13,Georgia,135,Gwinnett County,1308,1471,-163
45,South Carolina,13,Georgia,137,Habersham County,13,18,-5
45,South Carolina,13,Georgia,139,Hall County,84,346,-262
45,South Carolina,13,Georgia,141,Hancock County,0,29,-29
45,South Carolina,13,Georgia,143,Haralson County,0,80,-80
45,South Carolina,13,Georgia,145,Harris County,0,173,-173
45,South Carolina,13,Georgia,147,Hart County,22,83,-61
45,South Carolina,13,Georgia,149,Heard County,11,2,9
45,South Carolina,13,Georgia,151,Henry County,201,312,-111
45,South Carolina,13,Georgia,153,Houston County,308,156,152
45,South Carolina,13,Georgia,155,Irwin County,0,7,-7
45,South Carolina,13,Georgia,157,Jackson County,171,257,-86
45,South Carolina,13,Georgia,161,Jeff Davis County,0,7,-7
45,South Carolina,13,Georgia,163,Jefferson County,12,5,7
45,South Carolina,13,Georgia,165,Jenkins County,31,0,31
45,South Carolina,13,Georgia,169,Jones County,5,0,5
45,South Carolina,13,Georgia,171,Lamar County,31,4,27
45,South Carolina,13,Georgia,175,Laurens County,117,111,6
45,South Carolina,13,Georgia,177,Lee County,22,32,-10
45,South Carolina,13,Georgia,179,Liberty County,308,373,-65
45,South Carolina,13,Georgia,181,Lincoln County,39,36,3
45,South Carolina,13,Georgia,185,Lowndes County,143,112,31
45,South Carolina,13,Georgia,187,Lumpkin County,82,0,82
45,South Carolina,13,Georgia,189,McDuffie County,47,0,47
45,South Carolina,13,Georgia,195,Madison County,0,18,-18
45,South Carolina,13,Georgia,197,Marion County,14,0,14
45,South Carolina,13,Georgia,199,Meriwether County,0,9,-9
45,South Carolina,13,Georgia,205,Mitchell County,104,6,98
45,South Carolina,13,Georgia,207,Monroe County,20,7,13
45,South Carolina,13,Georgia,209,Montgomery County,16,8,8
45,South Carolina,13,Georgia,211,Morgan County,2,0,2
45,South Carolina,13,Georgia,213,Murray County,16,0,16
45,South Carolina,13,Georgia,215,Muscogee County,110,395,-285
45,South Carolina,13,Georgia,217,Newton County,68,9,59
45,South Carolina,13,Georgia,219,Oconee County,0,10,-10
45,South Carolina,13,Georgia,221,Oglethorpe County,61,42,19
45,South Carolina,13,Georgia,223,Paulding County,43,82,-39
45,South Carolina,13,Georgia,225,Peach County,28,45,-17
45,South Carolina,13,Georgia,227,Pickens County,44,0,44
45,South Carolina,13,Georgia,229,Pierce County,49,15,34
45,South Carolina,13,Georgia,233,Polk County,13,0,13
45,South Carolina,13,Georgia,235,Pulaski County,29,0,29
45,South Carolina,13,Georgia,237,Putnam County,98,8,90
45,South Carolina,13,Georgia,241,Rabun County,67,19,48
45,South Carolina,13,Georgia,243,Randolph County,10,4,6
45,South Carolina,13,Georgia,245,Richmond County,1535,1316,219
45,South Carolina,13,Georgia,247,Rockdale County,77,0,77
45,South Carolina,13,Georgia,251,Screven County,174,4,170
45,South Carolina,13,Georgia,255,Spalding County,18,0,18
45,South Carolina,13,Georgia,257,Stephens County,64,16,48
45,South Carolina,13,Georgia,259,Stewart County,0,100,-100
45,South Carolina,13,Georgia,261,Sumter County,29,6,23
45,South Carolina,13,Georgia,265,Taliaferro County,0,3,-3
45,South Carolina,13,Georgia,267,Tattnall County,0,40,-40
45,South Carolina,13,Georgia,269,Taylor County,17,0,17
45,South Carolina,13,Georgia,271,Telfair County,22,0,22
45,South Carolina,13,Georgia,275,Thomas County,0,35,-35
45,South Carolina,13,Georgia,277,Tift County,0,9,-9
45,South Carolina,13,Georgia,279,Toombs County,183,22,161
45,South Carolina,13,Georgia,283,Treutlen County,0,17,-17
45,South Carolina,13,Georgia,285,Troup County,0,99,-99
45,South Carolina,13,Georgia,287,Turner County,0,26,-26
45,South Carolina,13,Georgia,291,Union County,52,54,-2
45,South Carolina,13,Georgia,293,Upson County,0,12,-12
45,South Carolina,13,Georgia,297,Walton County,31,8,23
45,South Carolina,13,Georgia,301,Warren County,21,0,21
45,South Carolina,13,Georgia,303,Washington County,33,16,17
45,South Carolina,13,Georgia,305,Wayne County,95,10,85
45,South Carolina,13,Georgia,309,Wheeler County,11,0,11
45,South Carolina,13,Georgia,311,White County,6,85,-79
45,South Carolina,13,Georgia,313,Whitfield County,28,119,-91
45,South Carolina,13,Georgia,317,Wilkes County,57,0,57
45,South Carolina,13,Georgia,319,Wilkinson County,9,11,-2
45,South Carolina,15,Hawaii,1,Hawaii County,29,138,-109
45,South Carolina,15,Hawaii,3,Honolulu County,590,1032,-442
45,South Carolina,15,Hawaii,7,Kauai County,8,13,-5
45,South Carolina,15,Hawaii,9,Maui County,64,54,10
45,South Carolina,16,Idaho,1,Ada County,411,94,317
45,South Carolina,16,Idaho,5,Bannock County,0,17,-17
45,South Carolina,16,Idaho,17,Bonner County,3,0,3
45,South Carolina,16,Idaho,19,Bonneville County,81,22,59
45,South Carolina,16,Idaho,27,Canyon County,22,0,22
45,South Carolina,16,Idaho,31,Cassia County,0,19,-19
45,South Carolina,16,Idaho,35,Clearwater County,0,1,-1
45,South Carolina,16,Idaho,39,Elmore County,0,4,-4
45,South Carolina,16,Idaho,47,Gooding County,27,0,27
45,South Carolina,16,Idaho,49,Idaho County,0,14,-14
45,South Carolina,16,Idaho,51,Jefferson County,8,22,-14
45,South Carolina,16,Idaho,57,Latah County,10,10,0
45,South Carolina,16,Idaho,65,Madison County,0,17,-17
45,South Carolina,16,Idaho,81,Teton County,8,7,1
45,South Carolina,16,Idaho,87,Washington County,30,0,30
45,South Carolina,17,Illinois,3,Alexander County,0,14,-14
45,South Carolina,17,Illinois,5,Bond County,0,6,-6
45,South Carolina,17,Illinois,15,Carroll County,0,13,-13
45,South Carolina,17,Illinois,19,Champaign County,116,41,75
45,South Carolina,17,Illinois,21,Christian County,7,0,7
45,South Carolina,17,Illinois,29,Coles County,0,12,-12
45,South Carolina,17,Illinois,31,Cook County,1096,676,420
45,South Carolina,17,Illinois,37,DeKalb County,15,97,-82
45,South Carolina,17,Illinois,41,Douglas County,51,0,51
45,South Carolina,17,Illinois,43,DuPage County,210,141,69
45,South Carolina,17,Illinois,53,Ford County,62,0,62
45,South Carolina,17,Illinois,57,Fulton County,8,0,8
45,South Carolina,17,Illinois,59,Gallatin County,0,3,-3
45,South Carolina,17,Illinois,63,Grundy County,9,3,6
45,South Carolina,17,Illinois,67,Hancock County,21,0,21
45,South Carolina,17,Illinois,75,Iroquois County,9,0,9
45,South Carolina,17,Illinois,77,Jackson County,52,0,52
45,South Carolina,17,Illinois,81,Jefferson County,0,10,-10
45,South Carolina,17,Illinois,89,Kane County,362,0,362
45,South Carolina,17,Illinois,93,Kendall County,13,0,13
45,South Carolina,17,Illinois,97,Lake County,97,147,-50
45,South Carolina,17,Illinois,99,LaSalle County,91,0,91
45,South Carolina,17,Illinois,103,Lee County,4,0,4
45,South Carolina,17,Illinois,105,Livingston County,61,0,61
45,South Carolina,17,Illinois,107,Logan County,0,10,-10
45,South Carolina,17,Illinois,111,McHenry County,80,28,52
45,South Carolina,17,Illinois,113,McLean County,38,13,25
45,South Carolina,17,Illinois,115,Macon County,14,0,14
45,South Carolina,17,Illinois,117,Macoupin County,22,0,22
45,South Carolina,17,Illinois,119,Madison County,50,0,50
45,South Carolina,17,Illinois,123,Marshall County,0,5,-5
45,South Carolina,17,Illinois,133,Monroe County,20,0,20
45,South Carolina,17,Illinois,135,Montgomery County,66,0,66
45,South Carolina,17,Illinois,137,Morgan County,8,0,8
45,South Carolina,17,Illinois,141,Ogle County,52,0,52
45,South Carolina,17,Illinois,143,Peoria County,71,0,71
45,South Carolina,17,Illinois,157,Randolph County,0,2,-2
45,South Carolina,17,Illinois,161,Rock Island County,103,29,74
45,South Carolina,17,Illinois,163,St. Clair County,136,31,105
45,South Carolina,17,Illinois,167,Sangamon County,4,80,-76
45,South Carolina,17,Illinois,173,Shelby County,0,2,-2
45,South Carolina,17,Illinois,175,Stark County,0,4,-4
45,South Carolina,17,Illinois,179,Tazewell County,95,55,40
45,South Carolina,17,Illinois,183,Vermilion County,15,0,15
45,South Carolina,17,Illinois,197,Will County,204,11,193
45,South Carolina,17,Illinois,201,Winnebago County,37,97,-60
45,South Carolina,17,Illinois,203,Woodford County,43,0,43
45,South Carolina,18,Indiana,1,Adams County,11,0,11
45,South Carolina,18,Indiana,3,Allen County,47,7,40
45,South Carolina,18,Indiana,5,Bartholomew County,65,76,-11
45,South Carolina,18,Indiana,13,Brown County,112,0,112
45,South Carolina,18,Indiana,19,Clark County,36,0,36
45,South Carolina,18,Indiana,21,Clay County,14,7,7
45,South Carolina,18,Indiana,23,Clinton County,9,0,9
45,South Carolina,18,Indiana,33,DeKalb County,4,0,4
45,South Carolina,18,Indiana,35,Delaware County,93,72,21
45,South Carolina,18,Indiana,39,Elkhart County,66,11,55
45,South Carolina,18,Indiana,41,Fayette County,11,0,11
45,South Carolina,18,Indiana,43,Floyd County,75,46,29
45,South Carolina,18,Indiana,49,Fulton County,0,47,-47
45,South Carolina,18,Indiana,53,Grant County,0,12,-12
45,South Carolina,18,Indiana,55,Greene County,20,0,20
45,South Carolina,18,Indiana,57,Hamilton County,170,61,109
45,South Carolina,18,Indiana,59,Hancock County,30,6,24
45,South Carolina,18,Indiana,61,Harrison County,0,16,-16
45,South Carolina,18,Indiana,63,Hendricks County,0,100,-100
45,South Carolina,18,Indiana,65,Henry County,0,15,-15
45,South Carolina,18,Indiana,67,Howard County,92,56,36
45,South Carolina,18,Indiana,69,Huntington County,3,6,-3
45,South Carolina,18,Indiana,71,Jackson County,45,22,23
45,South Carolina,18,Indiana,81,Johnson County,39,59,-20
45,South Carolina,18,Indiana,85,Kosciusko County,0,19,-19
45,South Carolina,18,Indiana,87,LaGrange County,0,8,-8
45,South Carolina,18,Indiana,89,Lake County,164,0,164
45,South Carolina,18,Indiana,91,LaPorte County,23,0,23
45,South Carolina,18,Indiana,95,Madison County,22,17,5
45,South Carolina,18,Indiana,97,Marion County,421,89,332
45,South Carolina,18,Indiana,105,Monroe County,82,88,-6
45,South Carolina,18,Indiana,107,Montgomery County,0,33,-33
45,South Carolina,18,Indiana,109,Morgan County,50,0,50
45,South Carolina,18,Indiana,113,Noble County,5,7,-2
45,South Carolina,18,Indiana,127,Porter County,52,0,52
45,South Carolina,18,Indiana,129,Posey County,0,15,-15
45,South Carolina,18,Indiana,131,Pulaski County,17,0,17
45,South Carolina,18,Indiana,135,Randolph County,6,0,6
45,South Carolina,18,Indiana,137,Ripley County,16,0,16
45,South Carolina,18,Indiana,139,Rush County,0,33,-33
45,South Carolina,18,Indiana,141,St. Joseph County,125,0,125
45,South Carolina,18,Indiana,149,Starke County,45,0,45
45,South Carolina,18,Indiana,153,Sullivan County,5,11,-6
45,South Carolina,18,Indiana,157,Tippecanoe County,306,58,248
45,South Carolina,18,Indiana,163,Vanderburgh County,40,0,40
45,South Carolina,18,Indiana,167,Vigo County,85,0,85
45,South Carolina,18,Indiana,169,Wabash County,10,0,10
45,South Carolina,18,Indiana,175,Washington County,25,0,25
45,South Carolina,18,Indiana,177,Wayne County,46,298,-252
45,South Carolina,19,Iowa,5,Allamakee County,0,51,-51
45,South Carolina,19,Iowa,11,Benton County,0,8,-8
45,South Carolina,19,Iowa,13,Black Hawk County,21,26,-5
45,South Carolina,19,Iowa,21,Buena Vista County,0,1,-1
45,South Carolina,19,Iowa,49,Dallas County,117,13,104
45,South Carolina,19,Iowa,61,Dubuque County,0,7,-7
45,South Carolina,19,Iowa,75,Grundy County,0,8,-8
45,South Carolina,19,Iowa,83,Hardin County,34,0,34
45,South Carolina,19,Iowa,87,Henry County,0,9,-9
45,South Carolina,19,Iowa,95,Iowa County,0,7,-7
45,South Carolina,19,Iowa,103,Johnson County,30,8,22
45,South Carolina,19,Iowa,105,Jones County,17,0,17
45,South Carolina,19,Iowa,113,Linn County,17,41,-24
45,South Carolina,19,Iowa,121,Madison County,7,0,7
45,South Carolina,19,Iowa,139,Muscatine County,0,79,-79
45,South Carolina,19,Iowa,153,Polk County,98,162,-64
45,South Carolina,19,Iowa,155,Pottawattamie County,0,8,-8
45,South Carolina,19,Iowa,159,Ringgold County,16,0,16
45,South Carolina,19,Iowa,169,Story County,17,9,8
45,South Carolina,19,Iowa,171,Tama County,0,6,-6
45,South Carolina,19,Iowa,191,Winneshiek County,0,7,-7
45,South Carolina,19,Iowa,197,Wright County,0,12,-12
45,South Carolina,2,Alaska,20,Anchorage Municipality,285,137,148
45,South Carolina,2,Alaska,68,Denali Borough,0,2,-2
45,South Carolina,2,Alaska,90,Fairbanks North Star Borough,172,210,-38
45,South Carolina,2,Alaska,110,Juneau City and Borough,83,1,82
45,South Carolina,2,Alaska,122,Kenai Peninsula Borough,0,12,-12
45,South Carolina,2,Alaska,130,Ketchikan Gateway Borough,0,5,-5
45,South Carolina,2,Alaska,150,Kodiak Island Borough,0,57,-57
45,South Carolina,2,Alaska,164,Lake and Peninsula Borough,0,1,-1
45,South Carolina,2,Alaska,170,Matanuska-Susitna Borough,70,55,15
45,South Carolina,2,Alaska,188,Northwest Arctic Borough,8,0,8
45,South Carolina,2,Alaska,195,Petersburg Borough,0,1,-1
45,South Carolina,2,Alaska,290,Yukon-Koyukuk Census Area,0,4,-4
45,South Carolina,20,Kansas,1,Allen County,7,0,7
45,South Carolina,20,Kansas,13,Brown County,6,0,6
45,South Carolina,20,Kansas,15,Butler County,14,55,-41
45,South Carolina,20,Kansas,21,Cherokee County,25,0,25
45,South Carolina,20,Kansas,27,Clay County,7,0,7
45,South Carolina,20,Kansas,35,Cowley County,49,0,49
45,South Carolina,20,Kansas,45,Douglas County,5,0,5
45,South Carolina,20,Kansas,49,Elk County,1,0,1
45,South Carolina,20,Kansas,59,Franklin County,8,0,8
45,South Carolina,20,Kansas,61,Geary County,241,0,241
45,South Carolina,20,Kansas,77,Harper County,0,38,-38
45,South Carolina,20,Kansas,79,Harvey County,0,6,-6
45,South Carolina,20,Kansas,81,Haskell County,10,0,10
45,South Carolina,20,Kansas,87,Jefferson County,27,0,27
45,South Carolina,20,Kansas,89,Jewell County,0,1,-1
45,South Carolina,20,Kansas,91,Johnson County,107,44,63
45,South Carolina,20,Kansas,95,Kingman County,0,7,-7
45,South Carolina,20,Kansas,103,Leavenworth County,69,232,-163
45,South Carolina,20,Kansas,105,Lincoln County,0,2,-2
45,South Carolina,20,Kansas,111,Lyon County,25,0,25
45,South Carolina,20,Kansas,155,Reno County,0,4,-4
45,South Carolina,20,Kansas,159,Rice County,26,0,26
45,South Carolina,20,Kansas,161,Riley County,22,97,-75
45,South Carolina,20,Kansas,169,Saline County,7,0,7
45,South Carolina,20,Kansas,173,Sedgwick County,155,24,131
45,South Carolina,20,Kansas,177,Shawnee County,0,23,-23
45,South Carolina,20,Kansas,209,Wyandotte County,61,0,61
45,South Carolina,21,Kentucky,5,Anderson County,29,0,29
45,South Carolina,21,Kentucky,9,Barren County,0,38,-38
45,South Carolina,21,Kentucky,15,Boone County,92,73,19
45,South Carolina,21,Kentucky,17,Bourbon County,7,0,7
45,South Carolina,21,Kentucky,19,Boyd County,7,51,-44
45,South Carolina,21,Kentucky,21,Boyle County,0,9,-9
45,South Carolina,21,Kentucky,27,Breckinridge County,0,13,-13
45,South Carolina,21,Kentucky,29,Bullitt County,81,0,81
45,South Carolina,21,Kentucky,37,Campbell County,0,6,-6
45,South Carolina,21,Kentucky,43,Carter County,0,6,-6
45,South Carolina,21,Kentucky,47,Christian County,79,55,24
45,South Carolina,21,Kentucky,49,Clark County,37,0,37
45,South Carolina,21,Kentucky,51,Clay County,22,14,8
45,South Carolina,21,Kentucky,59,Daviess County,30,61,-31
45,South Carolina,21,Kentucky,67,Fayette County,387,204,183
45,South Carolina,21,Kentucky,79,Garrard County,107,0,107
45,South Carolina,21,Kentucky,81,Grant County,117,0,117
45,South Carolina,21,Kentucky,89,Greenup County,24,0,24
45,South Carolina,21,Kentucky,93,Hardin County,336,135,201
45,South Carolina,21,Kentucky,95,Harlan County,10,0,10
45,South Carolina,21,Kentucky,111,Jefferson County,304,84,220
45,South Carolina,21,Kentucky,115,Johnson County,0,53,-53
45,South Carolina,21,Kentucky,117,Kenton County,0,29,-29
45,South Carolina,21,Kentucky,119,Knott County,0,2,-2
45,South Carolina,21,Kentucky,121,Knox County,0,52,-52
45,South Carolina,21,Kentucky,125,Laurel County,65,0,65
45,South Carolina,21,Kentucky,127,Lawrence County,45,0,45
45,South Carolina,21,Kentucky,133,Letcher County,21,0,21
45,South Carolina,21,Kentucky,135,Lewis County,0,48,-48
45,South Carolina,21,Kentucky,137,Lincoln County,16,0,16
45,South Carolina,21,Kentucky,141,Logan County,34,0,34
45,South Carolina,21,Kentucky,143,Lyon County,4,0,4
45,South Carolina,21,Kentucky,145,McCracken County,27,0,27
45,South Carolina,21,Kentucky,147,McCreary County,27,0,27
45,South Carolina,21,Kentucky,151,Madison County,103,86,17
45,South Carolina,21,Kentucky,153,Magoffin County,14,0,14
45,South Carolina,21,Kentucky,157,Marshall County,9,0,9
45,South Carolina,21,Kentucky,159,Martin County,0,16,-16
45,South Carolina,21,Kentucky,163,Meade County,0,6,-6
45,South Carolina,21,Kentucky,165,Menifee County,5,0,5
45,South Carolina,21,Kentucky,171,Monroe County,7,0,7
45,South Carolina,21,Kentucky,185,Oldham County,28,69,-41
45,South Carolina,21,Kentucky,189,Owsley County,21,0,21
45,South Carolina,21,Kentucky,195,Pike County,96,0,96
45,South Carolina,21,Kentucky,199,Pulaski County,75,77,-2
45,South Carolina,21,Kentucky,209,Scott County,6,0,6
45,South Carolina,21,Kentucky,211,Shelby County,4,17,-13
45,South Carolina,21,Kentucky,217,Taylor County,0,38,-38
45,South Carolina,21,Kentucky,225,Union County,0,18,-18
45,South Carolina,21,Kentucky,227,Warren County,137,0,137
45,South Carolina,21,Kentucky,229,Washington County,0,5,-5
45,South Carolina,21,Kentucky,235,Whitley County,50,0,50
45,South Carolina,22,Louisiana,5,Ascension Parish,58,59,-1
45,South Carolina,22,Louisiana,9,Avoyelles Parish,53,0,53
45,South Carolina,22,Louisiana,11,Beauregard Parish,5,0,5
45,South Carolina,22,Louisiana,15,Bossier Parish,98,35,63
45,South Carolina,22,Louisiana,17,Caddo Parish,0,72,-72
45,South Carolina,22,Louisiana,19,Calcasieu Parish,101,222,-121
45,South Carolina,22,Louisiana,33,East Baton Rouge Parish,128,221,-93
45,South Carolina,22,Louisiana,43,Grant Parish,0,18,-18
45,South Carolina,22,Louisiana,47,Iberville Parish,0,1,-1
45,South Carolina,22,Louisiana,51,Jefferson Parish,49,72,-23
45,South Carolina,22,Louisiana,55,Lafayette Parish,67,0,67
45,South Carolina,22,Louisiana,57,Lafourche Parish,72,0,72
45,South Carolina,22,Louisiana,61,Lincoln Parish,58,29,29
45,South Carolina,22,Louisiana,63,Livingston Parish,12,27,-15
45,South Carolina,22,Louisiana,69,Natchitoches Parish,19,0,19
45,South Carolina,22,Louisiana,71,Orleans Parish,267,153,114
45,South Carolina,22,Louisiana,73,Ouachita Parish,18,0,18
45,South Carolina,22,Louisiana,75,Plaquemines Parish,72,0,72
45,South Carolina,22,Louisiana,79,Rapides Parish,76,0,76
45,South Carolina,22,Louisiana,85,Sabine Parish,9,3,6
45,South Carolina,22,Louisiana,87,St. Bernard Parish,8,0,8
45,South Carolina,22,Louisiana,93,St. James Parish,0,9,-9
45,South Carolina,22,Louisiana,95,St. John the Baptist Parish,5,0,5
45,South Carolina,22,Louisiana,97,St. Landry Parish,198,0,198
45,South Carolina,22,Louisiana,103,St. Tammany Parish,14,4,10
45,South Carolina,22,Louisiana,105,Tangipahoa Parish,0,45,-45
45,South Carolina,22,Louisiana,113,Vermilion Parish,18,0,18
45,South Carolina,22,Louisiana,115,Vernon Parish,158,94,64
45,South Carolina,22,Louisiana,119,Webster Parish,0,12,-12
45,South Carolina,22,Louisiana,127,Winn Parish,11,0,11
45,South Carolina,23,Maine,1,Androscoggin County,60,19,41
45,South Carolina,23,Maine,5,Cumberland County,453,18,435
45,South Carolina,23,Maine,7,Franklin County,0,14,-14
45,South Carolina,23,Maine,9,Hancock County,0,6,-6
45,South Carolina,23,Maine,11,Kennebec County,12,17,-5
45,South Carolina,23,Maine,13,Knox County,39,18,21
45,South Carolina,23,Maine,15,Lincoln County,37,8,29
45,South Carolina,23,Maine,17,Oxford County,10,151,-141
45,South Carolina,23,Maine,19,Penobscot County,188,26,162
45,South Carolina,23,Maine,21,Piscataquis County,67,0,67
45,South Carolina,23,Maine,23,Sagadahoc County,27,0,27
45,South Carolina,23,Maine,25,Somerset County,162,25,137
45,South Carolina,23,Maine,27,Waldo County,15,3,12
45,South Carolina,23,Maine,31,York County,121,34,87
45,South Carolina,24,Maryland,1,Allegany County,15,38,-23
45,South Carolina,24,Maryland,3,Anne Arundel County,613,369,244
45,South Carolina,24,Maryland,5,Baltimore County,510,289,221
45,South Carolina,24,Maryland,9,Calvert County,237,44,193
45,South Carolina,24,Maryland,11,Caroline County,13,12,1
45,South Carolina,24,Maryland,13,Carroll County,118,21,97
45,South Carolina,24,Maryland,15,Cecil County,68,60,8
45,South Carolina,24,Maryland,17,Charles County,150,23,127
45,South Carolina,24,Maryland,21,Frederick County,119,51,68
45,South Carolina,24,Maryland,23,Garrett County,0,17,-17
45,South Carolina,24,Maryland,25,Harford County,120,64,56
45,South Carolina,24,Maryland,27,Howard County,495,146,349
45,South Carolina,24,Maryland,29,Kent County,33,33,0
45,South Carolina,24,Maryland,31,Montgomery County,707,149,558
45,South Carolina,24,Maryland,33,Prince George's County,320,329,-9
45,South Carolina,24,Maryland,35,Queen Anne's County,0,10,-10
45,South Carolina,24,Maryland,37,St. Mary's County,191,0,191
45,South Carolina,24,Maryland,41,Talbot County,87,0,87
45,South Carolina,24,Maryland,43,Washington County,183,95,88
45,South Carolina,24,Maryland,45,Wicomico County,65,43,22
45,South Carolina,24,Maryland,47,Worcester County,81,16,65
45,South Carolina,24,Maryland,510,Baltimore city,330,187,143
45,South Carolina,25,Massachusetts,1,Barnstable County,73,15,58
45,South Carolina,25,Massachusetts,3,Berkshire County,10,6,4
45,South Carolina,25,Massachusetts,5,Bristol County,132,83,49
45,South Carolina,25,Massachusetts,7,Dukes County,10,0,10
45,South Carolina,25,Massachusetts,9,Essex County,195,11,184
45,South Carolina,25,Massachusetts,11,Franklin County,7,21,-14
45,South Carolina,25,Massachusetts,13,Hampden County,458,155,303
45,South Carolina,25,Massachusetts,15,Hampshire County,0,43,-43
45,South Carolina,25,Massachusetts,17,Middlesex County,501,311,190
45,South Carolina,25,Massachusetts,21,Norfolk County,237,141,96
45,South Carolina,25,Massachusetts,23,Plymouth County,375,94,281
45,South Carolina,25,Massachusetts,25,Suffolk County,237,335,-98
45,South Carolina,25,Massachusetts,27,Worcester County,349,136,213
45,South Carolina,26,Michigan,3,Alger County,0,18,-18
45,South Carolina,26,Michigan,5,Allegan County,0,3,-3
45,South Carolina,26,Michigan,15,Barry County,5,8,-3
45,South Carolina,26,Michigan,17,Bay County,41,0,41
45,South Carolina,26,Michigan,19,Benzie County,21,0,21
45,South Carolina,26,Michigan,21,Berrien County,86,11,75
45,South Carolina,26,Michigan,25,Calhoun County,0,10,-10
45,South Carolina,26,Michigan,27,Cass County,4,0,4
45,South Carolina,26,Michigan,29,Charlevoix County,30,0,30
45,South Carolina,26,Michigan,31,Cheboygan County,20,3,17
45,South Carolina,26,Michigan,33,Chippewa County,0,3,-3
45,South Carolina,26,Michigan,37,Clinton County,35,50,-15
45,South Carolina,26,Michigan,41,Delta County,0,3,-3
45,South Carolina,26,Michigan,43,Dickinson County,16,0,16
45,South Carolina,26,Michigan,45,Eaton County,262,60,202
45,South Carolina,26,Michigan,47,Emmet County,16,0,16
45,South Carolina,26,Michigan,49,Genesee County,161,223,-62
45,South Carolina,26,Michigan,51,Gladwin County,8,5,3
45,South Carolina,26,Michigan,55,Grand Traverse County,0,110,-110
45,South Carolina,26,Michigan,57,Gratiot County,0,2,-2
45,South Carolina,26,Michigan,59,Hillsdale County,0,32,-32
45,South Carolina,26,Michigan,61,Houghton County,119,5,114
45,South Carolina,26,Michigan,63,Huron County,0,17,-17
45,South Carolina,26,Michigan,65,Ingham County,69,174,-105
45,South Carolina,26,Michigan,69,Iosco County,15,40,-25
45,South Carolina,26,Michigan,73,Isabella County,12,20,-8
45,South Carolina,26,Michigan,75,Jackson County,135,0,135
45,South Carolina,26,Michigan,77,Kalamazoo County,87,29,58
45,South Carolina,26,Michigan,81,Kent County,59,190,-131
45,South Carolina,26,Michigan,85,Lake County,14,0,14
45,South Carolina,26,Michigan,87,Lapeer County,60,0,60
45,South Carolina,26,Michigan,91,Lenawee County,19,30,-11
45,South Carolina,26,Michigan,93,Livingston County,43,61,-18
45,South Carolina,26,Michigan,95,Luce County,0,9,-9
45,South Carolina,26,Michigan,97,Mackinac County,60,3,57
45,South Carolina,26,Michigan,99,Macomb County,332,177,155
45,South Carolina,26,Michigan,101,Manistee County,0,27,-27
45,South Carolina,26,Michigan,103,Marquette County,113,18,95
45,South Carolina,26,Michigan,105,Mason County,36,0,36
45,South Carolina,26,Michigan,107,Mecosta County,0,7,-7
45,South Carolina,26,Michigan,109,Menominee County,7,46,-39
45,South Carolina,26,Michigan,111,Midland County,50,0,50
45,South Carolina,26,Michigan,113,Missaukee County,58,0,58
45,South Carolina,26,Michigan,115,Monroe County,29,27,2
45,South Carolina,26,Michigan,117,Montcalm County,6,6,0
45,South Carolina,26,Michigan,119,Montmorency County,0,3,-3
45,South Carolina,26,Michigan,121,Muskegon County,22,12,10
45,South Carolina,26,Michigan,123,Newaygo County,34,0,34
45,South Carolina,26,Michigan,125,Oakland County,351,265,86
45,South Carolina,26,Michigan,127,Oceana County,0,4,-4
45,South Carolina,26,Michigan,129,Ogemaw County,6,3,3
45,South Carolina,26,Michigan,133,Osceola County,11,0,11
45,South Carolina,26,Michigan,139,Ottawa County,79,0,79
45,South Carolina,26,Michigan,145,Saginaw County,73,12,61
45,South Carolina,26,Michigan,147,St. Clair County,58,17,41
45,South Carolina,26,Michigan,151,Sanilac County,0,5,-5
45,South Carolina,26,Michigan,155,Shiawassee County,0,8,-8
45,South Carolina,26,Michigan,159,Van Buren County,64,17,47
45,South Carolina,26,Michigan,161,Washtenaw County,204,107,97
45,South Carolina,26,Michigan,163,Wayne County,399,500,-101
45,South Carolina,26,Michigan,165,Wexford County,0,8,-8
45,South Carolina,27,Minnesota,3,Anoka County,34,0,34
45,South Carolina,27,Minnesota,9,Benton County,0,4,-4
45,South Carolina,27,Minnesota,13,Blue Earth County,0,4,-4
45,South Carolina,27,Minnesota,19,Carver County,22,9,13
45,South Carolina,27,Minnesota,23,Chippewa County,0,27,-27
45,South Carolina,27,Minnesota,31,Cook County,0,12,-12
45,South Carolina,27,Minnesota,33,Cottonwood County,56,0,56
45,South Carolina,27,Minnesota,35,Crow Wing County,20,6,14
45,South Carolina,27,Minnesota,37,Dakota County,160,64,96
45,South Carolina,27,Minnesota,45,Fillmore County,0,1,-1
45,South Carolina,27,Minnesota,49,Goodhue County,11,0,11
45,South Carolina,27,Minnesota,53,Hennepin County,227,55,172
45,South Carolina,27,Minnesota,55,Houston County,58,0,58
45,South Carolina,27,Minnesota,59,Isanti County,0,8,-8
45,South Carolina,27,Minnesota,67,Kandiyohi County,5,2,3
45,South Carolina,27,Minnesota,95,Mille Lacs County,8,0,8
45,South Carolina,27,Minnesota,97,Morrison County,0,2,-2
45,South Carolina,27,Minnesota,99,Mower County,44,0,44
45,South Carolina,27,Minnesota,103,Nicollet County,0,21,-21
45,South Carolina,27,Minnesota,109,Olmsted County,71,20,51
45,South Carolina,27,Minnesota,115,Pine County,0,5,-5
45,South Carolina,27,Minnesota,123,Ramsey County,26,72,-46
45,South Carolina,27,Minnesota,137,St. Louis County,23,2,21
45,South Carolina,27,Minnesota,139,Scott County,16,0,16
45,South Carolina,27,Minnesota,141,Sherburne County,27,0,27
45,South Carolina,27,Minnesota,145,Stearns County,19,36,-17
45,South Carolina,27,Minnesota,153,Todd County,39,0,39
45,South Carolina,27,Minnesota,161,Waseca County,53,4,49
45,South Carolina,27,Minnesota,163,Washington County,31,113,-82
45,South Carolina,27,Minnesota,169,Winona County,14,0,14
45,South Carolina,27,Minnesota,171,Wright County,0,16,-16
45,South Carolina,28,Mississippi,5,Amite County,3,0,3
45,South Carolina,28,Mississippi,7,Attala County,14,0,14
45,South Carolina,28,Mississippi,11,Bolivar County,0,16,-16
45,South Carolina,28,Mississippi,33,DeSoto County,78,82,-4
45,South Carolina,28,Mississippi,35,Forrest County,0,34,-34
45,South Carolina,28,Mississippi,39,George County,6,0,6
45,South Carolina,28,Mississippi,45,Hancock County,27,145,-118
45,South Carolina,28,Mississippi,47,Harrison County,185,79,106
45,South Carolina,28,Mississippi,49,Hinds County,163,71,92
45,South Carolina,28,Mississippi,51,Holmes County,30,0,30
45,South Carolina,28,Mississippi,53,Humphreys County,25,0,25
45,South Carolina,28,Mississippi,57,Itawamba County,20,2,18
45,South Carolina,28,Mississippi,59,Jackson County,38,45,-7
45,South Carolina,28,Mississippi,67,Jones County,0,7,-7
45,South Carolina,28,Mississippi,71,Lafayette County,67,140,-73
45,South Carolina,28,Mississippi,73,Lamar County,24,109,-85
45,South Carolina,28,Mississippi,75,Lauderdale County,30,7,23
45,South Carolina,28,Mississippi,79,Leake County,5,0,5
45,South Carolina,28,Mississippi,81,Lee County,18,8,10
45,South Carolina,28,Mississippi,83,Leflore County,6,0,6
45,South Carolina,28,Mississippi,87,Lowndes County,7,8,-1
45,South Carolina,28,Mississippi,89,Madison County,77,8,69
45,South Carolina,28,Mississippi,105,Oktibbeha County,33,62,-29
45,South Carolina,28,Mississippi,109,Pearl River County,0,15,-15
45,South Carolina,28,Mississippi,119,Quitman County,8,0,8
45,South Carolina,28,Mississippi,121,Rankin County,53,6,47
45,South Carolina,28,Mississippi,123,Scott County,23,0,23
45,South Carolina,28,Mississippi,127,Simpson County,17,21,-4
45,South Carolina,28,Mississippi,137,Tate County,133,112,21
45,South Carolina,28,Mississippi,139,Tippah County,0,76,-76
45,South Carolina,28,Mississippi,143,Tunica County,15,0,15
45,South Carolina,28,Mississippi,147,Walthall County,14,0,14
45,South Carolina,28,Mississippi,149,Warren County,27,0,27
45,South Carolina,28,Mississippi,151,Washington County,0,93,-93
45,South Carolina,28,Mississippi,163,Yazoo County,22,31,-9
45,South Carolina,29,Missouri,3,Andrew County,10,0,10
45,South Carolina,29,Missouri,7,Audrain County,0,47,-47
45,South Carolina,29,Missouri,11,Barton County,0,17,-17
45,South Carolina,29,Missouri,13,Bates County,0,4,-4
45,South Carolina,29,Missouri,15,Benton County,3,0,3
45,South Carolina,29,Missouri,19,Boone County,136,221,-85
45,South Carolina,29,Missouri,21,Buchanan County,14,0,14
45,South Carolina,29,Missouri,23,Butler County,30,2,28
45,South Carolina,29,Missouri,31,Cape Girardeau County,30,4,26
45,South Carolina,29,Missouri,43,Christian County,0,121,-121
45,South Carolina,29,Missouri,47,Clay County,61,64,-3
45,South Carolina,29,Missouri,63,DeKalb County,0,2,-2
45,South Carolina,29,Missouri,65,Dent County,8,0,8
45,South Carolina,29,Missouri,69,Dunklin County,20,0,20
45,South Carolina,29,Missouri,77,Greene County,70,46,24
45,South Carolina,29,Missouri,79,Grundy County,0,13,-13
45,South Carolina,29,Missouri,83,Henry County,11,0,11
45,South Carolina,29,Missouri,91,Howell County,0,16,-16
45,South Carolina,29,Missouri,95,Jackson County,118,103,15
45,South Carolina,29,Missouri,97,Jasper County,137,0,137
45,South Carolina,29,Missouri,99,Jefferson County,48,0,48
45,South Carolina,29,Missouri,101,Johnson County,23,5,18
45,South Carolina,29,Missouri,109,Lawrence County,25,0,25
45,South Carolina,29,Missouri,113,Lincoln County,8,0,8
45,South Carolina,29,Missouri,119,McDonald County,6,0,6
45,South Carolina,29,Missouri,121,Macon County,16,0,16
45,South Carolina,29,Missouri,135,Moniteau County,12,0,12
45,South Carolina,29,Missouri,137,Monroe County,4,0,4
45,South Carolina,29,Missouri,139,Montgomery County,0,2,-2
45,South Carolina,29,Missouri,141,Morgan County,9,0,9
45,South Carolina,29,Missouri,145,Newton County,103,0,103
45,South Carolina,29,Missouri,149,Oregon County,19,0,19
45,South Carolina,29,Missouri,151,Osage County,6,0,6
45,South Carolina,29,Missouri,155,Pemiscot County,42,0,42
45,South Carolina,29,Missouri,159,Pettis County,18,0,18
45,South Carolina,29,Missouri,161,Phelps County,157,0,157
45,South Carolina,29,Missouri,163,Pike County,7,7,0
45,South Carolina,29,Missouri,165,Platte County,0,30,-30
45,South Carolina,29,Missouri,169,Pulaski County,247,266,-19
45,South Carolina,29,Missouri,171,Putnam County,15,0,15
45,South Carolina,29,Missouri,183,St. Charles County,32,2,30
45,South Carolina,29,Missouri,189,St. Louis County,290,206,84
45,South Carolina,29,Missouri,195,Saline County,9,17,-8
45,South Carolina,29,Missouri,197,Schuyler County,0,3,-3
45,South Carolina,29,Missouri,201,Scott County,0,8,-8
45,South Carolina,29,Missouri,207,Stoddard County,0,30,-30
45,South Carolina,29,Missouri,209,Stone County,8,0,8
45,South Carolina,29,Missouri,213,Taney County,32,63,-31
45,South Carolina,29,Missouri,221,Washington County,21,0,21
45,South Carolina,29,Missouri,510,St. Louis city,220,155,65
45,South Carolina,30,Montana,11,Carter County,0,1,-1
45,South Carolina,30,Montana,13,Cascade County,0,56,-56
45,South Carolina,30,Montana,31,Gallatin County,16,9,7
45,South Carolina,30,Montana,37,Golden Valley County,0,14,-14
45,South Carolina,30,Montana,43,Jefferson County,18,0,18
45,South Carolina,30,Montana,49,Lewis and Clark County,68,9,59
45,South Carolina,30,Montana,53,Lincoln County,5,0,5
45,South Carolina,30,Montana,63,Missoula County,12,7,5
45,South Carolina,30,Montana,65,Musselshell County,92,0,92
45,South Carolina,30,Montana,85,Roosevelt County,7,0,7
45,South Carolina,30,Montana,87,Rosebud County,0,2,-2
45,South Carolina,30,Montana,89,Sanders County,11,0,11
45,South Carolina,30,Montana,93,Silver Bow County,11,0,11
45,South Carolina,30,Montana,111,Yellowstone County,4,10,-6
45,South Carolina,31,Nebraska,27,Cedar County,0,6,-6
45,South Carolina,31,Nebraska,31,Cherry County,0,5,-5
45,South Carolina,31,Nebraska,33,Cheyenne County,0,11,-11
45,South Carolina,31,Nebraska,43,Dakota County,8,0,8
45,South Carolina,31,Nebraska,53,Dodge County,0,10,-10
45,South Carolina,31,Nebraska,55,Douglas County,68,53,15
45,South Carolina,31,Nebraska,67,Gage County,8,0,8
45,South Carolina,31,Nebraska,109,Lancaster County,42,91,-49
45,South Carolina,31,Nebraska,111,Lincoln County,62,0,62
45,South Carolina,31,Nebraska,127,Nemaha County,0,23,-23
45,South Carolina,31,Nebraska,143,Polk County,19,0,19
45,South Carolina,31,Nebraska,145,Red Willow County,0,3,-3
45,South Carolina,31,Nebraska,153,Sarpy County,75,181,-106
45,South Carolina,31,Nebraska,157,Scotts Bluff County,0,6,-6
45,South Carolina,31,Nebraska,177,Washington County,17,0,17
45,South Carolina,32,Nevada,1,Churchill County,10,12,-2
45,South Carolina,32,Nevada,3,Clark County,431,734,-303
45,South Carolina,32,Nevada,23,Nye County,19,0,19
45,South Carolina,32,Nevada,31,Washoe County,173,222,-49
45,South Carolina,32,Nevada,510,Carson City,0,9,-9
45,South Carolina,33,New Hampshire,1,Belknap County,38,12,26
45,South Carolina,33,New Hampshire,3,Carroll County,0,15,-15
45,South Carolina,33,New Hampshire,5,Cheshire County,68,0,68
45,South Carolina,33,New Hampshire,7,Coos County,33,0,33
45,South Carolina,33,New Hampshire,9,Grafton County,15,0,15
45,South Carolina,33,New Hampshire,11,Hillsborough County,171,16,155
45,South Carolina,33,New Hampshire,13,Merrimack County,207,65,142
45,South Carolina,33,New Hampshire,15,Rockingham County,224,12,212
45,South Carolina,33,New Hampshire,17,Strafford County,168,24,144
45,South Carolina,33,New Hampshire,19,Sullivan County,8,0,8
45,South Carolina,34,New Jersey,1,Atlantic County,317,70,247
45,South Carolina,34,New Jersey,3,Bergen County,477,143,334
45,South Carolina,34,New Jersey,5,Burlington County,253,141,112
45,South Carolina,34,New Jersey,7,Camden County,226,348,-122
45,South Carolina,34,New Jersey,9,Cape May County,60,66,-6
45,South Carolina,34,New Jersey,11,Cumberland County,22,8,14
45,South Carolina,34,New Jersey,13,Essex County,390,61,329
45,South Carolina,34,New Jersey,15,Gloucester County,93,14,79
45,South Carolina,34,New Jersey,17,Hudson County,238,45,193
45,South Carolina,34,New Jersey,19,Hunterdon County,201,33,168
45,South Carolina,34,New Jersey,21,Mercer County,138,47,91
45,South Carolina,34,New Jersey,23,Middlesex County,239,0,239
45,South Carolina,34,New Jersey,25,Monmouth County,621,156,465
45,South Carolina,34,New Jersey,27,Morris County,405,11,394
45,South Carolina,34,New Jersey,29,Ocean County,265,207,58
45,South Carolina,34,New Jersey,31,Passaic County,669,110,559
45,South Carolina,34,New Jersey,33,Salem County,79,10,69
45,South Carolina,34,New Jersey,35,Somerset County,369,28,341
45,South Carolina,34,New Jersey,37,Sussex County,133,28,105
45,South Carolina,34,New Jersey,39,Union County,149,24,125
45,South Carolina,34,New Jersey,41,Warren County,13,8,5
45,South Carolina,35,New Mexico,1,Bernalillo County,180,67,113
45,South Carolina,35,New Mexico,5,Chaves County,11,0,11
45,South Carolina,35,New Mexico,6,Cibola County,14,0,14
45,South Carolina,35,New Mexico,7,Colfax County,192,0,192
45,South Carolina,35,New Mexico,9,Curry County,17,79,-62
45,South Carolina,35,New Mexico,13,Doña Ana County,54,122,-68
45,South Carolina,35,New Mexico,17,Grant County,0,35,-35
45,South Carolina,35,New Mexico,25,Lea County,4,0,4
45,South Carolina,35,New Mexico,28,Los Alamos County,0,124,-124
45,South Carolina,35,New Mexico,35,Otero County,0,153,-153
45,South Carolina,35,New Mexico,43,Sandoval County,4,101,-97
45,South Carolina,35,New Mexico,49,Santa Fe County,44,109,-65
45,South Carolina,36,New York,1,Albany County,231,150,81
45,South Carolina,36,New York,3,Allegany County,6,8,-2
45,South Carolina,36,New York,5,Bronx County,371,215,156
45,South Carolina,36,New York,7,Broome County,71,75,-4
45,South Carolina,36,New York,9,Cattaraugus County,73,3,70
45,South Carolina,36,New York,11,Cayuga County,0,9,-9
45,South Carolina,36,New York,13,Chautauqua County,60,21,39
45,South Carolina,36,New York,15,Chemung County,58,52,6
45,South Carolina,36,New York,17,Chenango County,0,26,-26
45,South Carolina,36,New York,19,Clinton County,103,5,98
45,South Carolina,36,New York,21,Columbia County,259,64,195
45,South Carolina,36,New York,23,Cortland County,4,2,2
45,South Carolina,36,New York,25,Delaware County,68,0,68
45,South Carolina,36,New York,27,Dutchess County,29,45,-16
45,South Carolina,36,New York,29,Erie County,225,52,173
45,South Carolina,36,New York,31,Essex County,22,0,22
45,South Carolina,36,New York,33,Franklin County,0,3,-3
45,South Carolina,36,New York,37,Genesee County,53,0,53
45,South Carolina,36,New York,39,Greene County,173,0,173
45,South Carolina,36,New York,41,Hamilton County,0,44,-44
45,South Carolina,36,New York,43,Herkimer County,85,17,68
45,South Carolina,36,New York,45,Jefferson County,414,179,235
45,South Carolina,36,New York,47,Kings County,1029,256,773
45,South Carolina,36,New York,49,Lewis County,89,18,71
45,South Carolina,36,New York,51,Livingston County,0,19,-19
45,South Carolina,36,New York,53,Madison County,0,25,-25
45,South Carolina,36,New York,55,Monroe County,667,360,307
45,South Carolina,36,New York,57,Montgomery County,9,0,9
45,South Carolina,36,New York,59,Nassau County,579,114,465
45,South Carolina,36,New York,61,New York County,845,432,413
45,South Carolina,36,New York,63,Niagara County,139,26,113
45,South Carolina,36,New York,65,Oneida County,189,114,75
45,South Carolina,36,New York,67,Onondaga County,219,133,86
45,South Carolina,36,New York,69,Ontario County,160,13,147
45,South Carolina,36,New York,71,Orange County,286,189,97
45,South Carolina,36,New York,75,Oswego County,38,21,17
45,South Carolina,36,New York,77,Otsego County,26,49,-23
45,South Carolina,36,New York,79,Putnam County,85,0,85
45,South Carolina,36,New York,81,Queens County,339,379,-40
45,South Carolina,36,New York,83,Rensselaer County,68,394,-326
45,South Carolina,36,New York,85,Richmond County,128,80,48
45,South Carolina,36,New York,87,Rockland County,61,36,25
45,South Carolina,36,New York,89,St. Lawrence County,7,70,-63
45,South Carolina,36,New York,91,Saratoga County,151,1029,-878
45,South Carolina,36,New York,93,Schenectady County,63,18,45
45,South Carolina,36,New York,95,Schoharie County,67,18,49
45,South Carolina,36,New York,99,Seneca County,0,22,-22
45,South Carolina,36,New York,101,Steuben County,53,0,53
45,South Carolina,36,New York,103,Suffolk County,1237,165,1072
45,South Carolina,36,New York,105,Sullivan County,6,97,-91
45,South Carolina,36,New York,107,Tioga County,45,0,45
45,South Carolina,36,New York,109,Tompkins County,398,91,307
45,South Carolina,36,New York,111,Ulster County,19,0,19
45,South Carolina,36,New York,113,Warren County,73,0,73
45,South Carolina,36,New York,115,Washington County,15,15,0
45,South Carolina,36,New York,117,Wayne County,24,44,-20
45,South Carolina,36,New York,119,Westchester County,498,221,277
45,South Carolina,36,New York,121,Wyoming County,34,0,34
45,South Carolina,36,New York,123,Yates County,0,17,-17
45,South Carolina,37,North Carolina,1,Alamance County,400,119,281
45,South Carolina,37,North Carolina,3,Alexander County,14,0,14
45,South Carolina,37,North Carolina,7,Anson County,189,121,68
45,South Carolina,37,North Carolina,9,Ashe County,0,10,-10
45,South Carolina,37,North Carolina,11,Avery County,140,23,117
45,South Carolina,37,North Carolina,13,Beaufort County,12,79,-67
45,South Carolina,37,North Carolina,17,Bladen County,40,30,10
45,South Carolina,37,North Carolina,19,Brunswick County,437,467,-30
45,South Carolina,37,North Carolina,21,Buncombe County,916,492,424
45,South Carolina,37,North Carolina,23,Burke County,120,151,-31
45,South Carolina,37,North Carolina,25,Cabarrus County,654,452,202
45,South Carolina,37,North Carolina,27,Caldwell County,107,27,80
45,South Carolina,37,North Carolina,29,Camden County,22,0,22
45,South Carolina,37,North Carolina,31,Carteret County,129,80,49
45,South Carolina,37,North Carolina,33,Caswell County,21,39,-18
45,South Carolina,37,North Carolina,35,Catawba County,513,306,207
45,South Carolina,37,North Carolina,37,Chatham County,208,14,194
45,South Carolina,37,North Carolina,39,Cherokee County,37,41,-4
45,South Carolina,37,North Carolina,41,Chowan County,22,5,17
45,South Carolina,37,North Carolina,43,Clay County,25,47,-22
45,South Carolina,37,North Carolina,45,Cleveland County,379,522,-143
45,South Carolina,37,North Carolina,47,Columbus County,227,636,-409
45,South Carolina,37,North Carolina,49,Craven County,565,304,261
45,South Carolina,37,North Carolina,51,Cumberland County,1386,902,484
45,South Carolina,37,North Carolina,53,Currituck County,0,24,-24
45,South Carolina,37,North Carolina,55,Dare County,39,19,20
45,South Carolina,37,North Carolina,57,Davidson County,345,260,85
45,South Carolina,37,North Carolina,59,Davie County,38,48,-10
45,South Carolina,37,North Carolina,61,Duplin County,20,81,-61
45,South Carolina,37,North Carolina,63,Durham County,335,438,-103
45,South Carolina,37,North Carolina,65,Edgecombe County,0,70,-70
45,South Carolina,37,North Carolina,67,Forsyth County,590,757,-167
45,South Carolina,37,North Carolina,69,Franklin County,41,47,-6
45,South Carolina,37,North Carolina,71,Gaston County,939,993,-54
45,South Carolina,37,North Carolina,75,Graham County,0,6,-6
45,South Carolina,37,North Carolina,77,Granville County,112,58,54
45,South Carolina,37,North Carolina,79,Greene County,6,36,-30
45,South Carolina,37,North Carolina,81,Guilford County,800,586,214
45,South Carolina,37,North Carolina,83,Halifax County,0,13,-13
45,South Carolina,37,North Carolina,85,Harnett County,327,162,165
45,South Carolina,37,North Carolina,87,Haywood County,204,619,-415
45,South Carolina,37,North Carolina,89,Henderson County,457,423,34
45,South Carolina,37,North Carolina,91,Hertford County,11,48,-37
45,South Carolina,37,North Carolina,93,Hoke County,123,225,-102
45,South Carolina,37,North Carolina,97,Iredell County,838,289,549
45,South Carolina,37,North Carolina,99,Jackson County,70,266,-196
45,South Carolina,37,North Carolina,101,Johnston County,206,639,-433
45,South Carolina,37,North Carolina,105,Lee County,33,65,-32
45,South Carolina,37,North Carolina,107,Lenoir County,77,8,69
45,South Carolina,37,North Carolina,109,Lincoln County,144,176,-32
45,South Carolina,37,North Carolina,111,McDowell County,155,137,18
45,South Carolina,37,North Carolina,113,Macon County,119,106,13
45,South Carolina,37,North Carolina,115,Madison County,14,4,10
45,South Carolina,37,North Carolina,117,Martin County,0,17,-17
45,South Carolina,37,North Carolina,119,Mecklenburg County,7733,6963,770
45,South Carolina,37,North Carolina,123,Montgomery County,120,0,120
45,South Carolina,37,North Carolina,125,Moore County,104,287,-183
45,South Carolina,37,North Carolina,127,Nash County,36,54,-18
45,South Carolina,37,North Carolina,129,New Hanover County,626,536,90
45,South Carolina,37,North Carolina,131,Northampton County,0,23,-23
45,South Carolina,37,North Carolina,133,Onslow County,1882,1643,239
45,South Carolina,37,North Carolina,135,Orange County,176,144,32
45,South Carolina,37,North Carolina,137,Pamlico County,0,32,-32
45,South Carolina,37,North Carolina,139,Pasquotank County,51,21,30
45,South Carolina,37,North Carolina,141,Pender County,53,40,13
45,South Carolina,37,North Carolina,143,Perquimans County,0,79,-79
45,South Carolina,37,North Carolina,145,Person County,0,114,-114
45,South Carolina,37,North Carolina,147,Pitt County,92,117,-25
45,South Carolina,37,North Carolina,149,Polk County,283,124,159
45,South Carolina,37,North Carolina,151,Randolph County,120,68,52
45,South Carolina,37,North Carolina,153,Richmond County,113,78,35
45,South Carolina,37,North Carolina,155,Robeson County,254,184,70
45,South Carolina,37,North Carolina,157,Rockingham County,18,65,-47
45,South Carolina,37,North Carolina,159,Rowan County,120,437,-317
45,South Carolina,37,North Carolina,161,Rutherford County,99,318,-219
45,South Carolina,37,North Carolina,163,Sampson County,38,35,3
45,South Carolina,37,North Carolina,165,Scotland County,232,179,53
45,South Carolina,37,North Carolina,167,Stanly County,272,107,165
45,South Carolina,37,North Carolina,169,Stokes County,0,4,-4
45,South Carolina,37,North Carolina,171,Surry County,63,17,46
45,South Carolina,37,North Carolina,173,Swain County,10,27,-17
45,South Carolina,37,North Carolina,175,Transylvania County,98,146,-48
45,South Carolina,37,North Carolina,179,Union County,1197,1360,-163
45,South Carolina,37,North Carolina,181,Vance County,141,27,114
45,South Carolina,37,North Carolina,183,Wake County,1943,1646,297
45,South Carolina,37,North Carolina,185,Warren County,97,0,97
45,South Carolina,37,North Carolina,189,Watauga County,36,105,-69
45,South Carolina,37,North Carolina,191,Wayne County,337,251,86
45,South Carolina,37,North Carolina,193,Wilkes County,117,61,56
45,South Carolina,37,North Carolina,195,Wilson County,17,16,1
45,South Carolina,37,North Carolina,197,Yadkin County,128,50,78
45,South Carolina,37,North Carolina,199,Yancey County,0,24,-24
45,South Carolina,38,North Dakota,9,Bottineau County,0,33,-33
45,South Carolina,38,North Dakota,15,Burleigh County,8,0,8
45,South Carolina,38,North Dakota,17,Cass County,42,146,-104
45,South Carolina,38,North Dakota,21,Dickey County,0,33,-33
45,South Carolina,38,North Dakota,35,Grand Forks County,25,27,-2
45,South Carolina,38,North Dakota,57,Mercer County,0,4,-4
45,South Carolina,38,North Dakota,69,Pierce County,0,8,-8
45,South Carolina,38,North Dakota,77,Richland County,20,0,20
45,South Carolina,38,North Dakota,83,Sheridan County,0,2,-2
45,South Carolina,38,North Dakota,99,Walsh County,0,11,-11
45,South Carolina,38,North Dakota,101,Ward County,62,0,62
45,South Carolina,39,Ohio,1,Adams County,0,17,-17
45,South Carolina,39,Ohio,5,Ashland County,60,0,60
45,South Carolina,39,Ohio,7,Ashtabula County,31,31,0
45,South Carolina,39,Ohio,9,Athens County,0,8,-8
45,South Carolina,39,Ohio,11,Auglaize County,0,20,-20
45,South Carolina,39,Ohio,17,Butler County,224,70,154
45,South Carolina,39,Ohio,21,Champaign County,0,45,-45
45,South Carolina,39,Ohio,23,Clark County,0,61,-61
45,South Carolina,39,Ohio,25,Clermont County,77,72,5
45,South Carolina,39,Ohio,27,Clinton County,22,22,0
45,South Carolina,39,Ohio,29,Columbiana County,157,58,99
45,South Carolina,39,Ohio,33,Crawford County,26,8,18
45,South Carolina,39,Ohio,35,Cuyahoga County,509,200,309
45,South Carolina,39,Ohio,37,Darke County,35,0,35
45,South Carolina,39,Ohio,39,Defiance County,66,0,66
45,South Carolina,39,Ohio,41,Delaware County,41,12,29
45,South Carolina,39,Ohio,43,Erie County,163,0,163
45,South Carolina,39,Ohio,45,Fairfield County,143,67,76
45,South Carolina,39,Ohio,47,Fayette County,0,1,-1
45,South Carolina,39,Ohio,49,Franklin County,974,229,745
45,South Carolina,39,Ohio,53,Gallia County,31,8,23
45,South Carolina,39,Ohio,55,Geauga County,29,8,21
45,South Carolina,39,Ohio,57,Greene County,236,74,162
45,South Carolina,39,Ohio,59,Guernsey County,14,0,14
45,South Carolina,39,Ohio,61,Hamilton County,406,264,142
45,South Carolina,39,Ohio,63,Hancock County,66,33,33
45,South Carolina,39,Ohio,69,Henry County,12,28,-16
45,South Carolina,39,Ohio,71,Highland County,14,0,14
45,South Carolina,39,Ohio,75,Holmes County,10,0,10
45,South Carolina,39,Ohio,77,Huron County,6,0,6
45,South Carolina,39,Ohio,81,Jefferson County,27,31,-4
45,South Carolina,39,Ohio,83,Knox County,31,4,27
45,South Carolina,39,Ohio,85,Lake County,79,22,57
45,South Carolina,39,Ohio,87,Lawrence County,36,39,-3
45,South Carolina,39,Ohio,89,Licking County,80,17,63
45,South Carolina,39,Ohio,91,Logan County,38,0,38
45,South Carolina,39,Ohio,93,Lorain County,296,30,266
45,South Carolina,39,Ohio,95,Lucas County,221,37,184
45,South Carolina,39,Ohio,97,Madison County,8,17,-9
45,South Carolina,39,Ohio,99,Mahoning County,133,84,49
45,South Carolina,39,Ohio,103,Medina County,148,21,127
45,South Carolina,39,Ohio,107,Mercer County,23,0,23
45,South Carolina,39,Ohio,109,Miami County,58,0,58
45,South Carolina,39,Ohio,111,Monroe County,0,3,-3
45,South Carolina,39,Ohio,113,Montgomery County,240,228,12
45,South Carolina,39,Ohio,117,Morrow County,34,0,34
45,South Carolina,39,Ohio,123,Ottawa County,0,47,-47
45,South Carolina,39,Ohio,129,Pickaway County,0,5,-5
45,South Carolina,39,Ohio,133,Portage County,119,0,119
45,South Carolina,39,Ohio,135,Preble County,0,5,-5
45,South Carolina,39,Ohio,137,Putnam County,8,0,8
45,South Carolina,39,Ohio,139,Richland County,16,29,-13
45,South Carolina,39,Ohio,141,Ross County,6,8,-2
45,South Carolina,39,Ohio,145,Scioto County,9,0,9
45,South Carolina,39,Ohio,149,Shelby County,0,16,-16
45,South Carolina,39,Ohio,151,Stark County,595,162,433
45,South Carolina,39,Ohio,153,Summit County,413,41,372
45,South Carolina,39,Ohio,155,Trumbull County,136,45,91
45,South Carolina,39,Ohio,157,Tuscarawas County,31,116,-85
45,South Carolina,39,Ohio,165,Warren County,131,61,70
45,South Carolina,39,Ohio,167,Washington County,24,0,24
45,South Carolina,39,Ohio,169,Wayne County,58,68,-10
45,South Carolina,39,Ohio,171,Williams County,0,9,-9
45,South Carolina,39,Ohio,173,Wood County,40,23,17
45,South Carolina,39,Ohio,175,Wyandot County,0,24,-24
45,South Carolina,4,Arizona,3,Cochise County,43,191,-148
45,South Carolina,4,Arizona,5,Coconino County,0,32,-32
45,South Carolina,4,Arizona,9,Graham County,32,0,32
45,South Carolina,4,Arizona,13,Maricopa County,1043,543,500
45,South Carolina,4,Arizona,15,Mohave County,6,0,6
45,South Carolina,4,Arizona,17,Navajo County,42,0,42
45,South Carolina,4,Arizona,19,Pima County,489,24,465
45,South Carolina,4,Arizona,21,Pinal County,117,179,-62
45,South Carolina,4,Arizona,25,Yavapai County,35,97,-62
45,South Carolina,4,Arizona,27,Yuma County,80,197,-117
45,South Carolina,40,Oklahoma,3,Alfalfa County,17,0,17
45,South Carolina,40,Oklahoma,17,Canadian County,0,131,-131
45,South Carolina,40,Oklahoma,19,Carter County,10,0,10
45,South Carolina,40,Oklahoma,21,Cherokee County,5,0,5
45,South Carolina,40,Oklahoma,27,Cleveland County,174,13,161
45,South Carolina,40,Oklahoma,31,Comanche County,399,299,100
45,South Carolina,40,Oklahoma,37,Creek County,0,11,-11
45,South Carolina,40,Oklahoma,41,Delaware County,0,4,-4
45,South Carolina,40,Oklahoma,47,Garfield County,0,19,-19
45,South Carolina,40,Oklahoma,53,Grant County,14,0,14
45,South Carolina,40,Oklahoma,65,Jackson County,28,38,-10
45,South Carolina,40,Oklahoma,71,Kay County,10,36,-26
45,South Carolina,40,Oklahoma,75,Kiowa County,33,52,-19
45,South Carolina,40,Oklahoma,79,Le Flore County,0,9,-9
45,South Carolina,40,Oklahoma,87,McClain County,0,42,-42
45,South Carolina,40,Oklahoma,97,Mayes County,0,53,-53
45,South Carolina,40,Oklahoma,101,Muskogee County,20,8,12
45,South Carolina,40,Oklahoma,109,Oklahoma County,124,43,81
45,South Carolina,40,Oklahoma,111,Okmulgee County,25,0,25
45,South Carolina,40,Oklahoma,113,Osage County,9,18,-9
45,South Carolina,40,Oklahoma,119,Payne County,71,0,71
45,South Carolina,40,Oklahoma,121,Pittsburg County,0,4,-4
45,South Carolina,40,Oklahoma,123,Pontotoc County,16,0,16
45,South Carolina,40,Oklahoma,125,Pottawatomie County,16,0,16
45,South Carolina,40,Oklahoma,131,Rogers County,0,10,-10
45,South Carolina,40,Oklahoma,139,Texas County,55,0,55
45,South Carolina,40,Oklahoma,143,Tulsa County,108,169,-61
45,South Carolina,40,Oklahoma,145,Wagoner County,0,17,-17
45,South Carolina,40,Oklahoma,147,Washington County,12,42,-30
45,South Carolina,41,Oregon,3,Benton County,92,0,92
45,South Carolina,41,Oregon,5,Clackamas County,57,0,57
45,South Carolina,41,Oregon,9,Columbia County,0,22,-22
45,South Carolina,41,Oregon,13,Crook County,12,0,12
45,South Carolina,41,Oregon,17,Deschutes County,42,0,42
45,South Carolina,41,Oregon,19,Douglas County,0,10,-10
45,South Carolina,41,Oregon,29,Jackson County,16,113,-97
45,South Carolina,41,Oregon,33,Josephine County,6,0,6
45,South Carolina,41,Oregon,35,Klamath County,29,25,4
45,South Carolina,41,Oregon,39,Lane County,14,31,-17
45,South Carolina,41,Oregon,43,Linn County,15,0,15
45,South Carolina,41,Oregon,47,Marion County,0,58,-58
45,South Carolina,41,Oregon,51,Multnomah County,138,107,31
45,South Carolina,41,Oregon,55,Sherman County,16,0,16
45,South Carolina,41,Oregon,59,Umatilla County,0,32,-32
45,South Carolina,41,Oregon,67,Washington County,101,233,-132
45,South Carolina,41,Oregon,71,Yamhill County,8,0,8
45,South Carolina,42,Pennsylvania,1,Adams County,44,36,8
45,South Carolina,42,Pennsylvania,3,Allegheny County,971,388,583
45,South Carolina,42,Pennsylvania,5,Armstrong County,59,0,59
45,South Carolina,42,Pennsylvania,7,Beaver County,284,28,256
45,South Carolina,42,Pennsylvania,9,Bedford County,45,0,45
45,South Carolina,42,Pennsylvania,11,Berks County,300,66,234
45,South Carolina,42,Pennsylvania,13,Blair County,71,26,45
45,South Carolina,42,Pennsylvania,15,Bradford County,45,19,26
45,South Carolina,42,Pennsylvania,17,Bucks County,505,282,223
45,South Carolina,42,Pennsylvania,19,Butler County,80,76,4
45,South Carolina,42,Pennsylvania,21,Cambria County,73,52,21
45,South Carolina,42,Pennsylvania,27,Centre County,159,29,130
45,South Carolina,42,Pennsylvania,29,Chester County,325,53,272
45,South Carolina,42,Pennsylvania,33,Clearfield County,22,10,12
45,South Carolina,42,Pennsylvania,37,Columbia County,5,8,-3
45,South Carolina,42,Pennsylvania,39,Crawford County,78,48,30
45,South Carolina,42,Pennsylvania,41,Cumberland County,197,103,94
45,South Carolina,42,Pennsylvania,43,Dauphin County,203,66,137
45,South Carolina,42,Pennsylvania,45,Delaware County,44,78,-34
45,South Carolina,42,Pennsylvania,49,Erie County,379,303,76
45,South Carolina,42,Pennsylvania,51,Fayette County,70,27,43
45,South Carolina,42,Pennsylvania,53,Forest County,43,0,43
45,South Carolina,42,Pennsylvania,55,Franklin County,36,18,18
45,South Carolina,42,Pennsylvania,59,Greene County,17,26,-9
45,South Carolina,42,Pennsylvania,63,Indiana County,37,28,9
45,South Carolina,42,Pennsylvania,65,Jefferson County,0,31,-31
45,South Carolina,42,Pennsylvania,69,Lackawanna County,228,128,100
45,South Carolina,42,Pennsylvania,71,Lancaster County,371,406,-35
45,South Carolina,42,Pennsylvania,73,Lawrence County,65,64,1
45,South Carolina,42,Pennsylvania,75,Lebanon County,13,6,7
45,South Carolina,42,Pennsylvania,77,Lehigh County,269,7,262
45,South Carolina,42,Pennsylvania,79,Luzerne County,336,21,315
45,South Carolina,42,Pennsylvania,81,Lycoming County,8,5,3
45,South Carolina,42,Pennsylvania,83,McKean County,55,0,55
45,South Carolina,42,Pennsylvania,85,Mercer County,0,1,-1
45,South Carolina,42,Pennsylvania,89,Monroe County,159,0,159
45,South Carolina,42,Pennsylvania,91,Montgomery County,567,138,429
45,South Carolina,42,Pennsylvania,93,Montour County,126,0,126
45,South Carolina,42,Pennsylvania,95,Northampton County,78,36,42
45,South Carolina,42,Pennsylvania,101,Philadelphia County,458,97,361
45,South Carolina,42,Pennsylvania,103,Pike County,1,74,-73
45,South Carolina,42,Pennsylvania,107,Schuylkill County,24,33,-9
45,South Carolina,42,Pennsylvania,109,Snyder County,0,11,-11
45,South Carolina,42,Pennsylvania,111,Somerset County,23,14,9
45,South Carolina,42,Pennsylvania,115,Susquehanna County,16,10,6
45,South Carolina,42,Pennsylvania,117,Tioga County,146,37,109
45,South Carolina,42,Pennsylvania,119,Union County,13,28,-15
45,South Carolina,42,Pennsylvania,121,Venango County,36,3,33
45,South Carolina,42,Pennsylvania,123,Warren County,12,13,-1
45,South Carolina,42,Pennsylvania,125,Washington County,375,60,315
45,South Carolina,42,Pennsylvania,127,Wayne County,62,0,62
45,South Carolina,42,Pennsylvania,129,Westmoreland County,181,17,164
45,South Carolina,42,Pennsylvania,133,York County,231,155,76
45,South Carolina,44,Rhode Island,1,Bristol County,29,11,18
45,South Carolina,44,Rhode Island,3,Kent County,119,137,-18
45,South Carolina,44,Rhode Island,5,Newport County,56,77,-21
45,South Carolina,44,Rhode Island,7,Providence County,361,153,208
45,South Carolina,44,Rhode Island,9,Washington County,152,88,64
45,South Carolina,45,South Carolina,1,Abbeville County,1473,1226,247
45,South Carolina,45,South Carolina,3,Aiken County,3519,2603,916
45,South Carolina,45,South Carolina,5,Allendale County,476,600,-124
45,South Carolina,45,South Carolina,7,Anderson County,6566,6091,475
45,South Carolina,45,South Carolina,9,Bamberg County,507,527,-20
45,South Carolina,45,South Carolina,11,Barnwell County,972,667,305
45,South Carolina,45,South Carolina,13,Beaufort County,3035,2824,211
45,South Carolina,45,South Carolina,15,Berkeley County,8999,9087,-88
45,South Carolina,45,South Carolina,17,Calhoun County,358,383,-25
45,South Carolina,45,South Carolina,19,Charleston County,12124,11408,716
45,South Carolina,45,South Carolina,21,Cherokee County,1440,1403,37
45,South Carolina,45,South Carolina,23,Chester County,1044,674,370
45,South Carolina,45,South Carolina,25,Chesterfield County,1556,1275,281
45,South Carolina,45,South Carolina,27,Clarendon County,1357,1120,237
45,South Carolina,45,South Carolina,29,Colleton County,950,947,3
45,South Carolina,45,South Carolina,31,Darlington County,2076,2871,-795
45,South Carolina,45,South Carolina,33,Dillon County,675,579,96
45,South Carolina,45,South Carolina,35,Dorchester County,7167,8252,-1085
45,South Carolina,45,South Carolina,37,Edgefield County,1266,1510,-244
45,South Carolina,45,South Carolina,39,Fairfield County,720,253,467
45,South Carolina,45,South Carolina,41,Florence County,5089,3628,1461
45,South Carolina,45,South Carolina,43,Georgetown County,2296,1969,327
45,South Carolina,45,South Carolina,45,Greenville County,15124,11438,3686
45,South Carolina,45,South Carolina,47,Greenwood County,2542,2595,-53
45,South Carolina,45,South Carolina,49,Hampton County,540,174,366
45,South Carolina,45,South Carolina,51,Horry County,5520,4517,1003
45,South Carolina,45,South Carolina,53,Jasper County,816,1289,-473
45,South Carolina,45,South Carolina,55,Kershaw County,2607,985,1622
45,South Carolina,45,South Carolina,57,Lancaster County,2220,1525,695
45,South Carolina,45,South Carolina,59,Laurens County,2573,3404,-831
45,South Carolina,45,South Carolina,61,Lee County,1023,689,334
45,South Carolina,45,South Carolina,63,Lexington County,9614,10906,-1292
45,South Carolina,45,South Carolina,65,McCormick County,391,648,-257
45,South Carolina,45,South Carolina,67,Marion County,1161,409,752
45,South Carolina,45,South Carolina,69,Marlboro County,551,777,-226
45,South Carolina,45,South Carolina,71,Newberry County,1121,988,133
45,South Carolina,45,South Carolina,73,Oconee County,2056,2834,-778
45,South Carolina,45,South Carolina,75,Orangeburg County,4426,2126,2300
45,South Carolina,45,South Carolina,77,Pickens County,6375,8116,-1741
45,South Carolina,45,South Carolina,79,Richland County,13337,20412,-7075
45,South Carolina,45,South Carolina,81,Saluda County,831,381,450
45,South Carolina,45,South Carolina,83,Spartanburg County,7820,8741,-921
45,South Carolina,45,South Carolina,85,Sumter County,2735,2401,334
45,South Carolina,45,South Carolina,87,Union County,999,892,107
45,South Carolina,45,South Carolina,89,Williamsburg County,1225,785,440
45,South Carolina,45,South Carolina,91,York County,3731,6074,-2343
45,South Carolina,46,South Dakota,11,Brookings County,38,24,14
45,South Carolina,46,South Dakota,13,Brown County,15,0,15
45,South Carolina,46,South Dakota,47,Fall River County,9,0,9
45,South Carolina,46,South Dakota,63,Harding County,0,9,-9
45,South Carolina,46,South Dakota,71,Jackson County,0,15,-15
45,South Carolina,46,South Dakota,81,Lawrence County,16,8,8
45,South Carolina,46,South Dakota,87,McCook County,0,22,-22
45,South Carolina,46,South Dakota,89,McPherson County,0,3,-3
45,South Carolina,46,South Dakota,91,Marshall County,0,1,-1
45,South Carolina,46,South Dakota,93,Meade County,97,24,73
45,South Carolina,46,South Dakota,99,Minnehaha County,52,32,20
45,South Carolina,46,South Dakota,103,Pennington County,47,54,-7
45,South Carolina,46,South Dakota,135,Yankton County,0,11,-11
45,South Carolina,47,Tennessee,1,Anderson County,61,136,-75
45,South Carolina,47,Tennessee,3,Bedford County,0,20,-20
45,South Carolina,47,Tennessee,5,Benton County,7,0,7
45,South Carolina,47,Tennessee,9,Blount County,35,0,35
45,South Carolina,47,Tennessee,11,Bradley County,20,145,-125
45,South Carolina,47,Tennessee,13,Campbell County,0,20,-20
45,South Carolina,47,Tennessee,17,Carroll County,17,0,17
45,South Carolina,47,Tennessee,19,Carter County,0,24,-24
45,South Carolina,47,Tennessee,21,Cheatham County,8,23,-15
45,South Carolina,47,Tennessee,29,Cocke County,7,34,-27
45,South Carolina,47,Tennessee,35,Cumberland County,54,0,54
45,South Carolina,47,Tennessee,37,Davidson County,525,710,-185
45,South Carolina,47,Tennessee,39,Decatur County,14,5,9
45,South Carolina,47,Tennessee,43,Dickson County,21,0,21
45,South Carolina,47,Tennessee,45,Dyer County,231,0,231
45,South Carolina,47,Tennessee,51,Franklin County,17,19,-2
45,South Carolina,47,Tennessee,57,Grainger County,19,20,-1
45,South Carolina,47,Tennessee,59,Greene County,19,10,9
45,South Carolina,47,Tennessee,61,Grundy County,28,0,28
45,South Carolina,47,Tennessee,63,Hamblen County,44,0,44
45,South Carolina,47,Tennessee,65,Hamilton County,210,161,49
45,South Carolina,47,Tennessee,69,Hardeman County,12,0,12
45,South Carolina,47,Tennessee,73,Hawkins County,37,31,6
45,South Carolina,47,Tennessee,79,Henry County,37,5,32
45,South Carolina,47,Tennessee,83,Houston County,18,0,18
45,South Carolina,47,Tennessee,91,Johnson County,14,0,14
45,South Carolina,47,Tennessee,93,Knox County,456,487,-31
45,South Carolina,47,Tennessee,95,Lake County,6,0,6
45,South Carolina,47,Tennessee,97,Lauderdale County,50,0,50
45,South Carolina,47,Tennessee,103,Lincoln County,0,24,-24
45,South Carolina,47,Tennessee,105,Loudon County,100,0,100
45,South Carolina,47,Tennessee,107,McMinn County,0,3,-3
45,South Carolina,47,Tennessee,111,Macon County,0,59,-59
45,South Carolina,47,Tennessee,113,Madison County,14,18,-4
45,South Carolina,47,Tennessee,119,Maury County,33,7,26
45,South Carolina,47,Tennessee,125,Montgomery County,540,332,208
45,South Carolina,47,Tennessee,129,Morgan County,16,75,-59
45,South Carolina,47,Tennessee,131,Obion County,0,27,-27
45,South Carolina,47,Tennessee,139,Polk County,0,5,-5
45,South Carolina,47,Tennessee,141,Putnam County,42,17,25
45,South Carolina,47,Tennessee,143,Rhea County,23,0,23
45,South Carolina,47,Tennessee,145,Roane County,6,0,6
45,South Carolina,47,Tennessee,147,Robertson County,0,8,-8
45,South Carolina,47,Tennessee,149,Rutherford County,112,563,-451
45,South Carolina,47,Tennessee,153,Sequatchie County,15,0,15
45,South Carolina,47,Tennessee,155,Sevier County,59,491,-432
45,South Carolina,47,Tennessee,157,Shelby County,620,392,228
45,South Carolina,47,Tennessee,163,Sullivan County,179,249,-70
45,South Carolina,47,Tennessee,165,Sumner County,114,58,56
45,South Carolina,47,Tennessee,167,Tipton County,22,0,22
45,South Carolina,47,Tennessee,179,Washington County,122,112,10
45,South Carolina,47,Tennessee,183,Weakley County,0,24,-24
45,South Carolina,47,Tennessee,185,White County,81,0,81
45,South Carolina,47,Tennessee,187,Williamson County,54,71,-17
45,South Carolina,47,Tennessee,189,Wilson County,38,2,36
45,South Carolina,48,Texas,3,Andrews County,51,0,51
45,South Carolina,48,Texas,7,Aransas County,17,0,17
45,South Carolina,48,Texas,9,Archer County,0,18,-18
45,South Carolina,48,Texas,15,Austin County,7,0,7
45,South Carolina,48,Texas,21,Bastrop County,21,0,21
45,South Carolina,48,Texas,25,Bee County,0,7,-7
45,South Carolina,48,Texas,27,Bell County,237,909,-672
45,South Carolina,48,Texas,29,Bexar County,599,1139,-540
45,South Carolina,48,Texas,37,Bowie County,0,38,-38
45,South Carolina,48,Texas,39,Brazoria County,111,58,53
45,South Carolina,48,Texas,41,Brazos County,72,54,18
45,South Carolina,48,Texas,43,Brewster County,0,13,-13
45,South Carolina,48,Texas,47,Brooks County,0,7,-7
45,South Carolina,48,Texas,49,Brown County,25,0,25
45,South Carolina,48,Texas,55,Caldwell County,0,14,-14
45,South Carolina,48,Texas,57,Calhoun County,0,14,-14
45,South Carolina,48,Texas,61,Cameron County,51,3,48
45,South Carolina,48,Texas,73,Cherokee County,0,13,-13
45,South Carolina,48,Texas,83,Coleman County,0,1,-1
45,South Carolina,48,Texas,85,Collin County,151,182,-31
45,South Carolina,48,Texas,91,Comal County,9,28,-19
45,South Carolina,48,Texas,99,Coryell County,67,19,48
45,South Carolina,48,Texas,113,Dallas County,284,477,-193
45,South Carolina,48,Texas,121,Denton County,426,294,132
45,South Carolina,48,Texas,123,DeWitt County,33,0,33
45,South Carolina,48,Texas,133,Eastland County,0,2,-2
45,South Carolina,48,Texas,135,Ector County,367,2,365
45,South Carolina,48,Texas,139,Ellis County,26,20,6
45,South Carolina,48,Texas,141,El Paso County,1085,498,587
45,South Carolina,48,Texas,143,Erath County,7,33,-26
45,South Carolina,48,Texas,147,Fannin County,12,0,12
45,South Carolina,48,Texas,157,Fort Bend County,61,40,21
45,South Carolina,48,Texas,165,Gaines County,0,1,-1
45,South Carolina,48,Texas,167,Galveston County,130,0,130
45,South Carolina,48,Texas,171,Gillespie County,35,0,35
45,South Carolina,48,Texas,175,Goliad County,13,0,13
45,South Carolina,48,Texas,181,Grayson County,23,4,19
45,South Carolina,48,Texas,183,Gregg County,3,40,-37
45,South Carolina,48,Texas,187,Guadalupe County,67,163,-96
45,South Carolina,48,Texas,189,Hale County,0,30,-30
45,South Carolina,48,Texas,199,Hardin County,154,0,154
45,South Carolina,48,Texas,201,Harris County,1262,795,467
45,South Carolina,48,Texas,205,Hartley County,21,0,21
45,South Carolina,48,Texas,207,Haskell County,0,44,-44
45,South Carolina,48,Texas,209,Hays County,26,15,11
45,South Carolina,48,Texas,213,Henderson County,38,0,38
45,South Carolina,48,Texas,215,Hidalgo County,105,36,69
45,South Carolina,48,Texas,227,Howard County,0,9,-9
45,South Carolina,48,Texas,231,Hunt County,0,48,-48
45,South Carolina,48,Texas,241,Jasper County,22,6,16
45,South Carolina,48,Texas,243,Jeff Davis County,0,4,-4
45,South Carolina,48,Texas,245,Jefferson County,68,37,31
45,South Carolina,48,Texas,251,Johnson County,5,0,5
45,South Carolina,48,Texas,255,Karnes County,0,9,-9
45,South Carolina,48,Texas,257,Kaufman County,19,0,19
45,South Carolina,48,Texas,259,Kendall County,9,18,-9
45,South Carolina,48,Texas,265,Kerr County,19,0,19
45,South Carolina,48,Texas,273,Kleberg County,4,0,4
45,South Carolina,48,Texas,281,Lampasas County,13,0,13
45,South Carolina,48,Texas,291,Liberty County,36,114,-78
45,South Carolina,48,Texas,303,Lubbock County,6,37,-31
45,South Carolina,48,Texas,309,McLennan County,6,204,-198
45,South Carolina,48,Texas,321,Matagorda County,35,0,35
45,South Carolina,48,Texas,329,Midland County,78,18,60
45,South Carolina,48,Texas,331,Milam County,0,11,-11
45,South Carolina,48,Texas,339,Montgomery County,73,0,73
45,South Carolina,48,Texas,355,Nueces County,58,113,-55
45,South Carolina,48,Texas,357,Ochiltree County,17,0,17
45,South Carolina,48,Texas,363,Palo Pinto County,0,24,-24
45,South Carolina,48,Texas,367,Parker County,22,21,1
45,South Carolina,48,Texas,375,Potter County,10,14,-4
45,South Carolina,48,Texas,377,Presidio County,19,0,19
45,South Carolina,48,Texas,379,Rains County,17,0,17
45,South Carolina,48,Texas,395,Robertson County,0,11,-11
45,South Carolina,48,Texas,397,Rockwall County,25,0,25
45,South Carolina,48,Texas,401,Rusk County,10,0,10
45,South Carolina,48,Texas,407,San Jacinto County,17,0,17
45,South Carolina,48,Texas,409,San Patricio County,0,27,-27
45,South Carolina,48,Texas,417,Shackelford County,0,1,-1
45,South Carolina,48,Texas,423,Smith County,16,34,-18
45,South Carolina,48,Texas,439,Tarrant County,288,242,46
45,South Carolina,48,Texas,441,Taylor County,32,92,-60
45,South Carolina,48,Texas,449,Titus County,0,30,-30
45,South Carolina,48,Texas,451,Tom Green County,65,27,38
45,South Carolina,48,Texas,453,Travis County,154,156,-2
45,South Carolina,48,Texas,457,Tyler County,14,5,9
45,South Carolina,48,Texas,459,Upshur County,0,7,-7
45,South Carolina,48,Texas,463,Uvalde County,0,5,-5
45,South Carolina,48,Texas,467,Van Zandt County,48,0,48
45,South Carolina,48,Texas,469,Victoria County,20,68,-48
45,South Carolina,48,Texas,473,Waller County,0,13,-13
45,South Carolina,48,Texas,477,Washington County,0,4,-4
45,South Carolina,48,Texas,479,Webb County,19,0,19
45,South Carolina,48,Texas,485,Wichita County,125,184,-59
45,South Carolina,48,Texas,489,Willacy County,31,0,31
45,South Carolina,48,Texas,491,Williamson County,48,324,-276
45,South Carolina,48,Texas,493,Wilson County,5,0,5
45,South Carolina,48,Texas,507,Zavala County,9,0,9
45,South Carolina,49,Utah,1,Beaver County,12,0,12
45,South Carolina,49,Utah,3,Box Elder County,0,13,-13
45,South Carolina,49,Utah,5,Cache County,49,27,22
45,South Carolina,49,Utah,11,Davis County,24,131,-107
45,South Carolina,49,Utah,21,Iron County,14,0,14
45,South Carolina,49,Utah,35,Salt Lake County,305,342,-37
45,South Carolina,49,Utah,43,Summit County,0,11,-11
45,South Carolina,49,Utah,49,Utah County,85,367,-282
45,South Carolina,49,Utah,51,Wasatch County,26,0,26
45,South Carolina,49,Utah,53,Washington County,5,65,-60
45,South Carolina,49,Utah,57,Weber County,51,13,38
45,South Carolina,5,Arkansas,7,Benton County,44,59,-15
45,South Carolina,5,Arkansas,9,Boone County,47,1,46
45,South Carolina,5,Arkansas,31,Craighead County,102,0,102
45,South Carolina,5,Arkansas,33,Crawford County,27,4,23
45,South Carolina,5,Arkansas,35,Crittenden County,9,0,9
45,South Carolina,5,Arkansas,45,Faulkner County,257,41,216
45,South Carolina,5,Arkansas,51,Garland County,35,114,-79
45,South Carolina,5,Arkansas,57,Hempstead County,7,0,7
45,South Carolina,5,Arkansas,63,Independence County,22,0,22
45,South Carolina,5,Arkansas,69,Jefferson County,180,0,180
45,South Carolina,5,Arkansas,85,Lonoke County,64,0,64
45,South Carolina,5,Arkansas,93,Mississippi County,24,0,24
45,South Carolina,5,Arkansas,97,Montgomery County,0,6,-6
45,South Carolina,5,Arkansas,115,Pope County,8,0,8
45,South Carolina,5,Arkansas,119,Pulaski County,55,60,-5
45,South Carolina,5,Arkansas,123,St. Francis County,48,0,48
45,South Carolina,5,Arkansas,125,Saline County,24,0,24
45,South Carolina,5,Arkansas,127,Scott County,6,0,6
45,South Carolina,5,Arkansas,131,Sebastian County,30,78,-48
45,South Carolina,5,Arkansas,139,Union County,29,0,29
45,South Carolina,5,Arkansas,143,Washington County,6,20,-14
45,South Carolina,5,Arkansas,145,White County,28,13,15
45,South Carolina,5,Arkansas,149,Yell County,19,0,19
45,South Carolina,50,Vermont,1,Addison County,3,0,3
45,South Carolina,50,Vermont,3,Bennington County,16,0,16
45,South Carolina,50,Vermont,7,Chittenden County,34,15,19
45,South Carolina,50,Vermont,11,Franklin County,0,8,-8
45,South Carolina,50,Vermont,15,Lamoille County,20,0,20
45,South Carolina,50,Vermont,17,Orange County,0,3,-3
45,South Carolina,50,Vermont,19,Orleans County,0,6,-6
45,South Carolina,50,Vermont,21,Rutland County,0,21,-21
45,South Carolina,50,Vermont,23,Washington County,108,7,101
45,South Carolina,50,Vermont,25,Windham County,17,10,7
45,South Carolina,50,Vermont,27,Windsor County,11,13,-2
45,South Carolina,51,Virginia,1,Accomack County,49,4,45
45,South Carolina,51,Virginia,3,Albemarle County,163,75,88
45,South Carolina,51,Virginia,9,Amherst County,91,0,91
45,South Carolina,51,Virginia,13,Arlington County,172,251,-79
45,South Carolina,51,Virginia,15,Augusta County,143,0,143
45,South Carolina,51,Virginia,17,Bath County,0,92,-92
45,South Carolina,51,Virginia,19,Bedford County,8,44,-36
45,South Carolina,51,Virginia,23,Botetourt County,0,20,-20
45,South Carolina,51,Virginia,25,Brunswick County,0,8,-8
45,South Carolina,51,Virginia,27,Buchanan County,0,7,-7
45,South Carolina,51,Virginia,31,Campbell County,139,10,129
45,South Carolina,51,Virginia,33,Caroline County,120,61,59
45,South Carolina,51,Virginia,36,Charles City County,0,13,-13
45,South Carolina,51,Virginia,41,Chesterfield County,406,410,-4
45,South Carolina,51,Virginia,43,Clarke County,14,0,14
45,South Carolina,51,Virginia,47,Culpeper County,10,11,-1
45,South Carolina,51,Virginia,53,Dinwiddie County,3,0,3
45,South Carolina,51,Virginia,57,Essex County,17,0,17
45,South Carolina,51,Virginia,59,Fairfax County,724,793,-69
45,South Carolina,51,Virginia,61,Fauquier County,52,24,28
45,South Carolina,51,Virginia,65,Fluvanna County,16,0,16
45,South Carolina,51,Virginia,67,Franklin County,107,20,87
45,South Carolina,51,Virginia,69,Frederick County,61,7,54
45,South Carolina,51,Virginia,71,Giles County,5,0,5
45,South Carolina,51,Virginia,73,Gloucester County,58,49,9
45,South Carolina,51,Virginia,75,Goochland County,23,0,23
45,South Carolina,51,Virginia,77,Grayson County,0,29,-29
45,South Carolina,51,Virginia,83,Halifax County,26,9,17
45,South Carolina,51,Virginia,85,Hanover County,101,36,65
45,South Carolina,51,Virginia,87,Henrico County,217,181,36
45,South Carolina,51,Virginia,89,Henry County,0,25,-25
45,South Carolina,51,Virginia,93,Isle of Wight County,41,0,41
45,South Carolina,51,Virginia,95,James City County,8,126,-118
45,South Carolina,51,Virginia,97,King and Queen County,0,10,-10
45,South Carolina,51,Virginia,101,King William County,41,118,-77
45,South Carolina,51,Virginia,103,Lancaster County,0,3,-3
45,South Carolina,51,Virginia,105,Lee County,11,26,-15
45,South Carolina,51,Virginia,107,Loudoun County,248,87,161
45,South Carolina,51,Virginia,109,Louisa County,47,0,47
45,South Carolina,51,Virginia,111,Lunenburg County,0,6,-6
45,South Carolina,51,Virginia,113,Madison County,25,0,25
45,South Carolina,51,Virginia,115,Mathews County,45,0,45
45,South Carolina,51,Virginia,117,Mecklenburg County,13,3,10
45,South Carolina,51,Virginia,119,Middlesex County,0,7,-7
45,South Carolina,51,Virginia,121,Montgomery County,52,139,-87
45,South Carolina,51,Virginia,131,Northampton County,58,4,54
45,South Carolina,51,Virginia,135,Nottoway County,8,0,8
45,South Carolina,51,Virginia,139,Page County,103,0,103
45,South Carolina,51,Virginia,141,Patrick County,24,14,10
45,South Carolina,51,Virginia,143,Pittsylvania County,40,3,37
45,South Carolina,51,Virginia,145,Powhatan County,33,14,19
45,South Carolina,51,Virginia,147,Prince Edward County,0,14,-14
45,South Carolina,51,Virginia,149,Prince George County,31,85,-54
45,South Carolina,51,Virginia,153,Prince William County,670,226,444
45,South Carolina,51,Virginia,155,Pulaski County,9,64,-55
45,South Carolina,51,Virginia,161,Roanoke County,215,57,158
45,South Carolina,51,Virginia,163,Rockbridge County,10,0,10
45,South Carolina,51,Virginia,165,Rockingham County,57,62,-5
45,South Carolina,51,Virginia,169,Scott County,0,13,-13
45,South Carolina,51,Virginia,171,Shenandoah County,0,16,-16
45,South Carolina,51,Virginia,173,Smyth County,0,13,-13
45,South Carolina,51,Virginia,175,Southampton County,0,30,-30
45,South Carolina,51,Virginia,177,Spotsylvania County,128,26,102
45,South Carolina,51,Virginia,179,Stafford County,76,392,-316
45,South Carolina,51,Virginia,181,Surry County,52,0,52
45,South Carolina,51,Virginia,183,Sussex County,0,5,-5
45,South Carolina,51,Virginia,185,Tazewell County,36,0,36
45,South Carolina,51,Virginia,187,Warren County,45,6,39
45,South Carolina,51,Virginia,191,Washington County,11,150,-139
45,South Carolina,51,Virginia,195,Wise County,99,12,87
45,South Carolina,51,Virginia,197,Wythe County,14,0,14
45,South Carolina,51,Virginia,199,York County,95,297,-202
45,South Carolina,51,Virginia,510,Alexandria city,81,234,-153
45,South Carolina,51,Virginia,520,Bristol city,56,0,56
45,South Carolina,51,Virginia,530,Buena Vista city,73,0,73
45,South Carolina,51,Virginia,540,Charlottesville city,26,27,-1
45,South Carolina,51,Virginia,550,Chesapeake city,87,232,-145
45,South Carolina,51,Virginia,570,Colonial Heights city,3,0,3
45,South Carolina,51,Virginia,590,Danville city,25,47,-22
45,South Carolina,51,Virginia,595,Emporia city,0,14,-14
45,South Carolina,51,Virginia,600,Fairfax city,179,0,179
45,South Carolina,51,Virginia,610,Falls Church city,0,21,-21
45,South Carolina,51,Virginia,630,Fredericksburg city,11,51,-40
45,South Carolina,51,Virginia,640,Galax city,61,0,61
45,South Carolina,51,Virginia,650,Hampton city,102,214,-112
45,South Carolina,51,Virginia,660,Harrisonburg city,27,77,-50
45,South Carolina,51,Virginia,670,Hopewell city,33,17,16
45,South Carolina,51,Virginia,678,Lexington city,7,28,-21
45,South Carolina,51,Virginia,680,Lynchburg city,191,150,41
45,South Carolina,51,Virginia,683,Manassas city,0,34,-34
45,South Carolina,51,Virginia,685,Manassas Park city,0,13,-13
45,South Carolina,51,Virginia,690,Martinsville city,0,127,-127
45,South Carolina,51,Virginia,700,Newport News city,72,191,-119
45,South Carolina,51,Virginia,710,Norfolk city,577,712,-135
45,South Carolina,51,Virginia,730,Petersburg city,44,11,33
45,South Carolina,51,Virginia,735,Poquoson city,2,0,2
45,South Carolina,51,Virginia,740,Portsmouth city,125,182,-57
45,South Carolina,51,Virginia,750,Radford city,0,90,-90
45,South Carolina,51,Virginia,760,Richmond city,68,276,-208
45,South Carolina,51,Virginia,770,Roanoke city,232,31,201
45,South Carolina,51,Virginia,775,Salem city,19,51,-32
45,South Carolina,51,Virginia,790,Staunton city,16,0,16
45,South Carolina,51,Virginia,800,Suffolk city,84,165,-81
45,South Carolina,51,Virginia,810,Virginia Beach city,745,410,335
45,South Carolina,51,Virginia,830,Williamsburg city,33,4,29
45,South Carolina,51,Virginia,840,Winchester city,27,0,27
45,South Carolina,53,Washington,5,Benton County,0,58,-58
45,South Carolina,53,Washington,7,Chelan County,13,0,13
45,South Carolina,53,Washington,9,Clallam County,57,13,44
45,South Carolina,53,Washington,11,Clark County,174,141,33
45,South Carolina,53,Washington,15,Cowlitz County,16,0,16
45,South Carolina,53,Washington,17,Douglas County,0,9,-9
45,South Carolina,53,Washington,19,Ferry County,0,48,-48
45,South Carolina,53,Washington,25,Grant County,6,0,6
45,South Carolina,53,Washington,27,Grays Harbor County,6,0,6
45,South Carolina,53,Washington,29,Island County,19,64,-45
45,South Carolina,53,Washington,31,Jefferson County,0,25,-25
45,South Carolina,53,Washington,33,King County,564,514,50
45,South Carolina,53,Washington,35,Kitsap County,177,838,-661
45,South Carolina,53,Washington,37,Kittitas County,9,0,9
45,South Carolina,53,Washington,51,Pend Oreille County,0,3,-3
45,South Carolina,53,Washington,53,Pierce County,516,429,87
45,South Carolina,53,Washington,55,San Juan County,18,0,18
45,South Carolina,53,Washington,57,Skagit County,8,0,8
45,South Carolina,53,Washington,61,Snohomish County,457,237,220
45,South Carolina,53,Washington,63,Spokane County,20,25,-5
45,South Carolina,53,Washington,67,Thurston County,103,73,30
45,South Carolina,53,Washington,71,Walla Walla County,29,0,29
45,South Carolina,53,Washington,73,Whatcom County,20,8,12
45,South Carolina,53,Washington,75,Whitman County,20,0,20
45,South Carolina,53,Washington,77,Yakima County,9,31,-22
45,South Carolina,54,West Virginia,1,Barbour County,0,6,-6
45,South Carolina,54,West Virginia,3,Berkeley County,228,24,204
45,South Carolina,54,West Virginia,5,Boone County,31,11,20
45,South Carolina,54,West Virginia,9,Brooke County,115,49,66
45,South Carolina,54,West Virginia,11,Cabell County,38,40,-2
45,South Carolina,54,West Virginia,13,Calhoun County,0,17,-17
45,South Carolina,54,West Virginia,19,Fayette County,126,5,121
45,South Carolina,54,West Virginia,25,Greenbrier County,8,181,-173
45,South Carolina,54,West Virginia,27,Hampshire County,19,0,19
45,South Carolina,54,West Virginia,33,Harrison County,0,6,-6
45,South Carolina,54,West Virginia,37,Jefferson County,0,68,-68
45,South Carolina,54,West Virginia,39,Kanawha County,97,29,68
45,South Carolina,54,West Virginia,45,Logan County,77,0,77
45,South Carolina,54,West Virginia,47,McDowell County,49,0,49
45,South Carolina,54,West Virginia,49,Marion County,46,54,-8
45,South Carolina,54,West Virginia,51,Marshall County,9,0,9
45,South Carolina,54,West Virginia,55,Mercer County,30,6,24
45,South Carolina,54,West Virginia,59,Mingo County,19,17,2
45,South Carolina,54,West Virginia,61,Monongalia County,128,146,-18
45,South Carolina,54,West Virginia,63,Monroe County,0,59,-59
45,South Carolina,54,West Virginia,65,Morgan County,32,0,32
45,South Carolina,54,West Virginia,67,Nicholas County,70,0,70
45,South Carolina,54,West Virginia,69,Ohio County,55,19,36
45,South Carolina,54,West Virginia,73,Pleasants County,32,0,32
45,South Carolina,54,West Virginia,75,Pocahontas County,99,0,99
45,South Carolina,54,West Virginia,77,Preston County,156,2,154
45,South Carolina,54,West Virginia,79,Putnam County,74,15,59
45,South Carolina,54,West Virginia,81,Raleigh County,15,126,-111
45,South Carolina,54,West Virginia,89,Summers County,34,23,11
45,South Carolina,54,West Virginia,91,Taylor County,0,13,-13
45,South Carolina,54,West Virginia,95,Tyler County,0,5,-5
45,South Carolina,54,West Virginia,97,Upshur County,59,47,12
45,South Carolina,54,West Virginia,99,Wayne County,0,3,-3
45,South Carolina,54,West Virginia,103,Wetzel County,0,11,-11
45,South Carolina,54,West Virginia,107,Wood County,244,0,244
45,South Carolina,55,Wisconsin,5,Barron County,6,4,2
45,South Carolina,55,Wisconsin,9,Brown County,88,8,80
45,South Carolina,55,Wisconsin,25,Dane County,237,114,123
45,South Carolina,55,Wisconsin,27,Dodge County,0,6,-6
45,South Carolina,55,Wisconsin,29,Door County,36,8,28
45,South Carolina,55,Wisconsin,33,Dunn County,1,7,-6
45,South Carolina,55,Wisconsin,35,Eau Claire County,44,0,44
45,South Carolina,55,Wisconsin,43,Grant County,10,8,2
45,South Carolina,55,Wisconsin,45,Green County,0,10,-10
45,South Carolina,55,Wisconsin,53,Jackson County,5,0,5
45,South Carolina,55,Wisconsin,55,Jefferson County,37,0,37
45,South Carolina,55,Wisconsin,57,Juneau County,0,14,-14
45,South Carolina,55,Wisconsin,59,Kenosha County,49,80,-31
45,South Carolina,55,Wisconsin,63,La Crosse County,37,33,4
45,South Carolina,55,Wisconsin,67,Langlade County,0,2,-2
45,South Carolina,55,Wisconsin,73,Marathon County,30,0,30
45,South Carolina,55,Wisconsin,75,Marinette County,0,6,-6
45,South Carolina,55,Wisconsin,79,Milwaukee County,295,224,71
45,South Carolina,55,Wisconsin,81,Monroe County,0,48,-48
45,South Carolina,55,Wisconsin,87,Outagamie County,65,16,49
45,South Carolina,55,Wisconsin,89,Ozaukee County,17,0,17
45,South Carolina,55,Wisconsin,93,Pierce County,10,0,10
45,South Carolina,55,Wisconsin,97,Portage County,9,30,-21
45,South Carolina,55,Wisconsin,101,Racine County,43,0,43
45,South Carolina,55,Wisconsin,103,Richland County,0,1,-1
45,South Carolina,55,Wisconsin,105,Rock County,0,16,-16
45,South Carolina,55,Wisconsin,109,St. Croix County,0,14,-14
45,South Carolina,55,Wisconsin,111,Sauk County,15,7,8
45,South Carolina,55,Wisconsin,117,Sheboygan County,11,3,8
45,South Carolina,55,Wisconsin,127,Walworth County,12,39,-27
45,South Carolina,55,Wisconsin,129,Washburn County,0,11,-11
45,South Carolina,55,Wisconsin,131,Washington County,47,0,47
45,South Carolina,55,Wisconsin,133,Waukesha County,18,12,6
45,South Carolina,55,Wisconsin,139,Winnebago County,5,21,-16
45,South Carolina,55,Wisconsin,141,Wood County,10,0,10
45,South Carolina,56,Wyoming,7,Carbon County,18,0,18
45,South Carolina,56,Wyoming,15,Goshen County,0,1,-1
45,South Carolina,56,Wyoming,17,Hot Springs County,0,26,-26
45,South Carolina,56,Wyoming,21,Laramie County,94,10,84
45,South Carolina,56,Wyoming,39,Teton County,0,24,-24
45,South Carolina,6,California,1,Alameda County,129,273,-144
45,South Carolina,6,California,5,Amador County,0,62,-62
45,South Carolina,6,California,7,Butte County,39,0,39
45,South Carolina,6,California,9,Calaveras County,160,0,160
45,South Carolina,6,California,13,Contra Costa County,167,56,111
45,South Carolina,6,California,17,El Dorado County,19,0,19
45,South Carolina,6,California,19,Fresno County,102,21,81
45,South Carolina,6,California,23,Humboldt County,8,9,-1
45,South Carolina,6,California,25,Imperial County,0,11,-11
45,South Carolina,6,California,27,Inyo County,5,0,5
45,South Carolina,6,California,29,Kern County,119,179,-60
45,South Carolina,6,California,31,Kings County,36,155,-119
45,South Carolina,6,California,33,Lake County,48,61,-13
45,South Carolina,6,California,35,Lassen County,35,1,34
45,South Carolina,6,California,37,Los Angeles County,1522,389,1133
45,South Carolina,6,California,39,Madera County,12,0,12
45,South Carolina,6,California,41,Marin County,19,55,-36
45,South Carolina,6,California,45,Mendocino County,86,0,86
45,South Carolina,6,California,47,Merced County,20,42,-22
45,South Carolina,6,California,53,Monterey County,106,194,-88
45,South Carolina,6,California,55,Napa County,23,0,23
45,South Carolina,6,California,59,Orange County,362,395,-33
45,South Carolina,6,California,61,Placer County,416,9,407
45,South Carolina,6,California,63,Plumas County,0,10,-10
45,South Carolina,6,California,65,Riverside County,242,239,3
45,South Carolina,6,California,67,Sacramento County,411,344,67
45,South Carolina,6,California,71,San Bernardino County,429,249,180
45,South Carolina,6,California,73,San Diego County,1085,1873,-788
45,South Carolina,6,California,75,San Francisco County,136,65,71
45,South Carolina,6,California,77,San Joaquin County,92,43,49
45,South Carolina,6,California,79,San Luis Obispo County,0,389,-389
45,South Carolina,6,California,81,San Mateo County,0,135,-135
45,South Carolina,6,California,83,Santa Barbara County,142,2,140
45,South Carolina,6,California,85,Santa Clara County,97,143,-46
45,South Carolina,6,California,87,Santa Cruz County,25,249,-224
45,South Carolina,6,California,89,Shasta County,184,0,184
45,South Carolina,6,California,93,Siskiyou County,7,7,0
45,South Carolina,6,California,95,Solano County,128,85,43
45,South Carolina,6,California,97,Sonoma County,21,34,-13
45,South Carolina,6,California,99,Stanislaus County,68,0,68
45,South Carolina,6,California,101,Sutter County,14,18,-4
45,South Carolina,6,California,103,Tehama County,15,0,15
45,South Carolina,6,California,107,Tulare County,16,273,-257
45,South Carolina,6,California,111,Ventura County,71,15,56
45,South Carolina,6,California,113,Yolo County,2,17,-15
45,South Carolina,6,California,115,Yuba County,0,85,-85
45,South Carolina,72,Puerto Rico,3,Aguada Municipio,8,0,8
45,South Carolina,72,Puerto Rico,5,Aguadilla Municipio,6,0,6
45,South Carolina,72,Puerto Rico,7,Aguas Buenas Municipio,6,0,6
45,South Carolina,72,Puerto Rico,11,Añasco Municipio,53,0,53
45,South Carolina,72,Puerto Rico,13,Arecibo Municipio,11,15,-4
45,South Carolina,72,Puerto Rico,21,Bayamón Municipio,170,37,133
45,South Carolina,72,Puerto Rico,25,Caguas Municipio,17,0,17
45,South Carolina,72,Puerto Rico,31,Carolina Municipio,0,35,-35
45,South Carolina,72,Puerto Rico,49,Culebra Municipio,14,0,14
45,South Carolina,72,Puerto Rico,53,Fajardo Municipio,37,0,37
45,South Carolina,72,Puerto Rico,59,Guayanilla Municipio,0,19,-19
45,South Carolina,72,Puerto Rico,61,Guaynabo Municipio,19,0,19
45,South Carolina,72,Puerto Rico,65,Hatillo Municipio,103,0,103
45,South Carolina,72,Puerto Rico,69,Humacao Municipio,56,0,56
45,South Carolina,72,Puerto Rico,71,Isabela Municipio,15,0,15
45,South Carolina,72,Puerto Rico,77,Juncos Municipio,13,0,13
45,South Carolina,72,Puerto Rico,101,Morovis Municipio,14,0,14
45,South Carolina,72,Puerto Rico,105,Naranjito Municipio,18,20,-2
45,South Carolina,72,Puerto Rico,111,Peñuelas Municipio,112,0,112
45,South Carolina,72,Puerto Rico,113,Ponce Municipio,59,0,59
45,South Carolina,72,Puerto Rico,127,San Juan Municipio,174,0,174
45,South Carolina,72,Puerto Rico,135,Toa Alta Municipio,23,0,23
45,South Carolina,72,Puerto Rico,137,Toa Baja Municipio,25,0,25
45,South Carolina,72,Puerto Rico,145,Vega Baja Municipio,11,0,11
45,South Carolina,8,Colorado,1,Adams County,272,119,153
45,South Carolina,8,Colorado,5,Arapahoe County,178,178,0
45,South Carolina,8,Colorado,13,Boulder County,29,57,-28
45,South Carolina,8,Colorado,14,Broomfield County,12,22,-10
45,South Carolina,8,Colorado,15,Chaffee County,73,0,73
45,South Carolina,8,Colorado,23,Costilla County,0,10,-10
45,South Carolina,8,Colorado,29,Delta County,10,2,8
45,South Carolina,8,Colorado,31,Denver County,70,308,-238
45,South Carolina,8,Colorado,35,Douglas County,298,96,202
45,South Carolina,8,Colorado,37,Eagle County,103,0,103
45,South Carolina,8,Colorado,39,Elbert County,0,3,-3
45,South Carolina,8,Colorado,41,El Paso County,952,558,394
45,South Carolina,8,Colorado,45,Garfield County,0,28,-28
45,South Carolina,8,Colorado,51,Gunnison County,14,0,14
45,South Carolina,8,Colorado,59,Jefferson County,135,89,46
45,South Carolina,8,Colorado,63,Kit Carson County,12,0,12
45,South Carolina,8,Colorado,67,La Plata County,9,0,9
45,South Carolina,8,Colorado,69,Larimer County,139,225,-86
45,South Carolina,8,Colorado,77,Mesa County,0,8,-8
45,South Carolina,8,Colorado,87,Morgan County,14,0,14
45,South Carolina,8,Colorado,97,Pitkin County,13,0,13
45,South Carolina,8,Colorado,101,Pueblo County,66,0,66
45,South Carolina,8,Colorado,113,San Miguel County,0,2,-2
45,South Carolina,8,Colorado,121,Washington County,18,0,18
45,South Carolina,8,Colorado,123,Weld County,11,92,-81
45,South Carolina,9,Connecticut,1,Fairfield County,803,118,685
45,South Carolina,9,Connecticut,3,Hartford County,914,92,822
45,South Carolina,9,Connecticut,5,Litchfield County,465,0,465
45,South Carolina,9,Connecticut,7,Middlesex County,42,15,27
45,South Carolina,9,Connecticut,9,New Haven County,581,251,330
45,South Carolina,9,Connecticut,11,New London County,437,277,160
45,South Carolina,9,Connecticut,13,Tolland County,52,195,-143
45,South Carolina,9,Connecticut,15,Windham County,263,44,219
45,South Carolina,AFR,Africa,,-,1833,0,0
45,South Carolina,ASI,Asia,,-,7175,0,0
45,South Carolina,CAM,Central America,,-,2770,0,0
45,South Carolina,CAR,Caribbean,,-,930,0,0
45,South Carolina,EUR,Europe,,-,3530,0,0
45,South Carolina,ISL,U.S. Island Areas,,-,325,0,0
45,South Carolina,NAM,Northern America,,-,975,0,0
45,South Carolina,OCE,Oceania and At Sea,,-,239,0,0
45,South Carolina,SAM,South America,,-,753,0,0
46,South Dakota,1,Alabama,1,Autauga County,0,38,-38
46,South Dakota,1,Alabama,3,Baldwin County,0,20,-20
46,South Dakota,1,Alabama,33,Colbert County,16,0,16
46,South Dakota,1,Alabama,49,DeKalb County,8,0,8
46,South Dakota,1,Alabama,95,Marshall County,0,13,-13
46,South Dakota,1,Alabama,105,Perry County,0,13,-13
46,South Dakota,1,Alabama,121,Talladega County,17,0,17
46,South Dakota,1,Alabama,125,Tuscaloosa County,0,11,-11
46,South Dakota,10,Delaware,5,Sussex County,0,6,-6
46,South Dakota,11,District of Columbia,1,District of Columbia,5,23,-18
46,South Dakota,12,Florida,1,Alachua County,0,21,-21
46,South Dakota,12,Florida,5,Bay County,27,25,2
46,South Dakota,12,Florida,9,Brevard County,1,0,1
46,South Dakota,12,Florida,11,Broward County,5,0,5
46,South Dakota,12,Florida,17,Citrus County,0,140,-140
46,South Dakota,12,Florida,21,Collier County,0,38,-38
46,South Dakota,12,Florida,31,Duval County,0,46,-46
46,South Dakota,12,Florida,33,Escambia County,14,4,10
46,South Dakota,12,Florida,55,Highlands County,0,41,-41
46,South Dakota,12,Florida,57,Hillsborough County,12,150,-138
46,South Dakota,12,Florida,69,Lake County,9,0,9
46,South Dakota,12,Florida,71,Lee County,3,57,-54
46,South Dakota,12,Florida,81,Manatee County,80,35,45
46,South Dakota,12,Florida,83,Marion County,29,14,15
46,South Dakota,12,Florida,86,Miami-Dade County,10,19,-9
46,South Dakota,12,Florida,91,Okaloosa County,21,0,21
46,South Dakota,12,Florida,95,Orange County,5,20,-15
46,South Dakota,12,Florida,99,Palm Beach County,38,0,38
46,South Dakota,12,Florida,101,Pasco County,90,0,90
46,South Dakota,12,Florida,103,Pinellas County,0,10,-10
46,South Dakota,12,Florida,105,Polk County,24,0,24
46,South Dakota,12,Florida,113,Santa Rosa County,41,0,41
46,South Dakota,12,Florida,117,Seminole County,10,0,10
46,South Dakota,12,Florida,127,Volusia County,24,193,-169
46,South Dakota,13,Georgia,3,Atkinson County,0,26,-26
46,South Dakota,13,Georgia,11,Banks County,0,3,-3
46,South Dakota,13,Georgia,15,Bartow County,0,16,-16
46,South Dakota,13,Georgia,19,Berrien County,6,8,-2
46,South Dakota,13,Georgia,47,Catoosa County,18,0,18
46,South Dakota,13,Georgia,51,Chatham County,8,0,8
46,South Dakota,13,Georgia,67,Cobb County,14,0,14
46,South Dakota,13,Georgia,73,Columbia County,19,0,19
46,South Dakota,13,Georgia,97,Douglas County,13,0,13
46,South Dakota,13,Georgia,115,Floyd County,5,0,5
46,South Dakota,13,Georgia,121,Fulton County,5,50,-45
46,South Dakota,13,Georgia,153,Houston County,0,6,-6
46,South Dakota,13,Georgia,175,Laurens County,0,6,-6
46,South Dakota,13,Georgia,179,Liberty County,32,20,12
46,South Dakota,13,Georgia,183,Long County,10,0,10
46,South Dakota,13,Georgia,185,Lowndes County,1,0,1
46,South Dakota,13,Georgia,187,Lumpkin County,21,0,21
46,South Dakota,13,Georgia,211,Morgan County,14,0,14
46,South Dakota,13,Georgia,215,Muscogee County,20,0,20
46,South Dakota,13,Georgia,245,Richmond County,27,0,27
46,South Dakota,13,Georgia,313,Whitfield County,0,50,-50
46,South Dakota,15,Hawaii,1,Hawaii County,0,4,-4
46,South Dakota,15,Hawaii,3,Honolulu County,99,48,51
46,South Dakota,16,Idaho,1,Ada County,19,508,-489
46,South Dakota,16,Idaho,5,Bannock County,13,0,13
46,South Dakota,16,Idaho,19,Bonneville County,16,0,16
46,South Dakota,16,Idaho,27,Canyon County,15,0,15
46,South Dakota,16,Idaho,31,Cassia County,0,31,-31
46,South Dakota,16,Idaho,39,Elmore County,0,15,-15
46,South Dakota,16,Idaho,43,Fremont County,4,0,4
46,South Dakota,16,Idaho,53,Jerome County,0,28,-28
46,South Dakota,16,Idaho,55,Kootenai County,0,28,-28
46,South Dakota,16,Idaho,65,Madison County,4,0,4
46,South Dakota,16,Idaho,71,Oneida County,0,11,-11
46,South Dakota,16,Idaho,73,Owyhee County,0,5,-5
46,South Dakota,16,Idaho,83,Twin Falls County,15,0,15
46,South Dakota,17,Illinois,11,Bureau County,0,13,-13
46,South Dakota,17,Illinois,21,Christian County,0,11,-11
46,South Dakota,17,Illinois,31,Cook County,56,38,18
46,South Dakota,17,Illinois,37,DeKalb County,7,0,7
46,South Dakota,17,Illinois,43,DuPage County,64,80,-16
46,South Dakota,17,Illinois,53,Ford County,0,2,-2
46,South Dakota,17,Illinois,55,Franklin County,36,0,36
46,South Dakota,17,Illinois,57,Fulton County,0,7,-7
46,South Dakota,17,Illinois,75,Iroquois County,0,29,-29
46,South Dakota,17,Illinois,77,Jackson County,0,11,-11
46,South Dakota,17,Illinois,89,Kane County,7,0,7
46,South Dakota,17,Illinois,93,Kendall County,4,0,4
46,South Dakota,17,Illinois,97,Lake County,22,0,22
46,South Dakota,17,Illinois,105,Livingston County,26,0,26
46,South Dakota,17,Illinois,111,McHenry County,6,0,6
46,South Dakota,17,Illinois,113,McLean County,42,44,-2
46,South Dakota,17,Illinois,115,Macon County,24,8,16
46,South Dakota,17,Illinois,117,Macoupin County,17,0,17
46,South Dakota,17,Illinois,119,Madison County,0,14,-14
46,South Dakota,17,Illinois,131,Mercer County,0,13,-13
46,South Dakota,17,Illinois,133,Monroe County,8,0,8
46,South Dakota,17,Illinois,137,Morgan County,7,0,7
46,South Dakota,17,Illinois,143,Peoria County,4,0,4
46,South Dakota,17,Illinois,147,Piatt County,0,6,-6
46,South Dakota,17,Illinois,157,Randolph County,0,5,-5
46,South Dakota,17,Illinois,161,Rock Island County,73,0,73
46,South Dakota,17,Illinois,163,St. Clair County,6,1,5
46,South Dakota,17,Illinois,167,Sangamon County,21,0,21
46,South Dakota,17,Illinois,179,Tazewell County,1,0,1
46,South Dakota,17,Illinois,197,Will County,8,0,8
46,South Dakota,17,Illinois,199,Williamson County,9,20,-11
46,South Dakota,17,Illinois,201,Winnebago County,4,1,3
46,South Dakota,18,Indiana,1,Adams County,97,0,97
46,South Dakota,18,Indiana,3,Allen County,6,118,-112
46,South Dakota,18,Indiana,11,Boone County,13,0,13
46,South Dakota,18,Indiana,21,Clay County,0,1,-1
46,South Dakota,18,Indiana,39,Elkhart County,10,0,10
46,South Dakota,18,Indiana,43,Floyd County,0,8,-8
46,South Dakota,18,Indiana,53,Grant County,0,4,-4
46,South Dakota,18,Indiana,63,Hendricks County,88,0,88
46,South Dakota,18,Indiana,67,Howard County,4,0,4
46,South Dakota,18,Indiana,69,Huntington County,0,8,-8
46,South Dakota,18,Indiana,71,Jackson County,2,5,-3
46,South Dakota,18,Indiana,81,Johnson County,30,0,30
46,South Dakota,18,Indiana,89,Lake County,37,0,37
46,South Dakota,18,Indiana,95,Madison County,14,2,12
46,South Dakota,18,Indiana,97,Marion County,62,11,51
46,South Dakota,18,Indiana,127,Porter County,32,0,32
46,South Dakota,18,Indiana,141,St. Joseph County,10,0,10
46,South Dakota,18,Indiana,145,Shelby County,0,13,-13
46,South Dakota,18,Indiana,157,Tippecanoe County,0,66,-66
46,South Dakota,18,Indiana,167,Vigo County,18,0,18
46,South Dakota,19,Iowa,7,Appanoose County,0,37,-37
46,South Dakota,19,Iowa,13,Black Hawk County,26,11,15
46,South Dakota,19,Iowa,15,Boone County,0,1,-1
46,South Dakota,19,Iowa,17,Bremer County,0,23,-23
46,South Dakota,19,Iowa,21,Buena Vista County,26,10,16
46,South Dakota,19,Iowa,27,Carroll County,3,7,-4
46,South Dakota,19,Iowa,31,Cedar County,6,3,3
46,South Dakota,19,Iowa,33,Cerro Gordo County,7,13,-6
46,South Dakota,19,Iowa,35,Cherokee County,18,3,15
46,South Dakota,19,Iowa,37,Chickasaw County,0,2,-2
46,South Dakota,19,Iowa,41,Clay County,99,113,-14
46,South Dakota,19,Iowa,45,Clinton County,2,0,2
46,South Dakota,19,Iowa,47,Crawford County,95,8,87
46,South Dakota,19,Iowa,49,Dallas County,13,42,-29
46,South Dakota,19,Iowa,53,Decatur County,0,6,-6
46,South Dakota,19,Iowa,59,Dickinson County,121,47,74
46,South Dakota,19,Iowa,61,Dubuque County,18,25,-7
46,South Dakota,19,Iowa,63,Emmet County,48,32,16
46,South Dakota,19,Iowa,65,Fayette County,0,19,-19
46,South Dakota,19,Iowa,67,Floyd County,10,2,8
46,South Dakota,19,Iowa,69,Franklin County,8,0,8
46,South Dakota,19,Iowa,71,Fremont County,0,1,-1
46,South Dakota,19,Iowa,83,Hardin County,0,1,-1
46,South Dakota,19,Iowa,85,Harrison County,21,13,8
46,South Dakota,19,Iowa,91,Humboldt County,0,6,-6
46,South Dakota,19,Iowa,93,Ida County,19,30,-11
46,South Dakota,19,Iowa,95,Iowa County,3,0,3
46,South Dakota,19,Iowa,99,Jasper County,34,0,34
46,South Dakota,19,Iowa,103,Johnson County,60,95,-35
46,South Dakota,19,Iowa,105,Jones County,0,9,-9
46,South Dakota,19,Iowa,109,Kossuth County,28,61,-33
46,South Dakota,19,Iowa,113,Linn County,22,26,-4
46,South Dakota,19,Iowa,117,Lucas County,0,20,-20
46,South Dakota,19,Iowa,119,Lyon County,174,92,82
46,South Dakota,19,Iowa,121,Madison County,21,0,21
46,South Dakota,19,Iowa,123,Mahaska County,5,7,-2
46,South Dakota,19,Iowa,125,Marion County,6,0,6
46,South Dakota,19,Iowa,127,Marshall County,3,0,3
46,South Dakota,19,Iowa,129,Mills County,10,36,-26
46,South Dakota,19,Iowa,131,Mitchell County,7,1,6
46,South Dakota,19,Iowa,133,Monona County,17,1,16
46,South Dakota,19,Iowa,139,Muscatine County,12,0,12
46,South Dakota,19,Iowa,141,O'Brien County,58,0,58
46,South Dakota,19,Iowa,143,Osceola County,61,0,61
46,South Dakota,19,Iowa,145,Page County,81,7,74
46,South Dakota,19,Iowa,147,Palo Alto County,12,8,4
46,South Dakota,19,Iowa,149,Plymouth County,96,92,4
46,South Dakota,19,Iowa,151,Pocahontas County,3,0,3
46,South Dakota,19,Iowa,153,Polk County,86,143,-57
46,South Dakota,19,Iowa,155,Pottawattamie County,14,51,-37
46,South Dakota,19,Iowa,157,Poweshiek County,0,23,-23
46,South Dakota,19,Iowa,161,Sac County,30,14,16
46,South Dakota,19,Iowa,163,Scott County,88,32,56
46,South Dakota,19,Iowa,167,Sioux County,206,89,117
46,South Dakota,19,Iowa,169,Story County,99,31,68
46,South Dakota,19,Iowa,171,Tama County,0,13,-13
46,South Dakota,19,Iowa,173,Taylor County,26,0,26
46,South Dakota,19,Iowa,175,Union County,0,5,-5
46,South Dakota,19,Iowa,179,Wapello County,8,0,8
46,South Dakota,19,Iowa,181,Warren County,0,10,-10
46,South Dakota,19,Iowa,187,Webster County,152,6,146
46,South Dakota,19,Iowa,191,Winneshiek County,11,2,9
46,South Dakota,19,Iowa,193,Woodbury County,824,625,199
46,South Dakota,19,Iowa,195,Worth County,0,6,-6
46,South Dakota,19,Iowa,197,Wright County,0,4,-4
46,South Dakota,2,Alaska,16,Aleutians West Census Area,3,0,3
46,South Dakota,2,Alaska,20,Anchorage Municipality,133,116,17
46,South Dakota,2,Alaska,60,Bristol Bay Borough,0,7,-7
46,South Dakota,2,Alaska,90,Fairbanks North Star Borough,52,12,40
46,South Dakota,2,Alaska,110,Juneau City and Borough,3,0,3
46,South Dakota,2,Alaska,122,Kenai Peninsula Borough,38,0,38
46,South Dakota,2,Alaska,130,Ketchikan Gateway Borough,0,9,-9
46,South Dakota,2,Alaska,170,Matanuska-Susitna Borough,16,27,-11
46,South Dakota,2,Alaska,180,Nome Census Area,21,0,21
46,South Dakota,2,Alaska,220,Sitka City and Borough,0,20,-20
46,South Dakota,2,Alaska,230,Skagway Municipality,0,1,-1
46,South Dakota,20,Kansas,5,Atchison County,23,0,23
46,South Dakota,20,Kansas,9,Barton County,5,2,3
46,South Dakota,20,Kansas,13,Brown County,0,65,-65
46,South Dakota,20,Kansas,29,Cloud County,0,87,-87
46,South Dakota,20,Kansas,45,Douglas County,0,32,-32
46,South Dakota,20,Kansas,51,Ellis County,6,9,-3
46,South Dakota,20,Kansas,55,Finney County,45,12,33
46,South Dakota,20,Kansas,59,Franklin County,23,0,23
46,South Dakota,20,Kansas,61,Geary County,2,0,2
46,South Dakota,20,Kansas,79,Harvey County,6,0,6
46,South Dakota,20,Kansas,91,Johnson County,187,0,187
46,South Dakota,20,Kansas,103,Leavenworth County,141,0,141
46,South Dakota,20,Kansas,143,Ottawa County,6,6,0
46,South Dakota,20,Kansas,147,Phillips County,17,0,17
46,South Dakota,20,Kansas,149,Pottawatomie County,0,54,-54
46,South Dakota,20,Kansas,155,Reno County,31,0,31
46,South Dakota,20,Kansas,161,Riley County,2,84,-82
46,South Dakota,20,Kansas,169,Saline County,22,0,22
46,South Dakota,20,Kansas,173,Sedgwick County,57,87,-30
46,South Dakota,20,Kansas,175,Seward County,10,0,10
46,South Dakota,20,Kansas,177,Shawnee County,25,0,25
46,South Dakota,20,Kansas,209,Wyandotte County,3,0,3
46,South Dakota,21,Kentucky,13,Bell County,0,14,-14
46,South Dakota,21,Kentucky,67,Fayette County,17,76,-59
46,South Dakota,21,Kentucky,101,Henderson County,0,42,-42
46,South Dakota,21,Kentucky,111,Jefferson County,0,6,-6
46,South Dakota,21,Kentucky,125,Laurel County,29,0,29
46,South Dakota,21,Kentucky,145,McCracken County,0,21,-21
46,South Dakota,21,Kentucky,147,McCreary County,5,0,5
46,South Dakota,21,Kentucky,183,Ohio County,0,18,-18
46,South Dakota,22,Louisiana,3,Allen Parish,0,42,-42
46,South Dakota,22,Louisiana,7,Assumption Parish,16,0,16
46,South Dakota,22,Louisiana,11,Beauregard Parish,0,3,-3
46,South Dakota,22,Louisiana,15,Bossier Parish,0,2,-2
46,South Dakota,22,Louisiana,17,Caddo Parish,16,21,-5
46,South Dakota,22,Louisiana,19,Calcasieu Parish,9,28,-19
46,South Dakota,22,Louisiana,45,Iberia Parish,4,0,4
46,South Dakota,22,Louisiana,51,Jefferson Parish,99,0,99
46,South Dakota,22,Louisiana,55,Lafayette Parish,65,0,65
46,South Dakota,22,Louisiana,71,Orleans Parish,68,2,66
46,South Dakota,22,Louisiana,99,St. Martin Parish,0,73,-73
46,South Dakota,22,Louisiana,103,St. Tammany Parish,12,0,12
46,South Dakota,22,Louisiana,105,Tangipahoa Parish,3,0,3
46,South Dakota,22,Louisiana,113,Vermilion Parish,14,0,14
46,South Dakota,23,Maine,21,Piscataquis County,0,4,-4
46,South Dakota,23,Maine,23,Sagadahoc County,0,7,-7
46,South Dakota,23,Maine,29,Washington County,8,0,8
46,South Dakota,24,Maryland,5,Baltimore County,18,22,-4
46,South Dakota,24,Maryland,9,Calvert County,4,0,4
46,South Dakota,24,Maryland,13,Carroll County,0,52,-52
46,South Dakota,24,Maryland,15,Cecil County,17,0,17
46,South Dakota,24,Maryland,17,Charles County,20,0,20
46,South Dakota,24,Maryland,23,Garrett County,2,0,2
46,South Dakota,24,Maryland,25,Harford County,7,0,7
46,South Dakota,24,Maryland,31,Montgomery County,6,44,-38
46,South Dakota,24,Maryland,33,Prince George's County,68,19,49
46,South Dakota,24,Maryland,43,Washington County,4,0,4
46,South Dakota,24,Maryland,510,Baltimore city,16,0,16
46,South Dakota,25,Massachusetts,3,Berkshire County,14,0,14
46,South Dakota,25,Massachusetts,5,Bristol County,32,18,14
46,South Dakota,25,Massachusetts,13,Hampden County,21,6,15
46,South Dakota,25,Massachusetts,17,Middlesex County,40,29,11
46,South Dakota,25,Massachusetts,21,Norfolk County,0,5,-5
46,South Dakota,25,Massachusetts,25,Suffolk County,7,0,7
46,South Dakota,26,Michigan,13,Baraga County,2,0,2
46,South Dakota,26,Michigan,15,Barry County,2,0,2
46,South Dakota,26,Michigan,19,Benzie County,0,50,-50
46,South Dakota,26,Michigan,21,Berrien County,0,12,-12
46,South Dakota,26,Michigan,25,Calhoun County,3,7,-4
46,South Dakota,26,Michigan,31,Cheboygan County,12,0,12
46,South Dakota,26,Michigan,37,Clinton County,0,30,-30
46,South Dakota,26,Michigan,53,Gogebic County,4,0,4
46,South Dakota,26,Michigan,61,Houghton County,1,51,-50
46,South Dakota,26,Michigan,65,Ingham County,0,7,-7
46,South Dakota,26,Michigan,67,Ionia County,0,26,-26
46,South Dakota,26,Michigan,77,Kalamazoo County,0,12,-12
46,South Dakota,26,Michigan,81,Kent County,0,9,-9
46,South Dakota,26,Michigan,87,Lapeer County,0,12,-12
46,South Dakota,26,Michigan,89,Leelanau County,0,8,-8
46,South Dakota,26,Michigan,93,Livingston County,4,0,4
46,South Dakota,26,Michigan,99,Macomb County,0,2,-2
46,South Dakota,26,Michigan,103,Marquette County,0,21,-21
46,South Dakota,26,Michigan,111,Midland County,0,1,-1
46,South Dakota,26,Michigan,115,Monroe County,2,0,2
46,South Dakota,26,Michigan,117,Montcalm County,5,0,5
46,South Dakota,26,Michigan,121,Muskegon County,38,0,38
46,South Dakota,26,Michigan,125,Oakland County,5,14,-9
46,South Dakota,26,Michigan,139,Ottawa County,6,0,6
46,South Dakota,26,Michigan,147,St. Clair County,10,0,10
46,South Dakota,26,Michigan,149,St. Joseph County,0,21,-21
46,South Dakota,26,Michigan,151,Sanilac County,7,0,7
46,South Dakota,26,Michigan,161,Washtenaw County,11,22,-11
46,South Dakota,26,Michigan,163,Wayne County,24,14,10
46,South Dakota,27,Minnesota,1,Aitkin County,0,1,-1
46,South Dakota,27,Minnesota,3,Anoka County,211,72,139
46,South Dakota,27,Minnesota,5,Becker County,52,4,48
46,South Dakota,27,Minnesota,7,Beltrami County,0,9,-9
46,South Dakota,27,Minnesota,9,Benton County,66,0,66
46,South Dakota,27,Minnesota,11,Big Stone County,85,40,45
46,South Dakota,27,Minnesota,13,Blue Earth County,178,110,68
46,South Dakota,27,Minnesota,15,Brown County,75,23,52
46,South Dakota,27,Minnesota,17,Carlton County,9,5,4
46,South Dakota,27,Minnesota,19,Carver County,141,47,94
46,South Dakota,27,Minnesota,21,Cass County,43,4,39
46,South Dakota,27,Minnesota,23,Chippewa County,54,79,-25
46,South Dakota,27,Minnesota,25,Chisago County,15,4,11
46,South Dakota,27,Minnesota,27,Clay County,36,231,-195
46,South Dakota,27,Minnesota,29,Clearwater County,1,0,1
46,South Dakota,27,Minnesota,33,Cottonwood County,35,24,11
46,South Dakota,27,Minnesota,35,Crow Wing County,16,36,-20
46,South Dakota,27,Minnesota,37,Dakota County,148,118,30
46,South Dakota,27,Minnesota,41,Douglas County,24,7,17
46,South Dakota,27,Minnesota,43,Faribault County,56,3,53
46,South Dakota,27,Minnesota,45,Fillmore County,15,32,-17
46,South Dakota,27,Minnesota,47,Freeborn County,47,8,39
46,South Dakota,27,Minnesota,49,Goodhue County,36,35,1
46,South Dakota,27,Minnesota,51,Grant County,0,12,-12
46,South Dakota,27,Minnesota,53,Hennepin County,524,729,-205
46,South Dakota,27,Minnesota,55,Houston County,9,35,-26
46,South Dakota,27,Minnesota,59,Isanti County,0,15,-15
46,South Dakota,27,Minnesota,61,Itasca County,43,16,27
46,South Dakota,27,Minnesota,63,Jackson County,22,44,-22
46,South Dakota,27,Minnesota,65,Kanabec County,0,12,-12
46,South Dakota,27,Minnesota,67,Kandiyohi County,93,22,71
46,South Dakota,27,Minnesota,69,Kittson County,0,1,-1
46,South Dakota,27,Minnesota,71,Koochiching County,7,7,0
46,South Dakota,27,Minnesota,73,Lac qui Parle County,37,5,32
46,South Dakota,27,Minnesota,77,Lake of the Woods County,10,26,-16
46,South Dakota,27,Minnesota,79,Le Sueur County,4,19,-15
46,South Dakota,27,Minnesota,81,Lincoln County,175,85,90
46,South Dakota,27,Minnesota,83,Lyon County,214,109,105
46,South Dakota,27,Minnesota,85,McLeod County,41,20,21
46,South Dakota,27,Minnesota,87,Mahnomen County,10,1,9
46,South Dakota,27,Minnesota,89,Marshall County,0,4,-4
46,South Dakota,27,Minnesota,91,Martin County,56,97,-41
46,South Dakota,27,Minnesota,93,Meeker County,0,53,-53
46,South Dakota,27,Minnesota,95,Mille Lacs County,9,1,8
46,South Dakota,27,Minnesota,97,Morrison County,3,7,-4
46,South Dakota,27,Minnesota,99,Mower County,14,142,-128
46,South Dakota,27,Minnesota,101,Murray County,63,13,50
46,South Dakota,27,Minnesota,103,Nicollet County,64,150,-86
46,South Dakota,27,Minnesota,105,Nobles County,100,77,23
46,South Dakota,27,Minnesota,107,Norman County,0,52,-52
46,South Dakota,27,Minnesota,109,Olmsted County,99,77,22
46,South Dakota,27,Minnesota,111,Otter Tail County,0,19,-19
46,South Dakota,27,Minnesota,113,Pennington County,0,13,-13
46,South Dakota,27,Minnesota,115,Pine County,34,0,34
46,South Dakota,27,Minnesota,117,Pipestone County,186,246,-60
46,South Dakota,27,Minnesota,119,Polk County,3,20,-17
46,South Dakota,27,Minnesota,121,Pope County,27,11,16
46,South Dakota,27,Minnesota,123,Ramsey County,106,460,-354
46,South Dakota,27,Minnesota,127,Redwood County,77,22,55
46,South Dakota,27,Minnesota,129,Renville County,9,17,-8
46,South Dakota,27,Minnesota,131,Rice County,131,90,41
46,South Dakota,27,Minnesota,133,Rock County,233,390,-157
46,South Dakota,27,Minnesota,135,Roseau County,0,7,-7
46,South Dakota,27,Minnesota,137,St. Louis County,24,38,-14
46,South Dakota,27,Minnesota,139,Scott County,111,25,86
46,South Dakota,27,Minnesota,141,Sherburne County,10,13,-3
46,South Dakota,27,Minnesota,143,Sibley County,16,0,16
46,South Dakota,27,Minnesota,145,Stearns County,198,78,120
46,South Dakota,27,Minnesota,147,Steele County,24,50,-26
46,South Dakota,27,Minnesota,149,Stevens County,49,63,-14
46,South Dakota,27,Minnesota,151,Swift County,10,11,-1
46,South Dakota,27,Minnesota,153,Todd County,0,8,-8
46,South Dakota,27,Minnesota,155,Traverse County,33,52,-19
46,South Dakota,27,Minnesota,157,Wabasha County,30,0,30
46,South Dakota,27,Minnesota,159,Wadena County,14,5,9
46,South Dakota,27,Minnesota,161,Waseca County,12,1,11
46,South Dakota,27,Minnesota,163,Washington County,43,73,-30
46,South Dakota,27,Minnesota,165,Watonwan County,27,3,24
46,South Dakota,27,Minnesota,167,Wilkin County,0,1,-1
46,South Dakota,27,Minnesota,169,Winona County,22,82,-60
46,South Dakota,27,Minnesota,171,Wright County,40,152,-112
46,South Dakota,27,Minnesota,173,Yellow Medicine County,118,41,77
46,South Dakota,28,Mississippi,25,Clay County,16,0,16
46,South Dakota,28,Mississippi,43,Grenada County,9,0,9
46,South Dakota,28,Mississippi,47,Harrison County,8,11,-3
46,South Dakota,28,Mississippi,81,Lee County,2,0,2
46,South Dakota,28,Mississippi,151,Washington County,1,0,1
46,South Dakota,29,Missouri,1,Adair County,10,0,10
46,South Dakota,29,Missouri,3,Andrew County,5,0,5
46,South Dakota,29,Missouri,7,Audrain County,2,11,-9
46,South Dakota,29,Missouri,19,Boone County,0,31,-31
46,South Dakota,29,Missouri,21,Buchanan County,11,0,11
46,South Dakota,29,Missouri,23,Butler County,7,0,7
46,South Dakota,29,Missouri,29,Camden County,7,0,7
46,South Dakota,29,Missouri,37,Cass County,5,9,-4
46,South Dakota,29,Missouri,43,Christian County,0,49,-49
46,South Dakota,29,Missouri,47,Clay County,9,81,-72
46,South Dakota,29,Missouri,51,Cole County,4,0,4
46,South Dakota,29,Missouri,53,Cooper County,13,0,13
46,South Dakota,29,Missouri,71,Franklin County,15,0,15
46,South Dakota,29,Missouri,77,Greene County,21,0,21
46,South Dakota,29,Missouri,79,Grundy County,8,0,8
46,South Dakota,29,Missouri,87,Holt County,0,1,-1
46,South Dakota,29,Missouri,95,Jackson County,44,79,-35
46,South Dakota,29,Missouri,101,Johnson County,0,11,-11
46,South Dakota,29,Missouri,113,Lincoln County,0,15,-15
46,South Dakota,29,Missouri,117,Livingston County,0,20,-20
46,South Dakota,29,Missouri,123,Madison County,0,19,-19
46,South Dakota,29,Missouri,139,Montgomery County,0,2,-2
46,South Dakota,29,Missouri,155,Pemiscot County,0,3,-3
46,South Dakota,29,Missouri,157,Perry County,1,0,1
46,South Dakota,29,Missouri,165,Platte County,0,73,-73
46,South Dakota,29,Missouri,169,Pulaski County,68,61,7
46,South Dakota,29,Missouri,177,Ray County,0,2,-2
46,South Dakota,29,Missouri,183,St. Charles County,0,134,-134
46,South Dakota,29,Missouri,189,St. Louis County,20,36,-16
46,South Dakota,29,Missouri,195,Saline County,0,3,-3
46,South Dakota,29,Missouri,213,Taney County,3,5,-2
46,South Dakota,29,Missouri,215,Texas County,0,8,-8
46,South Dakota,29,Missouri,223,Wayne County,0,14,-14
46,South Dakota,29,Missouri,510,St. Louis city,10,33,-23
46,South Dakota,30,Montana,3,Big Horn County,25,0,25
46,South Dakota,30,Montana,11,Carter County,44,2,42
46,South Dakota,30,Montana,13,Cascade County,0,25,-25
46,South Dakota,30,Montana,17,Custer County,0,11,-11
46,South Dakota,30,Montana,21,Dawson County,16,17,-1
46,South Dakota,30,Montana,27,Fergus County,0,1,-1
46,South Dakota,30,Montana,29,Flathead County,56,25,31
46,South Dakota,30,Montana,31,Gallatin County,51,34,17
46,South Dakota,30,Montana,33,Garfield County,0,19,-19
46,South Dakota,30,Montana,49,Lewis and Clark County,23,36,-13
46,South Dakota,30,Montana,57,Madison County,0,10,-10
46,South Dakota,30,Montana,63,Missoula County,41,15,26
46,South Dakota,30,Montana,67,Park County,5,0,5
46,South Dakota,30,Montana,75,Powder River County,3,6,-3
46,South Dakota,30,Montana,79,Prairie County,21,0,21
46,South Dakota,30,Montana,81,Ravalli County,4,0,4
46,South Dakota,30,Montana,83,Richland County,5,3,2
46,South Dakota,30,Montana,87,Rosebud County,5,41,-36
46,South Dakota,30,Montana,91,Sheridan County,2,0,2
46,South Dakota,30,Montana,93,Silver Bow County,12,0,12
46,South Dakota,30,Montana,95,Stillwater County,0,26,-26
46,South Dakota,30,Montana,103,Treasure County,0,1,-1
46,South Dakota,30,Montana,107,Wheatland County,6,0,6
46,South Dakota,30,Montana,111,Yellowstone County,138,79,59
46,South Dakota,31,Nebraska,1,Adams County,23,41,-18
46,South Dakota,31,Nebraska,3,Antelope County,19,27,-8
46,South Dakota,31,Nebraska,11,Boone County,16,15,1
46,South Dakota,31,Nebraska,13,Box Butte County,19,1,18
46,South Dakota,31,Nebraska,15,Boyd County,6,5,1
46,South Dakota,31,Nebraska,17,Brown County,2,0,2
46,South Dakota,31,Nebraska,19,Buffalo County,23,72,-49
46,South Dakota,31,Nebraska,27,Cedar County,49,179,-130
46,South Dakota,31,Nebraska,29,Chase County,0,11,-11
46,South Dakota,31,Nebraska,31,Cherry County,123,112,11
46,South Dakota,31,Nebraska,33,Cheyenne County,0,11,-11
46,South Dakota,31,Nebraska,35,Clay County,0,9,-9
46,South Dakota,31,Nebraska,39,Cuming County,2,0,2
46,South Dakota,31,Nebraska,41,Custer County,7,1,6
46,South Dakota,31,Nebraska,43,Dakota County,41,93,-52
46,South Dakota,31,Nebraska,45,Dawes County,134,258,-124
46,South Dakota,31,Nebraska,47,Dawson County,21,0,21
46,South Dakota,31,Nebraska,49,Deuel County,0,38,-38
46,South Dakota,31,Nebraska,51,Dixon County,17,3,14
46,South Dakota,31,Nebraska,53,Dodge County,12,34,-22
46,South Dakota,31,Nebraska,55,Douglas County,383,383,0
46,South Dakota,31,Nebraska,65,Furnas County,2,0,2
46,South Dakota,31,Nebraska,67,Gage County,4,2,2
46,South Dakota,31,Nebraska,79,Hall County,136,54,82
46,South Dakota,31,Nebraska,81,Hamilton County,5,0,5
46,South Dakota,31,Nebraska,87,Hitchcock County,0,2,-2
46,South Dakota,31,Nebraska,89,Holt County,23,45,-22
46,South Dakota,31,Nebraska,93,Howard County,0,9,-9
46,South Dakota,31,Nebraska,95,Jefferson County,0,2,-2
46,South Dakota,31,Nebraska,97,Johnson County,0,3,-3
46,South Dakota,31,Nebraska,99,Kearney County,4,18,-14
46,South Dakota,31,Nebraska,101,Keith County,13,8,5
46,South Dakota,31,Nebraska,107,Knox County,102,66,36
46,South Dakota,31,Nebraska,109,Lancaster County,308,478,-170
46,South Dakota,31,Nebraska,111,Lincoln County,25,10,15
46,South Dakota,31,Nebraska,119,Madison County,114,71,43
46,South Dakota,31,Nebraska,121,Merrick County,0,2,-2
46,South Dakota,31,Nebraska,125,Nance County,0,5,-5
46,South Dakota,31,Nebraska,129,Nuckolls County,6,0,6
46,South Dakota,31,Nebraska,137,Phelps County,1,0,1
46,South Dakota,31,Nebraska,139,Pierce County,6,9,-3
46,South Dakota,31,Nebraska,141,Platte County,20,10,10
46,South Dakota,31,Nebraska,143,Polk County,7,0,7
46,South Dakota,31,Nebraska,147,Richardson County,0,1,-1
46,South Dakota,31,Nebraska,151,Saline County,0,36,-36
46,South Dakota,31,Nebraska,153,Sarpy County,104,37,67
46,South Dakota,31,Nebraska,155,Saunders County,0,10,-10
46,South Dakota,31,Nebraska,157,Scotts Bluff County,93,10,83
46,South Dakota,31,Nebraska,159,Seward County,0,40,-40
46,South Dakota,31,Nebraska,161,Sheridan County,79,131,-52
46,South Dakota,31,Nebraska,163,Sherman County,0,5,-5
46,South Dakota,31,Nebraska,165,Sioux County,3,0,3
46,South Dakota,31,Nebraska,167,Stanton County,122,0,122
46,South Dakota,31,Nebraska,173,Thurston County,70,4,66
46,South Dakota,31,Nebraska,177,Washington County,9,0,9
46,South Dakota,31,Nebraska,179,Wayne County,45,0,45
46,South Dakota,31,Nebraska,181,Webster County,0,6,-6
46,South Dakota,31,Nebraska,185,York County,13,8,5
46,South Dakota,32,Nevada,1,Churchill County,0,115,-115
46,South Dakota,32,Nevada,3,Clark County,232,266,-34
46,South Dakota,32,Nevada,5,Douglas County,0,4,-4
46,South Dakota,32,Nevada,7,Elko County,14,14,0
46,South Dakota,32,Nevada,23,Nye County,0,60,-60
46,South Dakota,32,Nevada,31,Washoe County,103,86,17
46,South Dakota,32,Nevada,33,White Pine County,15,0,15
46,South Dakota,32,Nevada,510,Carson City,0,12,-12
46,South Dakota,33,New Hampshire,5,Cheshire County,0,31,-31
46,South Dakota,33,New Hampshire,11,Hillsborough County,14,0,14
46,South Dakota,33,New Hampshire,13,Merrimack County,5,0,5
46,South Dakota,33,New Hampshire,15,Rockingham County,6,0,6
46,South Dakota,34,New Jersey,5,Burlington County,24,27,-3
46,South Dakota,34,New Jersey,13,Essex County,0,21,-21
46,South Dakota,34,New Jersey,17,Hudson County,0,13,-13
46,South Dakota,34,New Jersey,21,Mercer County,3,0,3
46,South Dakota,34,New Jersey,25,Monmouth County,5,0,5
46,South Dakota,34,New Jersey,29,Ocean County,3,0,3
46,South Dakota,34,New Jersey,31,Passaic County,11,0,11
46,South Dakota,35,New Mexico,1,Bernalillo County,26,10,16
46,South Dakota,35,New Mexico,9,Curry County,0,13,-13
46,South Dakota,35,New Mexico,13,Doña Ana County,13,8,5
46,South Dakota,35,New Mexico,15,Eddy County,6,0,6
46,South Dakota,35,New Mexico,31,McKinley County,48,0,48
46,South Dakota,35,New Mexico,35,Otero County,22,0,22
46,South Dakota,35,New Mexico,41,Roosevelt County,2,0,2
46,South Dakota,35,New Mexico,43,Sandoval County,0,115,-115
46,South Dakota,35,New Mexico,45,San Juan County,66,7,59
46,South Dakota,35,New Mexico,49,Santa Fe County,4,0,4
46,South Dakota,35,New Mexico,51,Sierra County,16,0,16
46,South Dakota,35,New Mexico,55,Taos County,0,6,-6
46,South Dakota,35,New Mexico,61,Valencia County,8,13,-5
46,South Dakota,36,New York,1,Albany County,0,28,-28
46,South Dakota,36,New York,3,Allegany County,0,3,-3
46,South Dakota,36,New York,5,Bronx County,0,9,-9
46,South Dakota,36,New York,9,Cattaraugus County,16,0,16
46,South Dakota,36,New York,27,Dutchess County,0,33,-33
46,South Dakota,36,New York,29,Erie County,169,0,169
46,South Dakota,36,New York,47,Kings County,15,44,-29
46,South Dakota,36,New York,55,Monroe County,5,0,5
46,South Dakota,36,New York,57,Montgomery County,17,0,17
46,South Dakota,36,New York,59,Nassau County,10,0,10
46,South Dakota,36,New York,61,New York County,19,0,19
46,South Dakota,36,New York,63,Niagara County,6,0,6
46,South Dakota,36,New York,71,Orange County,6,0,6
46,South Dakota,36,New York,75,Oswego County,0,14,-14
46,South Dakota,36,New York,77,Otsego County,0,9,-9
46,South Dakota,36,New York,83,Rensselaer County,35,0,35
46,South Dakota,36,New York,89,St. Lawrence County,21,0,21
46,South Dakota,36,New York,91,Saratoga County,8,0,8
46,South Dakota,36,New York,103,Suffolk County,15,33,-18
46,South Dakota,36,New York,115,Washington County,0,3,-3
46,South Dakota,36,New York,119,Westchester County,5,15,-10
46,South Dakota,36,New York,121,Wyoming County,1,0,1
46,South Dakota,37,North Carolina,1,Alamance County,0,3,-3
46,South Dakota,37,North Carolina,19,Brunswick County,0,61,-61
46,South Dakota,37,North Carolina,21,Buncombe County,4,0,4
46,South Dakota,37,North Carolina,31,Carteret County,9,0,9
46,South Dakota,37,North Carolina,49,Craven County,27,14,13
46,South Dakota,37,North Carolina,51,Cumberland County,0,16,-16
46,South Dakota,37,North Carolina,63,Durham County,2,0,2
46,South Dakota,37,North Carolina,65,Edgecombe County,0,8,-8
46,South Dakota,37,North Carolina,67,Forsyth County,12,0,12
46,South Dakota,37,North Carolina,77,Granville County,6,0,6
46,South Dakota,37,North Carolina,81,Guilford County,65,0,65
46,South Dakota,37,North Carolina,85,Harnett County,8,0,8
46,South Dakota,37,North Carolina,101,Johnston County,0,25,-25
46,South Dakota,37,North Carolina,105,Lee County,0,30,-30
46,South Dakota,37,North Carolina,111,McDowell County,4,0,4
46,South Dakota,37,North Carolina,119,Mecklenburg County,5,13,-8
46,South Dakota,37,North Carolina,133,Onslow County,3,52,-49
46,South Dakota,37,North Carolina,135,Orange County,0,86,-86
46,South Dakota,37,North Carolina,147,Pitt County,0,108,-108
46,South Dakota,37,North Carolina,151,Randolph County,0,18,-18
46,South Dakota,37,North Carolina,155,Robeson County,80,0,80
46,South Dakota,37,North Carolina,179,Union County,13,0,13
46,South Dakota,37,North Carolina,183,Wake County,13,116,-103
46,South Dakota,37,North Carolina,189,Watauga County,0,45,-45
46,South Dakota,37,North Carolina,191,Wayne County,21,0,21
46,South Dakota,38,North Dakota,1,Adams County,79,38,41
46,South Dakota,38,North Dakota,3,Barnes County,15,63,-48
46,South Dakota,38,North Dakota,5,Benson County,2,0,2
46,South Dakota,38,North Dakota,9,Bottineau County,11,0,11
46,South Dakota,38,North Dakota,11,Bowman County,41,0,41
46,South Dakota,38,North Dakota,15,Burleigh County,139,287,-148
46,South Dakota,38,North Dakota,17,Cass County,596,478,118
46,South Dakota,38,North Dakota,19,Cavalier County,0,6,-6
46,South Dakota,38,North Dakota,21,Dickey County,35,27,8
46,South Dakota,38,North Dakota,25,Dunn County,12,0,12
46,South Dakota,38,North Dakota,29,Emmons County,0,4,-4
46,South Dakota,38,North Dakota,35,Grand Forks County,208,138,70
46,South Dakota,38,North Dakota,37,Grant County,0,32,-32
46,South Dakota,38,North Dakota,39,Griggs County,0,12,-12
46,South Dakota,38,North Dakota,41,Hettinger County,0,13,-13
46,South Dakota,38,North Dakota,45,LaMoure County,56,15,41
46,South Dakota,38,North Dakota,49,McHenry County,0,2,-2
46,South Dakota,38,North Dakota,51,McIntosh County,0,18,-18
46,South Dakota,38,North Dakota,53,McKenzie County,46,58,-12
46,South Dakota,38,North Dakota,55,McLean County,0,5,-5
46,South Dakota,38,North Dakota,57,Mercer County,57,52,5
46,South Dakota,38,North Dakota,59,Morton County,0,31,-31
46,South Dakota,38,North Dakota,61,Mountrail County,97,21,76
46,South Dakota,38,North Dakota,67,Pembina County,0,1,-1
46,South Dakota,38,North Dakota,71,Ramsey County,6,3,3
46,South Dakota,38,North Dakota,73,Ransom County,2,0,2
46,South Dakota,38,North Dakota,75,Renville County,29,1,28
46,South Dakota,38,North Dakota,77,Richland County,49,144,-95
46,South Dakota,38,North Dakota,79,Rolette County,176,26,150
46,South Dakota,38,North Dakota,81,Sargent County,3,96,-93
46,South Dakota,38,North Dakota,83,Sheridan County,0,5,-5
46,South Dakota,38,North Dakota,85,Sioux County,58,31,27
46,South Dakota,38,North Dakota,89,Stark County,96,18,78
46,South Dakota,38,North Dakota,93,Stutsman County,10,22,-12
46,South Dakota,38,North Dakota,97,Traill County,0,15,-15
46,South Dakota,38,North Dakota,99,Walsh County,4,0,4
46,South Dakota,38,North Dakota,101,Ward County,50,161,-111
46,South Dakota,38,North Dakota,103,Wells County,0,1,-1
46,South Dakota,38,North Dakota,105,Williams County,252,106,146
46,South Dakota,39,Ohio,7,Ashtabula County,0,2,-2
46,South Dakota,39,Ohio,17,Butler County,1,7,-6
46,South Dakota,39,Ohio,29,Columbiana County,6,0,6
46,South Dakota,39,Ohio,35,Cuyahoga County,18,7,11
46,South Dakota,39,Ohio,37,Darke County,0,9,-9
46,South Dakota,39,Ohio,45,Fairfield County,90,0,90
46,South Dakota,39,Ohio,47,Fayette County,3,0,3
46,South Dakota,39,Ohio,55,Geauga County,0,1,-1
46,South Dakota,39,Ohio,63,Hancock County,43,0,43
46,South Dakota,39,Ohio,77,Huron County,0,5,-5
46,South Dakota,39,Ohio,91,Logan County,0,2,-2
46,South Dakota,39,Ohio,93,Lorain County,17,0,17
46,South Dakota,39,Ohio,95,Lucas County,5,0,5
46,South Dakota,39,Ohio,97,Madison County,24,0,24
46,South Dakota,39,Ohio,101,Marion County,0,27,-27
46,South Dakota,39,Ohio,103,Medina County,16,0,16
46,South Dakota,39,Ohio,105,Meigs County,0,41,-41
46,South Dakota,39,Ohio,113,Montgomery County,8,0,8
46,South Dakota,39,Ohio,117,Morrow County,0,2,-2
46,South Dakota,39,Ohio,149,Shelby County,0,10,-10
46,South Dakota,39,Ohio,151,Stark County,16,0,16
46,South Dakota,39,Ohio,165,Warren County,5,0,5
46,South Dakota,39,Ohio,173,Wood County,9,0,9
46,South Dakota,4,Arizona,1,Apache County,18,0,18
46,South Dakota,4,Arizona,3,Cochise County,0,33,-33
46,South Dakota,4,Arizona,5,Coconino County,85,0,85
46,South Dakota,4,Arizona,7,Gila County,2,6,-4
46,South Dakota,4,Arizona,9,Graham County,51,0,51
46,South Dakota,4,Arizona,13,Maricopa County,623,817,-194
46,South Dakota,4,Arizona,15,Mohave County,13,361,-348
46,South Dakota,4,Arizona,17,Navajo County,6,17,-11
46,South Dakota,4,Arizona,19,Pima County,150,210,-60
46,South Dakota,4,Arizona,21,Pinal County,83,142,-59
46,South Dakota,4,Arizona,25,Yavapai County,0,82,-82
46,South Dakota,4,Arizona,27,Yuma County,2,174,-172
46,South Dakota,40,Oklahoma,3,Alfalfa County,0,16,-16
46,South Dakota,40,Oklahoma,17,Canadian County,43,65,-22
46,South Dakota,40,Oklahoma,19,Carter County,0,9,-9
46,South Dakota,40,Oklahoma,27,Cleveland County,0,95,-95
46,South Dakota,40,Oklahoma,31,Comanche County,0,10,-10
46,South Dakota,40,Oklahoma,47,Garfield County,20,0,20
46,South Dakota,40,Oklahoma,49,Garvin County,5,0,5
46,South Dakota,40,Oklahoma,71,Kay County,0,2,-2
46,South Dakota,40,Oklahoma,83,Logan County,5,0,5
46,South Dakota,40,Oklahoma,89,McCurtain County,5,0,5
46,South Dakota,40,Oklahoma,101,Muskogee County,0,3,-3
46,South Dakota,40,Oklahoma,109,Oklahoma County,39,6,33
46,South Dakota,40,Oklahoma,115,Ottawa County,9,0,9
46,South Dakota,40,Oklahoma,125,Pottawatomie County,4,0,4
46,South Dakota,40,Oklahoma,127,Pushmataha County,68,0,68
46,South Dakota,40,Oklahoma,139,Texas County,0,5,-5
46,South Dakota,40,Oklahoma,143,Tulsa County,69,12,57
46,South Dakota,40,Oklahoma,147,Washington County,0,2,-2
46,South Dakota,40,Oklahoma,149,Washita County,0,7,-7
46,South Dakota,41,Oregon,5,Clackamas County,15,0,15
46,South Dakota,41,Oregon,15,Curry County,0,3,-3
46,South Dakota,41,Oregon,17,Deschutes County,8,0,8
46,South Dakota,41,Oregon,19,Douglas County,19,0,19
46,South Dakota,41,Oregon,25,Harney County,0,5,-5
46,South Dakota,41,Oregon,29,Jackson County,0,9,-9
46,South Dakota,41,Oregon,31,Jefferson County,0,7,-7
46,South Dakota,41,Oregon,35,Klamath County,0,19,-19
46,South Dakota,41,Oregon,39,Lane County,26,6,20
46,South Dakota,41,Oregon,47,Marion County,8,0,8
46,South Dakota,41,Oregon,51,Multnomah County,0,137,-137
46,South Dakota,41,Oregon,53,Polk County,15,0,15
46,South Dakota,41,Oregon,59,Umatilla County,36,0,36
46,South Dakota,41,Oregon,63,Wallowa County,0,79,-79
46,South Dakota,41,Oregon,67,Washington County,0,105,-105
46,South Dakota,41,Oregon,71,Yamhill County,5,16,-11
46,South Dakota,42,Pennsylvania,3,Allegheny County,9,0,9
46,South Dakota,42,Pennsylvania,21,Cambria County,5,0,5
46,South Dakota,42,Pennsylvania,25,Carbon County,27,0,27
46,South Dakota,42,Pennsylvania,31,Clarion County,0,9,-9
46,South Dakota,42,Pennsylvania,41,Cumberland County,0,15,-15
46,South Dakota,42,Pennsylvania,45,Delaware County,41,0,41
46,South Dakota,42,Pennsylvania,47,Elk County,0,4,-4
46,South Dakota,42,Pennsylvania,55,Franklin County,0,82,-82
46,South Dakota,42,Pennsylvania,57,Fulton County,0,10,-10
46,South Dakota,42,Pennsylvania,63,Indiana County,17,0,17
46,South Dakota,42,Pennsylvania,69,Lackawanna County,0,11,-11
46,South Dakota,42,Pennsylvania,71,Lancaster County,0,58,-58
46,South Dakota,42,Pennsylvania,75,Lebanon County,0,68,-68
46,South Dakota,42,Pennsylvania,77,Lehigh County,14,0,14
46,South Dakota,42,Pennsylvania,79,Luzerne County,18,24,-6
46,South Dakota,42,Pennsylvania,95,Northampton County,0,19,-19
46,South Dakota,42,Pennsylvania,101,Philadelphia County,0,34,-34
46,South Dakota,42,Pennsylvania,133,York County,0,46,-46
46,South Dakota,44,Rhode Island,7,Providence County,70,21,49
46,South Dakota,44,Rhode Island,9,Washington County,9,0,9
46,South Dakota,45,South Carolina,19,Charleston County,0,56,-56
46,South Dakota,45,South Carolina,35,Dorchester County,12,97,-85
46,South Dakota,45,South Carolina,41,Florence County,60,15,45
46,South Dakota,45,South Carolina,45,Greenville County,0,12,-12
46,South Dakota,45,South Carolina,51,Horry County,11,0,11
46,South Dakota,45,South Carolina,61,Lee County,0,13,-13
46,South Dakota,45,South Carolina,77,Pickens County,15,38,-23
46,South Dakota,45,South Carolina,79,Richland County,18,43,-25
46,South Dakota,45,South Carolina,85,Sumter County,87,0,87
46,South Dakota,46,South Dakota,3,Aurora County,621,105,516
46,South Dakota,46,South Dakota,5,Beadle County,800,374,426
46,South Dakota,46,South Dakota,7,Bennett County,166,165,1
46,South Dakota,46,South Dakota,9,Bon Homme County,365,671,-306
46,South Dakota,46,South Dakota,11,Brookings County,1809,2577,-768
46,South Dakota,46,South Dakota,13,Brown County,1035,1155,-120
46,South Dakota,46,South Dakota,15,Brule County,219,207,12
46,South Dakota,46,South Dakota,17,Buffalo County,149,24,125
46,South Dakota,46,South Dakota,19,Butte County,400,500,-100
46,South Dakota,46,South Dakota,21,Campbell County,39,40,-1
46,South Dakota,46,South Dakota,23,Charles Mix County,284,257,27
46,South Dakota,46,South Dakota,25,Clark County,429,274,155
46,South Dakota,46,South Dakota,27,Clay County,645,1291,-646
46,South Dakota,46,South Dakota,29,Codington County,1405,1074,331
46,South Dakota,46,South Dakota,31,Corson County,104,25,79
46,South Dakota,46,South Dakota,33,Custer County,436,522,-86
46,South Dakota,46,South Dakota,35,Davison County,837,1068,-231
46,South Dakota,46,South Dakota,37,Day County,184,278,-94
46,South Dakota,46,South Dakota,39,Deuel County,160,115,45
46,South Dakota,46,South Dakota,41,Dewey County,566,77,489
46,South Dakota,46,South Dakota,43,Douglas County,42,138,-96
46,South Dakota,46,South Dakota,45,Edmunds County,77,120,-43
46,South Dakota,46,South Dakota,47,Fall River County,438,81,357
46,South Dakota,46,South Dakota,49,Faulk County,51,247,-196
46,South Dakota,46,South Dakota,51,Grant County,235,106,129
46,South Dakota,46,South Dakota,53,Gregory County,134,121,13
46,South Dakota,46,South Dakota,55,Haakon County,68,31,37
46,South Dakota,46,South Dakota,57,Hamlin County,390,375,15
46,South Dakota,46,South Dakota,59,Hand County,102,82,20
46,South Dakota,46,South Dakota,61,Hanson County,65,118,-53
46,South Dakota,46,South Dakota,63,Harding County,28,56,-28
46,South Dakota,46,South Dakota,65,Hughes County,854,1016,-162
46,South Dakota,46,South Dakota,67,Hutchinson County,371,423,-52
46,South Dakota,46,South Dakota,69,Hyde County,30,75,-45
46,South Dakota,46,South Dakota,71,Jackson County,93,104,-11
46,South Dakota,46,South Dakota,73,Jerauld County,173,26,147
46,South Dakota,46,South Dakota,75,Jones County,100,0,100
46,South Dakota,46,South Dakota,77,Kingsbury County,244,328,-84
46,South Dakota,46,South Dakota,79,Lake County,470,634,-164
46,South Dakota,46,South Dakota,81,Lawrence County,719,1372,-653
46,South Dakota,46,South Dakota,83,Lincoln County,3307,3415,-108
46,South Dakota,46,South Dakota,85,Lyman County,126,112,14
46,South Dakota,46,South Dakota,87,McCook County,198,420,-222
46,South Dakota,46,South Dakota,89,McPherson County,47,158,-111
46,South Dakota,46,South Dakota,91,Marshall County,260,218,42
46,South Dakota,46,South Dakota,93,Meade County,1137,2150,-1013
46,South Dakota,46,South Dakota,95,Mellette County,51,58,-7
46,South Dakota,46,South Dakota,97,Miner County,141,55,86
46,South Dakota,46,South Dakota,99,Minnehaha County,6943,6110,833
46,South Dakota,46,South Dakota,101,Moody County,337,333,4
46,South Dakota,46,South Dakota,102,Oglala Lakota County,964,181,783
46,South Dakota,46,South Dakota,103,Pennington County,3757,3913,-156
46,South Dakota,46,South Dakota,105,Perkins County,193,76,117
46,South Dakota,46,South Dakota,107,Potter County,103,28,75
46,South Dakota,46,South Dakota,109,Roberts County,546,333,213
46,South Dakota,46,South Dakota,111,Sanborn County,156,73,83
46,South Dakota,46,South Dakota,115,Spink County,215,261,-46
46,South Dakota,46,South Dakota,117,Stanley County,299,154,145
46,South Dakota,46,South Dakota,119,Sully County,123,36,87
46,South Dakota,46,South Dakota,121,Todd County,211,205,6
46,South Dakota,46,South Dakota,123,Tripp County,243,144,99
46,South Dakota,46,South Dakota,125,Turner County,609,507,102
46,South Dakota,46,South Dakota,127,Union County,372,466,-94
46,South Dakota,46,South Dakota,129,Walworth County,281,198,83
46,South Dakota,46,South Dakota,135,Yankton County,651,852,-201
46,South Dakota,46,South Dakota,137,Ziebach County,143,42,101
46,South Dakota,47,Tennessee,11,Bradley County,0,28,-28
46,South Dakota,47,Tennessee,13,Campbell County,16,0,16
46,South Dakota,47,Tennessee,23,Chester County,4,0,4
46,South Dakota,47,Tennessee,31,Coffee County,10,0,10
46,South Dakota,47,Tennessee,35,Cumberland County,0,10,-10
46,South Dakota,47,Tennessee,37,Davidson County,120,0,120
46,South Dakota,47,Tennessee,43,Dickson County,0,19,-19
46,South Dakota,47,Tennessee,53,Gibson County,11,0,11
46,South Dakota,47,Tennessee,57,Grainger County,0,27,-27
46,South Dakota,47,Tennessee,63,Hamblen County,8,0,8
46,South Dakota,47,Tennessee,65,Hamilton County,7,30,-23
46,South Dakota,47,Tennessee,89,Jefferson County,0,21,-21
46,South Dakota,47,Tennessee,93,Knox County,33,0,33
46,South Dakota,47,Tennessee,113,Madison County,0,24,-24
46,South Dakota,47,Tennessee,119,Maury County,8,0,8
46,South Dakota,47,Tennessee,125,Montgomery County,95,0,95
46,South Dakota,47,Tennessee,145,Roane County,81,0,81
46,South Dakota,47,Tennessee,149,Rutherford County,18,0,18
46,South Dakota,47,Tennessee,157,Shelby County,32,93,-61
46,South Dakota,47,Tennessee,163,Sullivan County,27,0,27
46,South Dakota,47,Tennessee,165,Sumner County,0,16,-16
46,South Dakota,47,Tennessee,167,Tipton County,0,5,-5
46,South Dakota,47,Tennessee,179,Washington County,35,0,35
46,South Dakota,47,Tennessee,183,Weakley County,4,0,4
46,South Dakota,47,Tennessee,189,Wilson County,0,23,-23
46,South Dakota,48,Texas,13,Atascosa County,7,0,7
46,South Dakota,48,Texas,27,Bell County,48,0,48
46,South Dakota,48,Texas,29,Bexar County,138,77,61
46,South Dakota,48,Texas,37,Bowie County,6,0,6
46,South Dakota,48,Texas,39,Brazoria County,2,0,2
46,South Dakota,48,Texas,59,Callahan County,0,41,-41
46,South Dakota,48,Texas,73,Cherokee County,1,0,1
46,South Dakota,48,Texas,85,Collin County,14,236,-222
46,South Dakota,48,Texas,91,Comal County,72,0,72
46,South Dakota,48,Texas,113,Dallas County,26,100,-74
46,South Dakota,48,Texas,121,Denton County,4,24,-20
46,South Dakota,48,Texas,135,Ector County,4,0,4
46,South Dakota,48,Texas,141,El Paso County,389,23,366
46,South Dakota,48,Texas,157,Fort Bend County,82,0,82
46,South Dakota,48,Texas,167,Galveston County,2,33,-31
46,South Dakota,48,Texas,201,Harris County,94,160,-66
46,South Dakota,48,Texas,207,Haskell County,0,6,-6
46,South Dakota,48,Texas,215,Hidalgo County,49,24,25
46,South Dakota,48,Texas,223,Hopkins County,0,31,-31
46,South Dakota,48,Texas,231,Hunt County,0,22,-22
46,South Dakota,48,Texas,233,Hutchinson County,38,0,38
46,South Dakota,48,Texas,257,Kaufman County,11,0,11
46,South Dakota,48,Texas,259,Kendall County,39,0,39
46,South Dakota,48,Texas,271,Kinney County,0,37,-37
46,South Dakota,48,Texas,297,Live Oak County,6,0,6
46,South Dakota,48,Texas,339,Montgomery County,19,54,-35
46,South Dakota,48,Texas,347,Nacogdoches County,0,10,-10
46,South Dakota,48,Texas,355,Nueces County,2,12,-10
46,South Dakota,48,Texas,363,Palo Pinto County,0,9,-9
46,South Dakota,48,Texas,375,Potter County,21,7,14
46,South Dakota,48,Texas,381,Randall County,36,0,36
46,South Dakota,48,Texas,401,Rusk County,0,95,-95
46,South Dakota,48,Texas,407,San Jacinto County,4,0,4
46,South Dakota,48,Texas,409,San Patricio County,0,5,-5
46,South Dakota,48,Texas,435,Sutton County,7,0,7
46,South Dakota,48,Texas,439,Tarrant County,7,104,-97
46,South Dakota,48,Texas,441,Taylor County,86,88,-2
46,South Dakota,48,Texas,453,Travis County,51,12,39
46,South Dakota,48,Texas,477,Washington County,7,0,7
46,South Dakota,48,Texas,479,Webb County,20,0,20
46,South Dakota,48,Texas,485,Wichita County,61,72,-11
46,South Dakota,48,Texas,491,Williamson County,46,151,-105
46,South Dakota,49,Utah,5,Cache County,72,19,53
46,South Dakota,49,Utah,11,Davis County,8,0,8
46,South Dakota,49,Utah,15,Emery County,28,0,28
46,South Dakota,49,Utah,21,Iron County,0,2,-2
46,South Dakota,49,Utah,35,Salt Lake County,74,31,43
46,South Dakota,49,Utah,43,Summit County,23,0,23
46,South Dakota,49,Utah,49,Utah County,39,124,-85
46,South Dakota,49,Utah,53,Washington County,0,106,-106
46,South Dakota,49,Utah,57,Weber County,53,0,53
46,South Dakota,5,Arkansas,7,Benton County,85,35,50
46,South Dakota,5,Arkansas,15,Carroll County,11,0,11
46,South Dakota,5,Arkansas,91,Miller County,2,0,2
46,South Dakota,5,Arkansas,131,Sebastian County,8,0,8
46,South Dakota,5,Arkansas,143,Washington County,0,14,-14
46,South Dakota,50,Vermont,1,Addison County,0,4,-4
46,South Dakota,50,Vermont,7,Chittenden County,0,114,-114
46,South Dakota,50,Vermont,11,Franklin County,0,1,-1
46,South Dakota,50,Vermont,19,Orleans County,0,2,-2
46,South Dakota,50,Vermont,21,Rutland County,4,5,-1
46,South Dakota,50,Vermont,23,Washington County,0,2,-2
46,South Dakota,50,Vermont,25,Windham County,0,3,-3
46,South Dakota,50,Vermont,27,Windsor County,25,10,15
46,South Dakota,51,Virginia,9,Amherst County,0,36,-36
46,South Dakota,51,Virginia,13,Arlington County,0,40,-40
46,South Dakota,51,Virginia,59,Fairfax County,25,57,-32
46,South Dakota,51,Virginia,69,Frederick County,26,0,26
46,South Dakota,51,Virginia,87,Henrico County,29,0,29
46,South Dakota,51,Virginia,95,James City County,0,15,-15
46,South Dakota,51,Virginia,143,Pittsylvania County,62,0,62
46,South Dakota,51,Virginia,155,Pulaski County,12,0,12
46,South Dakota,51,Virginia,179,Stafford County,274,0,274
46,South Dakota,51,Virginia,540,Charlottesville city,0,15,-15
46,South Dakota,51,Virginia,550,Chesapeake city,70,0,70
46,South Dakota,51,Virginia,660,Harrisonburg city,6,0,6
46,South Dakota,51,Virginia,710,Norfolk city,14,0,14
46,South Dakota,51,Virginia,735,Poquoson city,0,13,-13
46,South Dakota,51,Virginia,810,Virginia Beach city,19,0,19
46,South Dakota,53,Washington,5,Benton County,10,0,10
46,South Dakota,53,Washington,9,Clallam County,15,35,-20
46,South Dakota,53,Washington,11,Clark County,41,139,-98
46,South Dakota,53,Washington,19,Ferry County,6,11,-5
46,South Dakota,53,Washington,21,Franklin County,0,23,-23
46,South Dakota,53,Washington,33,King County,9,503,-494
46,South Dakota,53,Washington,35,Kitsap County,5,20,-15
46,South Dakota,53,Washington,37,Kittitas County,0,10,-10
46,South Dakota,53,Washington,45,Mason County,0,8,-8
46,South Dakota,53,Washington,49,Pacific County,12,24,-12
46,South Dakota,53,Washington,53,Pierce County,350,90,260
46,South Dakota,53,Washington,61,Snohomish County,39,166,-127
46,South Dakota,53,Washington,63,Spokane County,4,29,-25
46,South Dakota,53,Washington,65,Stevens County,0,2,-2
46,South Dakota,53,Washington,67,Thurston County,2,0,2
46,South Dakota,53,Washington,77,Yakima County,0,15,-15
46,South Dakota,54,West Virginia,61,Monongalia County,3,26,-23
46,South Dakota,54,West Virginia,67,Nicholas County,29,0,29
46,South Dakota,54,West Virginia,69,Ohio County,6,0,6
46,South Dakota,55,Wisconsin,1,Adams County,0,10,-10
46,South Dakota,55,Wisconsin,5,Barron County,19,2,17
46,South Dakota,55,Wisconsin,7,Bayfield County,0,4,-4
46,South Dakota,55,Wisconsin,9,Brown County,56,0,56
46,South Dakota,55,Wisconsin,13,Burnett County,0,4,-4
46,South Dakota,55,Wisconsin,17,Chippewa County,0,28,-28
46,South Dakota,55,Wisconsin,25,Dane County,23,96,-73
46,South Dakota,55,Wisconsin,27,Dodge County,0,7,-7
46,South Dakota,55,Wisconsin,31,Douglas County,5,0,5
46,South Dakota,55,Wisconsin,35,Eau Claire County,1,0,1
46,South Dakota,55,Wisconsin,39,Fond du Lac County,5,0,5
46,South Dakota,55,Wisconsin,41,Forest County,0,3,-3
46,South Dakota,55,Wisconsin,43,Grant County,4,0,4
46,South Dakota,55,Wisconsin,47,Green Lake County,2,0,2
46,South Dakota,55,Wisconsin,55,Jefferson County,9,6,3
46,South Dakota,55,Wisconsin,63,La Crosse County,6,30,-24
46,South Dakota,55,Wisconsin,67,Langlade County,24,2,22
46,South Dakota,55,Wisconsin,73,Marathon County,10,26,-16
46,South Dakota,55,Wisconsin,79,Milwaukee County,91,18,73
46,South Dakota,55,Wisconsin,81,Monroe County,6,0,6
46,South Dakota,55,Wisconsin,87,Outagamie County,0,20,-20
46,South Dakota,55,Wisconsin,89,Ozaukee County,0,16,-16
46,South Dakota,55,Wisconsin,93,Pierce County,16,0,16
46,South Dakota,55,Wisconsin,95,Polk County,14,0,14
46,South Dakota,55,Wisconsin,97,Portage County,1,0,1
46,South Dakota,55,Wisconsin,101,Racine County,51,0,51
46,South Dakota,55,Wisconsin,105,Rock County,17,72,-55
46,South Dakota,55,Wisconsin,107,Rusk County,12,6,6
46,South Dakota,55,Wisconsin,109,St. Croix County,214,3,211
46,South Dakota,55,Wisconsin,117,Sheboygan County,0,8,-8
46,South Dakota,55,Wisconsin,119,Taylor County,0,11,-11
46,South Dakota,55,Wisconsin,121,Trempealeau County,6,0,6
46,South Dakota,55,Wisconsin,127,Walworth County,47,0,47
46,South Dakota,55,Wisconsin,131,Washington County,3,0,3
46,South Dakota,55,Wisconsin,133,Waukesha County,27,0,27
46,South Dakota,55,Wisconsin,135,Waupaca County,11,11,0
46,South Dakota,56,Wyoming,1,Albany County,184,33,151
46,South Dakota,56,Wyoming,3,Big Horn County,12,19,-7
46,South Dakota,56,Wyoming,5,Campbell County,464,187,277
46,South Dakota,56,Wyoming,7,Carbon County,0,1,-1
46,South Dakota,56,Wyoming,9,Converse County,22,0,22
46,South Dakota,56,Wyoming,11,Crook County,147,151,-4
46,South Dakota,56,Wyoming,13,Fremont County,3,44,-41
46,South Dakota,56,Wyoming,15,Goshen County,70,2,68
46,South Dakota,56,Wyoming,17,Hot Springs County,54,0,54
46,South Dakota,56,Wyoming,19,Johnson County,0,16,-16
46,South Dakota,56,Wyoming,21,Laramie County,142,53,89
46,South Dakota,56,Wyoming,23,Lincoln County,0,4,-4
46,South Dakota,56,Wyoming,25,Natrona County,130,26,104
46,South Dakota,56,Wyoming,27,Niobrara County,0,5,-5
46,South Dakota,56,Wyoming,29,Park County,73,0,73
46,South Dakota,56,Wyoming,31,Platte County,33,51,-18
46,South Dakota,56,Wyoming,33,Sheridan County,69,67,2
46,South Dakota,56,Wyoming,41,Uinta County,0,33,-33
46,South Dakota,56,Wyoming,43,Washakie County,3,9,-6
46,South Dakota,56,Wyoming,45,Weston County,87,14,73
46,South Dakota,6,California,1,Alameda County,64,60,4
46,South Dakota,6,California,7,Butte County,29,9,20
46,South Dakota,6,California,13,Contra Costa County,6,0,6
46,South Dakota,6,California,17,El Dorado County,8,0,8
46,South Dakota,6,California,19,Fresno County,31,0,31
46,South Dakota,6,California,23,Humboldt County,0,18,-18
46,South Dakota,6,California,29,Kern County,65,127,-62
46,South Dakota,6,California,37,Los Angeles County,306,125,181
46,South Dakota,6,California,39,Madera County,0,27,-27
46,South Dakota,6,California,53,Monterey County,0,12,-12
46,South Dakota,6,California,55,Napa County,6,0,6
46,South Dakota,6,California,57,Nevada County,0,18,-18
46,South Dakota,6,California,59,Orange County,85,0,85
46,South Dakota,6,California,61,Placer County,99,0,99
46,South Dakota,6,California,65,Riverside County,82,143,-61
46,South Dakota,6,California,67,Sacramento County,139,125,14
46,South Dakota,6,California,71,San Bernardino County,104,216,-112
46,South Dakota,6,California,73,San Diego County,693,216,477
46,South Dakota,6,California,75,San Francisco County,0,7,-7
46,South Dakota,6,California,77,San Joaquin County,6,17,-11
46,South Dakota,6,California,79,San Luis Obispo County,2,0,2
46,South Dakota,6,California,83,Santa Barbara County,0,35,-35
46,South Dakota,6,California,85,Santa Clara County,26,10,16
46,South Dakota,6,California,87,Santa Cruz County,0,25,-25
46,South Dakota,6,California,89,Shasta County,97,46,51
46,South Dakota,6,California,95,Solano County,165,11,154
46,South Dakota,6,California,97,Sonoma County,43,0,43
46,South Dakota,6,California,99,Stanislaus County,16,0,16
46,South Dakota,6,California,101,Sutter County,4,0,4
46,South Dakota,6,California,107,Tulare County,2,0,2
46,South Dakota,6,California,111,Ventura County,411,0,411
46,South Dakota,6,California,113,Yolo County,14,0,14
46,South Dakota,72,Puerto Rico,21,Bayamón Municipio,0,8,-8
46,South Dakota,72,Puerto Rico,57,Guayama Municipio,61,0,61
46,South Dakota,72,Puerto Rico,127,San Juan Municipio,5,0,5
46,South Dakota,8,Colorado,1,Adams County,48,34,14
46,South Dakota,8,Colorado,5,Arapahoe County,102,51,51
46,South Dakota,8,Colorado,13,Boulder County,79,118,-39
46,South Dakota,8,Colorado,14,Broomfield County,6,0,6
46,South Dakota,8,Colorado,15,Chaffee County,5,0,5
46,South Dakota,8,Colorado,25,Crowley County,0,2,-2
46,South Dakota,8,Colorado,31,Denver County,153,67,86
46,South Dakota,8,Colorado,35,Douglas County,131,0,131
46,South Dakota,8,Colorado,41,El Paso County,256,487,-231
46,South Dakota,8,Colorado,43,Fremont County,21,22,-1
46,South Dakota,8,Colorado,45,Garfield County,29,0,29
46,South Dakota,8,Colorado,49,Grand County,0,8,-8
46,South Dakota,8,Colorado,51,Gunnison County,0,13,-13
46,South Dakota,8,Colorado,59,Jefferson County,42,248,-206
46,South Dakota,8,Colorado,67,La Plata County,9,44,-35
46,South Dakota,8,Colorado,69,Larimer County,95,166,-71
46,South Dakota,8,Colorado,73,Lincoln County,0,14,-14
46,South Dakota,8,Colorado,75,Logan County,0,36,-36
46,South Dakota,8,Colorado,77,Mesa County,68,2,66
46,South Dakota,8,Colorado,79,Mineral County,0,4,-4
46,South Dakota,8,Colorado,81,Moffat County,17,0,17
46,South Dakota,8,Colorado,83,Montezuma County,15,0,15
46,South Dakota,8,Colorado,89,Otero County,0,7,-7
46,South Dakota,8,Colorado,93,Park County,23,0,23
46,South Dakota,8,Colorado,101,Pueblo County,31,5,26
46,South Dakota,8,Colorado,117,Summit County,9,0,9
46,South Dakota,8,Colorado,119,Teller County,0,22,-22
46,South Dakota,8,Colorado,123,Weld County,154,85,69
46,South Dakota,9,Connecticut,1,Fairfield County,5,0,5
46,South Dakota,9,Connecticut,9,New Haven County,0,69,-69
46,South Dakota,9,Connecticut,11,New London County,0,24,-24
46,South Dakota,9,Connecticut,13,Tolland County,2,0,2
46,South Dakota,AFR,Africa,,-,404,0,0
46,South Dakota,ASI,Asia,,-,1725,0,0
46,South Dakota,CAM,Central America,,-,351,0,0
46,South Dakota,CAR,Caribbean,,-,56,0,0
46,South Dakota,EUR,Europe,,-,515,0,0
46,South Dakota,ISL,U.S. Island Areas,,-,30,0,0
46,South Dakota,NAM,Northern America,,-,120,0,0
46,South Dakota,OCE,Oceania and At Sea,,-,22,0,0
46,South Dakota,SAM,South America,,-,161,0,0
47,Tennessee,1,Alabama,1,Autauga County,19,28,-9
47,Tennessee,1,Alabama,3,Baldwin County,184,282,-98
47,Tennessee,1,Alabama,5,Barbour County,0,12,-12
47,Tennessee,1,Alabama,7,Bibb County,11,0,11
47,Tennessee,1,Alabama,9,Blount County,38,6,32
47,Tennessee,1,Alabama,11,Bullock County,0,19,-19
47,Tennessee,1,Alabama,13,Butler County,0,1,-1
47,Tennessee,1,Alabama,15,Calhoun County,66,53,13
47,Tennessee,1,Alabama,17,Chambers County,43,15,28
47,Tennessee,1,Alabama,19,Cherokee County,0,8,-8
47,Tennessee,1,Alabama,21,Chilton County,0,2,-2
47,Tennessee,1,Alabama,25,Clarke County,15,0,15
47,Tennessee,1,Alabama,31,Coffee County,61,205,-144
47,Tennessee,1,Alabama,33,Colbert County,135,45,90
47,Tennessee,1,Alabama,39,Covington County,0,6,-6
47,Tennessee,1,Alabama,43,Cullman County,109,36,73
47,Tennessee,1,Alabama,45,Dale County,86,449,-363
47,Tennessee,1,Alabama,47,Dallas County,32,11,21
47,Tennessee,1,Alabama,49,DeKalb County,359,52,307
47,Tennessee,1,Alabama,51,Elmore County,81,34,47
47,Tennessee,1,Alabama,53,Escambia County,50,0,50
47,Tennessee,1,Alabama,55,Etowah County,86,107,-21
47,Tennessee,1,Alabama,57,Fayette County,48,2,46
47,Tennessee,1,Alabama,59,Franklin County,41,0,41
47,Tennessee,1,Alabama,61,Geneva County,15,16,-1
47,Tennessee,1,Alabama,63,Greene County,13,0,13
47,Tennessee,1,Alabama,65,Hale County,19,0,19
47,Tennessee,1,Alabama,67,Henry County,0,36,-36
47,Tennessee,1,Alabama,69,Houston County,117,149,-32
47,Tennessee,1,Alabama,71,Jackson County,356,297,59
47,Tennessee,1,Alabama,73,Jefferson County,1196,1010,186
47,Tennessee,1,Alabama,75,Lamar County,0,5,-5
47,Tennessee,1,Alabama,77,Lauderdale County,338,820,-482
47,Tennessee,1,Alabama,79,Lawrence County,23,77,-54
47,Tennessee,1,Alabama,81,Lee County,417,486,-69
47,Tennessee,1,Alabama,83,Limestone County,469,342,127
47,Tennessee,1,Alabama,89,Madison County,1636,1452,184
47,Tennessee,1,Alabama,91,Marengo County,55,6,49
47,Tennessee,1,Alabama,93,Marion County,35,93,-58
47,Tennessee,1,Alabama,95,Marshall County,212,56,156
47,Tennessee,1,Alabama,97,Mobile County,475,246,229
47,Tennessee,1,Alabama,99,Monroe County,0,7,-7
47,Tennessee,1,Alabama,101,Montgomery County,474,282,192
47,Tennessee,1,Alabama,103,Morgan County,223,127,96
47,Tennessee,1,Alabama,105,Perry County,0,18,-18
47,Tennessee,1,Alabama,107,Pickens County,0,44,-44
47,Tennessee,1,Alabama,109,Pike County,9,24,-15
47,Tennessee,1,Alabama,111,Randolph County,53,6,47
47,Tennessee,1,Alabama,113,Russell County,17,0,17
47,Tennessee,1,Alabama,115,St. Clair County,238,9,229
47,Tennessee,1,Alabama,117,Shelby County,241,307,-66
47,Tennessee,1,Alabama,121,Talladega County,54,14,40
47,Tennessee,1,Alabama,123,Tallapoosa County,9,10,-1
47,Tennessee,1,Alabama,125,Tuscaloosa County,447,801,-354
47,Tennessee,1,Alabama,127,Walker County,37,1,36
47,Tennessee,1,Alabama,129,Washington County,0,17,-17
47,Tennessee,1,Alabama,133,Winston County,55,36,19
47,Tennessee,10,Delaware,1,Kent County,36,147,-111
47,Tennessee,10,Delaware,3,New Castle County,120,39,81
47,Tennessee,10,Delaware,5,Sussex County,229,34,195
47,Tennessee,11,District of Columbia,1,District of Columbia,574,655,-81
47,Tennessee,12,Florida,1,Alachua County,114,124,-10
47,Tennessee,12,Florida,5,Bay County,519,442,77
47,Tennessee,12,Florida,9,Brevard County,936,995,-59
47,Tennessee,12,Florida,11,Broward County,1516,437,1079
47,Tennessee,12,Florida,13,Calhoun County,0,15,-15
47,Tennessee,12,Florida,15,Charlotte County,136,112,24
47,Tennessee,12,Florida,17,Citrus County,171,175,-4
47,Tennessee,12,Florida,19,Clay County,362,79,283
47,Tennessee,12,Florida,21,Collier County,76,457,-381
47,Tennessee,12,Florida,23,Columbia County,11,92,-81
47,Tennessee,12,Florida,27,DeSoto County,42,39,3
47,Tennessee,12,Florida,29,Dixie County,0,6,-6
47,Tennessee,12,Florida,31,Duval County,637,760,-123
47,Tennessee,12,Florida,33,Escambia County,505,541,-36
47,Tennessee,12,Florida,35,Flagler County,67,56,11
47,Tennessee,12,Florida,39,Gadsden County,2,0,2
47,Tennessee,12,Florida,45,Gulf County,0,47,-47
47,Tennessee,12,Florida,49,Hardee County,0,7,-7
47,Tennessee,12,Florida,51,Hendry County,0,179,-179
47,Tennessee,12,Florida,53,Hernando County,45,163,-118
47,Tennessee,12,Florida,55,Highlands County,84,25,59
47,Tennessee,12,Florida,57,Hillsborough County,1315,657,658
47,Tennessee,12,Florida,59,Holmes County,25,4,21
47,Tennessee,12,Florida,61,Indian River County,303,90,213
47,Tennessee,12,Florida,63,Jackson County,11,1,10
47,Tennessee,12,Florida,65,Jefferson County,65,91,-26
47,Tennessee,12,Florida,67,Lafayette County,0,13,-13
47,Tennessee,12,Florida,69,Lake County,314,396,-82
47,Tennessee,12,Florida,71,Lee County,435,446,-11
47,Tennessee,12,Florida,73,Leon County,420,214,206
47,Tennessee,12,Florida,75,Levy County,20,2,18
47,Tennessee,12,Florida,77,Liberty County,0,63,-63
47,Tennessee,12,Florida,79,Madison County,9,0,9
47,Tennessee,12,Florida,81,Manatee County,651,527,124
47,Tennessee,12,Florida,83,Marion County,377,267,110
47,Tennessee,12,Florida,85,Martin County,70,85,-15
47,Tennessee,12,Florida,86,Miami-Dade County,1076,311,765
47,Tennessee,12,Florida,87,Monroe County,61,129,-68
47,Tennessee,12,Florida,89,Nassau County,54,176,-122
47,Tennessee,12,Florida,91,Okaloosa County,522,953,-431
47,Tennessee,12,Florida,93,Okeechobee County,3,57,-54
47,Tennessee,12,Florida,95,Orange County,1173,754,419
47,Tennessee,12,Florida,97,Osceola County,444,247,197
47,Tennessee,12,Florida,99,Palm Beach County,1071,795,276
47,Tennessee,12,Florida,101,Pasco County,587,413,174
47,Tennessee,12,Florida,103,Pinellas County,809,939,-130
47,Tennessee,12,Florida,105,Polk County,681,409,272
47,Tennessee,12,Florida,107,Putnam County,0,28,-28
47,Tennessee,12,Florida,109,St. Johns County,239,149,90
47,Tennessee,12,Florida,111,St. Lucie County,173,336,-163
47,Tennessee,12,Florida,113,Santa Rosa County,437,229,208
47,Tennessee,12,Florida,115,Sarasota County,93,395,-302
47,Tennessee,12,Florida,117,Seminole County,274,153,121
47,Tennessee,12,Florida,119,Sumter County,56,207,-151
47,Tennessee,12,Florida,121,Suwannee County,55,0,55
47,Tennessee,12,Florida,125,Union County,0,30,-30
47,Tennessee,12,Florida,127,Volusia County,364,490,-126
47,Tennessee,12,Florida,129,Wakulla County,0,22,-22
47,Tennessee,12,Florida,131,Walton County,67,253,-186
47,Tennessee,12,Florida,133,Washington County,20,0,20
47,Tennessee,13,Georgia,1,Appling County,0,5,-5
47,Tennessee,13,Georgia,5,Bacon County,31,11,20
47,Tennessee,13,Georgia,9,Baldwin County,17,0,17
47,Tennessee,13,Georgia,13,Barrow County,112,27,85
47,Tennessee,13,Georgia,15,Bartow County,141,136,5
47,Tennessee,13,Georgia,17,Ben Hill County,13,0,13
47,Tennessee,13,Georgia,19,Berrien County,16,0,16
47,Tennessee,13,Georgia,21,Bibb County,42,133,-91
47,Tennessee,13,Georgia,23,Bleckley County,10,0,10
47,Tennessee,13,Georgia,25,Brantley County,0,38,-38
47,Tennessee,13,Georgia,27,Brooks County,9,0,9
47,Tennessee,13,Georgia,29,Bryan County,64,17,47
47,Tennessee,13,Georgia,31,Bulloch County,79,15,64
47,Tennessee,13,Georgia,35,Butts County,10,0,10
47,Tennessee,13,Georgia,37,Calhoun County,9,0,9
47,Tennessee,13,Georgia,39,Camden County,175,25,150
47,Tennessee,13,Georgia,43,Candler County,29,16,13
47,Tennessee,13,Georgia,45,Carroll County,110,23,87
47,Tennessee,13,Georgia,47,Catoosa County,1226,1528,-302
47,Tennessee,13,Georgia,51,Chatham County,405,718,-313
47,Tennessee,13,Georgia,53,Chattahoochee County,23,101,-78
47,Tennessee,13,Georgia,55,Chattooga County,8,44,-36
47,Tennessee,13,Georgia,57,Cherokee County,235,202,33
47,Tennessee,13,Georgia,59,Clarke County,165,332,-167
47,Tennessee,13,Georgia,63,Clayton County,293,291,2
47,Tennessee,13,Georgia,67,Cobb County,996,1029,-33
47,Tennessee,13,Georgia,71,Colquitt County,0,145,-145
47,Tennessee,13,Georgia,73,Columbia County,276,182,94
47,Tennessee,13,Georgia,75,Cook County,76,0,76
47,Tennessee,13,Georgia,77,Coweta County,98,193,-95
47,Tennessee,13,Georgia,83,Dade County,334,481,-147
47,Tennessee,13,Georgia,85,Dawson County,13,0,13
47,Tennessee,13,Georgia,89,DeKalb County,1427,856,571
47,Tennessee,13,Georgia,91,Dodge County,0,13,-13
47,Tennessee,13,Georgia,93,Dooly County,0,2,-2
47,Tennessee,13,Georgia,95,Dougherty County,12,12,0
47,Tennessee,13,Georgia,97,Douglas County,64,83,-19
47,Tennessee,13,Georgia,99,Early County,0,16,-16
47,Tennessee,13,Georgia,101,Echols County,0,6,-6
47,Tennessee,13,Georgia,103,Effingham County,19,212,-193
47,Tennessee,13,Georgia,109,Evans County,0,11,-11
47,Tennessee,13,Georgia,111,Fannin County,77,83,-6
47,Tennessee,13,Georgia,113,Fayette County,199,19,180
47,Tennessee,13,Georgia,115,Floyd County,109,277,-168
47,Tennessee,13,Georgia,117,Forsyth County,137,343,-206
47,Tennessee,13,Georgia,119,Franklin County,12,0,12
47,Tennessee,13,Georgia,121,Fulton County,1484,1764,-280
47,Tennessee,13,Georgia,123,Gilmer County,129,17,112
47,Tennessee,13,Georgia,125,Glascock County,0,29,-29
47,Tennessee,13,Georgia,127,Glynn County,14,129,-115
47,Tennessee,13,Georgia,129,Gordon County,129,262,-133
47,Tennessee,13,Georgia,131,Grady County,13,0,13
47,Tennessee,13,Georgia,135,Gwinnett County,762,1166,-404
47,Tennessee,13,Georgia,137,Habersham County,11,46,-35
47,Tennessee,13,Georgia,139,Hall County,29,113,-84
47,Tennessee,13,Georgia,143,Haralson County,0,6,-6
47,Tennessee,13,Georgia,145,Harris County,11,21,-10
47,Tennessee,13,Georgia,149,Heard County,59,25,34
47,Tennessee,13,Georgia,151,Henry County,232,438,-206
47,Tennessee,13,Georgia,153,Houston County,116,79,37
47,Tennessee,13,Georgia,155,Irwin County,0,14,-14
47,Tennessee,13,Georgia,157,Jackson County,22,5,17
47,Tennessee,13,Georgia,159,Jasper County,0,14,-14
47,Tennessee,13,Georgia,163,Jefferson County,0,4,-4
47,Tennessee,13,Georgia,165,Jenkins County,0,26,-26
47,Tennessee,13,Georgia,167,Johnson County,0,22,-22
47,Tennessee,13,Georgia,171,Lamar County,0,4,-4
47,Tennessee,13,Georgia,175,Laurens County,0,44,-44
47,Tennessee,13,Georgia,177,Lee County,7,0,7
47,Tennessee,13,Georgia,179,Liberty County,381,58,323
47,Tennessee,13,Georgia,183,Long County,36,146,-110
47,Tennessee,13,Georgia,185,Lowndes County,317,162,155
47,Tennessee,13,Georgia,187,Lumpkin County,6,0,6
47,Tennessee,13,Georgia,189,McDuffie County,14,55,-41
47,Tennessee,13,Georgia,191,McIntosh County,0,74,-74
47,Tennessee,13,Georgia,197,Marion County,0,6,-6
47,Tennessee,13,Georgia,199,Meriwether County,83,0,83
47,Tennessee,13,Georgia,207,Monroe County,0,52,-52
47,Tennessee,13,Georgia,211,Morgan County,8,0,8
47,Tennessee,13,Georgia,213,Murray County,84,104,-20
47,Tennessee,13,Georgia,215,Muscogee County,429,344,85
47,Tennessee,13,Georgia,217,Newton County,100,69,31
47,Tennessee,13,Georgia,219,Oconee County,50,46,4
47,Tennessee,13,Georgia,223,Paulding County,191,229,-38
47,Tennessee,13,Georgia,225,Peach County,0,7,-7
47,Tennessee,13,Georgia,227,Pickens County,0,37,-37
47,Tennessee,13,Georgia,231,Pike County,0,10,-10
47,Tennessee,13,Georgia,233,Polk County,0,45,-45
47,Tennessee,13,Georgia,235,Pulaski County,0,7,-7
47,Tennessee,13,Georgia,237,Putnam County,0,55,-55
47,Tennessee,13,Georgia,243,Randolph County,26,0,26
47,Tennessee,13,Georgia,245,Richmond County,505,619,-114
47,Tennessee,13,Georgia,247,Rockdale County,16,18,-2
47,Tennessee,13,Georgia,251,Screven County,0,6,-6
47,Tennessee,13,Georgia,255,Spalding County,36,6,30
47,Tennessee,13,Georgia,257,Stephens County,188,0,188
47,Tennessee,13,Georgia,261,Sumter County,6,0,6
47,Tennessee,13,Georgia,267,Tattnall County,46,18,28
47,Tennessee,13,Georgia,269,Taylor County,20,31,-11
47,Tennessee,13,Georgia,275,Thomas County,0,176,-176
47,Tennessee,13,Georgia,277,Tift County,0,2,-2
47,Tennessee,13,Georgia,279,Toombs County,3,0,3
47,Tennessee,13,Georgia,281,Towns County,61,0,61
47,Tennessee,13,Georgia,285,Troup County,13,49,-36
47,Tennessee,13,Georgia,287,Turner County,12,0,12
47,Tennessee,13,Georgia,291,Union County,68,18,50
47,Tennessee,13,Georgia,293,Upson County,60,28,32
47,Tennessee,13,Georgia,295,Walker County,1919,1677,242
47,Tennessee,13,Georgia,297,Walton County,63,185,-122
47,Tennessee,13,Georgia,299,Ware County,24,143,-119
47,Tennessee,13,Georgia,303,Washington County,17,5,12
47,Tennessee,13,Georgia,305,Wayne County,49,58,-9
47,Tennessee,13,Georgia,311,White County,30,37,-7
47,Tennessee,13,Georgia,313,Whitfield County,710,551,159
47,Tennessee,13,Georgia,317,Wilkes County,0,28,-28
47,Tennessee,13,Georgia,321,Worth County,0,82,-82
47,Tennessee,15,Hawaii,1,Hawaii County,0,208,-208
47,Tennessee,15,Hawaii,3,Honolulu County,666,603,63
47,Tennessee,15,Hawaii,7,Kauai County,72,9,63
47,Tennessee,16,Idaho,1,Ada County,30,123,-93
47,Tennessee,16,Idaho,5,Bannock County,162,89,73
47,Tennessee,16,Idaho,9,Benewah County,0,2,-2
47,Tennessee,16,Idaho,17,Bonner County,0,13,-13
47,Tennessee,16,Idaho,19,Bonneville County,98,73,25
47,Tennessee,16,Idaho,27,Canyon County,13,81,-68
47,Tennessee,16,Idaho,39,Elmore County,0,113,-113
47,Tennessee,16,Idaho,53,Jerome County,4,9,-5
47,Tennessee,16,Idaho,55,Kootenai County,56,27,29
47,Tennessee,16,Idaho,57,Latah County,22,0,22
47,Tennessee,16,Idaho,65,Madison County,483,19,464
47,Tennessee,16,Idaho,69,Nez Perce County,0,95,-95
47,Tennessee,16,Idaho,73,Owyhee County,0,3,-3
47,Tennessee,16,Idaho,77,Power County,16,0,16
47,Tennessee,16,Idaho,81,Teton County,26,20,6
47,Tennessee,16,Idaho,83,Twin Falls County,21,20,1
47,Tennessee,16,Idaho,85,Valley County,0,1,-1
47,Tennessee,17,Illinois,5,Bond County,0,80,-80
47,Tennessee,17,Illinois,7,Boone County,69,44,25
47,Tennessee,17,Illinois,9,Brown County,0,2,-2
47,Tennessee,17,Illinois,17,Cass County,0,2,-2
47,Tennessee,17,Illinois,19,Champaign County,112,357,-245
47,Tennessee,17,Illinois,21,Christian County,53,3,50
47,Tennessee,17,Illinois,23,Clark County,10,6,4
47,Tennessee,17,Illinois,27,Clinton County,0,10,-10
47,Tennessee,17,Illinois,29,Coles County,43,201,-158
47,Tennessee,17,Illinois,31,Cook County,3301,1497,1804
47,Tennessee,17,Illinois,33,Crawford County,0,20,-20
47,Tennessee,17,Illinois,37,DeKalb County,0,119,-119
47,Tennessee,17,Illinois,39,De Witt County,305,0,305
47,Tennessee,17,Illinois,43,DuPage County,433,234,199
47,Tennessee,17,Illinois,47,Edwards County,46,0,46
47,Tennessee,17,Illinois,49,Effingham County,217,3,214
47,Tennessee,17,Illinois,51,Fayette County,0,121,-121
47,Tennessee,17,Illinois,55,Franklin County,79,0,79
47,Tennessee,17,Illinois,57,Fulton County,0,18,-18
47,Tennessee,17,Illinois,59,Gallatin County,0,4,-4
47,Tennessee,17,Illinois,61,Greene County,0,20,-20
47,Tennessee,17,Illinois,63,Grundy County,33,34,-1
47,Tennessee,17,Illinois,67,Hancock County,0,12,-12
47,Tennessee,17,Illinois,69,Hardin County,173,0,173
47,Tennessee,17,Illinois,73,Henry County,48,0,48
47,Tennessee,17,Illinois,75,Iroquois County,3,51,-48
47,Tennessee,17,Illinois,77,Jackson County,120,58,62
47,Tennessee,17,Illinois,81,Jefferson County,24,41,-17
47,Tennessee,17,Illinois,85,Jo Daviess County,11,2,9
47,Tennessee,17,Illinois,89,Kane County,793,329,464
47,Tennessee,17,Illinois,91,Kankakee County,57,26,31
47,Tennessee,17,Illinois,93,Kendall County,90,2,88
47,Tennessee,17,Illinois,95,Knox County,0,7,-7
47,Tennessee,17,Illinois,97,Lake County,523,312,211
47,Tennessee,17,Illinois,99,LaSalle County,56,31,25
47,Tennessee,17,Illinois,101,Lawrence County,10,0,10
47,Tennessee,17,Illinois,105,Livingston County,21,14,7
47,Tennessee,17,Illinois,109,McDonough County,0,46,-46
47,Tennessee,17,Illinois,111,McHenry County,156,41,115
47,Tennessee,17,Illinois,113,McLean County,245,226,19
47,Tennessee,17,Illinois,115,Macon County,84,59,25
47,Tennessee,17,Illinois,117,Macoupin County,41,52,-11
47,Tennessee,17,Illinois,119,Madison County,277,122,155
47,Tennessee,17,Illinois,121,Marion County,12,20,-8
47,Tennessee,17,Illinois,125,Mason County,0,6,-6
47,Tennessee,17,Illinois,127,Massac County,0,171,-171
47,Tennessee,17,Illinois,131,Mercer County,24,0,24
47,Tennessee,17,Illinois,135,Montgomery County,0,14,-14
47,Tennessee,17,Illinois,137,Morgan County,0,96,-96
47,Tennessee,17,Illinois,139,Moultrie County,8,0,8
47,Tennessee,17,Illinois,141,Ogle County,42,0,42
47,Tennessee,17,Illinois,143,Peoria County,117,53,64
47,Tennessee,17,Illinois,145,Perry County,0,32,-32
47,Tennessee,17,Illinois,151,Pope County,0,28,-28
47,Tennessee,17,Illinois,153,Pulaski County,1,0,1
47,Tennessee,17,Illinois,157,Randolph County,0,15,-15
47,Tennessee,17,Illinois,161,Rock Island County,91,31,60
47,Tennessee,17,Illinois,163,St. Clair County,136,261,-125
47,Tennessee,17,Illinois,165,Saline County,23,22,1
47,Tennessee,17,Illinois,167,Sangamon County,191,34,157
47,Tennessee,17,Illinois,179,Tazewell County,235,17,218
47,Tennessee,17,Illinois,183,Vermilion County,135,12,123
47,Tennessee,17,Illinois,185,Wabash County,0,2,-2
47,Tennessee,17,Illinois,187,Warren County,54,6,48
47,Tennessee,17,Illinois,195,Whiteside County,76,0,76
47,Tennessee,17,Illinois,197,Will County,469,77,392
47,Tennessee,17,Illinois,199,Williamson County,184,95,89
47,Tennessee,17,Illinois,201,Winnebago County,210,122,88
47,Tennessee,17,Illinois,203,Woodford County,138,0,138
47,Tennessee,18,Indiana,3,Allen County,359,226,133
47,Tennessee,18,Indiana,5,Bartholomew County,206,77,129
47,Tennessee,18,Indiana,11,Boone County,11,70,-59
47,Tennessee,18,Indiana,13,Brown County,0,32,-32
47,Tennessee,18,Indiana,17,Cass County,0,7,-7
47,Tennessee,18,Indiana,19,Clark County,14,37,-23
47,Tennessee,18,Indiana,23,Clinton County,13,10,3
47,Tennessee,18,Indiana,27,Daviess County,0,50,-50
47,Tennessee,18,Indiana,29,Dearborn County,53,30,23
47,Tennessee,18,Indiana,31,Decatur County,10,0,10
47,Tennessee,18,Indiana,33,DeKalb County,0,15,-15
47,Tennessee,18,Indiana,35,Delaware County,204,11,193
47,Tennessee,18,Indiana,37,Dubois County,39,129,-90
47,Tennessee,18,Indiana,39,Elkhart County,193,58,135
47,Tennessee,18,Indiana,41,Fayette County,0,14,-14
47,Tennessee,18,Indiana,43,Floyd County,95,114,-19
47,Tennessee,18,Indiana,45,Fountain County,25,4,21
47,Tennessee,18,Indiana,47,Franklin County,0,4,-4
47,Tennessee,18,Indiana,49,Fulton County,1,0,1
47,Tennessee,18,Indiana,51,Gibson County,0,8,-8
47,Tennessee,18,Indiana,53,Grant County,60,24,36
47,Tennessee,18,Indiana,55,Greene County,14,31,-17
47,Tennessee,18,Indiana,57,Hamilton County,198,206,-8
47,Tennessee,18,Indiana,59,Hancock County,105,16,89
47,Tennessee,18,Indiana,61,Harrison County,10,0,10
47,Tennessee,18,Indiana,63,Hendricks County,89,11,78
47,Tennessee,18,Indiana,65,Henry County,0,12,-12
47,Tennessee,18,Indiana,67,Howard County,28,43,-15
47,Tennessee,18,Indiana,69,Huntington County,0,7,-7
47,Tennessee,18,Indiana,71,Jackson County,21,40,-19
47,Tennessee,18,Indiana,73,Jasper County,128,73,55
47,Tennessee,18,Indiana,77,Jefferson County,37,28,9
47,Tennessee,18,Indiana,79,Jennings County,0,21,-21
47,Tennessee,18,Indiana,81,Johnson County,236,21,215
47,Tennessee,18,Indiana,85,Kosciusko County,28,122,-94
47,Tennessee,18,Indiana,89,Lake County,538,102,436
47,Tennessee,18,Indiana,91,LaPorte County,10,165,-155
47,Tennessee,18,Indiana,93,Lawrence County,6,15,-9
47,Tennessee,18,Indiana,95,Madison County,130,30,100
47,Tennessee,18,Indiana,97,Marion County,671,309,362
47,Tennessee,18,Indiana,99,Marshall County,66,5,61
47,Tennessee,18,Indiana,101,Martin County,0,23,-23
47,Tennessee,18,Indiana,103,Miami County,58,0,58
47,Tennessee,18,Indiana,105,Monroe County,59,216,-157
47,Tennessee,18,Indiana,107,Montgomery County,45,3,42
47,Tennessee,18,Indiana,109,Morgan County,25,26,-1
47,Tennessee,18,Indiana,111,Newton County,20,85,-65
47,Tennessee,18,Indiana,113,Noble County,218,4,214
47,Tennessee,18,Indiana,115,Ohio County,0,95,-95
47,Tennessee,18,Indiana,117,Orange County,25,68,-43
47,Tennessee,18,Indiana,121,Parke County,26,0,26
47,Tennessee,18,Indiana,123,Perry County,0,20,-20
47,Tennessee,18,Indiana,125,Pike County,7,0,7
47,Tennessee,18,Indiana,127,Porter County,130,18,112
47,Tennessee,18,Indiana,129,Posey County,0,7,-7
47,Tennessee,18,Indiana,133,Putnam County,0,42,-42
47,Tennessee,18,Indiana,135,Randolph County,0,62,-62
47,Tennessee,18,Indiana,137,Ripley County,30,22,8
47,Tennessee,18,Indiana,139,Rush County,0,39,-39
47,Tennessee,18,Indiana,141,St. Joseph County,51,133,-82
47,Tennessee,18,Indiana,147,Spencer County,76,19,57
47,Tennessee,18,Indiana,157,Tippecanoe County,367,110,257
47,Tennessee,18,Indiana,159,Tipton County,6,0,6
47,Tennessee,18,Indiana,163,Vanderburgh County,551,162,389
47,Tennessee,18,Indiana,167,Vigo County,103,51,52
47,Tennessee,18,Indiana,169,Wabash County,0,33,-33
47,Tennessee,18,Indiana,173,Warrick County,3,0,3
47,Tennessee,18,Indiana,175,Washington County,27,0,27
47,Tennessee,18,Indiana,177,Wayne County,32,73,-41
47,Tennessee,18,Indiana,181,White County,1,0,1
47,Tennessee,18,Indiana,183,Whitley County,8,77,-69
47,Tennessee,19,Iowa,7,Appanoose County,0,16,-16
47,Tennessee,19,Iowa,15,Boone County,16,0,16
47,Tennessee,19,Iowa,19,Buchanan County,0,7,-7
47,Tennessee,19,Iowa,27,Carroll County,149,0,149
47,Tennessee,19,Iowa,29,Cass County,40,0,40
47,Tennessee,19,Iowa,37,Chickasaw County,0,3,-3
47,Tennessee,19,Iowa,43,Clayton County,0,22,-22
47,Tennessee,19,Iowa,53,Decatur County,0,5,-5
47,Tennessee,19,Iowa,57,Des Moines County,0,8,-8
47,Tennessee,19,Iowa,59,Dickinson County,0,5,-5
47,Tennessee,19,Iowa,61,Dubuque County,41,88,-47
47,Tennessee,19,Iowa,63,Emmet County,0,1,-1
47,Tennessee,19,Iowa,97,Jackson County,0,50,-50
47,Tennessee,19,Iowa,103,Johnson County,70,283,-213
47,Tennessee,19,Iowa,111,Lee County,29,0,29
47,Tennessee,19,Iowa,113,Linn County,25,137,-112
47,Tennessee,19,Iowa,123,Mahaska County,7,0,7
47,Tennessee,19,Iowa,127,Marshall County,43,0,43
47,Tennessee,19,Iowa,137,Montgomery County,0,4,-4
47,Tennessee,19,Iowa,141,O'Brien County,0,15,-15
47,Tennessee,19,Iowa,149,Plymouth County,0,54,-54
47,Tennessee,19,Iowa,153,Polk County,247,93,154
47,Tennessee,19,Iowa,155,Pottawattamie County,0,47,-47
47,Tennessee,19,Iowa,157,Poweshiek County,6,28,-22
47,Tennessee,19,Iowa,161,Sac County,0,31,-31
47,Tennessee,19,Iowa,163,Scott County,18,68,-50
47,Tennessee,19,Iowa,169,Story County,63,7,56
47,Tennessee,19,Iowa,179,Wapello County,0,46,-46
47,Tennessee,19,Iowa,181,Warren County,14,0,14
47,Tennessee,19,Iowa,183,Washington County,0,9,-9
47,Tennessee,19,Iowa,187,Webster County,0,15,-15
47,Tennessee,19,Iowa,193,Woodbury County,20,4,16
47,Tennessee,19,Iowa,195,Worth County,10,0,10
47,Tennessee,2,Alaska,13,Aleutians East Borough,0,4,-4
47,Tennessee,2,Alaska,20,Anchorage Municipality,654,58,596
47,Tennessee,2,Alaska,90,Fairbanks North Star Borough,115,177,-62
47,Tennessee,2,Alaska,100,Haines Borough,0,6,-6
47,Tennessee,2,Alaska,110,Juneau City and Borough,0,3,-3
47,Tennessee,2,Alaska,122,Kenai Peninsula Borough,0,8,-8
47,Tennessee,2,Alaska,130,Ketchikan Gateway Borough,84,16,68
47,Tennessee,2,Alaska,150,Kodiak Island Borough,0,4,-4
47,Tennessee,2,Alaska,170,Matanuska-Susitna Borough,117,32,85
47,Tennessee,2,Alaska,180,Nome Census Area,0,2,-2
47,Tennessee,2,Alaska,185,North Slope Borough,0,5,-5
47,Tennessee,2,Alaska,198,Prince of Wales-Hyder Census Area,64,0,64
47,Tennessee,2,Alaska,220,Sitka City and Borough,0,33,-33
47,Tennessee,2,Alaska,240,Southeast Fairbanks Census Area,0,19,-19
47,Tennessee,2,Alaska,261,Valdez-Cordova Census Area,0,2,-2
47,Tennessee,2,Alaska,275,Wrangell City and Borough,29,0,29
47,Tennessee,2,Alaska,290,Yukon-Koyukuk Census Area,0,16,-16
47,Tennessee,20,Kansas,3,Anderson County,0,5,-5
47,Tennessee,20,Kansas,5,Atchison County,0,3,-3
47,Tennessee,20,Kansas,9,Barton County,72,0,72
47,Tennessee,20,Kansas,19,Chautauqua County,0,3,-3
47,Tennessee,20,Kansas,21,Cherokee County,0,10,-10
47,Tennessee,20,Kansas,25,Clark County,0,16,-16
47,Tennessee,20,Kansas,27,Clay County,0,4,-4
47,Tennessee,20,Kansas,31,Coffey County,0,7,-7
47,Tennessee,20,Kansas,35,Cowley County,16,0,16
47,Tennessee,20,Kansas,37,Crawford County,0,22,-22
47,Tennessee,20,Kansas,41,Dickinson County,57,11,46
47,Tennessee,20,Kansas,43,Doniphan County,0,2,-2
47,Tennessee,20,Kansas,45,Douglas County,111,16,95
47,Tennessee,20,Kansas,49,Elk County,0,8,-8
47,Tennessee,20,Kansas,51,Ellis County,0,13,-13
47,Tennessee,20,Kansas,61,Geary County,60,168,-108
47,Tennessee,20,Kansas,85,Jackson County,0,9,-9
47,Tennessee,20,Kansas,87,Jefferson County,89,0,89
47,Tennessee,20,Kansas,91,Johnson County,204,267,-63
47,Tennessee,20,Kansas,93,Kearny County,0,22,-22
47,Tennessee,20,Kansas,99,Labette County,8,0,8
47,Tennessee,20,Kansas,103,Leavenworth County,79,160,-81
47,Tennessee,20,Kansas,113,McPherson County,8,0,8
47,Tennessee,20,Kansas,123,Mitchell County,0,1,-1
47,Tennessee,20,Kansas,125,Montgomery County,0,20,-20
47,Tennessee,20,Kansas,143,Ottawa County,0,9,-9
47,Tennessee,20,Kansas,155,Reno County,90,0,90
47,Tennessee,20,Kansas,161,Riley County,123,111,12
47,Tennessee,20,Kansas,163,Rooks County,0,3,-3
47,Tennessee,20,Kansas,169,Saline County,31,49,-18
47,Tennessee,20,Kansas,173,Sedgwick County,300,266,34
47,Tennessee,20,Kansas,177,Shawnee County,0,28,-28
47,Tennessee,20,Kansas,191,Sumner County,396,15,381
47,Tennessee,20,Kansas,197,Wabaunsee County,23,0,23
47,Tennessee,20,Kansas,209,Wyandotte County,22,2,20
47,Tennessee,21,Kentucky,1,Adair County,0,3,-3
47,Tennessee,21,Kentucky,3,Allen County,91,324,-233
47,Tennessee,21,Kentucky,9,Barren County,67,122,-55
47,Tennessee,21,Kentucky,11,Bath County,0,25,-25
47,Tennessee,21,Kentucky,13,Bell County,214,81,133
47,Tennessee,21,Kentucky,15,Boone County,45,130,-85
47,Tennessee,21,Kentucky,17,Bourbon County,42,0,42
47,Tennessee,21,Kentucky,19,Boyd County,24,25,-1
47,Tennessee,21,Kentucky,21,Boyle County,20,207,-187
47,Tennessee,21,Kentucky,25,Breathitt County,0,9,-9
47,Tennessee,21,Kentucky,27,Breckinridge County,70,0,70
47,Tennessee,21,Kentucky,29,Bullitt County,40,11,29
47,Tennessee,21,Kentucky,31,Butler County,0,22,-22
47,Tennessee,21,Kentucky,33,Caldwell County,86,0,86
47,Tennessee,21,Kentucky,35,Calloway County,207,349,-142
47,Tennessee,21,Kentucky,37,Campbell County,0,67,-67
47,Tennessee,21,Kentucky,39,Carlisle County,0,6,-6
47,Tennessee,21,Kentucky,41,Carroll County,89,31,58
47,Tennessee,21,Kentucky,43,Carter County,33,28,5
47,Tennessee,21,Kentucky,45,Casey County,15,0,15
47,Tennessee,21,Kentucky,47,Christian County,3292,1779,1513
47,Tennessee,21,Kentucky,49,Clark County,26,150,-124
47,Tennessee,21,Kentucky,51,Clay County,28,48,-20
47,Tennessee,21,Kentucky,53,Clinton County,47,84,-37
47,Tennessee,21,Kentucky,55,Crittenden County,0,5,-5
47,Tennessee,21,Kentucky,57,Cumberland County,7,14,-7
47,Tennessee,21,Kentucky,59,Daviess County,275,143,132
47,Tennessee,21,Kentucky,61,Edmonson County,11,51,-40
47,Tennessee,21,Kentucky,67,Fayette County,685,644,41
47,Tennessee,21,Kentucky,69,Fleming County,57,0,57
47,Tennessee,21,Kentucky,71,Floyd County,3,75,-72
47,Tennessee,21,Kentucky,73,Franklin County,19,129,-110
47,Tennessee,21,Kentucky,75,Fulton County,326,87,239
47,Tennessee,21,Kentucky,79,Garrard County,61,13,48
47,Tennessee,21,Kentucky,81,Grant County,0,7,-7
47,Tennessee,21,Kentucky,83,Graves County,29,62,-33
47,Tennessee,21,Kentucky,87,Green County,8,0,8
47,Tennessee,21,Kentucky,89,Greenup County,0,6,-6
47,Tennessee,21,Kentucky,93,Hardin County,252,197,55
47,Tennessee,21,Kentucky,95,Harlan County,67,46,21
47,Tennessee,21,Kentucky,101,Henderson County,8,49,-41
47,Tennessee,21,Kentucky,103,Henry County,6,0,6
47,Tennessee,21,Kentucky,105,Hickman County,25,61,-36
47,Tennessee,21,Kentucky,107,Hopkins County,194,55,139
47,Tennessee,21,Kentucky,111,Jefferson County,949,1284,-335
47,Tennessee,21,Kentucky,113,Jessamine County,10,131,-121
47,Tennessee,21,Kentucky,115,Johnson County,2,2,0
47,Tennessee,21,Kentucky,117,Kenton County,74,192,-118
47,Tennessee,21,Kentucky,119,Knott County,29,31,-2
47,Tennessee,21,Kentucky,121,Knox County,51,39,12
47,Tennessee,21,Kentucky,123,Larue County,8,5,3
47,Tennessee,21,Kentucky,125,Laurel County,255,32,223
47,Tennessee,21,Kentucky,127,Lawrence County,21,0,21
47,Tennessee,21,Kentucky,131,Leslie County,66,0,66
47,Tennessee,21,Kentucky,133,Letcher County,187,0,187
47,Tennessee,21,Kentucky,135,Lewis County,0,5,-5
47,Tennessee,21,Kentucky,137,Lincoln County,3,0,3
47,Tennessee,21,Kentucky,139,Livingston County,16,8,8
47,Tennessee,21,Kentucky,141,Logan County,237,139,98
47,Tennessee,21,Kentucky,143,Lyon County,0,12,-12
47,Tennessee,21,Kentucky,145,McCracken County,437,271,166
47,Tennessee,21,Kentucky,147,McCreary County,144,72,72
47,Tennessee,21,Kentucky,151,Madison County,308,432,-124
47,Tennessee,21,Kentucky,155,Marion County,0,31,-31
47,Tennessee,21,Kentucky,157,Marshall County,163,39,124
47,Tennessee,21,Kentucky,159,Martin County,0,34,-34
47,Tennessee,21,Kentucky,163,Meade County,35,106,-71
47,Tennessee,21,Kentucky,165,Menifee County,0,2,-2
47,Tennessee,21,Kentucky,167,Mercer County,154,18,136
47,Tennessee,21,Kentucky,169,Metcalfe County,139,104,35
47,Tennessee,21,Kentucky,171,Monroe County,0,110,-110
47,Tennessee,21,Kentucky,173,Montgomery County,29,151,-122
47,Tennessee,21,Kentucky,175,Morgan County,37,17,20
47,Tennessee,21,Kentucky,177,Muhlenberg County,161,121,40
47,Tennessee,21,Kentucky,179,Nelson County,21,36,-15
47,Tennessee,21,Kentucky,183,Ohio County,1,23,-22
47,Tennessee,21,Kentucky,185,Oldham County,8,139,-131
47,Tennessee,21,Kentucky,193,Perry County,50,8,42
47,Tennessee,21,Kentucky,195,Pike County,71,211,-140
47,Tennessee,21,Kentucky,197,Powell County,91,11,80
47,Tennessee,21,Kentucky,199,Pulaski County,156,55,101
47,Tennessee,21,Kentucky,203,Rockcastle County,8,5,3
47,Tennessee,21,Kentucky,205,Rowan County,29,34,-5
47,Tennessee,21,Kentucky,207,Russell County,48,0,48
47,Tennessee,21,Kentucky,209,Scott County,48,55,-7
47,Tennessee,21,Kentucky,211,Shelby County,21,181,-160
47,Tennessee,21,Kentucky,213,Simpson County,281,114,167
47,Tennessee,21,Kentucky,217,Taylor County,0,20,-20
47,Tennessee,21,Kentucky,219,Todd County,127,132,-5
47,Tennessee,21,Kentucky,221,Trigg County,169,15,154
47,Tennessee,21,Kentucky,223,Trimble County,0,12,-12
47,Tennessee,21,Kentucky,225,Union County,51,162,-111
47,Tennessee,21,Kentucky,227,Warren County,642,1162,-520
47,Tennessee,21,Kentucky,229,Washington County,0,17,-17
47,Tennessee,21,Kentucky,235,Whitley County,144,248,-104
47,Tennessee,21,Kentucky,239,Woodford County,16,19,-3
47,Tennessee,22,Louisiana,1,Acadia Parish,0,20,-20
47,Tennessee,22,Louisiana,3,Allen Parish,0,26,-26
47,Tennessee,22,Louisiana,11,Beauregard Parish,52,64,-12
47,Tennessee,22,Louisiana,15,Bossier Parish,55,33,22
47,Tennessee,22,Louisiana,17,Caddo Parish,24,22,2
47,Tennessee,22,Louisiana,19,Calcasieu Parish,101,0,101
47,Tennessee,22,Louisiana,25,Catahoula Parish,0,5,-5
47,Tennessee,22,Louisiana,33,East Baton Rouge Parish,585,105,480
47,Tennessee,22,Louisiana,35,East Carroll Parish,0,4,-4
47,Tennessee,22,Louisiana,37,East Feliciana Parish,29,9,20
47,Tennessee,22,Louisiana,39,Evangeline Parish,0,19,-19
47,Tennessee,22,Louisiana,43,Grant Parish,0,13,-13
47,Tennessee,22,Louisiana,45,Iberia Parish,50,26,24
47,Tennessee,22,Louisiana,47,Iberville Parish,16,0,16
47,Tennessee,22,Louisiana,51,Jefferson Parish,198,404,-206
47,Tennessee,22,Louisiana,55,Lafayette Parish,196,367,-171
47,Tennessee,22,Louisiana,57,Lafourche Parish,48,69,-21
47,Tennessee,22,Louisiana,61,Lincoln Parish,54,41,13
47,Tennessee,22,Louisiana,63,Livingston Parish,238,0,238
47,Tennessee,22,Louisiana,65,Madison Parish,29,0,29
47,Tennessee,22,Louisiana,69,Natchitoches Parish,73,0,73
47,Tennessee,22,Louisiana,71,Orleans Parish,632,333,299
47,Tennessee,22,Louisiana,73,Ouachita Parish,29,92,-63
47,Tennessee,22,Louisiana,75,Plaquemines Parish,0,4,-4
47,Tennessee,22,Louisiana,77,Pointe Coupee Parish,0,61,-61
47,Tennessee,22,Louisiana,79,Rapides Parish,159,78,81
47,Tennessee,22,Louisiana,87,St. Bernard Parish,290,19,271
47,Tennessee,22,Louisiana,89,St. Charles Parish,31,0,31
47,Tennessee,22,Louisiana,91,St. Helena Parish,11,0,11
47,Tennessee,22,Louisiana,95,St. John the Baptist Parish,0,6,-6
47,Tennessee,22,Louisiana,99,St. Martin Parish,0,21,-21
47,Tennessee,22,Louisiana,101,St. Mary Parish,15,18,-3
47,Tennessee,22,Louisiana,103,St. Tammany Parish,45,194,-149
47,Tennessee,22,Louisiana,105,Tangipahoa Parish,0,48,-48
47,Tennessee,22,Louisiana,109,Terrebonne Parish,102,76,26
47,Tennessee,22,Louisiana,113,Vermilion Parish,8,7,1
47,Tennessee,22,Louisiana,115,Vernon Parish,74,151,-77
47,Tennessee,22,Louisiana,117,Washington Parish,14,51,-37
47,Tennessee,22,Louisiana,121,West Baton Rouge Parish,0,18,-18
47,Tennessee,22,Louisiana,123,West Carroll Parish,0,22,-22
47,Tennessee,23,Maine,1,Androscoggin County,24,15,9
47,Tennessee,23,Maine,3,Aroostook County,15,2,13
47,Tennessee,23,Maine,5,Cumberland County,222,84,138
47,Tennessee,23,Maine,7,Franklin County,0,20,-20
47,Tennessee,23,Maine,9,Hancock County,48,2,46
47,Tennessee,23,Maine,11,Kennebec County,9,14,-5
47,Tennessee,23,Maine,15,Lincoln County,0,16,-16
47,Tennessee,23,Maine,17,Oxford County,384,11,373
47,Tennessee,23,Maine,19,Penobscot County,140,41,99
47,Tennessee,23,Maine,21,Piscataquis County,4,0,4
47,Tennessee,23,Maine,27,Waldo County,19,3,16
47,Tennessee,23,Maine,31,York County,63,0,63
47,Tennessee,24,Maryland,3,Anne Arundel County,364,151,213
47,Tennessee,24,Maryland,5,Baltimore County,103,75,28
47,Tennessee,24,Maryland,9,Calvert County,0,23,-23
47,Tennessee,24,Maryland,13,Carroll County,37,0,37
47,Tennessee,24,Maryland,15,Cecil County,25,242,-217
47,Tennessee,24,Maryland,17,Charles County,32,8,24
47,Tennessee,24,Maryland,19,Dorchester County,79,0,79
47,Tennessee,24,Maryland,21,Frederick County,11,66,-55
47,Tennessee,24,Maryland,25,Harford County,74,51,23
47,Tennessee,24,Maryland,27,Howard County,25,20,5
47,Tennessee,24,Maryland,31,Montgomery County,245,476,-231
47,Tennessee,24,Maryland,33,Prince George's County,477,108,369
47,Tennessee,24,Maryland,37,St. Mary's County,79,0,79
47,Tennessee,24,Maryland,39,Somerset County,0,7,-7
47,Tennessee,24,Maryland,41,Talbot County,0,46,-46
47,Tennessee,24,Maryland,43,Washington County,95,14,81
47,Tennessee,24,Maryland,47,Worcester County,68,0,68
47,Tennessee,24,Maryland,510,Baltimore city,112,151,-39
47,Tennessee,25,Massachusetts,1,Barnstable County,34,80,-46
47,Tennessee,25,Massachusetts,3,Berkshire County,67,38,29
47,Tennessee,25,Massachusetts,5,Bristol County,345,0,345
47,Tennessee,25,Massachusetts,9,Essex County,183,24,159
47,Tennessee,25,Massachusetts,11,Franklin County,0,28,-28
47,Tennessee,25,Massachusetts,13,Hampden County,113,55,58
47,Tennessee,25,Massachusetts,15,Hampshire County,31,11,20
47,Tennessee,25,Massachusetts,17,Middlesex County,629,294,335
47,Tennessee,25,Massachusetts,21,Norfolk County,202,161,41
47,Tennessee,25,Massachusetts,23,Plymouth County,8,17,-9
47,Tennessee,25,Massachusetts,25,Suffolk County,315,46,269
47,Tennessee,25,Massachusetts,27,Worcester County,228,19,209
47,Tennessee,26,Michigan,1,Alcona County,19,11,8
47,Tennessee,26,Michigan,5,Allegan County,33,4,29
47,Tennessee,26,Michigan,7,Alpena County,123,18,105
47,Tennessee,26,Michigan,9,Antrim County,0,6,-6
47,Tennessee,26,Michigan,11,Arenac County,33,0,33
47,Tennessee,26,Michigan,15,Barry County,0,13,-13
47,Tennessee,26,Michigan,17,Bay County,0,28,-28
47,Tennessee,26,Michigan,19,Benzie County,0,35,-35
47,Tennessee,26,Michigan,21,Berrien County,92,45,47
47,Tennessee,26,Michigan,23,Branch County,36,80,-44
47,Tennessee,26,Michigan,25,Calhoun County,34,66,-32
47,Tennessee,26,Michigan,27,Cass County,0,38,-38
47,Tennessee,26,Michigan,29,Charlevoix County,23,0,23
47,Tennessee,26,Michigan,31,Cheboygan County,33,27,6
47,Tennessee,26,Michigan,33,Chippewa County,0,65,-65
47,Tennessee,26,Michigan,35,Clare County,7,15,-8
47,Tennessee,26,Michigan,37,Clinton County,5,61,-56
47,Tennessee,26,Michigan,43,Dickinson County,0,30,-30
47,Tennessee,26,Michigan,45,Eaton County,46,115,-69
47,Tennessee,26,Michigan,47,Emmet County,0,9,-9
47,Tennessee,26,Michigan,49,Genesee County,343,492,-149
47,Tennessee,26,Michigan,51,Gladwin County,0,8,-8
47,Tennessee,26,Michigan,53,Gogebic County,0,2,-2
47,Tennessee,26,Michigan,55,Grand Traverse County,14,6,8
47,Tennessee,26,Michigan,57,Gratiot County,99,5,94
47,Tennessee,26,Michigan,59,Hillsdale County,0,50,-50
47,Tennessee,26,Michigan,61,Houghton County,0,5,-5
47,Tennessee,26,Michigan,63,Huron County,0,7,-7
47,Tennessee,26,Michigan,65,Ingham County,160,104,56
47,Tennessee,26,Michigan,67,Ionia County,13,3,10
47,Tennessee,26,Michigan,69,Iosco County,11,0,11
47,Tennessee,26,Michigan,73,Isabella County,8,0,8
47,Tennessee,26,Michigan,75,Jackson County,22,0,22
47,Tennessee,26,Michigan,77,Kalamazoo County,104,16,88
47,Tennessee,26,Michigan,81,Kent County,185,390,-205
47,Tennessee,26,Michigan,87,Lapeer County,109,42,67
47,Tennessee,26,Michigan,89,Leelanau County,0,14,-14
47,Tennessee,26,Michigan,91,Lenawee County,121,12,109
47,Tennessee,26,Michigan,93,Livingston County,28,17,11
47,Tennessee,26,Michigan,97,Mackinac County,0,12,-12
47,Tennessee,26,Michigan,99,Macomb County,185,326,-141
47,Tennessee,26,Michigan,103,Marquette County,0,60,-60
47,Tennessee,26,Michigan,105,Mason County,69,0,69
47,Tennessee,26,Michigan,107,Mecosta County,84,0,84
47,Tennessee,26,Michigan,109,Menominee County,33,9,24
47,Tennessee,26,Michigan,111,Midland County,61,53,8
47,Tennessee,26,Michigan,113,Missaukee County,0,15,-15
47,Tennessee,26,Michigan,115,Monroe County,147,97,50
47,Tennessee,26,Michigan,117,Montcalm County,57,0,57
47,Tennessee,26,Michigan,121,Muskegon County,38,170,-132
47,Tennessee,26,Michigan,123,Newaygo County,36,44,-8
47,Tennessee,26,Michigan,125,Oakland County,716,504,212
47,Tennessee,26,Michigan,127,Oceana County,0,1,-1
47,Tennessee,26,Michigan,129,Ogemaw County,0,4,-4
47,Tennessee,26,Michigan,133,Osceola County,0,20,-20
47,Tennessee,26,Michigan,137,Otsego County,0,17,-17
47,Tennessee,26,Michigan,139,Ottawa County,96,242,-146
47,Tennessee,26,Michigan,141,Presque Isle County,0,2,-2
47,Tennessee,26,Michigan,143,Roscommon County,72,27,45
47,Tennessee,26,Michigan,145,Saginaw County,84,37,47
47,Tennessee,26,Michigan,147,St. Clair County,146,48,98
47,Tennessee,26,Michigan,149,St. Joseph County,46,128,-82
47,Tennessee,26,Michigan,151,Sanilac County,0,3,-3
47,Tennessee,26,Michigan,155,Shiawassee County,103,219,-116
47,Tennessee,26,Michigan,157,Tuscola County,26,0,26
47,Tennessee,26,Michigan,159,Van Buren County,41,0,41
47,Tennessee,26,Michigan,161,Washtenaw County,422,179,243
47,Tennessee,26,Michigan,163,Wayne County,1260,1000,260
47,Tennessee,26,Michigan,165,Wexford County,53,0,53
47,Tennessee,27,Minnesota,1,Aitkin County,0,1,-1
47,Tennessee,27,Minnesota,3,Anoka County,190,8,182
47,Tennessee,27,Minnesota,5,Becker County,0,15,-15
47,Tennessee,27,Minnesota,7,Beltrami County,0,2,-2
47,Tennessee,27,Minnesota,9,Benton County,120,0,120
47,Tennessee,27,Minnesota,17,Carlton County,0,2,-2
47,Tennessee,27,Minnesota,19,Carver County,8,19,-11
47,Tennessee,27,Minnesota,21,Cass County,0,1,-1
47,Tennessee,27,Minnesota,25,Chisago County,0,32,-32
47,Tennessee,27,Minnesota,27,Clay County,0,10,-10
47,Tennessee,27,Minnesota,33,Cottonwood County,0,4,-4
47,Tennessee,27,Minnesota,35,Crow Wing County,0,7,-7
47,Tennessee,27,Minnesota,37,Dakota County,6,164,-158
47,Tennessee,27,Minnesota,41,Douglas County,35,10,25
47,Tennessee,27,Minnesota,47,Freeborn County,14,3,11
47,Tennessee,27,Minnesota,53,Hennepin County,663,359,304
47,Tennessee,27,Minnesota,57,Hubbard County,0,9,-9
47,Tennessee,27,Minnesota,59,Isanti County,6,4,2
47,Tennessee,27,Minnesota,75,Lake County,89,3,86
47,Tennessee,27,Minnesota,87,Mahnomen County,0,3,-3
47,Tennessee,27,Minnesota,91,Martin County,15,5,10
47,Tennessee,27,Minnesota,93,Meeker County,0,3,-3
47,Tennessee,27,Minnesota,97,Morrison County,4,0,4
47,Tennessee,27,Minnesota,109,Olmsted County,0,49,-49
47,Tennessee,27,Minnesota,123,Ramsey County,154,236,-82
47,Tennessee,27,Minnesota,127,Redwood County,0,4,-4
47,Tennessee,27,Minnesota,137,St. Louis County,61,56,5
47,Tennessee,27,Minnesota,139,Scott County,47,284,-237
47,Tennessee,27,Minnesota,141,Sherburne County,0,8,-8
47,Tennessee,27,Minnesota,143,Sibley County,0,31,-31
47,Tennessee,27,Minnesota,145,Stearns County,57,40,17
47,Tennessee,27,Minnesota,147,Steele County,0,1,-1
47,Tennessee,27,Minnesota,159,Wadena County,10,0,10
47,Tennessee,27,Minnesota,163,Washington County,5,9,-4
47,Tennessee,27,Minnesota,169,Winona County,87,3,84
47,Tennessee,27,Minnesota,171,Wright County,45,41,4
47,Tennessee,28,Mississippi,1,Adams County,49,46,3
47,Tennessee,28,Mississippi,3,Alcorn County,190,359,-169
47,Tennessee,28,Mississippi,7,Attala County,9,22,-13
47,Tennessee,28,Mississippi,9,Benton County,22,25,-3
47,Tennessee,28,Mississippi,11,Bolivar County,0,6,-6
47,Tennessee,28,Mississippi,13,Calhoun County,5,2,3
47,Tennessee,28,Mississippi,15,Carroll County,161,0,161
47,Tennessee,28,Mississippi,17,Chickasaw County,10,0,10
47,Tennessee,28,Mississippi,19,Choctaw County,0,25,-25
47,Tennessee,28,Mississippi,21,Claiborne County,0,8,-8
47,Tennessee,28,Mississippi,25,Clay County,24,55,-31
47,Tennessee,28,Mississippi,27,Coahoma County,89,93,-4
47,Tennessee,28,Mississippi,29,Copiah County,0,82,-82
47,Tennessee,28,Mississippi,33,DeSoto County,3673,4177,-504
47,Tennessee,28,Mississippi,35,Forrest County,73,61,12
47,Tennessee,28,Mississippi,39,George County,68,8,60
47,Tennessee,28,Mississippi,41,Greene County,27,4,23
47,Tennessee,28,Mississippi,45,Hancock County,76,17,59
47,Tennessee,28,Mississippi,47,Harrison County,364,672,-308
47,Tennessee,28,Mississippi,49,Hinds County,428,216,212
47,Tennessee,28,Mississippi,51,Holmes County,27,5,22
47,Tennessee,28,Mississippi,53,Humphreys County,72,0,72
47,Tennessee,28,Mississippi,57,Itawamba County,13,39,-26
47,Tennessee,28,Mississippi,59,Jackson County,98,175,-77
47,Tennessee,28,Mississippi,65,Jefferson Davis County,0,3,-3
47,Tennessee,28,Mississippi,67,Jones County,37,11,26
47,Tennessee,28,Mississippi,69,Kemper County,0,19,-19
47,Tennessee,28,Mississippi,71,Lafayette County,437,573,-136
47,Tennessee,28,Mississippi,73,Lamar County,148,111,37
47,Tennessee,28,Mississippi,75,Lauderdale County,30,74,-44
47,Tennessee,28,Mississippi,79,Leake County,0,7,-7
47,Tennessee,28,Mississippi,81,Lee County,202,139,63
47,Tennessee,28,Mississippi,83,Leflore County,55,56,-1
47,Tennessee,28,Mississippi,85,Lincoln County,282,72,210
47,Tennessee,28,Mississippi,87,Lowndes County,56,79,-23
47,Tennessee,28,Mississippi,89,Madison County,33,183,-150
47,Tennessee,28,Mississippi,91,Marion County,8,32,-24
47,Tennessee,28,Mississippi,93,Marshall County,286,171,115
47,Tennessee,28,Mississippi,95,Monroe County,71,0,71
47,Tennessee,28,Mississippi,99,Neshoba County,0,15,-15
47,Tennessee,28,Mississippi,101,Newton County,0,4,-4
47,Tennessee,28,Mississippi,103,Noxubee County,0,13,-13
47,Tennessee,28,Mississippi,105,Oktibbeha County,185,542,-357
47,Tennessee,28,Mississippi,107,Panola County,64,84,-20
47,Tennessee,28,Mississippi,109,Pearl River County,3,26,-23
47,Tennessee,28,Mississippi,113,Pike County,6,216,-210
47,Tennessee,28,Mississippi,115,Pontotoc County,136,160,-24
47,Tennessee,28,Mississippi,117,Prentiss County,26,150,-124
47,Tennessee,28,Mississippi,119,Quitman County,21,10,11
47,Tennessee,28,Mississippi,121,Rankin County,348,390,-42
47,Tennessee,28,Mississippi,123,Scott County,0,91,-91
47,Tennessee,28,Mississippi,125,Sharkey County,0,5,-5
47,Tennessee,28,Mississippi,127,Simpson County,99,5,94
47,Tennessee,28,Mississippi,133,Sunflower County,84,25,59
47,Tennessee,28,Mississippi,135,Tallahatchie County,64,10,54
47,Tennessee,28,Mississippi,137,Tate County,80,107,-27
47,Tennessee,28,Mississippi,139,Tippah County,57,118,-61
47,Tennessee,28,Mississippi,141,Tishomingo County,32,47,-15
47,Tennessee,28,Mississippi,143,Tunica County,217,91,126
47,Tennessee,28,Mississippi,145,Union County,229,115,114
47,Tennessee,28,Mississippi,147,Walthall County,9,0,9
47,Tennessee,28,Mississippi,149,Warren County,22,36,-14
47,Tennessee,28,Mississippi,151,Washington County,297,129,168
47,Tennessee,28,Mississippi,153,Wayne County,10,49,-39
47,Tennessee,28,Mississippi,155,Webster County,14,109,-95
47,Tennessee,28,Mississippi,159,Winston County,16,6,10
47,Tennessee,28,Mississippi,161,Yalobusha County,70,127,-57
47,Tennessee,28,Mississippi,163,Yazoo County,95,129,-34
47,Tennessee,29,Missouri,1,Adair County,8,6,2
47,Tennessee,29,Missouri,7,Audrain County,0,8,-8
47,Tennessee,29,Missouri,19,Boone County,115,60,55
47,Tennessee,29,Missouri,21,Buchanan County,24,96,-72
47,Tennessee,29,Missouri,23,Butler County,0,6,-6
47,Tennessee,29,Missouri,25,Caldwell County,0,10,-10
47,Tennessee,29,Missouri,27,Callaway County,27,0,27
47,Tennessee,29,Missouri,29,Camden County,4,20,-16
47,Tennessee,29,Missouri,31,Cape Girardeau County,89,13,76
47,Tennessee,29,Missouri,37,Cass County,0,86,-86
47,Tennessee,29,Missouri,43,Christian County,88,41,47
47,Tennessee,29,Missouri,47,Clay County,30,96,-66
47,Tennessee,29,Missouri,51,Cole County,12,12,0
47,Tennessee,29,Missouri,55,Crawford County,29,0,29
47,Tennessee,29,Missouri,57,Dade County,53,0,53
47,Tennessee,29,Missouri,59,Dallas County,46,0,46
47,Tennessee,29,Missouri,63,DeKalb County,0,11,-11
47,Tennessee,29,Missouri,65,Dent County,0,14,-14
47,Tennessee,29,Missouri,69,Dunklin County,84,8,76
47,Tennessee,29,Missouri,71,Franklin County,21,0,21
47,Tennessee,29,Missouri,73,Gasconade County,0,5,-5
47,Tennessee,29,Missouri,77,Greene County,131,42,89
47,Tennessee,29,Missouri,81,Harrison County,48,0,48
47,Tennessee,29,Missouri,83,Henry County,0,4,-4
47,Tennessee,29,Missouri,91,Howell County,0,9,-9
47,Tennessee,29,Missouri,95,Jackson County,344,121,223
47,Tennessee,29,Missouri,97,Jasper County,24,45,-21
47,Tennessee,29,Missouri,99,Jefferson County,154,9,145
47,Tennessee,29,Missouri,101,Johnson County,17,78,-61
47,Tennessee,29,Missouri,105,Laclede County,0,18,-18
47,Tennessee,29,Missouri,109,Lawrence County,80,2,78
47,Tennessee,29,Missouri,115,Linn County,0,17,-17
47,Tennessee,29,Missouri,117,Livingston County,0,2,-2
47,Tennessee,29,Missouri,119,McDonald County,0,122,-122
47,Tennessee,29,Missouri,123,Madison County,59,2,57
47,Tennessee,29,Missouri,125,Maries County,10,0,10
47,Tennessee,29,Missouri,127,Marion County,9,0,9
47,Tennessee,29,Missouri,131,Miller County,8,0,8
47,Tennessee,29,Missouri,133,Mississippi County,43,0,43
47,Tennessee,29,Missouri,143,New Madrid County,400,15,385
47,Tennessee,29,Missouri,145,Newton County,9,49,-40
47,Tennessee,29,Missouri,153,Ozark County,0,9,-9
47,Tennessee,29,Missouri,155,Pemiscot County,252,61,191
47,Tennessee,29,Missouri,157,Perry County,15,0,15
47,Tennessee,29,Missouri,165,Platte County,10,2,8
47,Tennessee,29,Missouri,167,Polk County,0,6,-6
47,Tennessee,29,Missouri,169,Pulaski County,105,273,-168
47,Tennessee,29,Missouri,175,Randolph County,9,0,9
47,Tennessee,29,Missouri,177,Ray County,0,9,-9
47,Tennessee,29,Missouri,183,St. Charles County,162,183,-21
47,Tennessee,29,Missouri,186,Ste. Genevieve County,8,40,-32
47,Tennessee,29,Missouri,187,St. Francois County,10,68,-58
47,Tennessee,29,Missouri,189,St. Louis County,693,662,31
47,Tennessee,29,Missouri,201,Scott County,35,69,-34
47,Tennessee,29,Missouri,207,Stoddard County,0,82,-82
47,Tennessee,29,Missouri,209,Stone County,0,9,-9
47,Tennessee,29,Missouri,213,Taney County,44,257,-213
47,Tennessee,29,Missouri,217,Vernon County,0,3,-3
47,Tennessee,29,Missouri,219,Warren County,0,36,-36
47,Tennessee,29,Missouri,510,St. Louis city,259,230,29
47,Tennessee,30,Montana,13,Cascade County,24,0,24
47,Tennessee,30,Montana,29,Flathead County,185,0,185
47,Tennessee,30,Montana,31,Gallatin County,8,39,-31
47,Tennessee,30,Montana,53,Lincoln County,9,0,9
47,Tennessee,30,Montana,57,Madison County,0,16,-16
47,Tennessee,30,Montana,63,Missoula County,33,11,22
47,Tennessee,30,Montana,91,Sheridan County,7,0,7
47,Tennessee,30,Montana,93,Silver Bow County,0,4,-4
47,Tennessee,30,Montana,111,Yellowstone County,0,28,-28
47,Tennessee,31,Nebraska,1,Adams County,0,10,-10
47,Tennessee,31,Nebraska,13,Box Butte County,12,0,12
47,Tennessee,31,Nebraska,25,Cass County,5,0,5
47,Tennessee,31,Nebraska,27,Cedar County,0,6,-6
47,Tennessee,31,Nebraska,33,Cheyenne County,0,36,-36
47,Tennessee,31,Nebraska,47,Dawson County,0,9,-9
47,Tennessee,31,Nebraska,51,Dixon County,0,4,-4
47,Tennessee,31,Nebraska,53,Dodge County,0,7,-7
47,Tennessee,31,Nebraska,55,Douglas County,363,171,192
47,Tennessee,31,Nebraska,79,Hall County,0,25,-25
47,Tennessee,31,Nebraska,99,Kearney County,13,0,13
47,Tennessee,31,Nebraska,107,Knox County,0,15,-15
47,Tennessee,31,Nebraska,109,Lancaster County,24,28,-4
47,Tennessee,31,Nebraska,111,Lincoln County,0,8,-8
47,Tennessee,31,Nebraska,123,Morrill County,12,0,12
47,Tennessee,31,Nebraska,147,Richardson County,0,1,-1
47,Tennessee,31,Nebraska,153,Sarpy County,62,66,-4
47,Tennessee,31,Nebraska,159,Seward County,0,5,-5
47,Tennessee,31,Nebraska,177,Washington County,16,0,16
47,Tennessee,32,Nevada,1,Churchill County,94,0,94
47,Tennessee,32,Nevada,3,Clark County,547,877,-330
47,Tennessee,32,Nevada,5,Douglas County,0,2,-2
47,Tennessee,32,Nevada,7,Elko County,3,0,3
47,Tennessee,32,Nevada,23,Nye County,9,69,-60
47,Tennessee,32,Nevada,31,Washoe County,0,80,-80
47,Tennessee,32,Nevada,510,Carson City,0,66,-66
47,Tennessee,33,New Hampshire,1,Belknap County,63,21,42
47,Tennessee,33,New Hampshire,5,Cheshire County,60,0,60
47,Tennessee,33,New Hampshire,9,Grafton County,33,36,-3
47,Tennessee,33,New Hampshire,11,Hillsborough County,48,64,-16
47,Tennessee,33,New Hampshire,13,Merrimack County,34,0,34
47,Tennessee,33,New Hampshire,15,Rockingham County,10,27,-17
47,Tennessee,33,New Hampshire,17,Strafford County,0,8,-8
47,Tennessee,33,New Hampshire,19,Sullivan County,0,2,-2
47,Tennessee,34,New Jersey,1,Atlantic County,91,15,76
47,Tennessee,34,New Jersey,3,Bergen County,96,75,21
47,Tennessee,34,New Jersey,5,Burlington County,48,106,-58
47,Tennessee,34,New Jersey,7,Camden County,45,102,-57
47,Tennessee,34,New Jersey,9,Cape May County,9,5,4
47,Tennessee,34,New Jersey,11,Cumberland County,173,2,171
47,Tennessee,34,New Jersey,13,Essex County,76,90,-14
47,Tennessee,34,New Jersey,15,Gloucester County,90,9,81
47,Tennessee,34,New Jersey,17,Hudson County,45,138,-93
47,Tennessee,34,New Jersey,19,Hunterdon County,5,80,-75
47,Tennessee,34,New Jersey,21,Mercer County,29,78,-49
47,Tennessee,34,New Jersey,23,Middlesex County,95,29,66
47,Tennessee,34,New Jersey,25,Monmouth County,132,30,102
47,Tennessee,34,New Jersey,27,Morris County,121,104,17
47,Tennessee,34,New Jersey,29,Ocean County,146,156,-10
47,Tennessee,34,New Jersey,33,Salem County,20,24,-4
47,Tennessee,34,New Jersey,35,Somerset County,25,90,-65
47,Tennessee,34,New Jersey,37,Sussex County,0,7,-7
47,Tennessee,34,New Jersey,39,Union County,16,0,16
47,Tennessee,34,New Jersey,41,Warren County,38,0,38
47,Tennessee,35,New Mexico,1,Bernalillo County,44,233,-189
47,Tennessee,35,New Mexico,5,Chaves County,14,0,14
47,Tennessee,35,New Mexico,6,Cibola County,4,3,1
47,Tennessee,35,New Mexico,9,Curry County,0,42,-42
47,Tennessee,35,New Mexico,13,Doña Ana County,19,0,19
47,Tennessee,35,New Mexico,15,Eddy County,0,47,-47
47,Tennessee,35,New Mexico,27,Lincoln County,0,67,-67
47,Tennessee,35,New Mexico,28,Los Alamos County,81,0,81
47,Tennessee,35,New Mexico,29,Luna County,0,5,-5
47,Tennessee,35,New Mexico,35,Otero County,59,112,-53
47,Tennessee,35,New Mexico,43,Sandoval County,14,138,-124
47,Tennessee,35,New Mexico,45,San Juan County,40,0,40
47,Tennessee,35,New Mexico,49,Santa Fe County,4,19,-15
47,Tennessee,35,New Mexico,51,Sierra County,48,0,48
47,Tennessee,35,New Mexico,53,Socorro County,24,0,24
47,Tennessee,35,New Mexico,57,Torrance County,0,4,-4
47,Tennessee,35,New Mexico,61,Valencia County,29,0,29
47,Tennessee,36,New York,1,Albany County,114,0,114
47,Tennessee,36,New York,3,Allegany County,0,3,-3
47,Tennessee,36,New York,5,Bronx County,386,52,334
47,Tennessee,36,New York,7,Broome County,4,0,4
47,Tennessee,36,New York,9,Cattaraugus County,0,13,-13
47,Tennessee,36,New York,11,Cayuga County,9,0,9
47,Tennessee,36,New York,13,Chautauqua County,0,24,-24
47,Tennessee,36,New York,17,Chenango County,98,21,77
47,Tennessee,36,New York,19,Clinton County,51,33,18
47,Tennessee,36,New York,23,Cortland County,12,14,-2
47,Tennessee,36,New York,27,Dutchess County,115,62,53
47,Tennessee,36,New York,29,Erie County,260,134,126
47,Tennessee,36,New York,33,Franklin County,0,57,-57
47,Tennessee,36,New York,45,Jefferson County,400,137,263
47,Tennessee,36,New York,47,Kings County,436,163,273
47,Tennessee,36,New York,49,Lewis County,0,4,-4
47,Tennessee,36,New York,53,Madison County,74,13,61
47,Tennessee,36,New York,55,Monroe County,101,122,-21
47,Tennessee,36,New York,59,Nassau County,79,80,-1
47,Tennessee,36,New York,61,New York County,627,667,-40
47,Tennessee,36,New York,63,Niagara County,297,22,275
47,Tennessee,36,New York,65,Oneida County,22,36,-14
47,Tennessee,36,New York,67,Onondaga County,120,105,15
47,Tennessee,36,New York,69,Ontario County,0,39,-39
47,Tennessee,36,New York,71,Orange County,170,214,-44
47,Tennessee,36,New York,73,Orleans County,21,0,21
47,Tennessee,36,New York,75,Oswego County,130,49,81
47,Tennessee,36,New York,77,Otsego County,17,19,-2
47,Tennessee,36,New York,81,Queens County,223,67,156
47,Tennessee,36,New York,83,Rensselaer County,10,48,-38
47,Tennessee,36,New York,85,Richmond County,102,30,72
47,Tennessee,36,New York,87,Rockland County,20,13,7
47,Tennessee,36,New York,89,St. Lawrence County,22,5,17
47,Tennessee,36,New York,91,Saratoga County,46,19,27
47,Tennessee,36,New York,93,Schenectady County,47,0,47
47,Tennessee,36,New York,95,Schoharie County,45,15,30
47,Tennessee,36,New York,101,Steuben County,36,28,8
47,Tennessee,36,New York,103,Suffolk County,228,66,162
47,Tennessee,36,New York,105,Sullivan County,12,0,12
47,Tennessee,36,New York,107,Tioga County,16,55,-39
47,Tennessee,36,New York,109,Tompkins County,54,64,-10
47,Tennessee,36,New York,111,Ulster County,55,0,55
47,Tennessee,36,New York,113,Warren County,109,0,109
47,Tennessee,36,New York,115,Washington County,0,21,-21
47,Tennessee,36,New York,117,Wayne County,53,3,50
47,Tennessee,36,New York,119,Westchester County,189,117,72
47,Tennessee,36,New York,121,Wyoming County,26,102,-76
47,Tennessee,37,North Carolina,1,Alamance County,0,57,-57
47,Tennessee,37,North Carolina,3,Alexander County,15,0,15
47,Tennessee,37,North Carolina,5,Alleghany County,0,10,-10
47,Tennessee,37,North Carolina,9,Ashe County,102,14,88
47,Tennessee,37,North Carolina,11,Avery County,140,32,108
47,Tennessee,37,North Carolina,17,Bladen County,19,24,-5
47,Tennessee,37,North Carolina,19,Brunswick County,9,139,-130
47,Tennessee,37,North Carolina,21,Buncombe County,958,406,552
47,Tennessee,37,North Carolina,23,Burke County,122,37,85
47,Tennessee,37,North Carolina,25,Cabarrus County,92,337,-245
47,Tennessee,37,North Carolina,27,Caldwell County,51,103,-52
47,Tennessee,37,North Carolina,31,Carteret County,63,30,33
47,Tennessee,37,North Carolina,33,Caswell County,7,0,7
47,Tennessee,37,North Carolina,35,Catawba County,123,171,-48
47,Tennessee,37,North Carolina,37,Chatham County,5,1,4
47,Tennessee,37,North Carolina,39,Cherokee County,112,53,59
47,Tennessee,37,North Carolina,43,Clay County,0,23,-23
47,Tennessee,37,North Carolina,45,Cleveland County,21,4,17
47,Tennessee,37,North Carolina,47,Columbus County,0,28,-28
47,Tennessee,37,North Carolina,49,Craven County,259,80,179
47,Tennessee,37,North Carolina,51,Cumberland County,835,591,244
47,Tennessee,37,North Carolina,55,Dare County,9,8,1
47,Tennessee,37,North Carolina,57,Davidson County,47,100,-53
47,Tennessee,37,North Carolina,59,Davie County,135,2,133
47,Tennessee,37,North Carolina,61,Duplin County,9,0,9
47,Tennessee,37,North Carolina,63,Durham County,166,247,-81
47,Tennessee,37,North Carolina,65,Edgecombe County,3,0,3
47,Tennessee,37,North Carolina,67,Forsyth County,332,477,-145
47,Tennessee,37,North Carolina,69,Franklin County,30,4,26
47,Tennessee,37,North Carolina,71,Gaston County,296,58,238
47,Tennessee,37,North Carolina,75,Graham County,16,0,16
47,Tennessee,37,North Carolina,77,Granville County,123,28,95
47,Tennessee,37,North Carolina,79,Greene County,25,0,25
47,Tennessee,37,North Carolina,81,Guilford County,480,375,105
47,Tennessee,37,North Carolina,83,Halifax County,28,6,22
47,Tennessee,37,North Carolina,85,Harnett County,123,97,26
47,Tennessee,37,North Carolina,87,Haywood County,304,77,227
47,Tennessee,37,North Carolina,89,Henderson County,178,141,37
47,Tennessee,37,North Carolina,93,Hoke County,43,83,-40
47,Tennessee,37,North Carolina,97,Iredell County,49,29,20
47,Tennessee,37,North Carolina,99,Jackson County,6,66,-60
47,Tennessee,37,North Carolina,101,Johnston County,59,87,-28
47,Tennessee,37,North Carolina,103,Jones County,19,0,19
47,Tennessee,37,North Carolina,105,Lee County,0,20,-20
47,Tennessee,37,North Carolina,107,Lenoir County,0,4,-4
47,Tennessee,37,North Carolina,109,Lincoln County,75,0,75
47,Tennessee,37,North Carolina,111,McDowell County,269,10,259
47,Tennessee,37,North Carolina,113,Macon County,21,44,-23
47,Tennessee,37,North Carolina,115,Madison County,74,28,46
47,Tennessee,37,North Carolina,119,Mecklenburg County,872,1016,-144
47,Tennessee,37,North Carolina,121,Mitchell County,55,10,45
47,Tennessee,37,North Carolina,123,Montgomery County,0,7,-7
47,Tennessee,37,North Carolina,125,Moore County,143,113,30
47,Tennessee,37,North Carolina,127,Nash County,7,2,5
47,Tennessee,37,North Carolina,129,New Hanover County,251,135,116
47,Tennessee,37,North Carolina,131,Northampton County,0,10,-10
47,Tennessee,37,North Carolina,133,Onslow County,258,430,-172
47,Tennessee,37,North Carolina,135,Orange County,79,268,-189
47,Tennessee,37,North Carolina,137,Pamlico County,0,1,-1
47,Tennessee,37,North Carolina,139,Pasquotank County,0,14,-14
47,Tennessee,37,North Carolina,141,Pender County,81,18,63
47,Tennessee,37,North Carolina,143,Perquimans County,0,123,-123
47,Tennessee,37,North Carolina,145,Person County,16,19,-3
47,Tennessee,37,North Carolina,147,Pitt County,157,116,41
47,Tennessee,37,North Carolina,149,Polk County,2,0,2
47,Tennessee,37,North Carolina,151,Randolph County,86,124,-38
47,Tennessee,37,North Carolina,155,Robeson County,43,6,37
47,Tennessee,37,North Carolina,157,Rockingham County,0,52,-52
47,Tennessee,37,North Carolina,159,Rowan County,6,113,-107
47,Tennessee,37,North Carolina,161,Rutherford County,113,29,84
47,Tennessee,37,North Carolina,163,Sampson County,35,13,22
47,Tennessee,37,North Carolina,167,Stanly County,57,0,57
47,Tennessee,37,North Carolina,169,Stokes County,43,0,43
47,Tennessee,37,North Carolina,171,Surry County,39,12,27
47,Tennessee,37,North Carolina,173,Swain County,90,0,90
47,Tennessee,37,North Carolina,175,Transylvania County,0,46,-46
47,Tennessee,37,North Carolina,179,Union County,242,248,-6
47,Tennessee,37,North Carolina,181,Vance County,20,0,20
47,Tennessee,37,North Carolina,183,Wake County,911,513,398
47,Tennessee,37,North Carolina,185,Warren County,24,0,24
47,Tennessee,37,North Carolina,189,Watauga County,457,75,382
47,Tennessee,37,North Carolina,191,Wayne County,41,30,11
47,Tennessee,37,North Carolina,193,Wilkes County,0,14,-14
47,Tennessee,37,North Carolina,195,Wilson County,7,3,4
47,Tennessee,37,North Carolina,197,Yadkin County,9,5,4
47,Tennessee,37,North Carolina,199,Yancey County,64,0,64
47,Tennessee,38,North Dakota,3,Barnes County,0,42,-42
47,Tennessee,38,North Dakota,17,Cass County,19,0,19
47,Tennessee,38,North Dakota,35,Grand Forks County,0,103,-103
47,Tennessee,38,North Dakota,43,Kidder County,0,176,-176
47,Tennessee,38,North Dakota,53,McKenzie County,47,0,47
47,Tennessee,38,North Dakota,55,McLean County,0,1,-1
47,Tennessee,38,North Dakota,59,Morton County,0,3,-3
47,Tennessee,38,North Dakota,67,Pembina County,0,2,-2
47,Tennessee,38,North Dakota,89,Stark County,111,30,81
47,Tennessee,38,North Dakota,101,Ward County,9,34,-25
47,Tennessee,38,North Dakota,105,Williams County,0,37,-37
47,Tennessee,39,Ohio,1,Adams County,0,2,-2
47,Tennessee,39,Ohio,3,Allen County,264,128,136
47,Tennessee,39,Ohio,5,Ashland County,3,0,3
47,Tennessee,39,Ohio,7,Ashtabula County,51,0,51
47,Tennessee,39,Ohio,9,Athens County,5,84,-79
47,Tennessee,39,Ohio,11,Auglaize County,64,33,31
47,Tennessee,39,Ohio,13,Belmont County,0,10,-10
47,Tennessee,39,Ohio,15,Brown County,53,39,14
47,Tennessee,39,Ohio,17,Butler County,198,481,-283
47,Tennessee,39,Ohio,21,Champaign County,0,8,-8
47,Tennessee,39,Ohio,23,Clark County,39,29,10
47,Tennessee,39,Ohio,25,Clermont County,34,264,-230
47,Tennessee,39,Ohio,27,Clinton County,22,8,14
47,Tennessee,39,Ohio,29,Columbiana County,30,1,29
47,Tennessee,39,Ohio,33,Crawford County,0,20,-20
47,Tennessee,39,Ohio,35,Cuyahoga County,366,379,-13
47,Tennessee,39,Ohio,37,Darke County,9,38,-29
47,Tennessee,39,Ohio,39,Defiance County,25,0,25
47,Tennessee,39,Ohio,41,Delaware County,56,54,2
47,Tennessee,39,Ohio,43,Erie County,0,112,-112
47,Tennessee,39,Ohio,45,Fairfield County,136,50,86
47,Tennessee,39,Ohio,47,Fayette County,0,14,-14
47,Tennessee,39,Ohio,49,Franklin County,621,712,-91
47,Tennessee,39,Ohio,55,Geauga County,30,0,30
47,Tennessee,39,Ohio,57,Greene County,229,192,37
47,Tennessee,39,Ohio,59,Guernsey County,176,0,176
47,Tennessee,39,Ohio,61,Hamilton County,532,700,-168
47,Tennessee,39,Ohio,63,Hancock County,138,65,73
47,Tennessee,39,Ohio,65,Hardin County,13,0,13
47,Tennessee,39,Ohio,69,Henry County,0,2,-2
47,Tennessee,39,Ohio,71,Highland County,43,5,38
47,Tennessee,39,Ohio,75,Holmes County,22,0,22
47,Tennessee,39,Ohio,77,Huron County,30,34,-4
47,Tennessee,39,Ohio,79,Jackson County,0,17,-17
47,Tennessee,39,Ohio,81,Jefferson County,0,14,-14
47,Tennessee,39,Ohio,83,Knox County,0,8,-8
47,Tennessee,39,Ohio,85,Lake County,18,15,3
47,Tennessee,39,Ohio,87,Lawrence County,22,115,-93
47,Tennessee,39,Ohio,89,Licking County,53,28,25
47,Tennessee,39,Ohio,91,Logan County,22,2,20
47,Tennessee,39,Ohio,93,Lorain County,194,76,118
47,Tennessee,39,Ohio,95,Lucas County,102,354,-252
47,Tennessee,39,Ohio,97,Madison County,26,0,26
47,Tennessee,39,Ohio,99,Mahoning County,71,107,-36
47,Tennessee,39,Ohio,101,Marion County,16,78,-62
47,Tennessee,39,Ohio,103,Medina County,67,31,36
47,Tennessee,39,Ohio,105,Meigs County,0,2,-2
47,Tennessee,39,Ohio,107,Mercer County,13,0,13
47,Tennessee,39,Ohio,109,Miami County,99,0,99
47,Tennessee,39,Ohio,113,Montgomery County,257,507,-250
47,Tennessee,39,Ohio,117,Morrow County,39,0,39
47,Tennessee,39,Ohio,119,Muskingum County,49,0,49
47,Tennessee,39,Ohio,121,Noble County,0,8,-8
47,Tennessee,39,Ohio,123,Ottawa County,24,20,4
47,Tennessee,39,Ohio,127,Perry County,0,35,-35
47,Tennessee,39,Ohio,129,Pickaway County,2,21,-19
47,Tennessee,39,Ohio,131,Pike County,5,18,-13
47,Tennessee,39,Ohio,133,Portage County,66,1,65
47,Tennessee,39,Ohio,139,Richland County,217,87,130
47,Tennessee,39,Ohio,141,Ross County,0,7,-7
47,Tennessee,39,Ohio,143,Sandusky County,0,32,-32
47,Tennessee,39,Ohio,145,Scioto County,30,33,-3
47,Tennessee,39,Ohio,151,Stark County,57,228,-171
47,Tennessee,39,Ohio,153,Summit County,374,87,287
47,Tennessee,39,Ohio,155,Trumbull County,0,63,-63
47,Tennessee,39,Ohio,157,Tuscarawas County,102,0,102
47,Tennessee,39,Ohio,159,Union County,101,70,31
47,Tennessee,39,Ohio,161,Van Wert County,144,32,112
47,Tennessee,39,Ohio,165,Warren County,134,251,-117
47,Tennessee,39,Ohio,167,Washington County,0,33,-33
47,Tennessee,39,Ohio,169,Wayne County,35,22,13
47,Tennessee,39,Ohio,171,Williams County,15,8,7
47,Tennessee,39,Ohio,173,Wood County,58,10,48
47,Tennessee,39,Ohio,175,Wyandot County,61,0,61
47,Tennessee,4,Arizona,3,Cochise County,15,154,-139
47,Tennessee,4,Arizona,5,Coconino County,58,291,-233
47,Tennessee,4,Arizona,7,Gila County,17,0,17
47,Tennessee,4,Arizona,11,Greenlee County,17,0,17
47,Tennessee,4,Arizona,13,Maricopa County,1721,1476,245
47,Tennessee,4,Arizona,15,Mohave County,30,90,-60
47,Tennessee,4,Arizona,17,Navajo County,10,26,-16
47,Tennessee,4,Arizona,19,Pima County,369,194,175
47,Tennessee,4,Arizona,21,Pinal County,146,146,0
47,Tennessee,4,Arizona,25,Yavapai County,117,81,36
47,Tennessee,4,Arizona,27,Yuma County,54,10,44
47,Tennessee,40,Oklahoma,3,Alfalfa County,6,13,-7
47,Tennessee,40,Oklahoma,17,Canadian County,35,27,8
47,Tennessee,40,Oklahoma,19,Carter County,0,15,-15
47,Tennessee,40,Oklahoma,27,Cleveland County,188,118,70
47,Tennessee,40,Oklahoma,31,Comanche County,456,450,6
47,Tennessee,40,Oklahoma,35,Craig County,0,10,-10
47,Tennessee,40,Oklahoma,37,Creek County,12,5,7
47,Tennessee,40,Oklahoma,47,Garfield County,7,19,-12
47,Tennessee,40,Oklahoma,49,Garvin County,0,11,-11
47,Tennessee,40,Oklahoma,51,Grady County,14,11,3
47,Tennessee,40,Oklahoma,55,Greer County,0,4,-4
47,Tennessee,40,Oklahoma,61,Haskell County,71,5,66
47,Tennessee,40,Oklahoma,65,Jackson County,0,18,-18
47,Tennessee,40,Oklahoma,67,Jefferson County,0,6,-6
47,Tennessee,40,Oklahoma,69,Johnston County,0,23,-23
47,Tennessee,40,Oklahoma,71,Kay County,0,50,-50
47,Tennessee,40,Oklahoma,77,Latimer County,0,19,-19
47,Tennessee,40,Oklahoma,79,Le Flore County,0,25,-25
47,Tennessee,40,Oklahoma,81,Lincoln County,30,0,30
47,Tennessee,40,Oklahoma,83,Logan County,43,20,23
47,Tennessee,40,Oklahoma,87,McClain County,0,18,-18
47,Tennessee,40,Oklahoma,93,Major County,0,22,-22
47,Tennessee,40,Oklahoma,95,Marshall County,0,15,-15
47,Tennessee,40,Oklahoma,97,Mayes County,0,4,-4
47,Tennessee,40,Oklahoma,99,Murray County,0,10,-10
47,Tennessee,40,Oklahoma,101,Muskogee County,7,11,-4
47,Tennessee,40,Oklahoma,109,Oklahoma County,466,272,194
47,Tennessee,40,Oklahoma,111,Okmulgee County,0,16,-16
47,Tennessee,40,Oklahoma,113,Osage County,0,3,-3
47,Tennessee,40,Oklahoma,115,Ottawa County,0,7,-7
47,Tennessee,40,Oklahoma,117,Pawnee County,73,0,73
47,Tennessee,40,Oklahoma,119,Payne County,26,0,26
47,Tennessee,40,Oklahoma,121,Pittsburg County,0,7,-7
47,Tennessee,40,Oklahoma,123,Pontotoc County,0,1,-1
47,Tennessee,40,Oklahoma,125,Pottawatomie County,0,13,-13
47,Tennessee,40,Oklahoma,129,Roger Mills County,0,5,-5
47,Tennessee,40,Oklahoma,131,Rogers County,17,38,-21
47,Tennessee,40,Oklahoma,135,Sequoyah County,53,0,53
47,Tennessee,40,Oklahoma,137,Stephens County,0,8,-8
47,Tennessee,40,Oklahoma,141,Tillman County,0,3,-3
47,Tennessee,40,Oklahoma,143,Tulsa County,429,277,152
47,Tennessee,40,Oklahoma,145,Wagoner County,0,68,-68
47,Tennessee,40,Oklahoma,147,Washington County,0,12,-12
47,Tennessee,40,Oklahoma,153,Woodward County,30,0,30
47,Tennessee,41,Oregon,3,Benton County,14,0,14
47,Tennessee,41,Oregon,5,Clackamas County,49,83,-34
47,Tennessee,41,Oregon,7,Clatsop County,8,0,8
47,Tennessee,41,Oregon,9,Columbia County,0,207,-207
47,Tennessee,41,Oregon,11,Coos County,35,61,-26
47,Tennessee,41,Oregon,15,Curry County,0,2,-2
47,Tennessee,41,Oregon,17,Deschutes County,50,0,50
47,Tennessee,41,Oregon,23,Grant County,0,8,-8
47,Tennessee,41,Oregon,27,Hood River County,9,0,9
47,Tennessee,41,Oregon,29,Jackson County,29,67,-38
47,Tennessee,41,Oregon,33,Josephine County,15,13,2
47,Tennessee,41,Oregon,37,Lake County,0,8,-8
47,Tennessee,41,Oregon,39,Lane County,70,325,-255
47,Tennessee,41,Oregon,43,Linn County,0,31,-31
47,Tennessee,41,Oregon,45,Malheur County,98,6,92
47,Tennessee,41,Oregon,47,Marion County,36,22,14
47,Tennessee,41,Oregon,51,Multnomah County,293,60,233
47,Tennessee,41,Oregon,53,Polk County,17,0,17
47,Tennessee,41,Oregon,67,Washington County,72,136,-64
47,Tennessee,41,Oregon,71,Yamhill County,2,0,2
47,Tennessee,42,Pennsylvania,1,Adams County,99,0,99
47,Tennessee,42,Pennsylvania,3,Allegheny County,382,209,173
47,Tennessee,42,Pennsylvania,7,Beaver County,50,133,-83
47,Tennessee,42,Pennsylvania,9,Bedford County,26,4,22
47,Tennessee,42,Pennsylvania,11,Berks County,6,40,-34
47,Tennessee,42,Pennsylvania,13,Blair County,23,0,23
47,Tennessee,42,Pennsylvania,15,Bradford County,16,3,13
47,Tennessee,42,Pennsylvania,17,Bucks County,60,45,15
47,Tennessee,42,Pennsylvania,19,Butler County,16,68,-52
47,Tennessee,42,Pennsylvania,21,Cambria County,42,131,-89
47,Tennessee,42,Pennsylvania,25,Carbon County,93,0,93
47,Tennessee,42,Pennsylvania,27,Centre County,25,32,-7
47,Tennessee,42,Pennsylvania,29,Chester County,32,97,-65
47,Tennessee,42,Pennsylvania,33,Clearfield County,0,3,-3
47,Tennessee,42,Pennsylvania,35,Clinton County,24,0,24
47,Tennessee,42,Pennsylvania,37,Columbia County,124,3,121
47,Tennessee,42,Pennsylvania,39,Crawford County,44,13,31
47,Tennessee,42,Pennsylvania,41,Cumberland County,39,193,-154
47,Tennessee,42,Pennsylvania,43,Dauphin County,53,46,7
47,Tennessee,42,Pennsylvania,45,Delaware County,73,46,27
47,Tennessee,42,Pennsylvania,49,Erie County,188,63,125
47,Tennessee,42,Pennsylvania,51,Fayette County,23,11,12
47,Tennessee,42,Pennsylvania,53,Forest County,4,0,4
47,Tennessee,42,Pennsylvania,55,Franklin County,109,24,85
47,Tennessee,42,Pennsylvania,57,Fulton County,0,6,-6
47,Tennessee,42,Pennsylvania,59,Greene County,12,0,12
47,Tennessee,42,Pennsylvania,61,Huntingdon County,24,9,15
47,Tennessee,42,Pennsylvania,63,Indiana County,27,4,23
47,Tennessee,42,Pennsylvania,65,Jefferson County,0,56,-56
47,Tennessee,42,Pennsylvania,69,Lackawanna County,7,10,-3
47,Tennessee,42,Pennsylvania,71,Lancaster County,75,80,-5
47,Tennessee,42,Pennsylvania,73,Lawrence County,16,0,16
47,Tennessee,42,Pennsylvania,75,Lebanon County,74,7,67
47,Tennessee,42,Pennsylvania,77,Lehigh County,101,69,32
47,Tennessee,42,Pennsylvania,79,Luzerne County,31,3,28
47,Tennessee,42,Pennsylvania,81,Lycoming County,10,0,10
47,Tennessee,42,Pennsylvania,85,Mercer County,7,0,7
47,Tennessee,42,Pennsylvania,89,Monroe County,45,8,37
47,Tennessee,42,Pennsylvania,91,Montgomery County,133,193,-60
47,Tennessee,42,Pennsylvania,93,Montour County,38,10,28
47,Tennessee,42,Pennsylvania,95,Northampton County,32,83,-51
47,Tennessee,42,Pennsylvania,97,Northumberland County,0,12,-12
47,Tennessee,42,Pennsylvania,99,Perry County,32,8,24
47,Tennessee,42,Pennsylvania,101,Philadelphia County,286,478,-192
47,Tennessee,42,Pennsylvania,103,Pike County,15,0,15
47,Tennessee,42,Pennsylvania,105,Potter County,39,0,39
47,Tennessee,42,Pennsylvania,107,Schuylkill County,11,27,-16
47,Tennessee,42,Pennsylvania,109,Snyder County,0,22,-22
47,Tennessee,42,Pennsylvania,111,Somerset County,0,276,-276
47,Tennessee,42,Pennsylvania,117,Tioga County,0,16,-16
47,Tennessee,42,Pennsylvania,119,Union County,22,4,18
47,Tennessee,42,Pennsylvania,121,Venango County,23,0,23
47,Tennessee,42,Pennsylvania,123,Warren County,0,33,-33
47,Tennessee,42,Pennsylvania,125,Washington County,69,8,61
47,Tennessee,42,Pennsylvania,127,Wayne County,14,5,9
47,Tennessee,42,Pennsylvania,129,Westmoreland County,147,112,35
47,Tennessee,42,Pennsylvania,131,Wyoming County,0,6,-6
47,Tennessee,42,Pennsylvania,133,York County,264,126,138
47,Tennessee,44,Rhode Island,1,Bristol County,0,81,-81
47,Tennessee,44,Rhode Island,3,Kent County,99,20,79
47,Tennessee,44,Rhode Island,5,Newport County,26,114,-88
47,Tennessee,44,Rhode Island,7,Providence County,72,115,-43
47,Tennessee,44,Rhode Island,9,Washington County,53,67,-14
47,Tennessee,45,South Carolina,1,Abbeville County,2,44,-42
47,Tennessee,45,South Carolina,3,Aiken County,100,80,20
47,Tennessee,45,South Carolina,7,Anderson County,71,46,25
47,Tennessee,45,South Carolina,9,Bamberg County,0,6,-6
47,Tennessee,45,South Carolina,11,Barnwell County,0,17,-17
47,Tennessee,45,South Carolina,13,Beaufort County,245,239,6
47,Tennessee,45,South Carolina,15,Berkeley County,214,132,82
47,Tennessee,45,South Carolina,19,Charleston County,798,641,157
47,Tennessee,45,South Carolina,25,Chesterfield County,69,0,69
47,Tennessee,45,South Carolina,29,Colleton County,0,43,-43
47,Tennessee,45,South Carolina,31,Darlington County,0,48,-48
47,Tennessee,45,South Carolina,35,Dorchester County,50,145,-95
47,Tennessee,45,South Carolina,37,Edgefield County,0,49,-49
47,Tennessee,45,South Carolina,39,Fairfield County,7,54,-47
47,Tennessee,45,South Carolina,41,Florence County,39,56,-17
47,Tennessee,45,South Carolina,43,Georgetown County,0,16,-16
47,Tennessee,45,South Carolina,45,Greenville County,562,394,168
47,Tennessee,45,South Carolina,47,Greenwood County,13,38,-25
47,Tennessee,45,South Carolina,51,Horry County,803,253,550
47,Tennessee,45,South Carolina,53,Jasper County,4,0,4
47,Tennessee,45,South Carolina,55,Kershaw County,38,21,17
47,Tennessee,45,South Carolina,57,Lancaster County,0,307,-307
47,Tennessee,45,South Carolina,63,Lexington County,141,303,-162
47,Tennessee,45,South Carolina,67,Marion County,15,0,15
47,Tennessee,45,South Carolina,71,Newberry County,0,3,-3
47,Tennessee,45,South Carolina,73,Oconee County,62,42,20
47,Tennessee,45,South Carolina,75,Orangeburg County,16,0,16
47,Tennessee,45,South Carolina,77,Pickens County,193,173,20
47,Tennessee,45,South Carolina,79,Richland County,419,740,-321
47,Tennessee,45,South Carolina,83,Spartanburg County,117,93,24
47,Tennessee,45,South Carolina,85,Sumter County,55,54,1
47,Tennessee,45,South Carolina,89,Williamsburg County,308,0,308
47,Tennessee,45,South Carolina,91,York County,46,120,-74
47,Tennessee,46,South Dakota,5,Beadle County,0,9,-9
47,Tennessee,46,South Dakota,11,Brookings County,23,42,-19
47,Tennessee,46,South Dakota,27,Clay County,0,15,-15
47,Tennessee,46,South Dakota,29,Codington County,0,15,-15
47,Tennessee,46,South Dakota,35,Davison County,0,91,-91
47,Tennessee,46,South Dakota,45,Edmunds County,0,11,-11
47,Tennessee,46,South Dakota,61,Hanson County,10,1,9
47,Tennessee,46,South Dakota,71,Jackson County,40,0,40
47,Tennessee,46,South Dakota,79,Lake County,27,81,-54
47,Tennessee,46,South Dakota,83,Lincoln County,80,21,59
47,Tennessee,46,South Dakota,93,Meade County,30,14,16
47,Tennessee,46,South Dakota,99,Minnehaha County,13,58,-45
47,Tennessee,46,South Dakota,103,Pennington County,45,96,-51
47,Tennessee,46,South Dakota,105,Perkins County,0,21,-21
47,Tennessee,46,South Dakota,111,Sanborn County,0,11,-11
47,Tennessee,46,South Dakota,125,Turner County,0,9,-9
47,Tennessee,46,South Dakota,127,Union County,28,6,22
47,Tennessee,46,South Dakota,135,Yankton County,0,8,-8
47,Tennessee,47,Tennessee,1,Anderson County,4325,3334,991
47,Tennessee,47,Tennessee,3,Bedford County,1958,1110,848
47,Tennessee,47,Tennessee,5,Benton County,478,569,-91
47,Tennessee,47,Tennessee,7,Bledsoe County,1110,887,223
47,Tennessee,47,Tennessee,9,Blount County,4427,3088,1339
47,Tennessee,47,Tennessee,11,Bradley County,2967,2830,137
47,Tennessee,47,Tennessee,13,Campbell County,1205,727,478
47,Tennessee,47,Tennessee,15,Cannon County,356,899,-543
47,Tennessee,47,Tennessee,17,Carroll County,932,1016,-84
47,Tennessee,47,Tennessee,19,Carter County,2115,2019,96
47,Tennessee,47,Tennessee,21,Cheatham County,1917,1960,-43
47,Tennessee,47,Tennessee,23,Chester County,894,409,485
47,Tennessee,47,Tennessee,25,Claiborne County,703,717,-14
47,Tennessee,47,Tennessee,27,Clay County,103,475,-372
47,Tennessee,47,Tennessee,29,Cocke County,1219,593,626
47,Tennessee,47,Tennessee,31,Coffee County,1380,1842,-462
47,Tennessee,47,Tennessee,33,Crockett County,583,751,-168
47,Tennessee,47,Tennessee,35,Cumberland County,1236,1722,-486
47,Tennessee,47,Tennessee,37,Davidson County,25307,18105,7202
47,Tennessee,47,Tennessee,39,Decatur County,218,300,-82
47,Tennessee,47,Tennessee,41,DeKalb County,1144,837,307
47,Tennessee,47,Tennessee,43,Dickson County,1271,2053,-782
47,Tennessee,47,Tennessee,45,Dyer County,1100,1011,89
47,Tennessee,47,Tennessee,47,Fayette County,1707,1178,529
47,Tennessee,47,Tennessee,49,Fentress County,561,648,-87
47,Tennessee,47,Tennessee,51,Franklin County,1210,1451,-241
47,Tennessee,47,Tennessee,53,Gibson County,2128,1690,438
47,Tennessee,47,Tennessee,55,Giles County,395,873,-478
47,Tennessee,47,Tennessee,57,Grainger County,1078,844,234
47,Tennessee,47,Tennessee,59,Greene County,1898,1681,217
47,Tennessee,47,Tennessee,61,Grundy County,363,287,76
47,Tennessee,47,Tennessee,63,Hamblen County,1974,1865,109
47,Tennessee,47,Tennessee,65,Hamilton County,5523,6812,-1289
47,Tennessee,47,Tennessee,67,Hancock County,170,275,-105
47,Tennessee,47,Tennessee,69,Hardeman County,1371,498,873
47,Tennessee,47,Tennessee,71,Hardin County,706,363,343
47,Tennessee,47,Tennessee,73,Hawkins County,2664,2595,69
47,Tennessee,47,Tennessee,75,Haywood County,1007,360,647
47,Tennessee,47,Tennessee,77,Henderson County,729,723,6
47,Tennessee,47,Tennessee,79,Henry County,906,504,402
47,Tennessee,47,Tennessee,81,Hickman County,946,1116,-170
47,Tennessee,47,Tennessee,83,Houston County,555,420,135
47,Tennessee,47,Tennessee,85,Humphreys County,604,446,158
47,Tennessee,47,Tennessee,87,Jackson County,529,345,184
47,Tennessee,47,Tennessee,89,Jefferson County,2003,2664,-661
47,Tennessee,47,Tennessee,91,Johnson County,611,853,-242
47,Tennessee,47,Tennessee,93,Knox County,13317,16047,-2730
47,Tennessee,47,Tennessee,95,Lake County,596,973,-377
47,Tennessee,47,Tennessee,97,Lauderdale County,1189,1872,-683
47,Tennessee,47,Tennessee,99,Lawrence County,933,520,413
47,Tennessee,47,Tennessee,101,Lewis County,182,322,-140
47,Tennessee,47,Tennessee,103,Lincoln County,584,976,-392
47,Tennessee,47,Tennessee,105,Loudon County,1843,2174,-331
47,Tennessee,47,Tennessee,107,McMinn County,2125,1809,316
47,Tennessee,47,Tennessee,109,McNairy County,656,502,154
47,Tennessee,47,Tennessee,111,Macon County,880,718,162
47,Tennessee,47,Tennessee,113,Madison County,3118,3023,95
47,Tennessee,47,Tennessee,115,Marion County,740,342,398
47,Tennessee,47,Tennessee,117,Marshall County,1093,1395,-302
47,Tennessee,47,Tennessee,119,Maury County,3798,4281,-483
47,Tennessee,47,Tennessee,121,Meigs County,364,441,-77
47,Tennessee,47,Tennessee,123,Monroe County,1949,1639,310
47,Tennessee,47,Tennessee,125,Montgomery County,4167,3198,969
47,Tennessee,47,Tennessee,127,Moore County,364,362,2
47,Tennessee,47,Tennessee,129,Morgan County,1202,1719,-517
47,Tennessee,47,Tennessee,131,Obion County,1294,1153,141
47,Tennessee,47,Tennessee,133,Overton County,709,624,85
47,Tennessee,47,Tennessee,135,Perry County,88,157,-69
47,Tennessee,47,Tennessee,137,Pickett County,155,354,-199
47,Tennessee,47,Tennessee,139,Polk County,830,634,196
47,Tennessee,47,Tennessee,141,Putnam County,2618,3304,-686
47,Tennessee,47,Tennessee,143,Rhea County,1836,1200,636
47,Tennessee,47,Tennessee,145,Roane County,2127,2080,47
47,Tennessee,47,Tennessee,147,Robertson County,2105,3348,-1243
47,Tennessee,47,Tennessee,149,Rutherford County,10439,12361,-1922
47,Tennessee,47,Tennessee,151,Scott County,264,281,-17
47,Tennessee,47,Tennessee,153,Sequatchie County,461,638,-177
47,Tennessee,47,Tennessee,155,Sevier County,3507,3345,162
47,Tennessee,47,Tennessee,157,Shelby County,8747,10393,-1646
47,Tennessee,47,Tennessee,159,Smith County,1178,608,570
47,Tennessee,47,Tennessee,161,Stewart County,278,874,-596
47,Tennessee,47,Tennessee,163,Sullivan County,4306,4327,-21
47,Tennessee,47,Tennessee,165,Sumner County,6296,6418,-122
47,Tennessee,47,Tennessee,167,Tipton County,2309,2161,148
47,Tennessee,47,Tennessee,169,Trousdale County,824,608,216
47,Tennessee,47,Tennessee,171,Unicoi County,594,465,129
47,Tennessee,47,Tennessee,173,Union County,968,893,75
47,Tennessee,47,Tennessee,175,Van Buren County,196,241,-45
47,Tennessee,47,Tennessee,177,Warren County,769,948,-179
47,Tennessee,47,Tennessee,179,Washington County,5406,5048,358
47,Tennessee,47,Tennessee,181,Wayne County,708,450,258
47,Tennessee,47,Tennessee,183,Weakley County,1507,1705,-198
47,Tennessee,47,Tennessee,185,White County,606,839,-233
47,Tennessee,47,Tennessee,187,Williamson County,7773,10451,-2678
47,Tennessee,47,Tennessee,189,Wilson County,4692,5310,-618
47,Tennessee,48,Texas,1,Anderson County,10,0,10
47,Tennessee,48,Texas,7,Aransas County,19,0,19
47,Tennessee,48,Texas,15,Austin County,66,4,62
47,Tennessee,48,Texas,21,Bastrop County,15,19,-4
47,Tennessee,48,Texas,27,Bell County,611,601,10
47,Tennessee,48,Texas,29,Bexar County,1860,964,896
47,Tennessee,48,Texas,31,Blanco County,3,0,3
47,Tennessee,48,Texas,37,Bowie County,113,0,113
47,Tennessee,48,Texas,39,Brazoria County,55,193,-138
47,Tennessee,48,Texas,41,Brazos County,108,15,93
47,Tennessee,48,Texas,51,Burleson County,0,23,-23
47,Tennessee,48,Texas,55,Caldwell County,0,14,-14
47,Tennessee,48,Texas,57,Calhoun County,61,0,61
47,Tennessee,48,Texas,61,Cameron County,41,32,9
47,Tennessee,48,Texas,71,Chambers County,3,0,3
47,Tennessee,48,Texas,85,Collin County,334,830,-496
47,Tennessee,48,Texas,91,Comal County,28,141,-113
47,Tennessee,48,Texas,93,Comanche County,64,0,64
47,Tennessee,48,Texas,99,Coryell County,37,256,-219
47,Tennessee,48,Texas,113,Dallas County,1123,1447,-324
47,Tennessee,48,Texas,121,Denton County,239,872,-633
47,Tennessee,48,Texas,127,Dimmit County,0,2,-2
47,Tennessee,48,Texas,133,Eastland County,0,4,-4
47,Tennessee,48,Texas,135,Ector County,262,108,154
47,Tennessee,48,Texas,139,Ellis County,90,34,56
47,Tennessee,48,Texas,141,El Paso County,752,263,489
47,Tennessee,48,Texas,147,Fannin County,0,12,-12
47,Tennessee,48,Texas,157,Fort Bend County,170,209,-39
47,Tennessee,48,Texas,161,Freestone County,0,1,-1
47,Tennessee,48,Texas,167,Galveston County,7,406,-399
47,Tennessee,48,Texas,175,Goliad County,92,0,92
47,Tennessee,48,Texas,177,Gonzales County,0,13,-13
47,Tennessee,48,Texas,181,Grayson County,2,39,-37
47,Tennessee,48,Texas,183,Gregg County,44,75,-31
47,Tennessee,48,Texas,185,Grimes County,0,13,-13
47,Tennessee,48,Texas,187,Guadalupe County,57,39,18
47,Tennessee,48,Texas,189,Hale County,16,0,16
47,Tennessee,48,Texas,199,Hardin County,0,32,-32
47,Tennessee,48,Texas,201,Harris County,1411,1712,-301
47,Tennessee,48,Texas,203,Harrison County,0,8,-8
47,Tennessee,48,Texas,209,Hays County,70,40,30
47,Tennessee,48,Texas,213,Henderson County,0,2,-2
47,Tennessee,48,Texas,215,Hidalgo County,101,131,-30
47,Tennessee,48,Texas,217,Hill County,14,116,-102
47,Tennessee,48,Texas,219,Hockley County,0,20,-20
47,Tennessee,48,Texas,221,Hood County,72,0,72
47,Tennessee,48,Texas,223,Hopkins County,25,0,25
47,Tennessee,48,Texas,227,Howard County,9,0,9
47,Tennessee,48,Texas,231,Hunt County,13,82,-69
47,Tennessee,48,Texas,233,Hutchinson County,20,11,9
47,Tennessee,48,Texas,245,Jefferson County,35,95,-60
47,Tennessee,48,Texas,249,Jim Wells County,6,0,6
47,Tennessee,48,Texas,251,Johnson County,30,11,19
47,Tennessee,48,Texas,257,Kaufman County,2,31,-29
47,Tennessee,48,Texas,259,Kendall County,20,21,-1
47,Tennessee,48,Texas,265,Kerr County,65,0,65
47,Tennessee,48,Texas,277,Lamar County,25,0,25
47,Tennessee,48,Texas,281,Lampasas County,0,62,-62
47,Tennessee,48,Texas,283,La Salle County,0,30,-30
47,Tennessee,48,Texas,287,Lee County,211,0,211
47,Tennessee,48,Texas,289,Leon County,19,36,-17
47,Tennessee,48,Texas,291,Liberty County,68,0,68
47,Tennessee,48,Texas,299,Llano County,0,8,-8
47,Tennessee,48,Texas,303,Lubbock County,145,93,52
47,Tennessee,48,Texas,309,McLennan County,111,212,-101
47,Tennessee,48,Texas,325,Medina County,0,27,-27
47,Tennessee,48,Texas,329,Midland County,61,0,61
47,Tennessee,48,Texas,331,Milam County,0,27,-27
47,Tennessee,48,Texas,333,Mills County,0,10,-10
47,Tennessee,48,Texas,335,Mitchell County,0,131,-131
47,Tennessee,48,Texas,339,Montgomery County,281,241,40
47,Tennessee,48,Texas,343,Morris County,0,9,-9
47,Tennessee,48,Texas,349,Navarro County,0,2,-2
47,Tennessee,48,Texas,353,Nolan County,36,0,36
47,Tennessee,48,Texas,355,Nueces County,106,143,-37
47,Tennessee,48,Texas,361,Orange County,7,0,7
47,Tennessee,48,Texas,363,Palo Pinto County,5,9,-4
47,Tennessee,48,Texas,367,Parker County,75,9,66
47,Tennessee,48,Texas,369,Parmer County,0,4,-4
47,Tennessee,48,Texas,373,Polk County,89,18,71
47,Tennessee,48,Texas,375,Potter County,25,6,19
47,Tennessee,48,Texas,397,Rockwall County,98,91,7
47,Tennessee,48,Texas,409,San Patricio County,0,109,-109
47,Tennessee,48,Texas,411,San Saba County,29,8,21
47,Tennessee,48,Texas,415,Scurry County,21,0,21
47,Tennessee,48,Texas,423,Smith County,3,151,-148
47,Tennessee,48,Texas,437,Swisher County,0,2,-2
47,Tennessee,48,Texas,439,Tarrant County,635,2224,-1589
47,Tennessee,48,Texas,441,Taylor County,34,94,-60
47,Tennessee,48,Texas,449,Titus County,37,14,23
47,Tennessee,48,Texas,451,Tom Green County,55,175,-120
47,Tennessee,48,Texas,453,Travis County,627,594,33
47,Tennessee,48,Texas,463,Uvalde County,11,0,11
47,Tennessee,48,Texas,465,Val Verde County,0,13,-13
47,Tennessee,48,Texas,467,Van Zandt County,34,0,34
47,Tennessee,48,Texas,469,Victoria County,90,89,1
47,Tennessee,48,Texas,471,Walker County,0,233,-233
47,Tennessee,48,Texas,473,Waller County,4,7,-3
47,Tennessee,48,Texas,477,Washington County,48,0,48
47,Tennessee,48,Texas,479,Webb County,0,14,-14
47,Tennessee,48,Texas,481,Wharton County,0,12,-12
47,Tennessee,48,Texas,485,Wichita County,0,125,-125
47,Tennessee,48,Texas,491,Williamson County,174,358,-184
47,Tennessee,48,Texas,497,Wise County,100,11,89
47,Tennessee,49,Utah,3,Box Elder County,27,25,2
47,Tennessee,49,Utah,5,Cache County,38,0,38
47,Tennessee,49,Utah,7,Carbon County,0,16,-16
47,Tennessee,49,Utah,11,Davis County,124,26,98
47,Tennessee,49,Utah,21,Iron County,17,0,17
47,Tennessee,49,Utah,25,Kane County,0,7,-7
47,Tennessee,49,Utah,31,Piute County,0,1,-1
47,Tennessee,49,Utah,35,Salt Lake County,293,408,-115
47,Tennessee,49,Utah,39,Sanpete County,0,7,-7
47,Tennessee,49,Utah,49,Utah County,58,380,-322
47,Tennessee,49,Utah,53,Washington County,56,130,-74
47,Tennessee,49,Utah,55,Wayne County,0,2,-2
47,Tennessee,49,Utah,57,Weber County,0,30,-30
47,Tennessee,5,Arkansas,1,Arkansas County,0,43,-43
47,Tennessee,5,Arkansas,3,Ashley County,119,5,114
47,Tennessee,5,Arkansas,5,Baxter County,103,11,92
47,Tennessee,5,Arkansas,7,Benton County,230,262,-32
47,Tennessee,5,Arkansas,9,Boone County,135,27,108
47,Tennessee,5,Arkansas,15,Carroll County,106,6,100
47,Tennessee,5,Arkansas,17,Chicot County,10,16,-6
47,Tennessee,5,Arkansas,19,Clark County,57,27,30
47,Tennessee,5,Arkansas,21,Clay County,14,0,14
47,Tennessee,5,Arkansas,23,Cleburne County,0,56,-56
47,Tennessee,5,Arkansas,25,Cleveland County,0,5,-5
47,Tennessee,5,Arkansas,29,Conway County,0,59,-59
47,Tennessee,5,Arkansas,31,Craighead County,547,328,219
47,Tennessee,5,Arkansas,33,Crawford County,184,0,184
47,Tennessee,5,Arkansas,35,Crittenden County,851,732,119
47,Tennessee,5,Arkansas,37,Cross County,22,29,-7
47,Tennessee,5,Arkansas,43,Drew County,26,9,17
47,Tennessee,5,Arkansas,45,Faulkner County,318,257,61
47,Tennessee,5,Arkansas,49,Fulton County,21,0,21
47,Tennessee,5,Arkansas,51,Garland County,212,197,15
47,Tennessee,5,Arkansas,53,Grant County,23,0,23
47,Tennessee,5,Arkansas,55,Greene County,114,65,49
47,Tennessee,5,Arkansas,59,Hot Spring County,11,0,11
47,Tennessee,5,Arkansas,63,Independence County,44,119,-75
47,Tennessee,5,Arkansas,65,Izard County,0,5,-5
47,Tennessee,5,Arkansas,67,Jackson County,5,47,-42
47,Tennessee,5,Arkansas,69,Jefferson County,72,40,32
47,Tennessee,5,Arkansas,73,Lafayette County,14,0,14
47,Tennessee,5,Arkansas,75,Lawrence County,6,46,-40
47,Tennessee,5,Arkansas,83,Logan County,13,0,13
47,Tennessee,5,Arkansas,85,Lonoke County,187,23,164
47,Tennessee,5,Arkansas,89,Marion County,0,32,-32
47,Tennessee,5,Arkansas,91,Miller County,59,0,59
47,Tennessee,5,Arkansas,93,Mississippi County,208,155,53
47,Tennessee,5,Arkansas,95,Monroe County,9,0,9
47,Tennessee,5,Arkansas,97,Montgomery County,0,10,-10
47,Tennessee,5,Arkansas,107,Phillips County,4,0,4
47,Tennessee,5,Arkansas,111,Poinsett County,97,125,-28
47,Tennessee,5,Arkansas,113,Polk County,27,0,27
47,Tennessee,5,Arkansas,115,Pope County,11,2,9
47,Tennessee,5,Arkansas,119,Pulaski County,931,816,115
47,Tennessee,5,Arkansas,121,Randolph County,42,165,-123
47,Tennessee,5,Arkansas,123,St. Francis County,105,136,-31
47,Tennessee,5,Arkansas,125,Saline County,5,56,-51
47,Tennessee,5,Arkansas,127,Scott County,86,0,86
47,Tennessee,5,Arkansas,131,Sebastian County,139,273,-134
47,Tennessee,5,Arkansas,135,Sharp County,0,27,-27
47,Tennessee,5,Arkansas,139,Union County,144,0,144
47,Tennessee,5,Arkansas,143,Washington County,336,227,109
47,Tennessee,5,Arkansas,145,White County,93,203,-110
47,Tennessee,5,Arkansas,147,Woodruff County,0,8,-8
47,Tennessee,5,Arkansas,149,Yell County,56,6,50
47,Tennessee,50,Vermont,1,Addison County,0,26,-26
47,Tennessee,50,Vermont,3,Bennington County,6,0,6
47,Tennessee,50,Vermont,5,Caledonia County,39,15,24
47,Tennessee,50,Vermont,7,Chittenden County,60,2,58
47,Tennessee,50,Vermont,11,Franklin County,118,0,118
47,Tennessee,50,Vermont,13,Grand Isle County,0,13,-13
47,Tennessee,50,Vermont,17,Orange County,15,21,-6
47,Tennessee,50,Vermont,19,Orleans County,58,19,39
47,Tennessee,50,Vermont,21,Rutland County,9,0,9
47,Tennessee,50,Vermont,23,Washington County,0,4,-4
47,Tennessee,50,Vermont,25,Windham County,11,40,-29
47,Tennessee,51,Virginia,1,Accomack County,21,0,21
47,Tennessee,51,Virginia,3,Albemarle County,154,37,117
47,Tennessee,51,Virginia,5,Alleghany County,0,20,-20
47,Tennessee,51,Virginia,9,Amherst County,0,5,-5
47,Tennessee,51,Virginia,13,Arlington County,220,328,-108
47,Tennessee,51,Virginia,15,Augusta County,6,49,-43
47,Tennessee,51,Virginia,19,Bedford County,35,86,-51
47,Tennessee,51,Virginia,23,Botetourt County,0,45,-45
47,Tennessee,51,Virginia,27,Buchanan County,34,35,-1
47,Tennessee,51,Virginia,37,Charlotte County,0,4,-4
47,Tennessee,51,Virginia,41,Chesterfield County,267,203,64
47,Tennessee,51,Virginia,43,Clarke County,0,7,-7
47,Tennessee,51,Virginia,47,Culpeper County,9,17,-8
47,Tennessee,51,Virginia,51,Dickenson County,9,6,3
47,Tennessee,51,Virginia,57,Essex County,0,9,-9
47,Tennessee,51,Virginia,59,Fairfax County,526,457,69
47,Tennessee,51,Virginia,61,Fauquier County,21,0,21
47,Tennessee,51,Virginia,63,Floyd County,0,24,-24
47,Tennessee,51,Virginia,65,Fluvanna County,43,0,43
47,Tennessee,51,Virginia,67,Franklin County,15,0,15
47,Tennessee,51,Virginia,69,Frederick County,28,16,12
47,Tennessee,51,Virginia,71,Giles County,56,12,44
47,Tennessee,51,Virginia,73,Gloucester County,0,28,-28
47,Tennessee,51,Virginia,77,Grayson County,0,9,-9
47,Tennessee,51,Virginia,79,Greene County,58,0,58
47,Tennessee,51,Virginia,81,Greensville County,6,0,6
47,Tennessee,51,Virginia,83,Halifax County,19,0,19
47,Tennessee,51,Virginia,85,Hanover County,43,36,7
47,Tennessee,51,Virginia,87,Henrico County,49,30,19
47,Tennessee,51,Virginia,89,Henry County,0,13,-13
47,Tennessee,51,Virginia,93,Isle of Wight County,89,0,89
47,Tennessee,51,Virginia,95,James City County,52,14,38
47,Tennessee,51,Virginia,99,King George County,13,7,6
47,Tennessee,51,Virginia,101,King William County,42,0,42
47,Tennessee,51,Virginia,105,Lee County,363,170,193
47,Tennessee,51,Virginia,107,Loudoun County,187,140,47
47,Tennessee,51,Virginia,109,Louisa County,11,14,-3
47,Tennessee,51,Virginia,117,Mecklenburg County,90,0,90
47,Tennessee,51,Virginia,119,Middlesex County,0,35,-35
47,Tennessee,51,Virginia,121,Montgomery County,189,96,93
47,Tennessee,51,Virginia,131,Northampton County,0,4,-4
47,Tennessee,51,Virginia,135,Nottoway County,19,0,19
47,Tennessee,51,Virginia,139,Page County,42,0,42
47,Tennessee,51,Virginia,145,Powhatan County,5,3,2
47,Tennessee,51,Virginia,147,Prince Edward County,9,0,9
47,Tennessee,51,Virginia,149,Prince George County,41,51,-10
47,Tennessee,51,Virginia,153,Prince William County,382,123,259
47,Tennessee,51,Virginia,155,Pulaski County,13,14,-1
47,Tennessee,51,Virginia,161,Roanoke County,81,94,-13
47,Tennessee,51,Virginia,163,Rockbridge County,28,30,-2
47,Tennessee,51,Virginia,165,Rockingham County,0,50,-50
47,Tennessee,51,Virginia,167,Russell County,99,207,-108
47,Tennessee,51,Virginia,169,Scott County,645,319,326
47,Tennessee,51,Virginia,171,Shenandoah County,0,22,-22
47,Tennessee,51,Virginia,173,Smyth County,130,58,72
47,Tennessee,51,Virginia,177,Spotsylvania County,28,28,0
47,Tennessee,51,Virginia,179,Stafford County,132,101,31
47,Tennessee,51,Virginia,185,Tazewell County,41,27,14
47,Tennessee,51,Virginia,187,Warren County,68,0,68
47,Tennessee,51,Virginia,191,Washington County,521,504,17
47,Tennessee,51,Virginia,193,Westmoreland County,8,10,-2
47,Tennessee,51,Virginia,195,Wise County,391,152,239
47,Tennessee,51,Virginia,197,Wythe County,17,66,-49
47,Tennessee,51,Virginia,199,York County,40,12,28
47,Tennessee,51,Virginia,510,Alexandria city,59,109,-50
47,Tennessee,51,Virginia,520,Bristol city,584,604,-20
47,Tennessee,51,Virginia,540,Charlottesville city,81,103,-22
47,Tennessee,51,Virginia,550,Chesapeake city,272,204,68
47,Tennessee,51,Virginia,570,Colonial Heights city,44,0,44
47,Tennessee,51,Virginia,590,Danville city,29,92,-63
47,Tennessee,51,Virginia,600,Fairfax city,0,39,-39
47,Tennessee,51,Virginia,610,Falls Church city,0,34,-34
47,Tennessee,51,Virginia,620,Franklin city,13,0,13
47,Tennessee,51,Virginia,630,Fredericksburg city,61,4,57
47,Tennessee,51,Virginia,650,Hampton city,84,37,47
47,Tennessee,51,Virginia,660,Harrisonburg city,133,0,133
47,Tennessee,51,Virginia,678,Lexington city,4,15,-11
47,Tennessee,51,Virginia,680,Lynchburg city,73,16,57
47,Tennessee,51,Virginia,690,Martinsville city,0,9,-9
47,Tennessee,51,Virginia,700,Newport News city,41,432,-391
47,Tennessee,51,Virginia,710,Norfolk city,227,328,-101
47,Tennessee,51,Virginia,720,Norton city,0,39,-39
47,Tennessee,51,Virginia,730,Petersburg city,0,16,-16
47,Tennessee,51,Virginia,740,Portsmouth city,41,4,37
47,Tennessee,51,Virginia,750,Radford city,50,5,45
47,Tennessee,51,Virginia,760,Richmond city,78,89,-11
47,Tennessee,51,Virginia,770,Roanoke city,165,53,112
47,Tennessee,51,Virginia,775,Salem city,0,13,-13
47,Tennessee,51,Virginia,800,Suffolk city,49,0,49
47,Tennessee,51,Virginia,810,Virginia Beach city,278,311,-33
47,Tennessee,51,Virginia,820,Waynesboro city,16,0,16
47,Tennessee,51,Virginia,830,Williamsburg city,36,14,22
47,Tennessee,51,Virginia,840,Winchester city,19,159,-140
47,Tennessee,53,Washington,5,Benton County,46,41,5
47,Tennessee,53,Washington,9,Clallam County,0,16,-16
47,Tennessee,53,Washington,11,Clark County,0,7,-7
47,Tennessee,53,Washington,27,Grays Harbor County,24,0,24
47,Tennessee,53,Washington,29,Island County,74,70,4
47,Tennessee,53,Washington,33,King County,491,205,286
47,Tennessee,53,Washington,35,Kitsap County,76,132,-56
47,Tennessee,53,Washington,53,Pierce County,577,873,-296
47,Tennessee,53,Washington,55,San Juan County,0,11,-11
47,Tennessee,53,Washington,57,Skagit County,0,67,-67
47,Tennessee,53,Washington,61,Snohomish County,298,108,190
47,Tennessee,53,Washington,63,Spokane County,101,105,-4
47,Tennessee,53,Washington,67,Thurston County,217,275,-58
47,Tennessee,53,Washington,71,Walla Walla County,0,57,-57
47,Tennessee,53,Washington,73,Whatcom County,22,2,20
47,Tennessee,53,Washington,75,Whitman County,9,31,-22
47,Tennessee,53,Washington,77,Yakima County,12,0,12
47,Tennessee,54,West Virginia,1,Barbour County,161,0,161
47,Tennessee,54,West Virginia,3,Berkeley County,16,86,-70
47,Tennessee,54,West Virginia,5,Boone County,46,0,46
47,Tennessee,54,West Virginia,11,Cabell County,33,43,-10
47,Tennessee,54,West Virginia,17,Doddridge County,0,13,-13
47,Tennessee,54,West Virginia,19,Fayette County,102,0,102
47,Tennessee,54,West Virginia,21,Gilmer County,0,9,-9
47,Tennessee,54,West Virginia,25,Greenbrier County,65,5,60
47,Tennessee,54,West Virginia,33,Harrison County,17,40,-23
47,Tennessee,54,West Virginia,35,Jackson County,17,0,17
47,Tennessee,54,West Virginia,39,Kanawha County,113,184,-71
47,Tennessee,54,West Virginia,41,Lewis County,110,0,110
47,Tennessee,54,West Virginia,43,Lincoln County,4,72,-68
47,Tennessee,54,West Virginia,45,Logan County,126,0,126
47,Tennessee,54,West Virginia,49,Marion County,0,135,-135
47,Tennessee,54,West Virginia,51,Marshall County,32,7,25
47,Tennessee,54,West Virginia,53,Mason County,15,0,15
47,Tennessee,54,West Virginia,55,Mercer County,109,48,61
47,Tennessee,54,West Virginia,59,Mingo County,18,131,-113
47,Tennessee,54,West Virginia,61,Monongalia County,10,142,-132
47,Tennessee,54,West Virginia,67,Nicholas County,15,0,15
47,Tennessee,54,West Virginia,69,Ohio County,4,4,0
47,Tennessee,54,West Virginia,71,Pendleton County,4,0,4
47,Tennessee,54,West Virginia,75,Pocahontas County,15,0,15
47,Tennessee,54,West Virginia,77,Preston County,0,8,-8
47,Tennessee,54,West Virginia,79,Putnam County,60,43,17
47,Tennessee,54,West Virginia,81,Raleigh County,52,8,44
47,Tennessee,54,West Virginia,83,Randolph County,0,12,-12
47,Tennessee,54,West Virginia,85,Ritchie County,35,0,35
47,Tennessee,54,West Virginia,89,Summers County,0,42,-42
47,Tennessee,54,West Virginia,95,Tyler County,0,17,-17
47,Tennessee,54,West Virginia,97,Upshur County,0,30,-30
47,Tennessee,54,West Virginia,99,Wayne County,24,23,1
47,Tennessee,54,West Virginia,101,Webster County,0,8,-8
47,Tennessee,54,West Virginia,107,Wood County,35,22,13
47,Tennessee,55,Wisconsin,5,Barron County,0,2,-2
47,Tennessee,55,Wisconsin,7,Bayfield County,0,2,-2
47,Tennessee,55,Wisconsin,9,Brown County,28,17,11
47,Tennessee,55,Wisconsin,13,Burnett County,0,7,-7
47,Tennessee,55,Wisconsin,15,Calumet County,13,33,-20
47,Tennessee,55,Wisconsin,19,Clark County,5,2,3
47,Tennessee,55,Wisconsin,21,Columbia County,0,24,-24
47,Tennessee,55,Wisconsin,25,Dane County,77,384,-307
47,Tennessee,55,Wisconsin,27,Dodge County,0,6,-6
47,Tennessee,55,Wisconsin,33,Dunn County,71,0,71
47,Tennessee,55,Wisconsin,35,Eau Claire County,0,26,-26
47,Tennessee,55,Wisconsin,39,Fond du Lac County,72,0,72
47,Tennessee,55,Wisconsin,45,Green County,11,27,-16
47,Tennessee,55,Wisconsin,47,Green Lake County,35,0,35
47,Tennessee,55,Wisconsin,49,Iowa County,0,8,-8
47,Tennessee,55,Wisconsin,51,Iron County,0,3,-3
47,Tennessee,55,Wisconsin,53,Jackson County,0,2,-2
47,Tennessee,55,Wisconsin,55,Jefferson County,0,16,-16
47,Tennessee,55,Wisconsin,57,Juneau County,0,2,-2
47,Tennessee,55,Wisconsin,59,Kenosha County,0,83,-83
47,Tennessee,55,Wisconsin,63,La Crosse County,11,6,5
47,Tennessee,55,Wisconsin,73,Marathon County,0,17,-17
47,Tennessee,55,Wisconsin,75,Marinette County,18,23,-5
47,Tennessee,55,Wisconsin,79,Milwaukee County,437,312,125
47,Tennessee,55,Wisconsin,81,Monroe County,0,77,-77
47,Tennessee,55,Wisconsin,85,Oneida County,0,13,-13
47,Tennessee,55,Wisconsin,87,Outagamie County,9,75,-66
47,Tennessee,55,Wisconsin,89,Ozaukee County,310,28,282
47,Tennessee,55,Wisconsin,93,Pierce County,0,3,-3
47,Tennessee,55,Wisconsin,97,Portage County,7,0,7
47,Tennessee,55,Wisconsin,101,Racine County,82,120,-38
47,Tennessee,55,Wisconsin,105,Rock County,37,8,29
47,Tennessee,55,Wisconsin,111,Sauk County,0,26,-26
47,Tennessee,55,Wisconsin,113,Sawyer County,14,0,14
47,Tennessee,55,Wisconsin,117,Sheboygan County,0,16,-16
47,Tennessee,55,Wisconsin,121,Trempealeau County,7,0,7
47,Tennessee,55,Wisconsin,123,Vernon County,56,3,53
47,Tennessee,55,Wisconsin,125,Vilas County,0,2,-2
47,Tennessee,55,Wisconsin,127,Walworth County,73,93,-20
47,Tennessee,55,Wisconsin,131,Washington County,52,9,43
47,Tennessee,55,Wisconsin,133,Waukesha County,103,55,48
47,Tennessee,55,Wisconsin,135,Waupaca County,4,12,-8
47,Tennessee,55,Wisconsin,139,Winnebago County,128,96,32
47,Tennessee,55,Wisconsin,141,Wood County,15,191,-176
47,Tennessee,56,Wyoming,1,Albany County,16,0,16
47,Tennessee,56,Wyoming,3,Big Horn County,0,15,-15
47,Tennessee,56,Wyoming,7,Carbon County,0,35,-35
47,Tennessee,56,Wyoming,13,Fremont County,0,50,-50
47,Tennessee,56,Wyoming,19,Johnson County,0,1,-1
47,Tennessee,56,Wyoming,21,Laramie County,158,7,151
47,Tennessee,56,Wyoming,25,Natrona County,29,17,12
47,Tennessee,56,Wyoming,29,Park County,0,67,-67
47,Tennessee,56,Wyoming,39,Teton County,0,1,-1
47,Tennessee,6,California,1,Alameda County,254,131,123
47,Tennessee,6,California,5,Amador County,0,2,-2
47,Tennessee,6,California,7,Butte County,25,16,9
47,Tennessee,6,California,9,Calaveras County,5,0,5
47,Tennessee,6,California,11,Colusa County,0,83,-83
47,Tennessee,6,California,13,Contra Costa County,98,148,-50
47,Tennessee,6,California,17,El Dorado County,0,68,-68
47,Tennessee,6,California,19,Fresno County,126,26,100
47,Tennessee,6,California,23,Humboldt County,15,33,-18
47,Tennessee,6,California,25,Imperial County,84,35,49
47,Tennessee,6,California,27,Inyo County,154,18,136
47,Tennessee,6,California,29,Kern County,190,58,132
47,Tennessee,6,California,31,Kings County,85,41,44
47,Tennessee,6,California,37,Los Angeles County,1724,1390,334
47,Tennessee,6,California,41,Marin County,6,45,-39
47,Tennessee,6,California,45,Mendocino County,0,8,-8
47,Tennessee,6,California,47,Merced County,10,26,-16
47,Tennessee,6,California,53,Monterey County,216,302,-86
47,Tennessee,6,California,55,Napa County,0,41,-41
47,Tennessee,6,California,57,Nevada County,0,15,-15
47,Tennessee,6,California,59,Orange County,767,554,213
47,Tennessee,6,California,61,Placer County,124,44,80
47,Tennessee,6,California,63,Plumas County,10,0,10
47,Tennessee,6,California,65,Riverside County,626,710,-84
47,Tennessee,6,California,67,Sacramento County,467,88,379
47,Tennessee,6,California,69,San Benito County,0,14,-14
47,Tennessee,6,California,71,San Bernardino County,666,669,-3
47,Tennessee,6,California,73,San Diego County,1274,800,474
47,Tennessee,6,California,75,San Francisco County,374,242,132
47,Tennessee,6,California,77,San Joaquin County,110,88,22
47,Tennessee,6,California,79,San Luis Obispo County,17,0,17
47,Tennessee,6,California,81,San Mateo County,129,63,66
47,Tennessee,6,California,83,Santa Barbara County,74,8,66
47,Tennessee,6,California,85,Santa Clara County,595,214,381
47,Tennessee,6,California,87,Santa Cruz County,35,0,35
47,Tennessee,6,California,89,Shasta County,58,36,22
47,Tennessee,6,California,93,Siskiyou County,46,0,46
47,Tennessee,6,California,95,Solano County,71,110,-39
47,Tennessee,6,California,97,Sonoma County,73,14,59
47,Tennessee,6,California,99,Stanislaus County,136,53,83
47,Tennessee,6,California,101,Sutter County,16,56,-40
47,Tennessee,6,California,107,Tulare County,17,0,17
47,Tennessee,6,California,111,Ventura County,229,0,229
47,Tennessee,6,California,113,Yolo County,115,55,60
47,Tennessee,6,California,115,Yuba County,20,41,-21
47,Tennessee,72,Puerto Rico,5,Aguadilla Municipio,104,0,104
47,Tennessee,72,Puerto Rico,21,Bayamón Municipio,12,0,12
47,Tennessee,72,Puerto Rico,27,Camuy Municipio,26,0,26
47,Tennessee,72,Puerto Rico,31,Carolina Municipio,204,0,204
47,Tennessee,72,Puerto Rico,57,Guayama Municipio,10,0,10
47,Tennessee,72,Puerto Rico,67,Hormigueros Municipio,0,16,-16
47,Tennessee,72,Puerto Rico,77,Juncos Municipio,8,0,8
47,Tennessee,72,Puerto Rico,81,Lares Municipio,47,0,47
47,Tennessee,72,Puerto Rico,113,Ponce Municipio,0,135,-135
47,Tennessee,72,Puerto Rico,121,Sabana Grande Municipio,0,9,-9
47,Tennessee,72,Puerto Rico,125,San Germán Municipio,0,10,-10
47,Tennessee,72,Puerto Rico,127,San Juan Municipio,186,28,158
47,Tennessee,72,Puerto Rico,131,San Sebastián Municipio,58,0,58
47,Tennessee,8,Colorado,1,Adams County,57,268,-211
47,Tennessee,8,Colorado,3,Alamosa County,13,0,13
47,Tennessee,8,Colorado,5,Arapahoe County,293,218,75
47,Tennessee,8,Colorado,7,Archuleta County,20,3,17
47,Tennessee,8,Colorado,13,Boulder County,97,360,-263
47,Tennessee,8,Colorado,14,Broomfield County,50,20,30
47,Tennessee,8,Colorado,15,Chaffee County,56,0,56
47,Tennessee,8,Colorado,25,Crowley County,0,17,-17
47,Tennessee,8,Colorado,29,Delta County,28,14,14
47,Tennessee,8,Colorado,31,Denver County,422,313,109
47,Tennessee,8,Colorado,35,Douglas County,60,304,-244
47,Tennessee,8,Colorado,37,Eagle County,0,41,-41
47,Tennessee,8,Colorado,39,Elbert County,49,0,49
47,Tennessee,8,Colorado,41,El Paso County,376,626,-250
47,Tennessee,8,Colorado,43,Fremont County,0,24,-24
47,Tennessee,8,Colorado,45,Garfield County,0,60,-60
47,Tennessee,8,Colorado,47,Gilpin County,13,0,13
47,Tennessee,8,Colorado,51,Gunnison County,0,27,-27
47,Tennessee,8,Colorado,59,Jefferson County,66,305,-239
47,Tennessee,8,Colorado,67,La Plata County,29,0,29
47,Tennessee,8,Colorado,69,Larimer County,75,85,-10
47,Tennessee,8,Colorado,71,Las Animas County,0,7,-7
47,Tennessee,8,Colorado,77,Mesa County,31,0,31
47,Tennessee,8,Colorado,89,Otero County,0,17,-17
47,Tennessee,8,Colorado,93,Park County,99,0,99
47,Tennessee,8,Colorado,99,Prowers County,6,0,6
47,Tennessee,8,Colorado,101,Pueblo County,30,9,21
47,Tennessee,8,Colorado,109,Saguache County,0,13,-13
47,Tennessee,8,Colorado,113,San Miguel County,0,4,-4
47,Tennessee,8,Colorado,117,Summit County,13,0,13
47,Tennessee,8,Colorado,119,Teller County,23,0,23
47,Tennessee,8,Colorado,121,Washington County,0,7,-7
47,Tennessee,8,Colorado,123,Weld County,40,54,-14
47,Tennessee,9,Connecticut,1,Fairfield County,267,64,203
47,Tennessee,9,Connecticut,3,Hartford County,280,200,80
47,Tennessee,9,Connecticut,5,Litchfield County,79,0,79
47,Tennessee,9,Connecticut,9,New Haven County,193,290,-97
47,Tennessee,9,Connecticut,11,New London County,139,53,86
47,Tennessee,9,Connecticut,13,Tolland County,35,35,0
47,Tennessee,9,Connecticut,15,Windham County,52,0,52
47,Tennessee,AFR,Africa,,-,2150,0,0
47,Tennessee,ASI,Asia,,-,10019,0,0
47,Tennessee,CAM,Central America,,-,4480,0,0
47,Tennessee,CAR,Caribbean,,-,889,0,0
47,Tennessee,EUR,Europe,,-,4462,0,0
47,Tennessee,ISL,U.S. Island Areas,,-,308,0,0
47,Tennessee,NAM,Northern America,,-,901,0,0
47,Tennessee,OCE,Oceania and At Sea,,-,584,0,0
47,Tennessee,SAM,South America,,-,1069,0,0
48,Texas,1,Alabama,1,Autauga County,171,103,68
48,Texas,1,Alabama,3,Baldwin County,121,485,-364
48,Texas,1,Alabama,5,Barbour County,15,5,10
48,Texas,1,Alabama,7,Bibb County,3,0,3
48,Texas,1,Alabama,9,Blount County,19,6,13
48,Texas,1,Alabama,15,Calhoun County,38,82,-44
48,Texas,1,Alabama,17,Chambers County,11,23,-12
48,Texas,1,Alabama,19,Cherokee County,6,0,6
48,Texas,1,Alabama,21,Chilton County,58,191,-133
48,Texas,1,Alabama,23,Choctaw County,0,33,-33
48,Texas,1,Alabama,25,Clarke County,74,18,56
48,Texas,1,Alabama,27,Clay County,0,50,-50
48,Texas,1,Alabama,31,Coffee County,203,173,30
48,Texas,1,Alabama,33,Colbert County,11,0,11
48,Texas,1,Alabama,39,Covington County,61,8,53
48,Texas,1,Alabama,41,Crenshaw County,26,7,19
48,Texas,1,Alabama,43,Cullman County,0,81,-81
48,Texas,1,Alabama,45,Dale County,249,254,-5
48,Texas,1,Alabama,47,Dallas County,13,0,13
48,Texas,1,Alabama,49,DeKalb County,17,85,-68
48,Texas,1,Alabama,51,Elmore County,46,55,-9
48,Texas,1,Alabama,53,Escambia County,17,0,17
48,Texas,1,Alabama,55,Etowah County,240,187,53
48,Texas,1,Alabama,57,Fayette County,19,0,19
48,Texas,1,Alabama,59,Franklin County,24,0,24
48,Texas,1,Alabama,61,Geneva County,21,0,21
48,Texas,1,Alabama,63,Greene County,0,10,-10
48,Texas,1,Alabama,65,Hale County,165,63,102
48,Texas,1,Alabama,69,Houston County,153,98,55
48,Texas,1,Alabama,71,Jackson County,0,8,-8
48,Texas,1,Alabama,73,Jefferson County,1451,951,500
48,Texas,1,Alabama,77,Lauderdale County,113,54,59
48,Texas,1,Alabama,81,Lee County,438,240,198
48,Texas,1,Alabama,83,Limestone County,53,3,50
48,Texas,1,Alabama,87,Macon County,0,9,-9
48,Texas,1,Alabama,89,Madison County,925,686,239
48,Texas,1,Alabama,91,Marengo County,0,1,-1
48,Texas,1,Alabama,93,Marion County,0,51,-51
48,Texas,1,Alabama,95,Marshall County,22,106,-84
48,Texas,1,Alabama,97,Mobile County,1091,558,533
48,Texas,1,Alabama,101,Montgomery County,697,530,167
48,Texas,1,Alabama,103,Morgan County,26,96,-70
48,Texas,1,Alabama,105,Perry County,71,11,60
48,Texas,1,Alabama,107,Pickens County,25,37,-12
48,Texas,1,Alabama,109,Pike County,29,0,29
48,Texas,1,Alabama,113,Russell County,203,129,74
48,Texas,1,Alabama,115,St. Clair County,277,102,175
48,Texas,1,Alabama,117,Shelby County,130,253,-123
48,Texas,1,Alabama,119,Sumter County,18,0,18
48,Texas,1,Alabama,121,Talladega County,66,94,-28
48,Texas,1,Alabama,123,Tallapoosa County,32,64,-32
48,Texas,1,Alabama,125,Tuscaloosa County,372,654,-282
48,Texas,1,Alabama,127,Walker County,5,20,-15
48,Texas,1,Alabama,129,Washington County,0,1,-1
48,Texas,1,Alabama,133,Winston County,14,12,2
48,Texas,10,Delaware,1,Kent County,315,329,-14
48,Texas,10,Delaware,3,New Castle County,664,245,419
48,Texas,10,Delaware,5,Sussex County,240,126,114
48,Texas,11,District of Columbia,1,District of Columbia,1425,1850,-425
48,Texas,12,Florida,1,Alachua County,698,644,54
48,Texas,12,Florida,3,Baker County,89,0,89
48,Texas,12,Florida,5,Bay County,178,706,-528
48,Texas,12,Florida,9,Brevard County,1117,646,471
48,Texas,12,Florida,11,Broward County,2537,2106,431
48,Texas,12,Florida,13,Calhoun County,0,26,-26
48,Texas,12,Florida,15,Charlotte County,255,176,79
48,Texas,12,Florida,17,Citrus County,137,41,96
48,Texas,12,Florida,19,Clay County,466,207,259
48,Texas,12,Florida,21,Collier County,437,515,-78
48,Texas,12,Florida,23,Columbia County,40,47,-7
48,Texas,12,Florida,27,DeSoto County,0,44,-44
48,Texas,12,Florida,29,Dixie County,40,0,40
48,Texas,12,Florida,31,Duval County,1325,1636,-311
48,Texas,12,Florida,33,Escambia County,1481,1090,391
48,Texas,12,Florida,35,Flagler County,60,66,-6
48,Texas,12,Florida,37,Franklin County,20,5,15
48,Texas,12,Florida,39,Gadsden County,120,0,120
48,Texas,12,Florida,45,Gulf County,0,12,-12
48,Texas,12,Florida,49,Hardee County,95,0,95
48,Texas,12,Florida,53,Hernando County,141,223,-82
48,Texas,12,Florida,55,Highlands County,113,0,113
48,Texas,12,Florida,57,Hillsborough County,2100,1805,295
48,Texas,12,Florida,59,Holmes County,14,0,14
48,Texas,12,Florida,61,Indian River County,75,293,-218
48,Texas,12,Florida,63,Jackson County,39,62,-23
48,Texas,12,Florida,69,Lake County,951,571,380
48,Texas,12,Florida,71,Lee County,683,1057,-374
48,Texas,12,Florida,73,Leon County,502,290,212
48,Texas,12,Florida,75,Levy County,14,0,14
48,Texas,12,Florida,81,Manatee County,494,882,-388
48,Texas,12,Florida,83,Marion County,213,516,-303
48,Texas,12,Florida,85,Martin County,41,193,-152
48,Texas,12,Florida,86,Miami-Dade County,5148,1857,3291
48,Texas,12,Florida,87,Monroe County,129,265,-136
48,Texas,12,Florida,89,Nassau County,40,139,-99
48,Texas,12,Florida,91,Okaloosa County,1589,1071,518
48,Texas,12,Florida,93,Okeechobee County,0,108,-108
48,Texas,12,Florida,95,Orange County,2662,2342,320
48,Texas,12,Florida,97,Osceola County,1106,132,974
48,Texas,12,Florida,99,Palm Beach County,1314,1445,-131
48,Texas,12,Florida,101,Pasco County,642,361,281
48,Texas,12,Florida,103,Pinellas County,1157,1844,-687
48,Texas,12,Florida,105,Polk County,606,1255,-649
48,Texas,12,Florida,107,Putnam County,14,0,14
48,Texas,12,Florida,109,St. Johns County,364,369,-5
48,Texas,12,Florida,111,St. Lucie County,519,426,93
48,Texas,12,Florida,113,Santa Rosa County,658,1277,-619
48,Texas,12,Florida,115,Sarasota County,481,409,72
48,Texas,12,Florida,117,Seminole County,754,395,359
48,Texas,12,Florida,119,Sumter County,40,135,-95
48,Texas,12,Florida,121,Suwannee County,7,50,-43
48,Texas,12,Florida,123,Taylor County,0,13,-13
48,Texas,12,Florida,127,Volusia County,1589,413,1176
48,Texas,12,Florida,129,Wakulla County,50,26,24
48,Texas,12,Florida,131,Walton County,256,195,61
48,Texas,12,Florida,133,Washington County,104,42,62
48,Texas,13,Georgia,3,Atkinson County,40,0,40
48,Texas,13,Georgia,11,Banks County,0,13,-13
48,Texas,13,Georgia,13,Barrow County,77,3,74
48,Texas,13,Georgia,15,Bartow County,247,61,186
48,Texas,13,Georgia,17,Ben Hill County,0,14,-14
48,Texas,13,Georgia,19,Berrien County,59,0,59
48,Texas,13,Georgia,21,Bibb County,566,26,540
48,Texas,13,Georgia,25,Brantley County,18,0,18
48,Texas,13,Georgia,29,Bryan County,466,197,269
48,Texas,13,Georgia,31,Bulloch County,124,0,124
48,Texas,13,Georgia,35,Butts County,0,8,-8
48,Texas,13,Georgia,39,Camden County,57,210,-153
48,Texas,13,Georgia,45,Carroll County,231,277,-46
48,Texas,13,Georgia,47,Catoosa County,39,22,17
48,Texas,13,Georgia,49,Charlton County,26,28,-2
48,Texas,13,Georgia,51,Chatham County,711,958,-247
48,Texas,13,Georgia,53,Chattahoochee County,760,429,331
48,Texas,13,Georgia,55,Chattooga County,11,0,11
48,Texas,13,Georgia,57,Cherokee County,181,389,-208
48,Texas,13,Georgia,59,Clarke County,318,328,-10
48,Texas,13,Georgia,63,Clayton County,189,464,-275
48,Texas,13,Georgia,67,Cobb County,1630,1493,137
48,Texas,13,Georgia,69,Coffee County,0,8,-8
48,Texas,13,Georgia,71,Colquitt County,21,59,-38
48,Texas,13,Georgia,73,Columbia County,555,391,164
48,Texas,13,Georgia,75,Cook County,0,9,-9
48,Texas,13,Georgia,77,Coweta County,306,198,108
48,Texas,13,Georgia,83,Dade County,0,13,-13
48,Texas,13,Georgia,85,Dawson County,119,19,100
48,Texas,13,Georgia,87,Decatur County,16,0,16
48,Texas,13,Georgia,89,DeKalb County,1158,675,483
48,Texas,13,Georgia,93,Dooly County,0,14,-14
48,Texas,13,Georgia,95,Dougherty County,70,11,59
48,Texas,13,Georgia,97,Douglas County,98,36,62
48,Texas,13,Georgia,99,Early County,0,47,-47
48,Texas,13,Georgia,103,Effingham County,19,41,-22
48,Texas,13,Georgia,107,Emanuel County,0,9,-9
48,Texas,13,Georgia,111,Fannin County,0,25,-25
48,Texas,13,Georgia,113,Fayette County,464,367,97
48,Texas,13,Georgia,115,Floyd County,118,28,90
48,Texas,13,Georgia,117,Forsyth County,456,599,-143
48,Texas,13,Georgia,119,Franklin County,0,11,-11
48,Texas,13,Georgia,121,Fulton County,3139,2388,751
48,Texas,13,Georgia,123,Gilmer County,8,4,4
48,Texas,13,Georgia,127,Glynn County,17,200,-183
48,Texas,13,Georgia,131,Grady County,0,76,-76
48,Texas,13,Georgia,133,Greene County,9,0,9
48,Texas,13,Georgia,135,Gwinnett County,1424,1389,35
48,Texas,13,Georgia,137,Habersham County,6,5,1
48,Texas,13,Georgia,139,Hall County,240,293,-53
48,Texas,13,Georgia,143,Haralson County,0,43,-43
48,Texas,13,Georgia,145,Harris County,38,23,15
48,Texas,13,Georgia,147,Hart County,56,0,56
48,Texas,13,Georgia,149,Heard County,0,33,-33
48,Texas,13,Georgia,151,Henry County,163,238,-75
48,Texas,13,Georgia,153,Houston County,139,92,47
48,Texas,13,Georgia,157,Jackson County,58,46,12
48,Texas,13,Georgia,159,Jasper County,0,23,-23
48,Texas,13,Georgia,161,Jeff Davis County,34,0,34
48,Texas,13,Georgia,169,Jones County,31,0,31
48,Texas,13,Georgia,173,Lanier County,0,6,-6
48,Texas,13,Georgia,175,Laurens County,24,29,-5
48,Texas,13,Georgia,179,Liberty County,604,834,-230
48,Texas,13,Georgia,183,Long County,0,162,-162
48,Texas,13,Georgia,185,Lowndes County,209,161,48
48,Texas,13,Georgia,187,Lumpkin County,0,525,-525
48,Texas,13,Georgia,189,McDuffie County,23,127,-104
48,Texas,13,Georgia,191,McIntosh County,0,43,-43
48,Texas,13,Georgia,193,Macon County,0,12,-12
48,Texas,13,Georgia,199,Meriwether County,0,5,-5
48,Texas,13,Georgia,201,Miller County,0,5,-5
48,Texas,13,Georgia,205,Mitchell County,30,0,30
48,Texas,13,Georgia,207,Monroe County,40,0,40
48,Texas,13,Georgia,209,Montgomery County,87,13,74
48,Texas,13,Georgia,211,Morgan County,30,0,30
48,Texas,13,Georgia,213,Murray County,35,0,35
48,Texas,13,Georgia,215,Muscogee County,1197,1376,-179
48,Texas,13,Georgia,217,Newton County,29,19,10
48,Texas,13,Georgia,219,Oconee County,20,29,-9
48,Texas,13,Georgia,223,Paulding County,14,158,-144
48,Texas,13,Georgia,225,Peach County,5,0,5
48,Texas,13,Georgia,227,Pickens County,23,16,7
48,Texas,13,Georgia,229,Pierce County,125,0,125
48,Texas,13,Georgia,231,Pike County,0,26,-26
48,Texas,13,Georgia,237,Putnam County,35,0,35
48,Texas,13,Georgia,241,Rabun County,73,0,73
48,Texas,13,Georgia,245,Richmond County,691,728,-37
48,Texas,13,Georgia,247,Rockdale County,51,50,1
48,Texas,13,Georgia,255,Spalding County,113,27,86
48,Texas,13,Georgia,257,Stephens County,1,0,1
48,Texas,13,Georgia,259,Stewart County,0,38,-38
48,Texas,13,Georgia,261,Sumter County,12,8,4
48,Texas,13,Georgia,265,Taliaferro County,0,4,-4
48,Texas,13,Georgia,267,Tattnall County,27,8,19
48,Texas,13,Georgia,271,Telfair County,9,7,2
48,Texas,13,Georgia,275,Thomas County,27,24,3
48,Texas,13,Georgia,277,Tift County,107,0,107
48,Texas,13,Georgia,279,Toombs County,63,0,63
48,Texas,13,Georgia,281,Towns County,18,33,-15
48,Texas,13,Georgia,283,Treutlen County,19,0,19
48,Texas,13,Georgia,285,Troup County,44,84,-40
48,Texas,13,Georgia,287,Turner County,0,7,-7
48,Texas,13,Georgia,291,Union County,0,20,-20
48,Texas,13,Georgia,293,Upson County,10,0,10
48,Texas,13,Georgia,295,Walker County,0,90,-90
48,Texas,13,Georgia,297,Walton County,106,63,43
48,Texas,13,Georgia,299,Ware County,0,2,-2
48,Texas,13,Georgia,305,Wayne County,72,9,63
48,Texas,13,Georgia,311,White County,30,0,30
48,Texas,13,Georgia,313,Whitfield County,192,66,126
48,Texas,13,Georgia,315,Wilcox County,19,0,19
48,Texas,13,Georgia,317,Wilkes County,20,0,20
48,Texas,13,Georgia,321,Worth County,0,40,-40
48,Texas,15,Hawaii,1,Hawaii County,178,372,-194
48,Texas,15,Hawaii,3,Honolulu County,4346,3937,409
48,Texas,15,Hawaii,7,Kauai County,166,72,94
48,Texas,15,Hawaii,9,Maui County,117,6,111
48,Texas,16,Idaho,1,Ada County,458,980,-522
48,Texas,16,Idaho,5,Bannock County,260,100,160
48,Texas,16,Idaho,9,Benewah County,0,6,-6
48,Texas,16,Idaho,11,Bingham County,22,13,9
48,Texas,16,Idaho,13,Blaine County,33,0,33
48,Texas,16,Idaho,15,Boise County,0,13,-13
48,Texas,16,Idaho,17,Bonner County,95,107,-12
48,Texas,16,Idaho,19,Bonneville County,146,199,-53
48,Texas,16,Idaho,21,Boundary County,41,5,36
48,Texas,16,Idaho,27,Canyon County,187,373,-186
48,Texas,16,Idaho,31,Cassia County,0,39,-39
48,Texas,16,Idaho,35,Clearwater County,0,21,-21
48,Texas,16,Idaho,39,Elmore County,140,188,-48
48,Texas,16,Idaho,41,Franklin County,0,2,-2
48,Texas,16,Idaho,43,Fremont County,26,5,21
48,Texas,16,Idaho,45,Gem County,0,32,-32
48,Texas,16,Idaho,47,Gooding County,0,39,-39
48,Texas,16,Idaho,49,Idaho County,8,18,-10
48,Texas,16,Idaho,55,Kootenai County,177,169,8
48,Texas,16,Idaho,57,Latah County,98,66,32
48,Texas,16,Idaho,59,Lemhi County,0,25,-25
48,Texas,16,Idaho,63,Lincoln County,35,0,35
48,Texas,16,Idaho,65,Madison County,198,149,49
48,Texas,16,Idaho,67,Minidoka County,8,0,8
48,Texas,16,Idaho,69,Nez Perce County,120,81,39
48,Texas,16,Idaho,73,Owyhee County,0,6,-6
48,Texas,16,Idaho,75,Payette County,0,101,-101
48,Texas,16,Idaho,79,Shoshone County,15,0,15
48,Texas,16,Idaho,81,Teton County,0,58,-58
48,Texas,16,Idaho,83,Twin Falls County,51,58,-7
48,Texas,16,Idaho,85,Valley County,37,1,36
48,Texas,17,Illinois,1,Adams County,45,61,-16
48,Texas,17,Illinois,3,Alexander County,0,4,-4
48,Texas,17,Illinois,5,Bond County,45,0,45
48,Texas,17,Illinois,7,Boone County,124,42,82
48,Texas,17,Illinois,9,Brown County,64,5,59
48,Texas,17,Illinois,11,Bureau County,0,77,-77
48,Texas,17,Illinois,15,Carroll County,53,15,38
48,Texas,17,Illinois,19,Champaign County,693,291,402
48,Texas,17,Illinois,21,Christian County,227,141,86
48,Texas,17,Illinois,23,Clark County,68,0,68
48,Texas,17,Illinois,27,Clinton County,14,18,-4
48,Texas,17,Illinois,29,Coles County,73,48,25
48,Texas,17,Illinois,31,Cook County,10680,4552,6128
48,Texas,17,Illinois,33,Crawford County,186,15,171
48,Texas,17,Illinois,37,DeKalb County,109,324,-215
48,Texas,17,Illinois,39,De Witt County,0,9,-9
48,Texas,17,Illinois,41,Douglas County,35,14,21
48,Texas,17,Illinois,43,DuPage County,2350,873,1477
48,Texas,17,Illinois,47,Edwards County,59,5,54
48,Texas,17,Illinois,49,Effingham County,91,0,91
48,Texas,17,Illinois,51,Fayette County,5,0,5
48,Texas,17,Illinois,53,Ford County,0,48,-48
48,Texas,17,Illinois,55,Franklin County,0,4,-4
48,Texas,17,Illinois,57,Fulton County,110,25,85
48,Texas,17,Illinois,59,Gallatin County,0,6,-6
48,Texas,17,Illinois,61,Greene County,0,30,-30
48,Texas,17,Illinois,63,Grundy County,72,0,72
48,Texas,17,Illinois,67,Hancock County,9,0,9
48,Texas,17,Illinois,73,Henry County,36,41,-5
48,Texas,17,Illinois,75,Iroquois County,0,4,-4
48,Texas,17,Illinois,77,Jackson County,340,14,326
48,Texas,17,Illinois,81,Jefferson County,11,32,-21
48,Texas,17,Illinois,83,Jersey County,34,0,34
48,Texas,17,Illinois,87,Johnson County,118,6,112
48,Texas,17,Illinois,89,Kane County,1037,521,516
48,Texas,17,Illinois,91,Kankakee County,359,44,315
48,Texas,17,Illinois,93,Kendall County,206,7,199
48,Texas,17,Illinois,95,Knox County,6,27,-21
48,Texas,17,Illinois,97,Lake County,1280,1433,-153
48,Texas,17,Illinois,99,LaSalle County,73,87,-14
48,Texas,17,Illinois,101,Lawrence County,15,0,15
48,Texas,17,Illinois,103,Lee County,137,46,91
48,Texas,17,Illinois,105,Livingston County,0,7,-7
48,Texas,17,Illinois,107,Logan County,75,1,74
48,Texas,17,Illinois,109,McDonough County,103,25,78
48,Texas,17,Illinois,111,McHenry County,386,59,327
48,Texas,17,Illinois,113,McLean County,532,389,143
48,Texas,17,Illinois,115,Macon County,53,72,-19
48,Texas,17,Illinois,117,Macoupin County,59,50,9
48,Texas,17,Illinois,119,Madison County,448,75,373
48,Texas,17,Illinois,121,Marion County,0,5,-5
48,Texas,17,Illinois,125,Mason County,54,0,54
48,Texas,17,Illinois,127,Massac County,0,25,-25
48,Texas,17,Illinois,129,Menard County,8,0,8
48,Texas,17,Illinois,131,Mercer County,0,3,-3
48,Texas,17,Illinois,133,Monroe County,15,0,15
48,Texas,17,Illinois,135,Montgomery County,72,2,70
48,Texas,17,Illinois,137,Morgan County,0,112,-112
48,Texas,17,Illinois,139,Moultrie County,0,6,-6
48,Texas,17,Illinois,141,Ogle County,45,13,32
48,Texas,17,Illinois,143,Peoria County,476,103,373
48,Texas,17,Illinois,145,Perry County,0,58,-58
48,Texas,17,Illinois,147,Piatt County,0,4,-4
48,Texas,17,Illinois,149,Pike County,0,8,-8
48,Texas,17,Illinois,151,Pope County,61,0,61
48,Texas,17,Illinois,153,Pulaski County,52,0,52
48,Texas,17,Illinois,155,Putnam County,0,3,-3
48,Texas,17,Illinois,161,Rock Island County,274,98,176
48,Texas,17,Illinois,163,St. Clair County,416,538,-122
48,Texas,17,Illinois,165,Saline County,0,25,-25
48,Texas,17,Illinois,167,Sangamon County,267,348,-81
48,Texas,17,Illinois,169,Schuyler County,7,0,7
48,Texas,17,Illinois,175,Stark County,0,36,-36
48,Texas,17,Illinois,177,Stephenson County,129,93,36
48,Texas,17,Illinois,179,Tazewell County,286,73,213
48,Texas,17,Illinois,181,Union County,122,14,108
48,Texas,17,Illinois,183,Vermilion County,91,227,-136
48,Texas,17,Illinois,185,Wabash County,17,0,17
48,Texas,17,Illinois,187,Warren County,11,13,-2
48,Texas,17,Illinois,191,Wayne County,0,21,-21
48,Texas,17,Illinois,193,White County,0,15,-15
48,Texas,17,Illinois,195,Whiteside County,133,8,125
48,Texas,17,Illinois,197,Will County,1126,308,818
48,Texas,17,Illinois,199,Williamson County,36,116,-80
48,Texas,17,Illinois,201,Winnebago County,248,214,34
48,Texas,17,Illinois,203,Woodford County,27,0,27
48,Texas,18,Indiana,1,Adams County,97,0,97
48,Texas,18,Indiana,3,Allen County,563,311,252
48,Texas,18,Indiana,5,Bartholomew County,109,34,75
48,Texas,18,Indiana,7,Benton County,0,2,-2
48,Texas,18,Indiana,9,Blackford County,0,20,-20
48,Texas,18,Indiana,11,Boone County,45,140,-95
48,Texas,18,Indiana,15,Carroll County,5,9,-4
48,Texas,18,Indiana,17,Cass County,128,0,128
48,Texas,18,Indiana,19,Clark County,225,123,102
48,Texas,18,Indiana,21,Clay County,72,52,20
48,Texas,18,Indiana,23,Clinton County,57,269,-212
48,Texas,18,Indiana,27,Daviess County,0,6,-6
48,Texas,18,Indiana,29,Dearborn County,6,246,-240
48,Texas,18,Indiana,31,Decatur County,10,29,-19
48,Texas,18,Indiana,35,Delaware County,149,5,144
48,Texas,18,Indiana,37,Dubois County,21,6,15
48,Texas,18,Indiana,39,Elkhart County,227,172,55
48,Texas,18,Indiana,41,Fayette County,0,1,-1
48,Texas,18,Indiana,43,Floyd County,28,17,11
48,Texas,18,Indiana,45,Fountain County,0,6,-6
48,Texas,18,Indiana,47,Franklin County,0,212,-212
48,Texas,18,Indiana,49,Fulton County,0,10,-10
48,Texas,18,Indiana,51,Gibson County,75,12,63
48,Texas,18,Indiana,53,Grant County,81,82,-1
48,Texas,18,Indiana,57,Hamilton County,833,515,318
48,Texas,18,Indiana,59,Hancock County,104,31,73
48,Texas,18,Indiana,61,Harrison County,19,51,-32
48,Texas,18,Indiana,63,Hendricks County,144,457,-313
48,Texas,18,Indiana,65,Henry County,19,0,19
48,Texas,18,Indiana,67,Howard County,16,12,4
48,Texas,18,Indiana,69,Huntington County,55,54,1
48,Texas,18,Indiana,71,Jackson County,34,11,23
48,Texas,18,Indiana,73,Jasper County,0,9,-9
48,Texas,18,Indiana,75,Jay County,5,0,5
48,Texas,18,Indiana,77,Jefferson County,33,13,20
48,Texas,18,Indiana,79,Jennings County,133,35,98
48,Texas,18,Indiana,81,Johnson County,153,415,-262
48,Texas,18,Indiana,83,Knox County,0,5,-5
48,Texas,18,Indiana,85,Kosciusko County,25,21,4
48,Texas,18,Indiana,87,LaGrange County,11,105,-94
48,Texas,18,Indiana,89,Lake County,879,164,715
48,Texas,18,Indiana,91,LaPorte County,217,26,191
48,Texas,18,Indiana,93,Lawrence County,71,24,47
48,Texas,18,Indiana,95,Madison County,42,52,-10
48,Texas,18,Indiana,97,Marion County,1498,914,584
48,Texas,18,Indiana,99,Marshall County,26,0,26
48,Texas,18,Indiana,103,Miami County,8,85,-77
48,Texas,18,Indiana,105,Monroe County,227,374,-147
48,Texas,18,Indiana,107,Montgomery County,0,44,-44
48,Texas,18,Indiana,109,Morgan County,0,28,-28
48,Texas,18,Indiana,111,Newton County,21,10,11
48,Texas,18,Indiana,113,Noble County,15,35,-20
48,Texas,18,Indiana,121,Parke County,0,7,-7
48,Texas,18,Indiana,125,Pike County,8,17,-9
48,Texas,18,Indiana,127,Porter County,479,276,203
48,Texas,18,Indiana,129,Posey County,26,71,-45
48,Texas,18,Indiana,131,Pulaski County,0,4,-4
48,Texas,18,Indiana,133,Putnam County,376,106,270
48,Texas,18,Indiana,137,Ripley County,0,22,-22
48,Texas,18,Indiana,141,St. Joseph County,422,292,130
48,Texas,18,Indiana,143,Scott County,5,0,5
48,Texas,18,Indiana,145,Shelby County,40,0,40
48,Texas,18,Indiana,147,Spencer County,35,0,35
48,Texas,18,Indiana,149,Starke County,0,14,-14
48,Texas,18,Indiana,151,Steuben County,0,28,-28
48,Texas,18,Indiana,157,Tippecanoe County,450,468,-18
48,Texas,18,Indiana,159,Tipton County,0,30,-30
48,Texas,18,Indiana,161,Union County,33,0,33
48,Texas,18,Indiana,163,Vanderburgh County,401,192,209
48,Texas,18,Indiana,167,Vigo County,362,101,261
48,Texas,18,Indiana,169,Wabash County,0,106,-106
48,Texas,18,Indiana,171,Warren County,0,8,-8
48,Texas,18,Indiana,173,Warrick County,138,63,75
48,Texas,18,Indiana,175,Washington County,0,17,-17
48,Texas,18,Indiana,177,Wayne County,19,44,-25
48,Texas,18,Indiana,181,White County,0,9,-9
48,Texas,18,Indiana,183,Whitley County,43,45,-2
48,Texas,19,Iowa,1,Adair County,0,50,-50
48,Texas,19,Iowa,5,Allamakee County,0,6,-6
48,Texas,19,Iowa,7,Appanoose County,0,29,-29
48,Texas,19,Iowa,9,Audubon County,0,1,-1
48,Texas,19,Iowa,11,Benton County,20,1,19
48,Texas,19,Iowa,13,Black Hawk County,428,56,372
48,Texas,19,Iowa,15,Boone County,0,88,-88
48,Texas,19,Iowa,17,Bremer County,184,13,171
48,Texas,19,Iowa,19,Buchanan County,0,3,-3
48,Texas,19,Iowa,21,Buena Vista County,0,81,-81
48,Texas,19,Iowa,23,Butler County,20,23,-3
48,Texas,19,Iowa,27,Carroll County,38,0,38
48,Texas,19,Iowa,29,Cass County,48,0,48
48,Texas,19,Iowa,33,Cerro Gordo County,70,54,16
48,Texas,19,Iowa,41,Clay County,33,0,33
48,Texas,19,Iowa,43,Clayton County,14,24,-10
48,Texas,19,Iowa,45,Clinton County,37,60,-23
48,Texas,19,Iowa,49,Dallas County,112,119,-7
48,Texas,19,Iowa,51,Davis County,48,0,48
48,Texas,19,Iowa,53,Decatur County,46,28,18
48,Texas,19,Iowa,55,Delaware County,8,45,-37
48,Texas,19,Iowa,57,Des Moines County,27,111,-84
48,Texas,19,Iowa,59,Dickinson County,37,5,32
48,Texas,19,Iowa,61,Dubuque County,60,76,-16
48,Texas,19,Iowa,63,Emmet County,8,18,-10
48,Texas,19,Iowa,65,Fayette County,28,22,6
48,Texas,19,Iowa,69,Franklin County,0,12,-12
48,Texas,19,Iowa,71,Fremont County,0,6,-6
48,Texas,19,Iowa,73,Greene County,18,21,-3
48,Texas,19,Iowa,75,Grundy County,0,9,-9
48,Texas,19,Iowa,77,Guthrie County,0,3,-3
48,Texas,19,Iowa,79,Hamilton County,14,0,14
48,Texas,19,Iowa,81,Hancock County,0,2,-2
48,Texas,19,Iowa,83,Hardin County,14,13,1
48,Texas,19,Iowa,85,Harrison County,58,5,53
48,Texas,19,Iowa,87,Henry County,32,13,19
48,Texas,19,Iowa,89,Howard County,34,0,34
48,Texas,19,Iowa,91,Humboldt County,119,2,117
48,Texas,19,Iowa,93,Ida County,0,9,-9
48,Texas,19,Iowa,95,Iowa County,29,105,-76
48,Texas,19,Iowa,97,Jackson County,0,9,-9
48,Texas,19,Iowa,99,Jasper County,11,62,-51
48,Texas,19,Iowa,101,Jefferson County,33,6,27
48,Texas,19,Iowa,103,Johnson County,575,39,536
48,Texas,19,Iowa,105,Jones County,0,13,-13
48,Texas,19,Iowa,109,Kossuth County,0,18,-18
48,Texas,19,Iowa,111,Lee County,60,93,-33
48,Texas,19,Iowa,113,Linn County,316,390,-74
48,Texas,19,Iowa,115,Louisa County,0,6,-6
48,Texas,19,Iowa,123,Mahaska County,0,18,-18
48,Texas,19,Iowa,125,Marion County,0,9,-9
48,Texas,19,Iowa,127,Marshall County,13,17,-4
48,Texas,19,Iowa,129,Mills County,0,6,-6
48,Texas,19,Iowa,131,Mitchell County,0,28,-28
48,Texas,19,Iowa,133,Monona County,0,1,-1
48,Texas,19,Iowa,135,Monroe County,0,33,-33
48,Texas,19,Iowa,137,Montgomery County,0,3,-3
48,Texas,19,Iowa,139,Muscatine County,441,9,432
48,Texas,19,Iowa,141,O'Brien County,0,3,-3
48,Texas,19,Iowa,143,Osceola County,0,15,-15
48,Texas,19,Iowa,145,Page County,7,2,5
48,Texas,19,Iowa,147,Palo Alto County,0,2,-2
48,Texas,19,Iowa,149,Plymouth County,0,19,-19
48,Texas,19,Iowa,153,Polk County,912,824,88
48,Texas,19,Iowa,155,Pottawattamie County,341,132,209
48,Texas,19,Iowa,157,Poweshiek County,40,14,26
48,Texas,19,Iowa,159,Ringgold County,38,0,38
48,Texas,19,Iowa,161,Sac County,0,6,-6
48,Texas,19,Iowa,163,Scott County,244,292,-48
48,Texas,19,Iowa,165,Shelby County,19,24,-5
48,Texas,19,Iowa,167,Sioux County,165,16,149
48,Texas,19,Iowa,169,Story County,258,285,-27
48,Texas,19,Iowa,177,Van Buren County,64,0,64
48,Texas,19,Iowa,179,Wapello County,41,76,-35
48,Texas,19,Iowa,181,Warren County,223,19,204
48,Texas,19,Iowa,183,Washington County,7,0,7
48,Texas,19,Iowa,185,Wayne County,197,16,181
48,Texas,19,Iowa,187,Webster County,104,14,90
48,Texas,19,Iowa,189,Winnebago County,35,15,20
48,Texas,19,Iowa,193,Woodbury County,327,71,256
48,Texas,19,Iowa,195,Worth County,0,3,-3
48,Texas,19,Iowa,197,Wright County,0,7,-7
48,Texas,2,Alaska,16,Aleutians West Census Area,90,19,71
48,Texas,2,Alaska,20,Anchorage Municipality,2446,1272,1174
48,Texas,2,Alaska,50,Bethel Census Area,0,9,-9
48,Texas,2,Alaska,60,Bristol Bay Borough,0,14,-14
48,Texas,2,Alaska,68,Denali Borough,0,9,-9
48,Texas,2,Alaska,90,Fairbanks North Star Borough,1521,748,773
48,Texas,2,Alaska,110,Juneau City and Borough,19,148,-129
48,Texas,2,Alaska,122,Kenai Peninsula Borough,516,118,398
48,Texas,2,Alaska,130,Ketchikan Gateway Borough,0,15,-15
48,Texas,2,Alaska,150,Kodiak Island Borough,13,21,-8
48,Texas,2,Alaska,158,Kusilvak Census Area,0,21,-21
48,Texas,2,Alaska,170,Matanuska-Susitna Borough,206,133,73
48,Texas,2,Alaska,180,Nome Census Area,0,5,-5
48,Texas,2,Alaska,185,North Slope Borough,0,23,-23
48,Texas,2,Alaska,188,Northwest Arctic Borough,22,0,22
48,Texas,2,Alaska,220,Sitka City and Borough,0,14,-14
48,Texas,2,Alaska,240,Southeast Fairbanks Census Area,0,6,-6
48,Texas,2,Alaska,261,Valdez-Cordova Census Area,192,62,130
48,Texas,2,Alaska,282,Yakutat City and Borough,0,2,-2
48,Texas,2,Alaska,290,Yukon-Koyukuk Census Area,0,1,-1
48,Texas,20,Kansas,1,Allen County,17,0,17
48,Texas,20,Kansas,3,Anderson County,0,3,-3
48,Texas,20,Kansas,5,Atchison County,47,4,43
48,Texas,20,Kansas,7,Barber County,0,69,-69
48,Texas,20,Kansas,9,Barton County,10,85,-75
48,Texas,20,Kansas,11,Bourbon County,28,6,22
48,Texas,20,Kansas,13,Brown County,0,2,-2
48,Texas,20,Kansas,15,Butler County,333,68,265
48,Texas,20,Kansas,19,Chautauqua County,24,0,24
48,Texas,20,Kansas,21,Cherokee County,24,256,-232
48,Texas,20,Kansas,23,Cheyenne County,0,2,-2
48,Texas,20,Kansas,25,Clark County,0,20,-20
48,Texas,20,Kansas,27,Clay County,0,123,-123
48,Texas,20,Kansas,29,Cloud County,20,5,15
48,Texas,20,Kansas,31,Coffey County,8,92,-84
48,Texas,20,Kansas,35,Cowley County,76,188,-112
48,Texas,20,Kansas,37,Crawford County,95,433,-338
48,Texas,20,Kansas,41,Dickinson County,10,55,-45
48,Texas,20,Kansas,43,Doniphan County,0,10,-10
48,Texas,20,Kansas,45,Douglas County,548,562,-14
48,Texas,20,Kansas,47,Edwards County,0,5,-5
48,Texas,20,Kansas,51,Ellis County,13,82,-69
48,Texas,20,Kansas,53,Ellsworth County,0,38,-38
48,Texas,20,Kansas,55,Finney County,340,243,97
48,Texas,20,Kansas,57,Ford County,89,297,-208
48,Texas,20,Kansas,59,Franklin County,0,23,-23
48,Texas,20,Kansas,61,Geary County,693,615,78
48,Texas,20,Kansas,65,Graham County,0,31,-31
48,Texas,20,Kansas,67,Grant County,70,0,70
48,Texas,20,Kansas,69,Gray County,8,46,-38
48,Texas,20,Kansas,71,Greeley County,11,0,11
48,Texas,20,Kansas,75,Hamilton County,0,55,-55
48,Texas,20,Kansas,77,Harper County,17,7,10
48,Texas,20,Kansas,79,Harvey County,30,63,-33
48,Texas,20,Kansas,81,Haskell County,3,0,3
48,Texas,20,Kansas,83,Hodgeman County,16,17,-1
48,Texas,20,Kansas,85,Jackson County,0,1,-1
48,Texas,20,Kansas,87,Jefferson County,14,9,5
48,Texas,20,Kansas,91,Johnson County,1509,1340,169
48,Texas,20,Kansas,93,Kearny County,137,1,136
48,Texas,20,Kansas,95,Kingman County,0,10,-10
48,Texas,20,Kansas,97,Kiowa County,0,6,-6
48,Texas,20,Kansas,99,Labette County,0,150,-150
48,Texas,20,Kansas,101,Lane County,2,0,2
48,Texas,20,Kansas,103,Leavenworth County,975,509,466
48,Texas,20,Kansas,105,Lincoln County,0,4,-4
48,Texas,20,Kansas,107,Linn County,0,3,-3
48,Texas,20,Kansas,111,Lyon County,225,222,3
48,Texas,20,Kansas,113,McPherson County,11,122,-111
48,Texas,20,Kansas,115,Marion County,0,10,-10
48,Texas,20,Kansas,117,Marshall County,0,11,-11
48,Texas,20,Kansas,119,Meade County,26,24,2
48,Texas,20,Kansas,121,Miami County,188,18,170
48,Texas,20,Kansas,123,Mitchell County,0,1,-1
48,Texas,20,Kansas,125,Montgomery County,163,39,124
48,Texas,20,Kansas,127,Morris County,0,19,-19
48,Texas,20,Kansas,129,Morton County,80,8,72
48,Texas,20,Kansas,133,Neosho County,40,17,23
48,Texas,20,Kansas,137,Norton County,8,0,8
48,Texas,20,Kansas,139,Osage County,139,14,125
48,Texas,20,Kansas,143,Ottawa County,14,1,13
48,Texas,20,Kansas,145,Pawnee County,10,123,-113
48,Texas,20,Kansas,147,Phillips County,18,6,12
48,Texas,20,Kansas,149,Pottawatomie County,15,50,-35
48,Texas,20,Kansas,151,Pratt County,18,46,-28
48,Texas,20,Kansas,153,Rawlins County,0,7,-7
48,Texas,20,Kansas,155,Reno County,198,118,80
48,Texas,20,Kansas,159,Rice County,57,42,15
48,Texas,20,Kansas,161,Riley County,1011,420,591
48,Texas,20,Kansas,165,Rush County,0,8,-8
48,Texas,20,Kansas,167,Russell County,0,2,-2
48,Texas,20,Kansas,169,Saline County,10,249,-239
48,Texas,20,Kansas,173,Sedgwick County,2008,1282,726
48,Texas,20,Kansas,175,Seward County,160,126,34
48,Texas,20,Kansas,177,Shawnee County,459,515,-56
48,Texas,20,Kansas,181,Sherman County,0,2,-2
48,Texas,20,Kansas,183,Smith County,0,12,-12
48,Texas,20,Kansas,187,Stanton County,0,20,-20
48,Texas,20,Kansas,191,Sumner County,38,12,26
48,Texas,20,Kansas,193,Thomas County,35,5,30
48,Texas,20,Kansas,195,Trego County,0,9,-9
48,Texas,20,Kansas,197,Wabaunsee County,0,29,-29
48,Texas,20,Kansas,201,Washington County,0,2,-2
48,Texas,20,Kansas,205,Wilson County,6,11,-5
48,Texas,20,Kansas,207,Woodson County,0,10,-10
48,Texas,20,Kansas,209,Wyandotte County,314,286,28
48,Texas,21,Kentucky,3,Allen County,16,0,16
48,Texas,21,Kentucky,5,Anderson County,11,28,-17
48,Texas,21,Kentucky,7,Ballard County,0,2,-2
48,Texas,21,Kentucky,11,Bath County,0,1,-1
48,Texas,21,Kentucky,13,Bell County,91,13,78
48,Texas,21,Kentucky,15,Boone County,300,253,47
48,Texas,21,Kentucky,17,Bourbon County,3,0,3
48,Texas,21,Kentucky,19,Boyd County,20,10,10
48,Texas,21,Kentucky,21,Boyle County,0,147,-147
48,Texas,21,Kentucky,27,Breckinridge County,0,33,-33
48,Texas,21,Kentucky,29,Bullitt County,101,56,45
48,Texas,21,Kentucky,33,Caldwell County,30,32,-2
48,Texas,21,Kentucky,35,Calloway County,62,109,-47
48,Texas,21,Kentucky,37,Campbell County,164,9,155
48,Texas,21,Kentucky,43,Carter County,0,13,-13
48,Texas,21,Kentucky,47,Christian County,689,483,206
48,Texas,21,Kentucky,49,Clark County,51,52,-1
48,Texas,21,Kentucky,51,Clay County,0,51,-51
48,Texas,21,Kentucky,59,Daviess County,60,144,-84
48,Texas,21,Kentucky,61,Edmonson County,23,50,-27
48,Texas,21,Kentucky,65,Estill County,0,23,-23
48,Texas,21,Kentucky,67,Fayette County,508,529,-21
48,Texas,21,Kentucky,73,Franklin County,35,0,35
48,Texas,21,Kentucky,77,Gallatin County,45,0,45
48,Texas,21,Kentucky,79,Garrard County,0,53,-53
48,Texas,21,Kentucky,83,Graves County,46,17,29
48,Texas,21,Kentucky,85,Grayson County,27,45,-18
48,Texas,21,Kentucky,89,Greenup County,131,0,131
48,Texas,21,Kentucky,91,Hancock County,30,0,30
48,Texas,21,Kentucky,93,Hardin County,456,904,-448
48,Texas,21,Kentucky,95,Harlan County,85,0,85
48,Texas,21,Kentucky,101,Henderson County,0,1,-1
48,Texas,21,Kentucky,107,Hopkins County,0,37,-37
48,Texas,21,Kentucky,111,Jefferson County,1321,1018,303
48,Texas,21,Kentucky,113,Jessamine County,37,36,1
48,Texas,21,Kentucky,115,Johnson County,68,0,68
48,Texas,21,Kentucky,117,Kenton County,145,47,98
48,Texas,21,Kentucky,125,Laurel County,17,0,17
48,Texas,21,Kentucky,133,Letcher County,0,4,-4
48,Texas,21,Kentucky,135,Lewis County,4,5,-1
48,Texas,21,Kentucky,139,Livingston County,0,43,-43
48,Texas,21,Kentucky,141,Logan County,15,2,13
48,Texas,21,Kentucky,143,Lyon County,72,3,69
48,Texas,21,Kentucky,145,McCracken County,102,114,-12
48,Texas,21,Kentucky,147,McCreary County,75,64,11
48,Texas,21,Kentucky,151,Madison County,78,37,41
48,Texas,21,Kentucky,155,Marion County,45,0,45
48,Texas,21,Kentucky,157,Marshall County,51,0,51
48,Texas,21,Kentucky,163,Meade County,150,202,-52
48,Texas,21,Kentucky,169,Metcalfe County,27,0,27
48,Texas,21,Kentucky,173,Montgomery County,0,7,-7
48,Texas,21,Kentucky,179,Nelson County,0,26,-26
48,Texas,21,Kentucky,181,Nicholas County,0,44,-44
48,Texas,21,Kentucky,185,Oldham County,38,154,-116
48,Texas,21,Kentucky,195,Pike County,4,0,4
48,Texas,21,Kentucky,199,Pulaski County,333,50,283
48,Texas,21,Kentucky,203,Rockcastle County,148,0,148
48,Texas,21,Kentucky,205,Rowan County,14,0,14
48,Texas,21,Kentucky,209,Scott County,157,127,30
48,Texas,21,Kentucky,211,Shelby County,80,56,24
48,Texas,21,Kentucky,213,Simpson County,0,5,-5
48,Texas,21,Kentucky,215,Spencer County,0,14,-14
48,Texas,21,Kentucky,217,Taylor County,8,83,-75
48,Texas,21,Kentucky,219,Todd County,0,8,-8
48,Texas,21,Kentucky,221,Trigg County,0,55,-55
48,Texas,21,Kentucky,227,Warren County,293,465,-172
48,Texas,21,Kentucky,229,Washington County,10,5,5
48,Texas,21,Kentucky,231,Wayne County,23,0,23
48,Texas,21,Kentucky,233,Webster County,0,22,-22
48,Texas,21,Kentucky,235,Whitley County,0,6,-6
48,Texas,21,Kentucky,239,Woodford County,77,0,77
48,Texas,22,Louisiana,1,Acadia Parish,168,62,106
48,Texas,22,Louisiana,3,Allen Parish,273,104,169
48,Texas,22,Louisiana,5,Ascension Parish,580,378,202
48,Texas,22,Louisiana,7,Assumption Parish,1,85,-84
48,Texas,22,Louisiana,9,Avoyelles Parish,4,49,-45
48,Texas,22,Louisiana,11,Beauregard Parish,316,295,21
48,Texas,22,Louisiana,13,Bienville Parish,163,136,27
48,Texas,22,Louisiana,15,Bossier Parish,917,1716,-799
48,Texas,22,Louisiana,17,Caddo Parish,3879,1323,2556
48,Texas,22,Louisiana,19,Calcasieu Parish,2333,1374,959
48,Texas,22,Louisiana,21,Caldwell Parish,68,0,68
48,Texas,22,Louisiana,23,Cameron Parish,96,12,84
48,Texas,22,Louisiana,25,Catahoula Parish,4,0,4
48,Texas,22,Louisiana,27,Claiborne Parish,13,11,2
48,Texas,22,Louisiana,29,Concordia Parish,56,28,28
48,Texas,22,Louisiana,31,De Soto Parish,174,179,-5
48,Texas,22,Louisiana,33,East Baton Rouge Parish,2944,2075,869
48,Texas,22,Louisiana,35,East Carroll Parish,0,123,-123
48,Texas,22,Louisiana,37,East Feliciana Parish,30,88,-58
48,Texas,22,Louisiana,39,Evangeline Parish,108,19,89
48,Texas,22,Louisiana,41,Franklin Parish,95,9,86
48,Texas,22,Louisiana,43,Grant Parish,230,298,-68
48,Texas,22,Louisiana,45,Iberia Parish,256,266,-10
48,Texas,22,Louisiana,47,Iberville Parish,55,78,-23
48,Texas,22,Louisiana,49,Jackson Parish,44,90,-46
48,Texas,22,Louisiana,51,Jefferson Parish,1377,1138,239
48,Texas,22,Louisiana,53,Jefferson Davis Parish,243,134,109
48,Texas,22,Louisiana,55,Lafayette Parish,2162,1453,709
48,Texas,22,Louisiana,57,Lafourche Parish,177,218,-41
48,Texas,22,Louisiana,59,LaSalle Parish,0,17,-17
48,Texas,22,Louisiana,61,Lincoln Parish,535,738,-203
48,Texas,22,Louisiana,63,Livingston Parish,357,246,111
48,Texas,22,Louisiana,65,Madison Parish,82,24,58
48,Texas,22,Louisiana,67,Morehouse Parish,128,95,33
48,Texas,22,Louisiana,69,Natchitoches Parish,227,419,-192
48,Texas,22,Louisiana,71,Orleans Parish,2638,1726,912
48,Texas,22,Louisiana,73,Ouachita Parish,1429,594,835
48,Texas,22,Louisiana,75,Plaquemines Parish,79,32,47
48,Texas,22,Louisiana,77,Pointe Coupee Parish,169,58,111
48,Texas,22,Louisiana,79,Rapides Parish,671,364,307
48,Texas,22,Louisiana,81,Red River Parish,38,3,35
48,Texas,22,Louisiana,83,Richland Parish,5,62,-57
48,Texas,22,Louisiana,85,Sabine Parish,283,101,182
48,Texas,22,Louisiana,87,St. Bernard Parish,10,74,-64
48,Texas,22,Louisiana,89,St. Charles Parish,282,185,97
48,Texas,22,Louisiana,93,St. James Parish,31,1,30
48,Texas,22,Louisiana,95,St. John the Baptist Parish,11,269,-258
48,Texas,22,Louisiana,97,St. Landry Parish,276,323,-47
48,Texas,22,Louisiana,99,St. Martin Parish,420,1,419
48,Texas,22,Louisiana,101,St. Mary Parish,273,55,218
48,Texas,22,Louisiana,103,St. Tammany Parish,852,829,23
48,Texas,22,Louisiana,105,Tangipahoa Parish,173,176,-3
48,Texas,22,Louisiana,107,Tensas Parish,0,46,-46
48,Texas,22,Louisiana,109,Terrebonne Parish,206,303,-97
48,Texas,22,Louisiana,111,Union Parish,47,54,-7
48,Texas,22,Louisiana,113,Vermilion Parish,685,538,147
48,Texas,22,Louisiana,115,Vernon Parish,939,975,-36
48,Texas,22,Louisiana,117,Washington Parish,338,160,178
48,Texas,22,Louisiana,119,Webster Parish,113,187,-74
48,Texas,22,Louisiana,121,West Baton Rouge Parish,86,57,29
48,Texas,22,Louisiana,123,West Carroll Parish,65,18,47
48,Texas,22,Louisiana,125,West Feliciana Parish,5,8,-3
48,Texas,22,Louisiana,127,Winn Parish,69,159,-90
48,Texas,23,Maine,1,Androscoggin County,0,66,-66
48,Texas,23,Maine,3,Aroostook County,113,59,54
48,Texas,23,Maine,5,Cumberland County,148,305,-157
48,Texas,23,Maine,7,Franklin County,14,0,14
48,Texas,23,Maine,9,Hancock County,85,23,62
48,Texas,23,Maine,11,Kennebec County,24,15,9
48,Texas,23,Maine,13,Knox County,5,64,-59
48,Texas,23,Maine,15,Lincoln County,57,0,57
48,Texas,23,Maine,17,Oxford County,85,81,4
48,Texas,23,Maine,19,Penobscot County,8,155,-147
48,Texas,23,Maine,21,Piscataquis County,0,23,-23
48,Texas,23,Maine,23,Sagadahoc County,30,8,22
48,Texas,23,Maine,25,Somerset County,140,16,124
48,Texas,23,Maine,27,Waldo County,0,54,-54
48,Texas,23,Maine,29,Washington County,82,39,43
48,Texas,23,Maine,31,York County,275,7,268
48,Texas,24,Maryland,1,Allegany County,212,52,160
48,Texas,24,Maryland,3,Anne Arundel County,1197,822,375
48,Texas,24,Maryland,5,Baltimore County,1550,650,900
48,Texas,24,Maryland,9,Calvert County,97,95,2
48,Texas,24,Maryland,11,Caroline County,15,0,15
48,Texas,24,Maryland,13,Carroll County,95,46,49
48,Texas,24,Maryland,15,Cecil County,53,107,-54
48,Texas,24,Maryland,17,Charles County,80,44,36
48,Texas,24,Maryland,19,Dorchester County,22,32,-10
48,Texas,24,Maryland,21,Frederick County,138,514,-376
48,Texas,24,Maryland,25,Harford County,378,314,64
48,Texas,24,Maryland,27,Howard County,893,282,611
48,Texas,24,Maryland,29,Kent County,0,27,-27
48,Texas,24,Maryland,31,Montgomery County,2310,1193,1117
48,Texas,24,Maryland,33,Prince George's County,1311,451,860
48,Texas,24,Maryland,35,Queen Anne's County,50,78,-28
48,Texas,24,Maryland,37,St. Mary's County,223,73,150
48,Texas,24,Maryland,39,Somerset County,0,19,-19
48,Texas,24,Maryland,43,Washington County,165,46,119
48,Texas,24,Maryland,45,Wicomico County,78,136,-58
48,Texas,24,Maryland,47,Worcester County,0,18,-18
48,Texas,24,Maryland,510,Baltimore city,925,482,443
48,Texas,25,Massachusetts,1,Barnstable County,297,36,261
48,Texas,25,Massachusetts,3,Berkshire County,82,136,-54
48,Texas,25,Massachusetts,5,Bristol County,187,189,-2
48,Texas,25,Massachusetts,7,Dukes County,0,1,-1
48,Texas,25,Massachusetts,9,Essex County,637,184,453
48,Texas,25,Massachusetts,11,Franklin County,36,31,5
48,Texas,25,Massachusetts,13,Hampden County,286,88,198
48,Texas,25,Massachusetts,15,Hampshire County,182,123,59
48,Texas,25,Massachusetts,17,Middlesex County,1281,1479,-198
48,Texas,25,Massachusetts,21,Norfolk County,781,829,-48
48,Texas,25,Massachusetts,23,Plymouth County,251,210,41
48,Texas,25,Massachusetts,25,Suffolk County,1348,747,601
48,Texas,25,Massachusetts,27,Worcester County,812,195,617
48,Texas,26,Michigan,1,Alcona County,0,5,-5
48,Texas,26,Michigan,3,Alger County,0,4,-4
48,Texas,26,Michigan,5,Allegan County,137,121,16
48,Texas,26,Michigan,7,Alpena County,52,18,34
48,Texas,26,Michigan,9,Antrim County,0,67,-67
48,Texas,26,Michigan,11,Arenac County,0,4,-4
48,Texas,26,Michigan,13,Baraga County,16,3,13
48,Texas,26,Michigan,15,Barry County,2,0,2
48,Texas,26,Michigan,17,Bay County,56,78,-22
48,Texas,26,Michigan,19,Benzie County,10,18,-8
48,Texas,26,Michigan,21,Berrien County,115,118,-3
48,Texas,26,Michigan,25,Calhoun County,245,101,144
48,Texas,26,Michigan,27,Cass County,0,30,-30
48,Texas,26,Michigan,29,Charlevoix County,93,21,72
48,Texas,26,Michigan,31,Cheboygan County,23,26,-3
48,Texas,26,Michigan,33,Chippewa County,0,3,-3
48,Texas,26,Michigan,35,Clare County,37,6,31
48,Texas,26,Michigan,37,Clinton County,15,61,-46
48,Texas,26,Michigan,39,Crawford County,7,9,-2
48,Texas,26,Michigan,41,Delta County,13,24,-11
48,Texas,26,Michigan,43,Dickinson County,0,3,-3
48,Texas,26,Michigan,45,Eaton County,119,60,59
48,Texas,26,Michigan,47,Emmet County,34,0,34
48,Texas,26,Michigan,49,Genesee County,577,186,391
48,Texas,26,Michigan,51,Gladwin County,11,17,-6
48,Texas,26,Michigan,53,Gogebic County,33,0,33
48,Texas,26,Michigan,55,Grand Traverse County,82,35,47
48,Texas,26,Michigan,57,Gratiot County,0,22,-22
48,Texas,26,Michigan,59,Hillsdale County,84,80,4
48,Texas,26,Michigan,61,Houghton County,129,125,4
48,Texas,26,Michigan,63,Huron County,0,5,-5
48,Texas,26,Michigan,65,Ingham County,352,346,6
48,Texas,26,Michigan,67,Ionia County,33,29,4
48,Texas,26,Michigan,69,Iosco County,71,23,48
48,Texas,26,Michigan,71,Iron County,0,18,-18
48,Texas,26,Michigan,73,Isabella County,26,67,-41
48,Texas,26,Michigan,75,Jackson County,125,164,-39
48,Texas,26,Michigan,77,Kalamazoo County,264,462,-198
48,Texas,26,Michigan,79,Kalkaska County,45,46,-1
48,Texas,26,Michigan,81,Kent County,513,655,-142
48,Texas,26,Michigan,83,Keweenaw County,0,2,-2
48,Texas,26,Michigan,85,Lake County,0,6,-6
48,Texas,26,Michigan,87,Lapeer County,98,50,48
48,Texas,26,Michigan,89,Leelanau County,0,16,-16
48,Texas,26,Michigan,91,Lenawee County,33,65,-32
48,Texas,26,Michigan,93,Livingston County,219,91,128
48,Texas,26,Michigan,97,Mackinac County,9,3,6
48,Texas,26,Michigan,99,Macomb County,981,390,591
48,Texas,26,Michigan,101,Manistee County,58,10,48
48,Texas,26,Michigan,103,Marquette County,43,45,-2
48,Texas,26,Michigan,105,Mason County,20,50,-30
48,Texas,26,Michigan,107,Mecosta County,123,11,112
48,Texas,26,Michigan,109,Menominee County,0,19,-19
48,Texas,26,Michigan,111,Midland County,147,82,65
48,Texas,26,Michigan,113,Missaukee County,0,17,-17
48,Texas,26,Michigan,115,Monroe County,13,51,-38
48,Texas,26,Michigan,117,Montcalm County,31,5,26
48,Texas,26,Michigan,119,Montmorency County,0,13,-13
48,Texas,26,Michigan,121,Muskegon County,211,212,-1
48,Texas,26,Michigan,123,Newaygo County,48,152,-104
48,Texas,26,Michigan,125,Oakland County,1603,1125,478
48,Texas,26,Michigan,127,Oceana County,91,123,-32
48,Texas,26,Michigan,129,Ogemaw County,0,8,-8
48,Texas,26,Michigan,133,Osceola County,0,6,-6
48,Texas,26,Michigan,135,Oscoda County,0,3,-3
48,Texas,26,Michigan,137,Otsego County,0,1,-1
48,Texas,26,Michigan,139,Ottawa County,308,278,30
48,Texas,26,Michigan,141,Presque Isle County,0,28,-28
48,Texas,26,Michigan,143,Roscommon County,0,4,-4
48,Texas,26,Michigan,145,Saginaw County,123,274,-151
48,Texas,26,Michigan,147,St. Clair County,36,185,-149
48,Texas,26,Michigan,149,St. Joseph County,0,39,-39
48,Texas,26,Michigan,151,Sanilac County,0,42,-42
48,Texas,26,Michigan,155,Shiawassee County,16,16,0
48,Texas,26,Michigan,157,Tuscola County,0,109,-109
48,Texas,26,Michigan,159,Van Buren County,69,27,42
48,Texas,26,Michigan,161,Washtenaw County,428,712,-284
48,Texas,26,Michigan,163,Wayne County,1919,1080,839
48,Texas,26,Michigan,165,Wexford County,0,3,-3
48,Texas,27,Minnesota,1,Aitkin County,38,5,33
48,Texas,27,Minnesota,3,Anoka County,326,303,23
48,Texas,27,Minnesota,5,Becker County,16,15,1
48,Texas,27,Minnesota,7,Beltrami County,32,38,-6
48,Texas,27,Minnesota,9,Benton County,65,9,56
48,Texas,27,Minnesota,13,Blue Earth County,2,61,-59
48,Texas,27,Minnesota,15,Brown County,0,58,-58
48,Texas,27,Minnesota,17,Carlton County,33,9,24
48,Texas,27,Minnesota,19,Carver County,323,194,129
48,Texas,27,Minnesota,21,Cass County,39,15,24
48,Texas,27,Minnesota,25,Chisago County,69,18,51
48,Texas,27,Minnesota,27,Clay County,86,7,79
48,Texas,27,Minnesota,29,Clearwater County,0,2,-2
48,Texas,27,Minnesota,33,Cottonwood County,45,1,44
48,Texas,27,Minnesota,35,Crow Wing County,0,108,-108
48,Texas,27,Minnesota,37,Dakota County,717,90,627
48,Texas,27,Minnesota,39,Dodge County,0,21,-21
48,Texas,27,Minnesota,41,Douglas County,0,11,-11
48,Texas,27,Minnesota,43,Faribault County,39,3,36
48,Texas,27,Minnesota,45,Fillmore County,0,9,-9
48,Texas,27,Minnesota,47,Freeborn County,13,31,-18
48,Texas,27,Minnesota,49,Goodhue County,73,9,64
48,Texas,27,Minnesota,53,Hennepin County,2279,2034,245
48,Texas,27,Minnesota,55,Houston County,7,3,4
48,Texas,27,Minnesota,57,Hubbard County,36,3,33
48,Texas,27,Minnesota,61,Itasca County,55,42,13
48,Texas,27,Minnesota,63,Jackson County,40,0,40
48,Texas,27,Minnesota,67,Kandiyohi County,56,206,-150
48,Texas,27,Minnesota,69,Kittson County,0,6,-6
48,Texas,27,Minnesota,71,Koochiching County,0,60,-60
48,Texas,27,Minnesota,75,Lake County,0,22,-22
48,Texas,27,Minnesota,79,Le Sueur County,5,116,-111
48,Texas,27,Minnesota,81,Lincoln County,0,1,-1
48,Texas,27,Minnesota,83,Lyon County,34,12,22
48,Texas,27,Minnesota,85,McLeod County,64,25,39
48,Texas,27,Minnesota,87,Mahnomen County,0,1,-1
48,Texas,27,Minnesota,89,Marshall County,5,0,5
48,Texas,27,Minnesota,91,Martin County,29,6,23
48,Texas,27,Minnesota,93,Meeker County,47,0,47
48,Texas,27,Minnesota,95,Mille Lacs County,21,22,-1
48,Texas,27,Minnesota,97,Morrison County,15,2,13
48,Texas,27,Minnesota,99,Mower County,55,99,-44
48,Texas,27,Minnesota,103,Nicollet County,36,4,32
48,Texas,27,Minnesota,105,Nobles County,67,21,46
48,Texas,27,Minnesota,107,Norman County,0,3,-3
48,Texas,27,Minnesota,109,Olmsted County,556,114,442
48,Texas,27,Minnesota,111,Otter Tail County,16,56,-40
48,Texas,27,Minnesota,115,Pine County,36,19,17
48,Texas,27,Minnesota,119,Polk County,20,28,-8
48,Texas,27,Minnesota,121,Pope County,0,17,-17
48,Texas,27,Minnesota,123,Ramsey County,418,386,32
48,Texas,27,Minnesota,127,Redwood County,32,0,32
48,Texas,27,Minnesota,129,Renville County,0,12,-12
48,Texas,27,Minnesota,131,Rice County,13,71,-58
48,Texas,27,Minnesota,133,Rock County,6,2,4
48,Texas,27,Minnesota,135,Roseau County,0,4,-4
48,Texas,27,Minnesota,137,St. Louis County,76,68,8
48,Texas,27,Minnesota,139,Scott County,80,17,63
48,Texas,27,Minnesota,141,Sherburne County,69,42,27
48,Texas,27,Minnesota,143,Sibley County,8,47,-39
48,Texas,27,Minnesota,145,Stearns County,259,131,128
48,Texas,27,Minnesota,147,Steele County,0,97,-97
48,Texas,27,Minnesota,149,Stevens County,4,0,4
48,Texas,27,Minnesota,151,Swift County,23,0,23
48,Texas,27,Minnesota,153,Todd County,0,52,-52
48,Texas,27,Minnesota,157,Wabasha County,32,29,3
48,Texas,27,Minnesota,161,Waseca County,73,19,54
48,Texas,27,Minnesota,163,Washington County,368,116,252
48,Texas,27,Minnesota,169,Winona County,50,54,-4
48,Texas,27,Minnesota,171,Wright County,29,8,21
48,Texas,27,Minnesota,173,Yellow Medicine County,0,1,-1
48,Texas,28,Mississippi,1,Adams County,282,38,244
48,Texas,28,Mississippi,3,Alcorn County,4,11,-7
48,Texas,28,Mississippi,7,Attala County,0,5,-5
48,Texas,28,Mississippi,9,Benton County,0,2,-2
48,Texas,28,Mississippi,11,Bolivar County,144,6,138
48,Texas,28,Mississippi,17,Chickasaw County,20,21,-1
48,Texas,28,Mississippi,21,Claiborne County,96,20,76
48,Texas,28,Mississippi,23,Clarke County,0,18,-18
48,Texas,28,Mississippi,25,Clay County,50,46,4
48,Texas,28,Mississippi,27,Coahoma County,0,32,-32
48,Texas,28,Mississippi,29,Copiah County,54,55,-1
48,Texas,28,Mississippi,31,Covington County,0,23,-23
48,Texas,28,Mississippi,33,DeSoto County,392,549,-157
48,Texas,28,Mississippi,35,Forrest County,335,269,66
48,Texas,28,Mississippi,37,Franklin County,0,7,-7
48,Texas,28,Mississippi,39,George County,121,17,104
48,Texas,28,Mississippi,43,Grenada County,69,176,-107
48,Texas,28,Mississippi,45,Hancock County,263,48,215
48,Texas,28,Mississippi,47,Harrison County,969,1157,-188
48,Texas,28,Mississippi,49,Hinds County,730,577,153
48,Texas,28,Mississippi,51,Holmes County,0,10,-10
48,Texas,28,Mississippi,53,Humphreys County,103,0,103
48,Texas,28,Mississippi,55,Issaquena County,18,0,18
48,Texas,28,Mississippi,57,Itawamba County,0,17,-17
48,Texas,28,Mississippi,59,Jackson County,1462,79,1383
48,Texas,28,Mississippi,63,Jefferson County,0,6,-6
48,Texas,28,Mississippi,65,Jefferson Davis County,0,6,-6
48,Texas,28,Mississippi,67,Jones County,431,5,426
48,Texas,28,Mississippi,69,Kemper County,160,2,158
48,Texas,28,Mississippi,71,Lafayette County,366,564,-198
48,Texas,28,Mississippi,73,Lamar County,173,80,93
48,Texas,28,Mississippi,75,Lauderdale County,584,194,390
48,Texas,28,Mississippi,77,Lawrence County,0,22,-22
48,Texas,28,Mississippi,79,Leake County,91,0,91
48,Texas,28,Mississippi,81,Lee County,55,21,34
48,Texas,28,Mississippi,83,Leflore County,117,36,81
48,Texas,28,Mississippi,85,Lincoln County,314,21,293
48,Texas,28,Mississippi,87,Lowndes County,325,142,183
48,Texas,28,Mississippi,89,Madison County,647,382,265
48,Texas,28,Mississippi,91,Marion County,20,80,-60
48,Texas,28,Mississippi,93,Marshall County,0,8,-8
48,Texas,28,Mississippi,95,Monroe County,0,4,-4
48,Texas,28,Mississippi,97,Montgomery County,55,0,55
48,Texas,28,Mississippi,99,Neshoba County,57,59,-2
48,Texas,28,Mississippi,105,Oktibbeha County,251,184,67
48,Texas,28,Mississippi,107,Panola County,80,0,80
48,Texas,28,Mississippi,109,Pearl River County,67,176,-109
48,Texas,28,Mississippi,111,Perry County,61,109,-48
48,Texas,28,Mississippi,113,Pike County,39,274,-235
48,Texas,28,Mississippi,115,Pontotoc County,0,7,-7
48,Texas,28,Mississippi,119,Quitman County,11,0,11
48,Texas,28,Mississippi,121,Rankin County,598,439,159
48,Texas,28,Mississippi,123,Scott County,0,13,-13
48,Texas,28,Mississippi,127,Simpson County,13,21,-8
48,Texas,28,Mississippi,131,Stone County,0,17,-17
48,Texas,28,Mississippi,133,Sunflower County,46,20,26
48,Texas,28,Mississippi,139,Tippah County,0,8,-8
48,Texas,28,Mississippi,141,Tishomingo County,130,11,119
48,Texas,28,Mississippi,145,Union County,20,18,2
48,Texas,28,Mississippi,147,Walthall County,0,108,-108
48,Texas,28,Mississippi,149,Warren County,62,87,-25
48,Texas,28,Mississippi,151,Washington County,196,74,122
48,Texas,28,Mississippi,153,Wayne County,199,2,197
48,Texas,28,Mississippi,155,Webster County,0,55,-55
48,Texas,28,Mississippi,159,Winston County,70,0,70
48,Texas,28,Mississippi,161,Yalobusha County,17,3,14
48,Texas,28,Mississippi,163,Yazoo County,34,173,-139
48,Texas,29,Missouri,1,Adair County,22,0,22
48,Texas,29,Missouri,3,Andrew County,36,0,36
48,Texas,29,Missouri,5,Atchison County,7,0,7
48,Texas,29,Missouri,7,Audrain County,0,11,-11
48,Texas,29,Missouri,9,Barry County,40,106,-66
48,Texas,29,Missouri,11,Barton County,25,21,4
48,Texas,29,Missouri,15,Benton County,13,122,-109
48,Texas,29,Missouri,19,Boone County,541,587,-46
48,Texas,29,Missouri,21,Buchanan County,181,58,123
48,Texas,29,Missouri,23,Butler County,175,31,144
48,Texas,29,Missouri,25,Caldwell County,8,14,-6
48,Texas,29,Missouri,27,Callaway County,89,63,26
48,Texas,29,Missouri,29,Camden County,26,67,-41
48,Texas,29,Missouri,31,Cape Girardeau County,149,57,92
48,Texas,29,Missouri,33,Carroll County,17,0,17
48,Texas,29,Missouri,37,Cass County,438,56,382
48,Texas,29,Missouri,39,Cedar County,3,7,-4
48,Texas,29,Missouri,43,Christian County,204,220,-16
48,Texas,29,Missouri,47,Clay County,467,309,158
48,Texas,29,Missouri,49,Clinton County,55,166,-111
48,Texas,29,Missouri,51,Cole County,205,63,142
48,Texas,29,Missouri,53,Cooper County,14,9,5
48,Texas,29,Missouri,55,Crawford County,38,25,13
48,Texas,29,Missouri,57,Dade County,0,10,-10
48,Texas,29,Missouri,59,Dallas County,25,0,25
48,Texas,29,Missouri,61,Daviess County,0,3,-3
48,Texas,29,Missouri,67,Douglas County,10,79,-69
48,Texas,29,Missouri,69,Dunklin County,8,43,-35
48,Texas,29,Missouri,71,Franklin County,47,66,-19
48,Texas,29,Missouri,73,Gasconade County,9,16,-7
48,Texas,29,Missouri,75,Gentry County,0,7,-7
48,Texas,29,Missouri,77,Greene County,961,709,252
48,Texas,29,Missouri,79,Grundy County,0,4,-4
48,Texas,29,Missouri,81,Harrison County,0,75,-75
48,Texas,29,Missouri,83,Henry County,98,19,79
48,Texas,29,Missouri,85,Hickory County,63,0,63
48,Texas,29,Missouri,87,Holt County,0,6,-6
48,Texas,29,Missouri,91,Howell County,242,57,185
48,Texas,29,Missouri,93,Iron County,0,20,-20
48,Texas,29,Missouri,95,Jackson County,1688,1296,392
48,Texas,29,Missouri,97,Jasper County,405,192,213
48,Texas,29,Missouri,99,Jefferson County,111,25,86
48,Texas,29,Missouri,101,Johnson County,256,234,22
48,Texas,29,Missouri,103,Knox County,0,13,-13
48,Texas,29,Missouri,105,Laclede County,237,20,217
48,Texas,29,Missouri,107,Lafayette County,10,15,-5
48,Texas,29,Missouri,109,Lawrence County,23,186,-163
48,Texas,29,Missouri,111,Lewis County,30,0,30
48,Texas,29,Missouri,113,Lincoln County,278,2,276
48,Texas,29,Missouri,115,Linn County,6,0,6
48,Texas,29,Missouri,117,Livingston County,0,7,-7
48,Texas,29,Missouri,119,McDonald County,47,93,-46
48,Texas,29,Missouri,123,Madison County,0,127,-127
48,Texas,29,Missouri,125,Maries County,2,18,-16
48,Texas,29,Missouri,127,Marion County,69,0,69
48,Texas,29,Missouri,129,Mercer County,0,16,-16
48,Texas,29,Missouri,133,Mississippi County,17,19,-2
48,Texas,29,Missouri,135,Moniteau County,25,12,13
48,Texas,29,Missouri,137,Monroe County,0,4,-4
48,Texas,29,Missouri,139,Montgomery County,0,8,-8
48,Texas,29,Missouri,141,Morgan County,43,0,43
48,Texas,29,Missouri,143,New Madrid County,120,16,104
48,Texas,29,Missouri,145,Newton County,49,152,-103
48,Texas,29,Missouri,147,Nodaway County,19,6,13
48,Texas,29,Missouri,149,Oregon County,20,51,-31
48,Texas,29,Missouri,151,Osage County,0,25,-25
48,Texas,29,Missouri,153,Ozark County,0,12,-12
48,Texas,29,Missouri,155,Pemiscot County,14,67,-53
48,Texas,29,Missouri,157,Perry County,9,36,-27
48,Texas,29,Missouri,159,Pettis County,30,196,-166
48,Texas,29,Missouri,161,Phelps County,271,47,224
48,Texas,29,Missouri,163,Pike County,118,2,116
48,Texas,29,Missouri,165,Platte County,617,335,282
48,Texas,29,Missouri,167,Polk County,163,136,27
48,Texas,29,Missouri,169,Pulaski County,731,1139,-408
48,Texas,29,Missouri,171,Putnam County,78,17,61
48,Texas,29,Missouri,175,Randolph County,13,0,13
48,Texas,29,Missouri,177,Ray County,9,89,-80
48,Texas,29,Missouri,179,Reynolds County,0,3,-3
48,Texas,29,Missouri,183,St. Charles County,844,225,619
48,Texas,29,Missouri,185,St. Clair County,0,27,-27
48,Texas,29,Missouri,187,St. Francois County,20,84,-64
48,Texas,29,Missouri,189,St. Louis County,2834,1680,1154
48,Texas,29,Missouri,195,Saline County,0,53,-53
48,Texas,29,Missouri,197,Schuyler County,0,3,-3
48,Texas,29,Missouri,201,Scott County,42,0,42
48,Texas,29,Missouri,207,Stoddard County,12,50,-38
48,Texas,29,Missouri,209,Stone County,163,11,152
48,Texas,29,Missouri,213,Taney County,152,27,125
48,Texas,29,Missouri,215,Texas County,177,89,88
48,Texas,29,Missouri,217,Vernon County,15,3,12
48,Texas,29,Missouri,219,Warren County,0,6,-6
48,Texas,29,Missouri,221,Washington County,14,0,14
48,Texas,29,Missouri,225,Webster County,0,120,-120
48,Texas,29,Missouri,229,Wright County,0,32,-32
48,Texas,29,Missouri,510,St. Louis city,1177,725,452
48,Texas,30,Montana,1,Beaverhead County,0,9,-9
48,Texas,30,Montana,3,Big Horn County,0,12,-12
48,Texas,30,Montana,5,Blaine County,0,24,-24
48,Texas,30,Montana,9,Carbon County,9,21,-12
48,Texas,30,Montana,11,Carter County,12,0,12
48,Texas,30,Montana,13,Cascade County,224,468,-244
48,Texas,30,Montana,15,Chouteau County,0,28,-28
48,Texas,30,Montana,17,Custer County,67,8,59
48,Texas,30,Montana,21,Dawson County,0,10,-10
48,Texas,30,Montana,23,Deer Lodge County,0,14,-14
48,Texas,30,Montana,27,Fergus County,0,2,-2
48,Texas,30,Montana,29,Flathead County,111,203,-92
48,Texas,30,Montana,31,Gallatin County,104,239,-135
48,Texas,30,Montana,35,Glacier County,26,0,26
48,Texas,30,Montana,43,Jefferson County,0,20,-20
48,Texas,30,Montana,49,Lewis and Clark County,123,48,75
48,Texas,30,Montana,53,Lincoln County,0,179,-179
48,Texas,30,Montana,57,Madison County,0,15,-15
48,Texas,30,Montana,59,Meagher County,0,41,-41
48,Texas,30,Montana,63,Missoula County,53,200,-147
48,Texas,30,Montana,65,Musselshell County,2,0,2
48,Texas,30,Montana,67,Park County,17,0,17
48,Texas,30,Montana,71,Phillips County,39,0,39
48,Texas,30,Montana,73,Pondera County,0,15,-15
48,Texas,30,Montana,77,Powell County,40,9,31
48,Texas,30,Montana,81,Ravalli County,15,57,-42
48,Texas,30,Montana,83,Richland County,13,280,-267
48,Texas,30,Montana,87,Rosebud County,0,52,-52
48,Texas,30,Montana,89,Sanders County,0,12,-12
48,Texas,30,Montana,91,Sheridan County,0,39,-39
48,Texas,30,Montana,93,Silver Bow County,48,140,-92
48,Texas,30,Montana,99,Teton County,36,3,33
48,Texas,30,Montana,101,Toole County,0,150,-150
48,Texas,30,Montana,105,Valley County,0,2,-2
48,Texas,30,Montana,111,Yellowstone County,188,271,-83
48,Texas,31,Nebraska,1,Adams County,76,15,61
48,Texas,31,Nebraska,13,Box Butte County,15,79,-64
48,Texas,31,Nebraska,19,Buffalo County,31,14,17
48,Texas,31,Nebraska,21,Burt County,0,7,-7
48,Texas,31,Nebraska,23,Butler County,33,0,33
48,Texas,31,Nebraska,25,Cass County,68,61,7
48,Texas,31,Nebraska,27,Cedar County,28,31,-3
48,Texas,31,Nebraska,31,Cherry County,0,35,-35
48,Texas,31,Nebraska,33,Cheyenne County,0,3,-3
48,Texas,31,Nebraska,35,Clay County,0,8,-8
48,Texas,31,Nebraska,39,Cuming County,42,0,42
48,Texas,31,Nebraska,41,Custer County,0,2,-2
48,Texas,31,Nebraska,43,Dakota County,62,17,45
48,Texas,31,Nebraska,45,Dawes County,0,31,-31
48,Texas,31,Nebraska,47,Dawson County,23,8,15
48,Texas,31,Nebraska,49,Deuel County,0,3,-3
48,Texas,31,Nebraska,53,Dodge County,15,191,-176
48,Texas,31,Nebraska,55,Douglas County,1694,1222,472
48,Texas,31,Nebraska,59,Fillmore County,0,1,-1
48,Texas,31,Nebraska,61,Franklin County,0,5,-5
48,Texas,31,Nebraska,65,Furnas County,97,2,95
48,Texas,31,Nebraska,67,Gage County,0,1,-1
48,Texas,31,Nebraska,69,Garden County,85,9,76
48,Texas,31,Nebraska,75,Grant County,21,0,21
48,Texas,31,Nebraska,77,Greeley County,0,29,-29
48,Texas,31,Nebraska,79,Hall County,52,135,-83
48,Texas,31,Nebraska,83,Harlan County,0,10,-10
48,Texas,31,Nebraska,89,Holt County,5,3,2
48,Texas,31,Nebraska,91,Hooker County,0,3,-3
48,Texas,31,Nebraska,97,Johnson County,0,1,-1
48,Texas,31,Nebraska,101,Keith County,0,126,-126
48,Texas,31,Nebraska,105,Kimball County,10,17,-7
48,Texas,31,Nebraska,107,Knox County,0,34,-34
48,Texas,31,Nebraska,109,Lancaster County,724,390,334
48,Texas,31,Nebraska,111,Lincoln County,21,50,-29
48,Texas,31,Nebraska,115,Loup County,0,1,-1
48,Texas,31,Nebraska,119,Madison County,10,58,-48
48,Texas,31,Nebraska,123,Morrill County,117,28,89
48,Texas,31,Nebraska,127,Nemaha County,0,27,-27
48,Texas,31,Nebraska,131,Otoe County,30,44,-14
48,Texas,31,Nebraska,133,Pawnee County,0,2,-2
48,Texas,31,Nebraska,137,Phelps County,62,9,53
48,Texas,31,Nebraska,141,Platte County,13,2,11
48,Texas,31,Nebraska,143,Polk County,0,24,-24
48,Texas,31,Nebraska,145,Red Willow County,0,39,-39
48,Texas,31,Nebraska,147,Richardson County,0,6,-6
48,Texas,31,Nebraska,151,Saline County,10,1,9
48,Texas,31,Nebraska,153,Sarpy County,576,622,-46
48,Texas,31,Nebraska,155,Saunders County,0,24,-24
48,Texas,31,Nebraska,157,Scotts Bluff County,28,68,-40
48,Texas,31,Nebraska,159,Seward County,7,30,-23
48,Texas,31,Nebraska,161,Sheridan County,0,7,-7
48,Texas,31,Nebraska,163,Sherman County,0,11,-11
48,Texas,31,Nebraska,169,Thayer County,5,0,5
48,Texas,31,Nebraska,171,Thomas County,0,18,-18
48,Texas,31,Nebraska,175,Valley County,21,0,21
48,Texas,31,Nebraska,177,Washington County,80,0,80
48,Texas,31,Nebraska,179,Wayne County,0,49,-49
48,Texas,31,Nebraska,185,York County,0,17,-17
48,Texas,32,Nevada,1,Churchill County,21,36,-15
48,Texas,32,Nevada,3,Clark County,6241,3368,2873
48,Texas,32,Nevada,5,Douglas County,173,13,160
48,Texas,32,Nevada,7,Elko County,23,60,-37
48,Texas,32,Nevada,13,Humboldt County,0,26,-26
48,Texas,32,Nevada,17,Lincoln County,26,0,26
48,Texas,32,Nevada,19,Lyon County,152,228,-76
48,Texas,32,Nevada,21,Mineral County,0,1,-1
48,Texas,32,Nevada,23,Nye County,92,36,56
48,Texas,32,Nevada,27,Pershing County,0,36,-36
48,Texas,32,Nevada,31,Washoe County,962,836,126
48,Texas,32,Nevada,510,Carson City,173,36,137
48,Texas,33,New Hampshire,1,Belknap County,106,0,106
48,Texas,33,New Hampshire,3,Carroll County,30,6,24
48,Texas,33,New Hampshire,5,Cheshire County,70,59,11
48,Texas,33,New Hampshire,7,Coos County,33,3,30
48,Texas,33,New Hampshire,9,Grafton County,118,92,26
48,Texas,33,New Hampshire,11,Hillsborough County,459,684,-225
48,Texas,33,New Hampshire,13,Merrimack County,180,83,97
48,Texas,33,New Hampshire,15,Rockingham County,125,69,56
48,Texas,33,New Hampshire,17,Strafford County,194,63,131
48,Texas,34,New Jersey,1,Atlantic County,290,309,-19
48,Texas,34,New Jersey,3,Bergen County,914,527,387
48,Texas,34,New Jersey,5,Burlington County,788,520,268
48,Texas,34,New Jersey,7,Camden County,315,126,189
48,Texas,34,New Jersey,9,Cape May County,0,22,-22
48,Texas,34,New Jersey,11,Cumberland County,14,10,4
48,Texas,34,New Jersey,13,Essex County,755,441,314
48,Texas,34,New Jersey,15,Gloucester County,252,17,235
48,Texas,34,New Jersey,17,Hudson County,930,480,450
48,Texas,34,New Jersey,19,Hunterdon County,51,142,-91
48,Texas,34,New Jersey,21,Mercer County,324,468,-144
48,Texas,34,New Jersey,23,Middlesex County,1689,481,1208
48,Texas,34,New Jersey,25,Monmouth County,298,120,178
48,Texas,34,New Jersey,27,Morris County,393,251,142
48,Texas,34,New Jersey,29,Ocean County,122,230,-108
48,Texas,34,New Jersey,31,Passaic County,261,77,184
48,Texas,34,New Jersey,33,Salem County,0,8,-8
48,Texas,34,New Jersey,35,Somerset County,613,205,408
48,Texas,34,New Jersey,37,Sussex County,49,98,-49
48,Texas,34,New Jersey,39,Union County,314,141,173
48,Texas,34,New Jersey,41,Warren County,131,195,-64
48,Texas,35,New Mexico,1,Bernalillo County,3544,2974,570
48,Texas,35,New Mexico,3,Catron County,48,0,48
48,Texas,35,New Mexico,5,Chaves County,985,719,266
48,Texas,35,New Mexico,6,Cibola County,51,51,0
48,Texas,35,New Mexico,7,Colfax County,95,202,-107
48,Texas,35,New Mexico,9,Curry County,858,1057,-199
48,Texas,35,New Mexico,11,De Baca County,2,24,-22
48,Texas,35,New Mexico,13,Doña Ana County,4110,3183,927
48,Texas,35,New Mexico,15,Eddy County,1564,769,795
48,Texas,35,New Mexico,17,Grant County,136,295,-159
48,Texas,35,New Mexico,19,Guadalupe County,42,0,42
48,Texas,35,New Mexico,23,Hidalgo County,2,15,-13
48,Texas,35,New Mexico,25,Lea County,1409,1200,209
48,Texas,35,New Mexico,27,Lincoln County,171,546,-375
48,Texas,35,New Mexico,28,Los Alamos County,183,105,78
48,Texas,35,New Mexico,29,Luna County,423,115,308
48,Texas,35,New Mexico,31,McKinley County,132,23,109
48,Texas,35,New Mexico,33,Mora County,0,2,-2
48,Texas,35,New Mexico,35,Otero County,1017,1017,0
48,Texas,35,New Mexico,37,Quay County,213,115,98
48,Texas,35,New Mexico,39,Rio Arriba County,17,61,-44
48,Texas,35,New Mexico,41,Roosevelt County,97,420,-323
48,Texas,35,New Mexico,43,Sandoval County,687,473,214
48,Texas,35,New Mexico,45,San Juan County,847,474,373
48,Texas,35,New Mexico,47,San Miguel County,61,49,12
48,Texas,35,New Mexico,49,Santa Fe County,432,766,-334
48,Texas,35,New Mexico,51,Sierra County,93,85,8
48,Texas,35,New Mexico,53,Socorro County,0,114,-114
48,Texas,35,New Mexico,55,Taos County,129,161,-32
48,Texas,35,New Mexico,57,Torrance County,26,23,3
48,Texas,35,New Mexico,59,Union County,10,73,-63
48,Texas,35,New Mexico,61,Valencia County,134,24,110
48,Texas,36,New York,1,Albany County,263,190,73
48,Texas,36,New York,3,Allegany County,131,27,104
48,Texas,36,New York,5,Bronx County,903,347,556
48,Texas,36,New York,7,Broome County,194,229,-35
48,Texas,36,New York,9,Cattaraugus County,44,67,-23
48,Texas,36,New York,11,Cayuga County,145,7,138
48,Texas,36,New York,13,Chautauqua County,41,27,14
48,Texas,36,New York,15,Chemung County,114,11,103
48,Texas,36,New York,19,Clinton County,33,34,-1
48,Texas,36,New York,21,Columbia County,17,24,-7
48,Texas,36,New York,23,Cortland County,319,44,275
48,Texas,36,New York,25,Delaware County,39,4,35
48,Texas,36,New York,27,Dutchess County,280,97,183
48,Texas,36,New York,29,Erie County,879,733,146
48,Texas,36,New York,31,Essex County,117,19,98
48,Texas,36,New York,33,Franklin County,55,18,37
48,Texas,36,New York,35,Fulton County,95,0,95
48,Texas,36,New York,37,Genesee County,62,44,18
48,Texas,36,New York,43,Herkimer County,104,4,100
48,Texas,36,New York,45,Jefferson County,1713,1153,560
48,Texas,36,New York,47,Kings County,3163,1217,1946
48,Texas,36,New York,49,Lewis County,0,5,-5
48,Texas,36,New York,51,Livingston County,74,72,2
48,Texas,36,New York,53,Madison County,39,152,-113
48,Texas,36,New York,55,Monroe County,593,480,113
48,Texas,36,New York,57,Montgomery County,42,29,13
48,Texas,36,New York,59,Nassau County,1104,414,690
48,Texas,36,New York,61,New York County,2214,1785,429
48,Texas,36,New York,63,Niagara County,267,154,113
48,Texas,36,New York,65,Oneida County,93,44,49
48,Texas,36,New York,67,Onondaga County,515,532,-17
48,Texas,36,New York,69,Ontario County,28,84,-56
48,Texas,36,New York,71,Orange County,381,382,-1
48,Texas,36,New York,73,Orleans County,0,4,-4
48,Texas,36,New York,75,Oswego County,72,10,62
48,Texas,36,New York,77,Otsego County,91,25,66
48,Texas,36,New York,79,Putnam County,28,0,28
48,Texas,36,New York,81,Queens County,1781,858,923
48,Texas,36,New York,83,Rensselaer County,71,323,-252
48,Texas,36,New York,85,Richmond County,234,38,196
48,Texas,36,New York,87,Rockland County,442,79,363
48,Texas,36,New York,89,St. Lawrence County,283,13,270
48,Texas,36,New York,91,Saratoga County,264,172,92
48,Texas,36,New York,93,Schenectady County,134,16,118
48,Texas,36,New York,95,Schoharie County,112,9,103
48,Texas,36,New York,99,Seneca County,70,6,64
48,Texas,36,New York,101,Steuben County,29,56,-27
48,Texas,36,New York,103,Suffolk County,1334,409,925
48,Texas,36,New York,105,Sullivan County,123,37,86
48,Texas,36,New York,107,Tioga County,249,66,183
48,Texas,36,New York,109,Tompkins County,236,798,-562
48,Texas,36,New York,111,Ulster County,87,27,60
48,Texas,36,New York,113,Warren County,18,14,4
48,Texas,36,New York,115,Washington County,31,8,23
48,Texas,36,New York,117,Wayne County,22,26,-4
48,Texas,36,New York,119,Westchester County,1311,225,1086
48,Texas,36,New York,121,Wyoming County,0,96,-96
48,Texas,37,North Carolina,1,Alamance County,113,151,-38
48,Texas,37,North Carolina,9,Ashe County,0,7,-7
48,Texas,37,North Carolina,13,Beaufort County,0,12,-12
48,Texas,37,North Carolina,17,Bladen County,32,0,32
48,Texas,37,North Carolina,19,Brunswick County,87,291,-204
48,Texas,37,North Carolina,21,Buncombe County,216,369,-153
48,Texas,37,North Carolina,23,Burke County,14,85,-71
48,Texas,37,North Carolina,25,Cabarrus County,165,184,-19
48,Texas,37,North Carolina,27,Caldwell County,29,182,-153
48,Texas,37,North Carolina,31,Carteret County,37,93,-56
48,Texas,37,North Carolina,35,Catawba County,163,93,70
48,Texas,37,North Carolina,37,Chatham County,109,82,27
48,Texas,37,North Carolina,39,Cherokee County,77,6,71
48,Texas,37,North Carolina,41,Chowan County,3,0,3
48,Texas,37,North Carolina,43,Clay County,0,16,-16
48,Texas,37,North Carolina,45,Cleveland County,57,76,-19
48,Texas,37,North Carolina,49,Craven County,275,368,-93
48,Texas,37,North Carolina,51,Cumberland County,2669,2023,646
48,Texas,37,North Carolina,55,Dare County,8,21,-13
48,Texas,37,North Carolina,57,Davidson County,106,152,-46
48,Texas,37,North Carolina,59,Davie County,60,36,24
48,Texas,37,North Carolina,61,Duplin County,15,165,-150
48,Texas,37,North Carolina,63,Durham County,922,671,251
48,Texas,37,North Carolina,65,Edgecombe County,39,0,39
48,Texas,37,North Carolina,67,Forsyth County,250,603,-353
48,Texas,37,North Carolina,69,Franklin County,42,4,38
48,Texas,37,North Carolina,71,Gaston County,134,157,-23
48,Texas,37,North Carolina,77,Granville County,231,14,217
48,Texas,37,North Carolina,79,Greene County,32,35,-3
48,Texas,37,North Carolina,81,Guilford County,791,570,221
48,Texas,37,North Carolina,83,Halifax County,16,0,16
48,Texas,37,North Carolina,85,Harnett County,518,510,8
48,Texas,37,North Carolina,87,Haywood County,8,31,-23
48,Texas,37,North Carolina,89,Henderson County,77,92,-15
48,Texas,37,North Carolina,91,Hertford County,0,23,-23
48,Texas,37,North Carolina,93,Hoke County,260,122,138
48,Texas,37,North Carolina,97,Iredell County,53,102,-49
48,Texas,37,North Carolina,99,Jackson County,0,13,-13
48,Texas,37,North Carolina,101,Johnston County,335,72,263
48,Texas,37,North Carolina,105,Lee County,28,21,7
48,Texas,37,North Carolina,109,Lincoln County,71,24,47
48,Texas,37,North Carolina,113,Macon County,115,23,92
48,Texas,37,North Carolina,115,Madison County,0,11,-11
48,Texas,37,North Carolina,119,Mecklenburg County,1382,1701,-319
48,Texas,37,North Carolina,121,Mitchell County,0,18,-18
48,Texas,37,North Carolina,125,Moore County,210,161,49
48,Texas,37,North Carolina,127,Nash County,35,88,-53
48,Texas,37,North Carolina,129,New Hanover County,259,408,-149
48,Texas,37,North Carolina,133,Onslow County,1150,1157,-7
48,Texas,37,North Carolina,135,Orange County,437,114,323
48,Texas,37,North Carolina,137,Pamlico County,143,0,143
48,Texas,37,North Carolina,139,Pasquotank County,47,57,-10
48,Texas,37,North Carolina,141,Pender County,23,15,8
48,Texas,37,North Carolina,147,Pitt County,321,159,162
48,Texas,37,North Carolina,149,Polk County,0,33,-33
48,Texas,37,North Carolina,151,Randolph County,60,142,-82
48,Texas,37,North Carolina,153,Richmond County,20,0,20
48,Texas,37,North Carolina,155,Robeson County,105,30,75
48,Texas,37,North Carolina,157,Rockingham County,102,0,102
48,Texas,37,North Carolina,159,Rowan County,90,65,25
48,Texas,37,North Carolina,161,Rutherford County,0,12,-12
48,Texas,37,North Carolina,163,Sampson County,30,3,27
48,Texas,37,North Carolina,165,Scotland County,85,1,84
48,Texas,37,North Carolina,167,Stanly County,5,0,5
48,Texas,37,North Carolina,171,Surry County,7,0,7
48,Texas,37,North Carolina,173,Swain County,39,39,0
48,Texas,37,North Carolina,175,Transylvania County,37,0,37
48,Texas,37,North Carolina,179,Union County,364,475,-111
48,Texas,37,North Carolina,181,Vance County,79,4,75
48,Texas,37,North Carolina,183,Wake County,993,827,166
48,Texas,37,North Carolina,185,Warren County,0,8,-8
48,Texas,37,North Carolina,189,Watauga County,34,27,7
48,Texas,37,North Carolina,191,Wayne County,383,293,90
48,Texas,37,North Carolina,193,Wilkes County,26,0,26
48,Texas,37,North Carolina,195,Wilson County,8,6,2
48,Texas,37,North Carolina,197,Yadkin County,20,0,20
48,Texas,37,North Carolina,199,Yancey County,0,32,-32
48,Texas,38,North Dakota,3,Barnes County,41,6,35
48,Texas,38,North Dakota,9,Bottineau County,0,6,-6
48,Texas,38,North Dakota,13,Burke County,0,13,-13
48,Texas,38,North Dakota,15,Burleigh County,193,123,70
48,Texas,38,North Dakota,17,Cass County,110,671,-561
48,Texas,38,North Dakota,19,Cavalier County,39,0,39
48,Texas,38,North Dakota,21,Dickey County,0,13,-13
48,Texas,38,North Dakota,23,Divide County,23,0,23
48,Texas,38,North Dakota,25,Dunn County,0,12,-12
48,Texas,38,North Dakota,35,Grand Forks County,115,280,-165
48,Texas,38,North Dakota,37,Grant County,0,1,-1
48,Texas,38,North Dakota,41,Hettinger County,0,4,-4
48,Texas,38,North Dakota,43,Kidder County,0,18,-18
48,Texas,38,North Dakota,49,McHenry County,0,3,-3
48,Texas,38,North Dakota,53,McKenzie County,65,31,34
48,Texas,38,North Dakota,55,McLean County,56,0,56
48,Texas,38,North Dakota,57,Mercer County,0,35,-35
48,Texas,38,North Dakota,59,Morton County,0,115,-115
48,Texas,38,North Dakota,61,Mountrail County,98,2,96
48,Texas,38,North Dakota,67,Pembina County,0,1,-1
48,Texas,38,North Dakota,69,Pierce County,0,26,-26
48,Texas,38,North Dakota,79,Rolette County,0,2,-2
48,Texas,38,North Dakota,85,Sioux County,0,7,-7
48,Texas,38,North Dakota,89,Stark County,69,171,-102
48,Texas,38,North Dakota,91,Steele County,0,2,-2
48,Texas,38,North Dakota,93,Stutsman County,21,172,-151
48,Texas,38,North Dakota,97,Traill County,0,22,-22
48,Texas,38,North Dakota,99,Walsh County,76,6,70
48,Texas,38,North Dakota,101,Ward County,276,390,-114
48,Texas,38,North Dakota,105,Williams County,49,157,-108
48,Texas,39,Ohio,3,Allen County,0,102,-102
48,Texas,39,Ohio,5,Ashland County,0,62,-62
48,Texas,39,Ohio,7,Ashtabula County,26,25,1
48,Texas,39,Ohio,9,Athens County,99,24,75
48,Texas,39,Ohio,11,Auglaize County,22,25,-3
48,Texas,39,Ohio,13,Belmont County,15,61,-46
48,Texas,39,Ohio,15,Brown County,295,21,274
48,Texas,39,Ohio,17,Butler County,500,185,315
48,Texas,39,Ohio,19,Carroll County,78,0,78
48,Texas,39,Ohio,21,Champaign County,0,5,-5
48,Texas,39,Ohio,23,Clark County,65,83,-18
48,Texas,39,Ohio,25,Clermont County,124,113,11
48,Texas,39,Ohio,27,Clinton County,0,17,-17
48,Texas,39,Ohio,29,Columbiana County,6,89,-83
48,Texas,39,Ohio,31,Coshocton County,42,41,1
48,Texas,39,Ohio,33,Crawford County,0,80,-80
48,Texas,39,Ohio,35,Cuyahoga County,1520,1241,279
48,Texas,39,Ohio,39,Defiance County,26,49,-23
48,Texas,39,Ohio,41,Delaware County,198,81,117
48,Texas,39,Ohio,43,Erie County,16,34,-18
48,Texas,39,Ohio,45,Fairfield County,73,31,42
48,Texas,39,Ohio,47,Fayette County,0,12,-12
48,Texas,39,Ohio,49,Franklin County,2123,1551,572
48,Texas,39,Ohio,51,Fulton County,9,8,1
48,Texas,39,Ohio,53,Gallia County,0,19,-19
48,Texas,39,Ohio,55,Geauga County,25,43,-18
48,Texas,39,Ohio,57,Greene County,165,423,-258
48,Texas,39,Ohio,59,Guernsey County,0,11,-11
48,Texas,39,Ohio,61,Hamilton County,832,985,-153
48,Texas,39,Ohio,63,Hancock County,33,17,16
48,Texas,39,Ohio,65,Hardin County,14,118,-104
48,Texas,39,Ohio,67,Harrison County,5,46,-41
48,Texas,39,Ohio,69,Henry County,0,42,-42
48,Texas,39,Ohio,71,Highland County,0,7,-7
48,Texas,39,Ohio,77,Huron County,13,161,-148
48,Texas,39,Ohio,81,Jefferson County,0,151,-151
48,Texas,39,Ohio,83,Knox County,28,78,-50
48,Texas,39,Ohio,85,Lake County,75,208,-133
48,Texas,39,Ohio,87,Lawrence County,24,51,-27
48,Texas,39,Ohio,89,Licking County,53,195,-142
48,Texas,39,Ohio,91,Logan County,0,60,-60
48,Texas,39,Ohio,93,Lorain County,304,402,-98
48,Texas,39,Ohio,95,Lucas County,399,334,65
48,Texas,39,Ohio,97,Madison County,0,12,-12
48,Texas,39,Ohio,99,Mahoning County,266,63,203
48,Texas,39,Ohio,101,Marion County,0,23,-23
48,Texas,39,Ohio,103,Medina County,41,43,-2
48,Texas,39,Ohio,105,Meigs County,0,1,-1
48,Texas,39,Ohio,109,Miami County,319,158,161
48,Texas,39,Ohio,111,Monroe County,11,0,11
48,Texas,39,Ohio,113,Montgomery County,975,329,646
48,Texas,39,Ohio,117,Morrow County,0,31,-31
48,Texas,39,Ohio,119,Muskingum County,72,47,25
48,Texas,39,Ohio,121,Noble County,9,0,9
48,Texas,39,Ohio,123,Ottawa County,0,126,-126
48,Texas,39,Ohio,127,Perry County,49,0,49
48,Texas,39,Ohio,129,Pickaway County,0,8,-8
48,Texas,39,Ohio,131,Pike County,0,5,-5
48,Texas,39,Ohio,133,Portage County,92,114,-22
48,Texas,39,Ohio,135,Preble County,54,18,36
48,Texas,39,Ohio,137,Putnam County,0,11,-11
48,Texas,39,Ohio,139,Richland County,93,137,-44
48,Texas,39,Ohio,141,Ross County,38,0,38
48,Texas,39,Ohio,143,Sandusky County,86,13,73
48,Texas,39,Ohio,145,Scioto County,18,211,-193
48,Texas,39,Ohio,147,Seneca County,181,18,163
48,Texas,39,Ohio,149,Shelby County,161,2,159
48,Texas,39,Ohio,151,Stark County,324,310,14
48,Texas,39,Ohio,153,Summit County,1046,241,805
48,Texas,39,Ohio,155,Trumbull County,118,97,21
48,Texas,39,Ohio,157,Tuscarawas County,27,44,-17
48,Texas,39,Ohio,159,Union County,0,33,-33
48,Texas,39,Ohio,161,Van Wert County,0,20,-20
48,Texas,39,Ohio,165,Warren County,403,113,290
48,Texas,39,Ohio,167,Washington County,2,82,-80
48,Texas,39,Ohio,169,Wayne County,43,2,41
48,Texas,39,Ohio,171,Williams County,0,7,-7
48,Texas,39,Ohio,173,Wood County,252,69,183
48,Texas,39,Ohio,175,Wyandot County,0,16,-16
48,Texas,4,Arizona,1,Apache County,640,4,636
48,Texas,4,Arizona,3,Cochise County,1250,862,388
48,Texas,4,Arizona,5,Coconino County,507,149,358
48,Texas,4,Arizona,7,Gila County,72,120,-48
48,Texas,4,Arizona,9,Graham County,38,104,-66
48,Texas,4,Arizona,11,Greenlee County,11,61,-50
48,Texas,4,Arizona,12,La Paz County,3,7,-4
48,Texas,4,Arizona,13,Maricopa County,9820,8158,1662
48,Texas,4,Arizona,15,Mohave County,287,424,-137
48,Texas,4,Arizona,17,Navajo County,129,74,55
48,Texas,4,Arizona,19,Pima County,3696,2309,1387
48,Texas,4,Arizona,21,Pinal County,754,511,243
48,Texas,4,Arizona,23,Santa Cruz County,39,36,3
48,Texas,4,Arizona,25,Yavapai County,571,619,-48
48,Texas,4,Arizona,27,Yuma County,238,834,-596
48,Texas,40,Oklahoma,1,Adair County,55,19,36
48,Texas,40,Oklahoma,3,Alfalfa County,21,43,-22
48,Texas,40,Oklahoma,5,Atoka County,8,40,-32
48,Texas,40,Oklahoma,7,Beaver County,51,12,39
48,Texas,40,Oklahoma,9,Beckham County,381,172,209
48,Texas,40,Oklahoma,11,Blaine County,0,123,-123
48,Texas,40,Oklahoma,13,Bryan County,1363,1442,-79
48,Texas,40,Oklahoma,15,Caddo County,74,156,-82
48,Texas,40,Oklahoma,17,Canadian County,456,799,-343
48,Texas,40,Oklahoma,19,Carter County,412,474,-62
48,Texas,40,Oklahoma,21,Cherokee County,203,169,34
48,Texas,40,Oklahoma,23,Choctaw County,240,228,12
48,Texas,40,Oklahoma,25,Cimarron County,67,14,53
48,Texas,40,Oklahoma,27,Cleveland County,2281,3363,-1082
48,Texas,40,Oklahoma,29,Coal County,29,48,-19
48,Texas,40,Oklahoma,31,Comanche County,2148,2183,-35
48,Texas,40,Oklahoma,33,Cotton County,96,164,-68
48,Texas,40,Oklahoma,35,Craig County,24,2,22
48,Texas,40,Oklahoma,37,Creek County,99,77,22
48,Texas,40,Oklahoma,39,Custer County,344,114,230
48,Texas,40,Oklahoma,41,Delaware County,115,94,21
48,Texas,40,Oklahoma,43,Dewey County,3,4,-1
48,Texas,40,Oklahoma,45,Ellis County,9,49,-40
48,Texas,40,Oklahoma,47,Garfield County,520,555,-35
48,Texas,40,Oklahoma,49,Garvin County,148,88,60
48,Texas,40,Oklahoma,51,Grady County,23,217,-194
48,Texas,40,Oklahoma,55,Greer County,0,32,-32
48,Texas,40,Oklahoma,57,Harmon County,36,22,14
48,Texas,40,Oklahoma,59,Harper County,69,2,67
48,Texas,40,Oklahoma,61,Haskell County,127,15,112
48,Texas,40,Oklahoma,63,Hughes County,13,42,-29
48,Texas,40,Oklahoma,65,Jackson County,474,287,187
48,Texas,40,Oklahoma,67,Jefferson County,24,46,-22
48,Texas,40,Oklahoma,69,Johnston County,169,165,4
48,Texas,40,Oklahoma,71,Kay County,161,195,-34
48,Texas,40,Oklahoma,73,Kingfisher County,0,27,-27
48,Texas,40,Oklahoma,75,Kiowa County,13,63,-50
48,Texas,40,Oklahoma,77,Latimer County,8,39,-31
48,Texas,40,Oklahoma,79,Le Flore County,249,318,-69
48,Texas,40,Oklahoma,81,Lincoln County,7,94,-87
48,Texas,40,Oklahoma,83,Logan County,173,639,-466
48,Texas,40,Oklahoma,85,Love County,154,49,105
48,Texas,40,Oklahoma,87,McClain County,64,189,-125
48,Texas,40,Oklahoma,89,McCurtain County,194,86,108
48,Texas,40,Oklahoma,91,McIntosh County,75,58,17
48,Texas,40,Oklahoma,93,Major County,2,48,-46
48,Texas,40,Oklahoma,95,Marshall County,163,230,-67
48,Texas,40,Oklahoma,97,Mayes County,20,84,-64
48,Texas,40,Oklahoma,99,Murray County,152,63,89
48,Texas,40,Oklahoma,101,Muskogee County,71,445,-374
48,Texas,40,Oklahoma,103,Noble County,0,98,-98
48,Texas,40,Oklahoma,105,Nowata County,0,2,-2
48,Texas,40,Oklahoma,107,Okfuskee County,40,10,30
48,Texas,40,Oklahoma,109,Oklahoma County,5251,5966,-715
48,Texas,40,Oklahoma,111,Okmulgee County,51,179,-128
48,Texas,40,Oklahoma,113,Osage County,167,178,-11
48,Texas,40,Oklahoma,115,Ottawa County,25,131,-106
48,Texas,40,Oklahoma,117,Pawnee County,0,23,-23
48,Texas,40,Oklahoma,119,Payne County,794,1122,-328
48,Texas,40,Oklahoma,121,Pittsburg County,313,356,-43
48,Texas,40,Oklahoma,123,Pontotoc County,193,209,-16
48,Texas,40,Oklahoma,125,Pottawatomie County,274,568,-294
48,Texas,40,Oklahoma,127,Pushmataha County,186,122,64
48,Texas,40,Oklahoma,129,Roger Mills County,44,93,-49
48,Texas,40,Oklahoma,131,Rogers County,391,330,61
48,Texas,40,Oklahoma,133,Seminole County,26,64,-38
48,Texas,40,Oklahoma,135,Sequoyah County,107,158,-51
48,Texas,40,Oklahoma,137,Stephens County,384,260,124
48,Texas,40,Oklahoma,139,Texas County,542,131,411
48,Texas,40,Oklahoma,141,Tillman County,50,130,-80
48,Texas,40,Oklahoma,143,Tulsa County,4737,3737,1000
48,Texas,40,Oklahoma,145,Wagoner County,423,247,176
48,Texas,40,Oklahoma,147,Washington County,303,260,43
48,Texas,40,Oklahoma,149,Washita County,78,90,-12
48,Texas,40,Oklahoma,151,Woods County,89,186,-97
48,Texas,40,Oklahoma,153,Woodward County,71,149,-78
48,Texas,41,Oregon,1,Baker County,12,0,12
48,Texas,41,Oregon,3,Benton County,145,209,-64
48,Texas,41,Oregon,5,Clackamas County,160,672,-512
48,Texas,41,Oregon,7,Clatsop County,34,153,-119
48,Texas,41,Oregon,9,Columbia County,0,180,-180
48,Texas,41,Oregon,11,Coos County,15,131,-116
48,Texas,41,Oregon,15,Curry County,27,95,-68
48,Texas,41,Oregon,17,Deschutes County,245,97,148
48,Texas,41,Oregon,19,Douglas County,123,281,-158
48,Texas,41,Oregon,21,Gilliam County,53,5,48
48,Texas,41,Oregon,27,Hood River County,27,19,8
48,Texas,41,Oregon,29,Jackson County,176,234,-58
48,Texas,41,Oregon,31,Jefferson County,0,83,-83
48,Texas,41,Oregon,33,Josephine County,29,99,-70
48,Texas,41,Oregon,35,Klamath County,54,256,-202
48,Texas,41,Oregon,39,Lane County,184,520,-336
48,Texas,41,Oregon,41,Lincoln County,0,89,-89
48,Texas,41,Oregon,43,Linn County,61,113,-52
48,Texas,41,Oregon,45,Malheur County,169,52,117
48,Texas,41,Oregon,47,Marion County,296,253,43
48,Texas,41,Oregon,49,Morrow County,0,35,-35
48,Texas,41,Oregon,51,Multnomah County,1416,1265,151
48,Texas,41,Oregon,53,Polk County,0,213,-213
48,Texas,41,Oregon,57,Tillamook County,0,76,-76
48,Texas,41,Oregon,59,Umatilla County,14,28,-14
48,Texas,41,Oregon,61,Union County,99,0,99
48,Texas,41,Oregon,65,Wasco County,61,57,4
48,Texas,41,Oregon,67,Washington County,540,1221,-681
48,Texas,41,Oregon,71,Yamhill County,54,68,-14
48,Texas,42,Pennsylvania,1,Adams County,217,40,177
48,Texas,42,Pennsylvania,3,Allegheny County,1579,1258,321
48,Texas,42,Pennsylvania,5,Armstrong County,69,21,48
48,Texas,42,Pennsylvania,7,Beaver County,332,124,208
48,Texas,42,Pennsylvania,9,Bedford County,0,13,-13
48,Texas,42,Pennsylvania,11,Berks County,295,158,137
48,Texas,42,Pennsylvania,13,Blair County,36,3,33
48,Texas,42,Pennsylvania,15,Bradford County,80,11,69
48,Texas,42,Pennsylvania,17,Bucks County,407,270,137
48,Texas,42,Pennsylvania,19,Butler County,118,86,32
48,Texas,42,Pennsylvania,21,Cambria County,92,131,-39
48,Texas,42,Pennsylvania,23,Cameron County,0,16,-16
48,Texas,42,Pennsylvania,25,Carbon County,0,28,-28
48,Texas,42,Pennsylvania,27,Centre County,473,496,-23
48,Texas,42,Pennsylvania,29,Chester County,666,607,59
48,Texas,42,Pennsylvania,31,Clarion County,41,12,29
48,Texas,42,Pennsylvania,33,Clearfield County,36,74,-38
48,Texas,42,Pennsylvania,35,Clinton County,108,36,72
48,Texas,42,Pennsylvania,37,Columbia County,109,16,93
48,Texas,42,Pennsylvania,39,Crawford County,30,7,23
48,Texas,42,Pennsylvania,41,Cumberland County,197,436,-239
48,Texas,42,Pennsylvania,43,Dauphin County,448,198,250
48,Texas,42,Pennsylvania,45,Delaware County,153,246,-93
48,Texas,42,Pennsylvania,47,Elk County,0,13,-13
48,Texas,42,Pennsylvania,49,Erie County,713,222,491
48,Texas,42,Pennsylvania,51,Fayette County,294,26,268
48,Texas,42,Pennsylvania,55,Franklin County,19,256,-237
48,Texas,42,Pennsylvania,57,Fulton County,0,15,-15
48,Texas,42,Pennsylvania,59,Greene County,0,16,-16
48,Texas,42,Pennsylvania,61,Huntingdon County,34,4,30
48,Texas,42,Pennsylvania,63,Indiana County,78,38,40
48,Texas,42,Pennsylvania,65,Jefferson County,28,18,10
48,Texas,42,Pennsylvania,67,Juniata County,0,5,-5
48,Texas,42,Pennsylvania,69,Lackawanna County,145,127,18
48,Texas,42,Pennsylvania,71,Lancaster County,151,311,-160
48,Texas,42,Pennsylvania,73,Lawrence County,0,24,-24
48,Texas,42,Pennsylvania,75,Lebanon County,42,178,-136
48,Texas,42,Pennsylvania,77,Lehigh County,330,168,162
48,Texas,42,Pennsylvania,79,Luzerne County,415,186,229
48,Texas,42,Pennsylvania,81,Lycoming County,68,80,-12
48,Texas,42,Pennsylvania,83,McKean County,124,103,21
48,Texas,42,Pennsylvania,85,Mercer County,15,57,-42
48,Texas,42,Pennsylvania,87,Mifflin County,29,9,20
48,Texas,42,Pennsylvania,89,Monroe County,254,133,121
48,Texas,42,Pennsylvania,91,Montgomery County,704,954,-250
48,Texas,42,Pennsylvania,93,Montour County,9,3,6
48,Texas,42,Pennsylvania,95,Northampton County,339,38,301
48,Texas,42,Pennsylvania,97,Northumberland County,54,0,54
48,Texas,42,Pennsylvania,99,Perry County,0,14,-14
48,Texas,42,Pennsylvania,101,Philadelphia County,1372,953,419
48,Texas,42,Pennsylvania,103,Pike County,15,0,15
48,Texas,42,Pennsylvania,105,Potter County,27,8,19
48,Texas,42,Pennsylvania,107,Schuylkill County,19,11,8
48,Texas,42,Pennsylvania,109,Snyder County,0,25,-25
48,Texas,42,Pennsylvania,111,Somerset County,37,3,34
48,Texas,42,Pennsylvania,113,Sullivan County,15,0,15
48,Texas,42,Pennsylvania,115,Susquehanna County,0,13,-13
48,Texas,42,Pennsylvania,117,Tioga County,35,1,34
48,Texas,42,Pennsylvania,119,Union County,9,55,-46
48,Texas,42,Pennsylvania,121,Venango County,0,9,-9
48,Texas,42,Pennsylvania,123,Warren County,81,15,66
48,Texas,42,Pennsylvania,125,Washington County,160,105,55
48,Texas,42,Pennsylvania,127,Wayne County,91,41,50
48,Texas,42,Pennsylvania,129,Westmoreland County,419,268,151
48,Texas,42,Pennsylvania,133,York County,281,76,205
48,Texas,44,Rhode Island,1,Bristol County,0,101,-101
48,Texas,44,Rhode Island,3,Kent County,92,19,73
48,Texas,44,Rhode Island,5,Newport County,115,276,-161
48,Texas,44,Rhode Island,7,Providence County,912,459,453
48,Texas,44,Rhode Island,9,Washington County,19,39,-20
48,Texas,45,South Carolina,1,Abbeville County,2,1,1
48,Texas,45,South Carolina,3,Aiken County,213,159,54
48,Texas,45,South Carolina,7,Anderson County,333,363,-30
48,Texas,45,South Carolina,9,Bamberg County,14,21,-7
48,Texas,45,South Carolina,11,Barnwell County,0,34,-34
48,Texas,45,South Carolina,13,Beaufort County,249,215,34
48,Texas,45,South Carolina,15,Berkeley County,408,1449,-1041
48,Texas,45,South Carolina,19,Charleston County,539,302,237
48,Texas,45,South Carolina,21,Cherokee County,6,1,5
48,Texas,45,South Carolina,25,Chesterfield County,34,14,20
48,Texas,45,South Carolina,27,Clarendon County,74,20,54
48,Texas,45,South Carolina,29,Colleton County,26,9,17
48,Texas,45,South Carolina,31,Darlington County,38,59,-21
48,Texas,45,South Carolina,33,Dillon County,0,35,-35
48,Texas,45,South Carolina,35,Dorchester County,463,158,305
48,Texas,45,South Carolina,39,Fairfield County,0,24,-24
48,Texas,45,South Carolina,41,Florence County,654,48,606
48,Texas,45,South Carolina,43,Georgetown County,43,7,36
48,Texas,45,South Carolina,45,Greenville County,457,438,19
48,Texas,45,South Carolina,47,Greenwood County,61,26,35
48,Texas,45,South Carolina,49,Hampton County,17,31,-14
48,Texas,45,South Carolina,51,Horry County,199,142,57
48,Texas,45,South Carolina,53,Jasper County,0,84,-84
48,Texas,45,South Carolina,55,Kershaw County,115,63,52
48,Texas,45,South Carolina,57,Lancaster County,20,7,13
48,Texas,45,South Carolina,59,Laurens County,0,5,-5
48,Texas,45,South Carolina,63,Lexington County,390,184,206
48,Texas,45,South Carolina,67,Marion County,23,0,23
48,Texas,45,South Carolina,69,Marlboro County,43,136,-93
48,Texas,45,South Carolina,71,Newberry County,0,3,-3
48,Texas,45,South Carolina,73,Oconee County,133,40,93
48,Texas,45,South Carolina,75,Orangeburg County,68,21,47
48,Texas,45,South Carolina,77,Pickens County,225,32,193
48,Texas,45,South Carolina,79,Richland County,1229,1591,-362
48,Texas,45,South Carolina,83,Spartanburg County,102,572,-470
48,Texas,45,South Carolina,85,Sumter County,442,505,-63
48,Texas,45,South Carolina,87,Union County,5,0,5
48,Texas,45,South Carolina,89,Williamsburg County,0,57,-57
48,Texas,45,South Carolina,91,York County,303,202,101
48,Texas,46,South Dakota,3,Aurora County,0,3,-3
48,Texas,46,South Dakota,5,Beadle County,0,187,-187
48,Texas,46,South Dakota,7,Bennett County,0,7,-7
48,Texas,46,South Dakota,9,Bon Homme County,11,7,4
48,Texas,46,South Dakota,11,Brookings County,37,0,37
48,Texas,46,South Dakota,13,Brown County,50,15,35
48,Texas,46,South Dakota,23,Charles Mix County,0,2,-2
48,Texas,46,South Dakota,27,Clay County,33,1,32
48,Texas,46,South Dakota,29,Codington County,0,39,-39
48,Texas,46,South Dakota,33,Custer County,0,43,-43
48,Texas,46,South Dakota,35,Davison County,37,4,33
48,Texas,46,South Dakota,41,Dewey County,0,2,-2
48,Texas,46,South Dakota,47,Fall River County,0,14,-14
48,Texas,46,South Dakota,51,Grant County,78,0,78
48,Texas,46,South Dakota,53,Gregory County,0,2,-2
48,Texas,46,South Dakota,57,Hamlin County,12,12,0
48,Texas,46,South Dakota,61,Hanson County,24,0,24
48,Texas,46,South Dakota,67,Hutchinson County,0,4,-4
48,Texas,46,South Dakota,75,Jones County,0,6,-6
48,Texas,46,South Dakota,79,Lake County,92,5,87
48,Texas,46,South Dakota,81,Lawrence County,0,39,-39
48,Texas,46,South Dakota,83,Lincoln County,56,63,-7
48,Texas,46,South Dakota,87,McCook County,0,7,-7
48,Texas,46,South Dakota,89,McPherson County,0,49,-49
48,Texas,46,South Dakota,93,Meade County,111,133,-22
48,Texas,46,South Dakota,99,Minnehaha County,586,256,330
48,Texas,46,South Dakota,101,Moody County,0,1,-1
48,Texas,46,South Dakota,103,Pennington County,269,433,-164
48,Texas,46,South Dakota,109,Roberts County,0,32,-32
48,Texas,46,South Dakota,115,Spink County,0,1,-1
48,Texas,46,South Dakota,125,Turner County,22,0,22
48,Texas,46,South Dakota,127,Union County,0,11,-11
48,Texas,46,South Dakota,129,Walworth County,0,10,-10
48,Texas,46,South Dakota,135,Yankton County,0,11,-11
48,Texas,46,South Dakota,137,Ziebach County,15,0,15
48,Texas,47,Tennessee,1,Anderson County,202,38,164
48,Texas,47,Tennessee,3,Bedford County,0,61,-61
48,Texas,47,Tennessee,5,Benton County,84,21,63
48,Texas,47,Tennessee,9,Blount County,141,158,-17
48,Texas,47,Tennessee,11,Bradley County,169,164,5
48,Texas,47,Tennessee,13,Campbell County,0,141,-141
48,Texas,47,Tennessee,15,Cannon County,0,40,-40
48,Texas,47,Tennessee,17,Carroll County,21,18,3
48,Texas,47,Tennessee,19,Carter County,103,5,98
48,Texas,47,Tennessee,21,Cheatham County,32,27,5
48,Texas,47,Tennessee,23,Chester County,0,22,-22
48,Texas,47,Tennessee,25,Claiborne County,32,69,-37
48,Texas,47,Tennessee,31,Coffee County,0,24,-24
48,Texas,47,Tennessee,33,Crockett County,0,10,-10
48,Texas,47,Tennessee,35,Cumberland County,113,32,81
48,Texas,47,Tennessee,37,Davidson County,1931,1639,292
48,Texas,47,Tennessee,39,Decatur County,0,46,-46
48,Texas,47,Tennessee,41,DeKalb County,0,6,-6
48,Texas,47,Tennessee,43,Dickson County,29,178,-149
48,Texas,47,Tennessee,45,Dyer County,0,19,-19
48,Texas,47,Tennessee,47,Fayette County,0,22,-22
48,Texas,47,Tennessee,49,Fentress County,12,25,-13
48,Texas,47,Tennessee,51,Franklin County,62,29,33
48,Texas,47,Tennessee,53,Gibson County,34,66,-32
48,Texas,47,Tennessee,55,Giles County,17,29,-12
48,Texas,47,Tennessee,57,Grainger County,78,0,78
48,Texas,47,Tennessee,59,Greene County,23,23,0
48,Texas,47,Tennessee,61,Grundy County,10,0,10
48,Texas,47,Tennessee,63,Hamblen County,808,0,808
48,Texas,47,Tennessee,65,Hamilton County,399,525,-126
48,Texas,47,Tennessee,69,Hardeman County,0,18,-18
48,Texas,47,Tennessee,71,Hardin County,0,9,-9
48,Texas,47,Tennessee,73,Hawkins County,103,15,88
48,Texas,47,Tennessee,75,Haywood County,4,7,-3
48,Texas,47,Tennessee,77,Henderson County,66,21,45
48,Texas,47,Tennessee,79,Henry County,0,49,-49
48,Texas,47,Tennessee,81,Hickman County,7,0,7
48,Texas,47,Tennessee,83,Houston County,0,56,-56
48,Texas,47,Tennessee,85,Humphreys County,23,90,-67
48,Texas,47,Tennessee,87,Jackson County,0,3,-3
48,Texas,47,Tennessee,89,Jefferson County,97,36,61
48,Texas,47,Tennessee,91,Johnson County,1,0,1
48,Texas,47,Tennessee,93,Knox County,1036,1063,-27
48,Texas,47,Tennessee,97,Lauderdale County,5,23,-18
48,Texas,47,Tennessee,101,Lewis County,24,37,-13
48,Texas,47,Tennessee,105,Loudon County,45,100,-55
48,Texas,47,Tennessee,107,McMinn County,20,4,16
48,Texas,47,Tennessee,109,McNairy County,0,43,-43
48,Texas,47,Tennessee,111,Macon County,0,7,-7
48,Texas,47,Tennessee,113,Madison County,258,269,-11
48,Texas,47,Tennessee,115,Marion County,10,6,4
48,Texas,47,Tennessee,117,Marshall County,23,29,-6
48,Texas,47,Tennessee,119,Maury County,81,275,-194
48,Texas,47,Tennessee,123,Monroe County,39,19,20
48,Texas,47,Tennessee,125,Montgomery County,1497,1292,205
48,Texas,47,Tennessee,129,Morgan County,0,20,-20
48,Texas,47,Tennessee,131,Obion County,0,74,-74
48,Texas,47,Tennessee,133,Overton County,0,34,-34
48,Texas,47,Tennessee,137,Pickett County,80,0,80
48,Texas,47,Tennessee,139,Polk County,17,0,17
48,Texas,47,Tennessee,141,Putnam County,93,88,5
48,Texas,47,Tennessee,143,Rhea County,80,34,46
48,Texas,47,Tennessee,145,Roane County,142,82,60
48,Texas,47,Tennessee,147,Robertson County,0,49,-49
48,Texas,47,Tennessee,149,Rutherford County,656,562,94
48,Texas,47,Tennessee,155,Sevier County,244,121,123
48,Texas,47,Tennessee,157,Shelby County,3464,1219,2245
48,Texas,47,Tennessee,159,Smith County,0,2,-2
48,Texas,47,Tennessee,163,Sullivan County,112,106,6
48,Texas,47,Tennessee,165,Sumner County,202,563,-361
48,Texas,47,Tennessee,167,Tipton County,112,29,83
48,Texas,47,Tennessee,171,Unicoi County,14,0,14
48,Texas,47,Tennessee,173,Union County,0,25,-25
48,Texas,47,Tennessee,175,Van Buren County,0,19,-19
48,Texas,47,Tennessee,177,Warren County,9,0,9
48,Texas,47,Tennessee,179,Washington County,368,127,241
48,Texas,47,Tennessee,181,Wayne County,14,0,14
48,Texas,47,Tennessee,183,Weakley County,33,2,31
48,Texas,47,Tennessee,187,Williamson County,861,656,205
48,Texas,47,Tennessee,189,Wilson County,202,719,-517
48,Texas,48,Texas,1,Anderson County,4685,5019,-334
48,Texas,48,Texas,3,Andrews County,670,1068,-398
48,Texas,48,Texas,5,Angelina County,4043,4383,-340
48,Texas,48,Texas,7,Aransas County,2087,1967,120
48,Texas,48,Texas,9,Archer County,536,382,154
48,Texas,48,Texas,11,Armstrong County,180,97,83
48,Texas,48,Texas,13,Atascosa County,2486,2538,-52
48,Texas,48,Texas,15,Austin County,1083,1555,-472
48,Texas,48,Texas,17,Bailey County,361,145,216
48,Texas,48,Texas,19,Bandera County,957,2081,-1124
48,Texas,48,Texas,21,Bastrop County,3971,6000,-2029
48,Texas,48,Texas,23,Baylor County,129,141,-12
48,Texas,48,Texas,25,Bee County,3086,3723,-637
48,Texas,48,Texas,27,Bell County,13454,13877,-423
48,Texas,48,Texas,29,Bexar County,48620,48162,458
48,Texas,48,Texas,31,Blanco County,261,461,-200
48,Texas,48,Texas,33,Borden County,122,41,81
48,Texas,48,Texas,35,Bosque County,1257,1236,21
48,Texas,48,Texas,37,Bowie County,2911,1903,1008
48,Texas,48,Texas,39,Brazoria County,15940,14322,1618
48,Texas,48,Texas,41,Brazos County,14478,23467,-8989
48,Texas,48,Texas,43,Brewster County,983,951,32
48,Texas,48,Texas,45,Briscoe County,119,21,98
48,Texas,48,Texas,47,Brooks County,152,693,-541
48,Texas,48,Texas,49,Brown County,1692,1758,-66
48,Texas,48,Texas,51,Burleson County,1032,1306,-274
48,Texas,48,Texas,53,Burnet County,2079,3381,-1302
48,Texas,48,Texas,55,Caldwell County,2598,4160,-1562
48,Texas,48,Texas,57,Calhoun County,851,646,205
48,Texas,48,Texas,59,Callahan County,628,733,-105
48,Texas,48,Texas,61,Cameron County,9975,5523,4452
48,Texas,48,Texas,63,Camp County,376,458,-82
48,Texas,48,Texas,65,Carson County,315,400,-85
48,Texas,48,Texas,67,Cass County,906,755,151
48,Texas,48,Texas,69,Castro County,337,396,-59
48,Texas,48,Texas,71,Chambers County,1884,1638,246
48,Texas,48,Texas,73,Cherokee County,2108,2499,-391
48,Texas,48,Texas,75,Childress County,497,620,-123
48,Texas,48,Texas,77,Clay County,547,800,-253
48,Texas,48,Texas,79,Cochran County,193,63,130
48,Texas,48,Texas,81,Coke County,247,176,71
48,Texas,48,Texas,83,Coleman County,702,248,454
48,Texas,48,Texas,85,Collin County,41097,39778,1319
48,Texas,48,Texas,87,Collingsworth County,121,103,18
48,Texas,48,Texas,89,Colorado County,782,503,279
48,Texas,48,Texas,91,Comal County,7801,9649,-1848
48,Texas,48,Texas,93,Comanche County,563,478,85
48,Texas,48,Texas,95,Concho County,103,258,-155
48,Texas,48,Texas,97,Cooke County,2502,2335,167
48,Texas,48,Texas,99,Coryell County,6987,6161,826
48,Texas,48,Texas,101,Cottle County,85,79,6
48,Texas,48,Texas,103,Crane County,148,219,-71
48,Texas,48,Texas,105,Crockett County,94,172,-78
48,Texas,48,Texas,107,Crosby County,438,460,-22
48,Texas,48,Texas,109,Culberson County,85,108,-23
48,Texas,48,Texas,111,Dallam County,776,336,440
48,Texas,48,Texas,113,Dallas County,101371,71851,29520
48,Texas,48,Texas,115,Dawson County,1204,1085,119
48,Texas,48,Texas,117,Deaf Smith County,1047,578,469
48,Texas,48,Texas,119,Delta County,314,412,-98
48,Texas,48,Texas,121,Denton County,36805,52496,-15691
48,Texas,48,Texas,123,DeWitt County,1527,1410,117
48,Texas,48,Texas,125,Dickens County,189,139,50
48,Texas,48,Texas,127,Dimmit County,394,445,-51
48,Texas,48,Texas,129,Donley County,182,239,-57
48,Texas,48,Texas,131,Duval County,379,783,-404
48,Texas,48,Texas,133,Eastland County,1326,1217,109
48,Texas,48,Texas,135,Ector County,8666,7174,1492
48,Texas,48,Texas,137,Edwards County,59,53,6
48,Texas,48,Texas,139,Ellis County,7708,6851,857
48,Texas,48,Texas,141,El Paso County,14728,7959,6769
48,Texas,48,Texas,143,Erath County,2849,3446,-597
48,Texas,48,Texas,145,Falls County,1634,1486,148
48,Texas,48,Texas,147,Fannin County,2438,3701,-1263
48,Texas,48,Texas,149,Fayette County,1027,641,386
48,Texas,48,Texas,151,Fisher County,292,159,133
48,Texas,48,Texas,153,Floyd County,351,332,19
48,Texas,48,Texas,155,Foard County,50,70,-20
48,Texas,48,Texas,157,Fort Bend County,27927,30650,-2723
48,Texas,48,Texas,159,Franklin County,629,603,26
48,Texas,48,Texas,161,Freestone County,949,1709,-760
48,Texas,48,Texas,163,Frio County,1158,1083,75
48,Texas,48,Texas,165,Gaines County,970,740,230
48,Texas,48,Texas,167,Galveston County,14329,17460,-3131
48,Texas,48,Texas,169,Garza County,434,993,-559
48,Texas,48,Texas,171,Gillespie County,1180,1116,64
48,Texas,48,Texas,173,Glasscock County,39,88,-49
48,Texas,48,Texas,175,Goliad County,610,321,289
48,Texas,48,Texas,177,Gonzales County,1150,1006,144
48,Texas,48,Texas,179,Gray County,1587,1961,-374
48,Texas,48,Texas,181,Grayson County,4793,6154,-1361
48,Texas,48,Texas,183,Gregg County,6154,6997,-843
48,Texas,48,Texas,185,Grimes County,2422,2002,420
48,Texas,48,Texas,187,Guadalupe County,8804,8816,-12
48,Texas,48,Texas,189,Hale County,2303,3083,-780
48,Texas,48,Texas,191,Hall County,210,127,83
48,Texas,48,Texas,193,Hamilton County,389,289,100
48,Texas,48,Texas,195,Hansford County,139,174,-35
48,Texas,48,Texas,197,Hardeman County,302,197,105
48,Texas,48,Texas,199,Hardin County,2778,2812,-34
48,Texas,48,Texas,201,Harris County,112598,90464,22134
48,Texas,48,Texas,203,Harrison County,3198,2069,1129
48,Texas,48,Texas,205,Hartley County,431,577,-146
48,Texas,48,Texas,207,Haskell County,450,923,-473
48,Texas,48,Texas,209,Hays County,11971,20255,-8284
48,Texas,48,Texas,211,Hemphill County,236,169,67
48,Texas,48,Texas,213,Henderson County,3470,3522,-52
48,Texas,48,Texas,215,Hidalgo County,16088,10899,5189
48,Texas,48,Texas,217,Hill County,1846,2046,-200
48,Texas,48,Texas,219,Hockley County,1054,1810,-756
48,Texas,48,Texas,221,Hood County,2718,2806,-88
48,Texas,48,Texas,223,Hopkins County,1433,1723,-290
48,Texas,48,Texas,225,Houston County,1138,1067,71
48,Texas,48,Texas,227,Howard County,1542,1947,-405
48,Texas,48,Texas,229,Hudspeth County,114,179,-65
48,Texas,48,Texas,231,Hunt County,3956,5913,-1957
48,Texas,48,Texas,233,Hutchinson County,1614,866,748
48,Texas,48,Texas,235,Irion County,52,195,-143
48,Texas,48,Texas,237,Jack County,766,1058,-292
48,Texas,48,Texas,239,Jackson County,918,734,184
48,Texas,48,Texas,241,Jasper County,1345,1861,-516
48,Texas,48,Texas,243,Jeff Davis County,145,80,65
48,Texas,48,Texas,245,Jefferson County,11152,11239,-87
48,Texas,48,Texas,247,Jim Hogg County,117,235,-118
48,Texas,48,Texas,249,Jim Wells County,2336,1259,1077
48,Texas,48,Texas,251,Johnson County,7985,7124,861
48,Texas,48,Texas,253,Jones County,1230,4013,-2783
48,Texas,48,Texas,255,Karnes County,976,1078,-102
48,Texas,48,Texas,257,Kaufman County,6739,8549,-1810
48,Texas,48,Texas,259,Kendall County,2087,3575,-1488
48,Texas,48,Texas,261,Kenedy County,16,6,10
48,Texas,48,Texas,263,Kent County,41,51,-10
48,Texas,48,Texas,265,Kerr County,1827,2658,-831
48,Texas,48,Texas,267,Kimble County,168,293,-125
48,Texas,48,Texas,269,King County,43,5,38
48,Texas,48,Texas,271,Kinney County,358,232,126
48,Texas,48,Texas,273,Kleberg County,1879,2065,-186
48,Texas,48,Texas,275,Knox County,316,411,-95
48,Texas,48,Texas,277,Lamar County,2135,1606,529
48,Texas,48,Texas,279,Lamb County,805,611,194
48,Texas,48,Texas,281,Lampasas County,1930,775,1155
48,Texas,48,Texas,283,La Salle County,740,471,269
48,Texas,48,Texas,285,Lavaca County,709,1389,-680
48,Texas,48,Texas,287,Lee County,1059,1393,-334
48,Texas,48,Texas,289,Leon County,1339,970,369
48,Texas,48,Texas,291,Liberty County,5575,8517,-2942
48,Texas,48,Texas,293,Limestone County,1227,1231,-4
48,Texas,48,Texas,295,Lipscomb County,147,131,16
48,Texas,48,Texas,297,Live Oak County,449,733,-284
48,Texas,48,Texas,299,Llano County,1156,1676,-520
48,Texas,48,Texas,303,Lubbock County,13065,20171,-7106
48,Texas,48,Texas,305,Lynn County,339,399,-60
48,Texas,48,Texas,307,McCulloch County,418,403,15
48,Texas,48,Texas,309,McLennan County,11171,11292,-121
48,Texas,48,Texas,311,McMullen County,97,28,69
48,Texas,48,Texas,313,Madison County,1150,1691,-541
48,Texas,48,Texas,315,Marion County,265,346,-81
48,Texas,48,Texas,317,Martin County,367,230,137
48,Texas,48,Texas,319,Mason County,112,194,-82
48,Texas,48,Texas,321,Matagorda County,1059,920,139
48,Texas,48,Texas,323,Maverick County,1404,1446,-42
48,Texas,48,Texas,325,Medina County,2789,3251,-462
48,Texas,48,Texas,327,Menard County,46,108,-62
48,Texas,48,Texas,329,Midland County,10097,8000,2097
48,Texas,48,Texas,331,Milam County,1719,1608,111
48,Texas,48,Texas,333,Mills County,152,213,-61
48,Texas,48,Texas,335,Mitchell County,946,1326,-380
48,Texas,48,Texas,337,Montague County,1394,1343,51
48,Texas,48,Texas,339,Montgomery County,21586,25388,-3802
48,Texas,48,Texas,341,Moore County,1586,653,933
48,Texas,48,Texas,343,Morris County,557,631,-74
48,Texas,48,Texas,345,Motley County,45,133,-88
48,Texas,48,Texas,347,Nacogdoches County,3865,5408,-1543
48,Texas,48,Texas,349,Navarro County,2067,2073,-6
48,Texas,48,Texas,351,Newton County,919,379,540
48,Texas,48,Texas,353,Nolan County,839,1118,-279
48,Texas,48,Texas,355,Nueces County,13119,15569,-2450
48,Texas,48,Texas,357,Ochiltree County,245,130,115
48,Texas,48,Texas,359,Oldham County,199,186,13
48,Texas,48,Texas,361,Orange County,3150,3384,-234
48,Texas,48,Texas,363,Palo Pinto County,1722,1958,-236
48,Texas,48,Texas,365,Panola County,1149,1251,-102
48,Texas,48,Texas,367,Parker County,7163,7597,-434
48,Texas,48,Texas,369,Parmer County,198,472,-274
48,Texas,48,Texas,371,Pecos County,1662,1498,164
48,Texas,48,Texas,373,Polk County,3344,3229,115
48,Texas,48,Texas,375,Potter County,9889,6940,2949
48,Texas,48,Texas,377,Presidio County,827,209,618
48,Texas,48,Texas,379,Rains County,815,621,194
48,Texas,48,Texas,381,Randall County,8440,8838,-398
48,Texas,48,Texas,383,Reagan County,240,85,155
48,Texas,48,Texas,385,Real County,147,306,-159
48,Texas,48,Texas,387,Red River County,1000,457,543
48,Texas,48,Texas,389,Reeves County,459,1046,-587
48,Texas,48,Texas,391,Refugio County,496,541,-45
48,Texas,48,Texas,393,Roberts County,71,116,-45
48,Texas,48,Texas,395,Robertson County,707,1010,-303
48,Texas,48,Texas,397,Rockwall County,6105,5799,306
48,Texas,48,Texas,399,Runnels County,771,220,551
48,Texas,48,Texas,401,Rusk County,3839,6959,-3120
48,Texas,48,Texas,403,Sabine County,411,287,124
48,Texas,48,Texas,405,San Augustine County,373,368,5
48,Texas,48,Texas,407,San Jacinto County,1089,1894,-805
48,Texas,48,Texas,409,San Patricio County,2976,4151,-1175
48,Texas,48,Texas,411,San Saba County,346,594,-248
48,Texas,48,Texas,413,Schleicher County,345,66,279
48,Texas,48,Texas,415,Scurry County,1109,1292,-183
48,Texas,48,Texas,417,Shackelford County,160,175,-15
48,Texas,48,Texas,419,Shelby County,931,1016,-85
48,Texas,48,Texas,421,Sherman County,124,58,66
48,Texas,48,Texas,423,Smith County,9504,9535,-31
48,Texas,48,Texas,425,Somervell County,417,450,-33
48,Texas,48,Texas,427,Starr County,1697,832,865
48,Texas,48,Texas,429,Stephens County,522,823,-301
48,Texas,48,Texas,431,Sterling County,3,51,-48
48,Texas,48,Texas,433,Stonewall County,75,46,29
48,Texas,48,Texas,435,Sutton County,116,312,-196
48,Texas,48,Texas,437,Swisher County,365,690,-325
48,Texas,48,Texas,439,Tarrant County,63500,64025,-525
48,Texas,48,Texas,441,Taylor County,7616,7364,252
48,Texas,48,Texas,443,Terrell County,37,12,25
48,Texas,48,Texas,445,Terry County,759,1142,-383
48,Texas,48,Texas,447,Throckmorton County,44,57,-13
48,Texas,48,Texas,449,Titus County,1676,945,731
48,Texas,48,Texas,451,Tom Green County,5420,5144,276
48,Texas,48,Texas,453,Travis County,57594,48411,9183
48,Texas,48,Texas,455,Trinity County,993,898,95
48,Texas,48,Texas,457,Tyler County,1571,1509,62
48,Texas,48,Texas,459,Upshur County,1932,2304,-372
48,Texas,48,Texas,461,Upton County,201,108,93
48,Texas,48,Texas,463,Uvalde County,1511,765,746
48,Texas,48,Texas,465,Val Verde County,1811,1052,759
48,Texas,48,Texas,467,Van Zandt County,2814,2907,-93
48,Texas,48,Texas,469,Victoria County,4141,3389,752
48,Texas,48,Texas,471,Walker County,7445,7813,-368
48,Texas,48,Texas,473,Waller County,2474,4005,-1531
48,Texas,48,Texas,475,Ward County,375,547,-172
48,Texas,48,Texas,477,Washington County,1778,2108,-330
48,Texas,48,Texas,479,Webb County,6580,2355,4225
48,Texas,48,Texas,481,Wharton County,1262,1058,204
48,Texas,48,Texas,483,Wheeler County,487,230,257
48,Texas,48,Texas,485,Wichita County,5160,5636,-476
48,Texas,48,Texas,487,Wilbarger County,986,705,281
48,Texas,48,Texas,489,Willacy County,841,1077,-236
48,Texas,48,Texas,491,Williamson County,23850,32796,-8946
48,Texas,48,Texas,493,Wilson County,1843,1836,7
48,Texas,48,Texas,495,Winkler County,207,248,-41
48,Texas,48,Texas,497,Wise County,3228,3941,-713
48,Texas,48,Texas,499,Wood County,1858,2881,-1023
48,Texas,48,Texas,501,Yoakum County,452,189,263
48,Texas,48,Texas,503,Young County,843,661,182
48,Texas,48,Texas,505,Zapata County,445,196,249
48,Texas,48,Texas,507,Zavala County,516,238,278
48,Texas,49,Utah,3,Box Elder County,15,44,-29
48,Texas,49,Utah,5,Cache County,444,216,228
48,Texas,49,Utah,7,Carbon County,18,25,-7
48,Texas,49,Utah,11,Davis County,633,855,-222
48,Texas,49,Utah,13,Duchesne County,41,1,40
48,Texas,49,Utah,15,Emery County,19,11,8
48,Texas,49,Utah,17,Garfield County,0,1,-1
48,Texas,49,Utah,19,Grand County,30,0,30
48,Texas,49,Utah,21,Iron County,79,103,-24
48,Texas,49,Utah,23,Juab County,0,19,-19
48,Texas,49,Utah,27,Millard County,0,18,-18
48,Texas,49,Utah,29,Morgan County,93,0,93
48,Texas,49,Utah,35,Salt Lake County,3203,1971,1232
48,Texas,49,Utah,39,Sanpete County,0,16,-16
48,Texas,49,Utah,41,Sevier County,0,214,-214
48,Texas,49,Utah,43,Summit County,46,68,-22
48,Texas,49,Utah,45,Tooele County,140,59,81
48,Texas,49,Utah,47,Uintah County,409,172,237
48,Texas,49,Utah,49,Utah County,1210,1846,-636
48,Texas,49,Utah,51,Wasatch County,25,63,-38
48,Texas,49,Utah,53,Washington County,274,234,40
48,Texas,49,Utah,55,Wayne County,0,2,-2
48,Texas,49,Utah,57,Weber County,189,397,-208
48,Texas,5,Arkansas,1,Arkansas County,35,22,13
48,Texas,5,Arkansas,3,Ashley County,13,43,-30
48,Texas,5,Arkansas,5,Baxter County,0,147,-147
48,Texas,5,Arkansas,7,Benton County,1458,1200,258
48,Texas,5,Arkansas,9,Boone County,12,107,-95
48,Texas,5,Arkansas,11,Bradley County,44,25,19
48,Texas,5,Arkansas,13,Calhoun County,0,19,-19
48,Texas,5,Arkansas,15,Carroll County,23,426,-403
48,Texas,5,Arkansas,17,Chicot County,61,12,49
48,Texas,5,Arkansas,19,Clark County,194,323,-129
48,Texas,5,Arkansas,21,Clay County,0,18,-18
48,Texas,5,Arkansas,23,Cleburne County,247,68,179
48,Texas,5,Arkansas,25,Cleveland County,17,4,13
48,Texas,5,Arkansas,27,Columbia County,160,199,-39
48,Texas,5,Arkansas,29,Conway County,52,7,45
48,Texas,5,Arkansas,31,Craighead County,154,331,-177
48,Texas,5,Arkansas,33,Crawford County,2,81,-79
48,Texas,5,Arkansas,35,Crittenden County,80,174,-94
48,Texas,5,Arkansas,37,Cross County,35,8,27
48,Texas,5,Arkansas,39,Dallas County,6,37,-31
48,Texas,5,Arkansas,41,Desha County,37,29,8
48,Texas,5,Arkansas,43,Drew County,73,14,59
48,Texas,5,Arkansas,45,Faulkner County,586,495,91
48,Texas,5,Arkansas,47,Franklin County,0,40,-40
48,Texas,5,Arkansas,49,Fulton County,0,1,-1
48,Texas,5,Arkansas,51,Garland County,389,637,-248
48,Texas,5,Arkansas,53,Grant County,146,18,128
48,Texas,5,Arkansas,55,Greene County,66,162,-96
48,Texas,5,Arkansas,57,Hempstead County,145,143,2
48,Texas,5,Arkansas,59,Hot Spring County,193,94,99
48,Texas,5,Arkansas,61,Howard County,15,47,-32
48,Texas,5,Arkansas,63,Independence County,65,61,4
48,Texas,5,Arkansas,65,Izard County,0,72,-72
48,Texas,5,Arkansas,67,Jackson County,83,41,42
48,Texas,5,Arkansas,69,Jefferson County,258,237,21
48,Texas,5,Arkansas,71,Johnson County,73,161,-88
48,Texas,5,Arkansas,73,Lafayette County,65,2,63
48,Texas,5,Arkansas,75,Lawrence County,0,19,-19
48,Texas,5,Arkansas,77,Lee County,53,0,53
48,Texas,5,Arkansas,79,Lincoln County,34,76,-42
48,Texas,5,Arkansas,81,Little River County,334,130,204
48,Texas,5,Arkansas,83,Logan County,57,148,-91
48,Texas,5,Arkansas,85,Lonoke County,249,215,34
48,Texas,5,Arkansas,87,Madison County,0,9,-9
48,Texas,5,Arkansas,89,Marion County,11,24,-13
48,Texas,5,Arkansas,91,Miller County,1599,2277,-678
48,Texas,5,Arkansas,93,Mississippi County,232,241,-9
48,Texas,5,Arkansas,95,Monroe County,0,46,-46
48,Texas,5,Arkansas,97,Montgomery County,0,65,-65
48,Texas,5,Arkansas,99,Nevada County,103,37,66
48,Texas,5,Arkansas,101,Newton County,0,12,-12
48,Texas,5,Arkansas,103,Ouachita County,29,38,-9
48,Texas,5,Arkansas,105,Perry County,17,4,13
48,Texas,5,Arkansas,107,Phillips County,0,75,-75
48,Texas,5,Arkansas,109,Pike County,57,77,-20
48,Texas,5,Arkansas,111,Poinsett County,58,38,20
48,Texas,5,Arkansas,113,Polk County,106,181,-75
48,Texas,5,Arkansas,115,Pope County,285,149,136
48,Texas,5,Arkansas,117,Prairie County,0,67,-67
48,Texas,5,Arkansas,119,Pulaski County,2839,1102,1737
48,Texas,5,Arkansas,121,Randolph County,16,172,-156
48,Texas,5,Arkansas,123,St. Francis County,151,103,48
48,Texas,5,Arkansas,125,Saline County,156,639,-483
48,Texas,5,Arkansas,127,Scott County,44,33,11
48,Texas,5,Arkansas,129,Searcy County,0,58,-58
48,Texas,5,Arkansas,131,Sebastian County,469,548,-79
48,Texas,5,Arkansas,133,Sevier County,167,46,121
48,Texas,5,Arkansas,135,Sharp County,0,19,-19
48,Texas,5,Arkansas,137,Stone County,0,127,-127
48,Texas,5,Arkansas,139,Union County,105,67,38
48,Texas,5,Arkansas,141,Van Buren County,18,4,14
48,Texas,5,Arkansas,143,Washington County,1123,2309,-1186
48,Texas,5,Arkansas,145,White County,480,382,98
48,Texas,5,Arkansas,147,Woodruff County,11,0,11
48,Texas,5,Arkansas,149,Yell County,10,0,10
48,Texas,50,Vermont,1,Addison County,18,38,-20
48,Texas,50,Vermont,3,Bennington County,80,33,47
48,Texas,50,Vermont,5,Caledonia County,11,24,-13
48,Texas,50,Vermont,7,Chittenden County,0,56,-56
48,Texas,50,Vermont,9,Essex County,0,18,-18
48,Texas,50,Vermont,11,Franklin County,4,80,-76
48,Texas,50,Vermont,17,Orange County,0,19,-19
48,Texas,50,Vermont,19,Orleans County,0,18,-18
48,Texas,50,Vermont,21,Rutland County,84,0,84
48,Texas,50,Vermont,23,Washington County,238,48,190
48,Texas,50,Vermont,25,Windham County,0,22,-22
48,Texas,50,Vermont,27,Windsor County,4,0,4
48,Texas,51,Virginia,1,Accomack County,0,12,-12
48,Texas,51,Virginia,3,Albemarle County,82,120,-38
48,Texas,51,Virginia,5,Alleghany County,61,0,61
48,Texas,51,Virginia,9,Amherst County,28,0,28
48,Texas,51,Virginia,11,Appomattox County,0,3,-3
48,Texas,51,Virginia,13,Arlington County,466,421,45
48,Texas,51,Virginia,15,Augusta County,0,48,-48
48,Texas,51,Virginia,19,Bedford County,33,93,-60
48,Texas,51,Virginia,21,Bland County,0,20,-20
48,Texas,51,Virginia,23,Botetourt County,2,8,-6
48,Texas,51,Virginia,29,Buckingham County,0,39,-39
48,Texas,51,Virginia,31,Campbell County,10,11,-1
48,Texas,51,Virginia,33,Caroline County,78,99,-21
48,Texas,51,Virginia,35,Carroll County,9,0,9
48,Texas,51,Virginia,41,Chesterfield County,315,256,59
48,Texas,51,Virginia,47,Culpeper County,0,19,-19
48,Texas,51,Virginia,53,Dinwiddie County,25,10,15
48,Texas,51,Virginia,59,Fairfax County,4584,2062,2522
48,Texas,51,Virginia,61,Fauquier County,0,179,-179
48,Texas,51,Virginia,63,Floyd County,0,4,-4
48,Texas,51,Virginia,67,Franklin County,0,190,-190
48,Texas,51,Virginia,69,Frederick County,67,34,33
48,Texas,51,Virginia,71,Giles County,0,1,-1
48,Texas,51,Virginia,77,Grayson County,16,0,16
48,Texas,51,Virginia,79,Greene County,0,60,-60
48,Texas,51,Virginia,85,Hanover County,108,65,43
48,Texas,51,Virginia,87,Henrico County,208,233,-25
48,Texas,51,Virginia,89,Henry County,0,24,-24
48,Texas,51,Virginia,93,Isle of Wight County,123,0,123
48,Texas,51,Virginia,95,James City County,388,169,219
48,Texas,51,Virginia,97,King and Queen County,13,0,13
48,Texas,51,Virginia,99,King George County,44,0,44
48,Texas,51,Virginia,101,King William County,0,8,-8
48,Texas,51,Virginia,105,Lee County,5,0,5
48,Texas,51,Virginia,107,Loudoun County,1299,809,490
48,Texas,51,Virginia,109,Louisa County,0,94,-94
48,Texas,51,Virginia,117,Mecklenburg County,0,134,-134
48,Texas,51,Virginia,119,Middlesex County,0,54,-54
48,Texas,51,Virginia,121,Montgomery County,85,138,-53
48,Texas,51,Virginia,125,Nelson County,25,0,25
48,Texas,51,Virginia,127,New Kent County,5,291,-286
48,Texas,51,Virginia,131,Northampton County,23,1,22
48,Texas,51,Virginia,135,Nottoway County,0,5,-5
48,Texas,51,Virginia,137,Orange County,125,6,119
48,Texas,51,Virginia,141,Patrick County,0,29,-29
48,Texas,51,Virginia,143,Pittsylvania County,63,0,63
48,Texas,51,Virginia,145,Powhatan County,0,1,-1
48,Texas,51,Virginia,147,Prince Edward County,50,0,50
48,Texas,51,Virginia,149,Prince George County,140,324,-184
48,Texas,51,Virginia,153,Prince William County,1102,1071,31
48,Texas,51,Virginia,155,Pulaski County,0,64,-64
48,Texas,51,Virginia,157,Rappahannock County,0,12,-12
48,Texas,51,Virginia,161,Roanoke County,341,56,285
48,Texas,51,Virginia,163,Rockbridge County,28,77,-49
48,Texas,51,Virginia,165,Rockingham County,0,5,-5
48,Texas,51,Virginia,169,Scott County,0,15,-15
48,Texas,51,Virginia,171,Shenandoah County,165,17,148
48,Texas,51,Virginia,177,Spotsylvania County,149,128,21
48,Texas,51,Virginia,179,Stafford County,402,579,-177
48,Texas,51,Virginia,181,Surry County,0,4,-4
48,Texas,51,Virginia,183,Sussex County,0,56,-56
48,Texas,51,Virginia,185,Tazewell County,0,44,-44
48,Texas,51,Virginia,187,Warren County,8,0,8
48,Texas,51,Virginia,191,Washington County,0,95,-95
48,Texas,51,Virginia,193,Westmoreland County,0,202,-202
48,Texas,51,Virginia,195,Wise County,74,0,74
48,Texas,51,Virginia,199,York County,211,216,-5
48,Texas,51,Virginia,510,Alexandria city,423,529,-106
48,Texas,51,Virginia,530,Buena Vista city,0,8,-8
48,Texas,51,Virginia,540,Charlottesville city,86,138,-52
48,Texas,51,Virginia,550,Chesapeake city,846,411,435
48,Texas,51,Virginia,570,Colonial Heights city,56,122,-66
48,Texas,51,Virginia,590,Danville city,9,23,-14
48,Texas,51,Virginia,600,Fairfax city,78,6,72
48,Texas,51,Virginia,610,Falls Church city,42,0,42
48,Texas,51,Virginia,630,Fredericksburg city,80,53,27
48,Texas,51,Virginia,650,Hampton city,357,406,-49
48,Texas,51,Virginia,660,Harrisonburg city,109,36,73
48,Texas,51,Virginia,670,Hopewell city,24,32,-8
48,Texas,51,Virginia,678,Lexington city,26,31,-5
48,Texas,51,Virginia,680,Lynchburg city,105,162,-57
48,Texas,51,Virginia,683,Manassas city,160,22,138
48,Texas,51,Virginia,685,Manassas Park city,0,49,-49
48,Texas,51,Virginia,700,Newport News city,773,704,69
48,Texas,51,Virginia,710,Norfolk city,781,847,-66
48,Texas,51,Virginia,720,Norton city,0,13,-13
48,Texas,51,Virginia,730,Petersburg city,167,81,86
48,Texas,51,Virginia,735,Poquoson city,55,0,55
48,Texas,51,Virginia,740,Portsmouth city,254,157,97
48,Texas,51,Virginia,750,Radford city,12,0,12
48,Texas,51,Virginia,760,Richmond city,567,302,265
48,Texas,51,Virginia,770,Roanoke city,41,91,-50
48,Texas,51,Virginia,790,Staunton city,168,115,53
48,Texas,51,Virginia,800,Suffolk city,124,108,16
48,Texas,51,Virginia,810,Virginia Beach city,738,1684,-946
48,Texas,51,Virginia,830,Williamsburg city,0,67,-67
48,Texas,51,Virginia,840,Winchester city,127,10,117
48,Texas,53,Washington,1,Adams County,0,37,-37
48,Texas,53,Washington,3,Asotin County,79,23,56
48,Texas,53,Washington,5,Benton County,60,200,-140
48,Texas,53,Washington,7,Chelan County,19,11,8
48,Texas,53,Washington,9,Clallam County,32,234,-202
48,Texas,53,Washington,11,Clark County,732,705,27
48,Texas,53,Washington,15,Cowlitz County,74,102,-28
48,Texas,53,Washington,17,Douglas County,15,11,4
48,Texas,53,Washington,21,Franklin County,72,14,58
48,Texas,53,Washington,23,Garfield County,0,29,-29
48,Texas,53,Washington,25,Grant County,31,78,-47
48,Texas,53,Washington,27,Grays Harbor County,61,76,-15
48,Texas,53,Washington,29,Island County,294,260,34
48,Texas,53,Washington,31,Jefferson County,16,40,-24
48,Texas,53,Washington,33,King County,3163,5288,-2125
48,Texas,53,Washington,35,Kitsap County,548,733,-185
48,Texas,53,Washington,37,Kittitas County,23,132,-109
48,Texas,53,Washington,41,Lewis County,69,64,5
48,Texas,53,Washington,43,Lincoln County,0,18,-18
48,Texas,53,Washington,45,Mason County,13,17,-4
48,Texas,53,Washington,47,Okanogan County,12,11,1
48,Texas,53,Washington,49,Pacific County,22,18,4
48,Texas,53,Washington,53,Pierce County,2714,2232,482
48,Texas,53,Washington,55,San Juan County,0,2,-2
48,Texas,53,Washington,57,Skagit County,26,166,-140
48,Texas,53,Washington,59,Skamania County,0,6,-6
48,Texas,53,Washington,61,Snohomish County,1013,1032,-19
48,Texas,53,Washington,63,Spokane County,829,855,-26
48,Texas,53,Washington,65,Stevens County,27,52,-25
48,Texas,53,Washington,67,Thurston County,853,748,105
48,Texas,53,Washington,71,Walla Walla County,19,79,-60
48,Texas,53,Washington,73,Whatcom County,217,254,-37
48,Texas,53,Washington,75,Whitman County,98,138,-40
48,Texas,53,Washington,77,Yakima County,704,96,608
48,Texas,54,West Virginia,3,Berkeley County,40,371,-331
48,Texas,54,West Virginia,5,Boone County,57,0,57
48,Texas,54,West Virginia,9,Brooke County,9,32,-23
48,Texas,54,West Virginia,11,Cabell County,24,50,-26
48,Texas,54,West Virginia,17,Doddridge County,46,0,46
48,Texas,54,West Virginia,19,Fayette County,0,9,-9
48,Texas,54,West Virginia,21,Gilmer County,0,21,-21
48,Texas,54,West Virginia,25,Greenbrier County,118,0,118
48,Texas,54,West Virginia,29,Hancock County,88,1,87
48,Texas,54,West Virginia,33,Harrison County,312,117,195
48,Texas,54,West Virginia,37,Jefferson County,0,49,-49
48,Texas,54,West Virginia,39,Kanawha County,247,92,155
48,Texas,54,West Virginia,41,Lewis County,33,23,10
48,Texas,54,West Virginia,43,Lincoln County,0,45,-45
48,Texas,54,West Virginia,47,McDowell County,0,60,-60
48,Texas,54,West Virginia,49,Marion County,8,72,-64
48,Texas,54,West Virginia,51,Marshall County,38,0,38
48,Texas,54,West Virginia,53,Mason County,0,46,-46
48,Texas,54,West Virginia,59,Mingo County,27,0,27
48,Texas,54,West Virginia,61,Monongalia County,446,72,374
48,Texas,54,West Virginia,69,Ohio County,0,29,-29
48,Texas,54,West Virginia,75,Pocahontas County,25,10,15
48,Texas,54,West Virginia,77,Preston County,42,26,16
48,Texas,54,West Virginia,79,Putnam County,156,0,156
48,Texas,54,West Virginia,81,Raleigh County,46,0,46
48,Texas,54,West Virginia,85,Ritchie County,0,11,-11
48,Texas,54,West Virginia,87,Roane County,0,1,-1
48,Texas,54,West Virginia,89,Summers County,0,31,-31
48,Texas,54,West Virginia,91,Taylor County,0,88,-88
48,Texas,54,West Virginia,93,Tucker County,0,10,-10
48,Texas,54,West Virginia,97,Upshur County,50,3,47
48,Texas,54,West Virginia,107,Wood County,11,79,-68
48,Texas,54,West Virginia,109,Wyoming County,0,18,-18
48,Texas,55,Wisconsin,1,Adams County,0,13,-13
48,Texas,55,Wisconsin,5,Barron County,40,3,37
48,Texas,55,Wisconsin,7,Bayfield County,0,8,-8
48,Texas,55,Wisconsin,9,Brown County,146,118,28
48,Texas,55,Wisconsin,11,Buffalo County,21,19,2
48,Texas,55,Wisconsin,13,Burnett County,17,7,10
48,Texas,55,Wisconsin,15,Calumet County,15,70,-55
48,Texas,55,Wisconsin,17,Chippewa County,47,0,47
48,Texas,55,Wisconsin,19,Clark County,34,1,33
48,Texas,55,Wisconsin,21,Columbia County,0,123,-123
48,Texas,55,Wisconsin,23,Crawford County,70,8,62
48,Texas,55,Wisconsin,25,Dane County,1140,419,721
48,Texas,55,Wisconsin,27,Dodge County,4,76,-72
48,Texas,55,Wisconsin,29,Door County,27,0,27
48,Texas,55,Wisconsin,31,Douglas County,0,66,-66
48,Texas,55,Wisconsin,33,Dunn County,0,11,-11
48,Texas,55,Wisconsin,35,Eau Claire County,216,131,85
48,Texas,55,Wisconsin,39,Fond du Lac County,88,78,10
48,Texas,55,Wisconsin,41,Forest County,7,4,3
48,Texas,55,Wisconsin,43,Grant County,23,19,4
48,Texas,55,Wisconsin,45,Green County,29,0,29
48,Texas,55,Wisconsin,47,Green Lake County,0,75,-75
48,Texas,55,Wisconsin,49,Iowa County,9,13,-4
48,Texas,55,Wisconsin,53,Jackson County,0,12,-12
48,Texas,55,Wisconsin,55,Jefferson County,33,22,11
48,Texas,55,Wisconsin,57,Juneau County,0,50,-50
48,Texas,55,Wisconsin,59,Kenosha County,264,247,17
48,Texas,55,Wisconsin,61,Kewaunee County,40,39,1
48,Texas,55,Wisconsin,63,La Crosse County,107,53,54
48,Texas,55,Wisconsin,65,Lafayette County,0,27,-27
48,Texas,55,Wisconsin,67,Langlade County,47,0,47
48,Texas,55,Wisconsin,69,Lincoln County,0,10,-10
48,Texas,55,Wisconsin,71,Manitowoc County,0,4,-4
48,Texas,55,Wisconsin,73,Marathon County,150,64,86
48,Texas,55,Wisconsin,75,Marinette County,0,3,-3
48,Texas,55,Wisconsin,77,Marquette County,10,39,-29
48,Texas,55,Wisconsin,79,Milwaukee County,1355,819,536
48,Texas,55,Wisconsin,81,Monroe County,0,33,-33
48,Texas,55,Wisconsin,85,Oneida County,71,0,71
48,Texas,55,Wisconsin,87,Outagamie County,63,31,32
48,Texas,55,Wisconsin,89,Ozaukee County,20,97,-77
48,Texas,55,Wisconsin,93,Pierce County,18,30,-12
48,Texas,55,Wisconsin,95,Polk County,20,52,-32
48,Texas,55,Wisconsin,97,Portage County,50,82,-32
48,Texas,55,Wisconsin,99,Price County,8,5,3
48,Texas,55,Wisconsin,101,Racine County,33,127,-94
48,Texas,55,Wisconsin,103,Richland County,57,32,25
48,Texas,55,Wisconsin,105,Rock County,218,148,70
48,Texas,55,Wisconsin,107,Rusk County,0,4,-4
48,Texas,55,Wisconsin,109,St. Croix County,101,123,-22
48,Texas,55,Wisconsin,111,Sauk County,119,55,64
48,Texas,55,Wisconsin,113,Sawyer County,108,0,108
48,Texas,55,Wisconsin,115,Shawano County,0,85,-85
48,Texas,55,Wisconsin,117,Sheboygan County,4,106,-102
48,Texas,55,Wisconsin,119,Taylor County,0,1,-1
48,Texas,55,Wisconsin,121,Trempealeau County,0,14,-14
48,Texas,55,Wisconsin,125,Vilas County,0,12,-12
48,Texas,55,Wisconsin,127,Walworth County,0,82,-82
48,Texas,55,Wisconsin,129,Washburn County,0,14,-14
48,Texas,55,Wisconsin,131,Washington County,151,101,50
48,Texas,55,Wisconsin,133,Waukesha County,703,297,406
48,Texas,55,Wisconsin,135,Waupaca County,59,37,22
48,Texas,55,Wisconsin,137,Waushara County,0,88,-88
48,Texas,55,Wisconsin,139,Winnebago County,184,121,63
48,Texas,55,Wisconsin,141,Wood County,152,8,144
48,Texas,56,Wyoming,1,Albany County,283,104,179
48,Texas,56,Wyoming,3,Big Horn County,8,159,-151
48,Texas,56,Wyoming,5,Campbell County,316,66,250
48,Texas,56,Wyoming,7,Carbon County,50,52,-2
48,Texas,56,Wyoming,9,Converse County,93,22,71
48,Texas,56,Wyoming,11,Crook County,0,5,-5
48,Texas,56,Wyoming,13,Fremont County,134,28,106
48,Texas,56,Wyoming,15,Goshen County,17,67,-50
48,Texas,56,Wyoming,17,Hot Springs County,0,52,-52
48,Texas,56,Wyoming,19,Johnson County,0,10,-10
48,Texas,56,Wyoming,21,Laramie County,238,489,-251
48,Texas,56,Wyoming,23,Lincoln County,18,0,18
48,Texas,56,Wyoming,25,Natrona County,240,211,29
48,Texas,56,Wyoming,27,Niobrara County,17,0,17
48,Texas,56,Wyoming,29,Park County,196,357,-161
48,Texas,56,Wyoming,31,Platte County,0,103,-103
48,Texas,56,Wyoming,33,Sheridan County,20,73,-53
48,Texas,56,Wyoming,37,Sweetwater County,117,186,-69
48,Texas,56,Wyoming,39,Teton County,119,52,67
48,Texas,56,Wyoming,41,Uinta County,278,0,278
48,Texas,56,Wyoming,43,Washakie County,0,1,-1
48,Texas,56,Wyoming,45,Weston County,5,0,5
48,Texas,6,California,1,Alameda County,3053,1530,1523
48,Texas,6,California,3,Alpine County,0,29,-29
48,Texas,6,California,5,Amador County,278,33,245
48,Texas,6,California,7,Butte County,305,353,-48
48,Texas,6,California,9,Calaveras County,10,53,-43
48,Texas,6,California,13,Contra Costa County,1754,868,886
48,Texas,6,California,17,El Dorado County,60,94,-34
48,Texas,6,California,19,Fresno County,623,612,11
48,Texas,6,California,21,Glenn County,16,0,16
48,Texas,6,California,23,Humboldt County,142,0,142
48,Texas,6,California,25,Imperial County,362,70,292
48,Texas,6,California,27,Inyo County,0,3,-3
48,Texas,6,California,29,Kern County,1627,1244,383
48,Texas,6,California,31,Kings County,464,322,142
48,Texas,6,California,33,Lake County,113,109,4
48,Texas,6,California,35,Lassen County,23,88,-65
48,Texas,6,California,37,Los Angeles County,16087,8846,7241
48,Texas,6,California,39,Madera County,217,87,130
48,Texas,6,California,41,Marin County,364,277,87
48,Texas,6,California,45,Mendocino County,34,151,-117
48,Texas,6,California,47,Merced County,197,319,-122
48,Texas,6,California,49,Modoc County,0,27,-27
48,Texas,6,California,51,Mono County,0,12,-12
48,Texas,6,California,53,Monterey County,1477,680,797
48,Texas,6,California,55,Napa County,170,302,-132
48,Texas,6,California,57,Nevada County,126,31,95
48,Texas,6,California,59,Orange County,6899,2617,4282
48,Texas,6,California,61,Placer County,531,317,214
48,Texas,6,California,63,Plumas County,0,9,-9
48,Texas,6,California,65,Riverside County,3882,1977,1905
48,Texas,6,California,67,Sacramento County,2005,1286,719
48,Texas,6,California,69,San Benito County,5,33,-28
48,Texas,6,California,71,San Bernardino County,3380,2301,1079
48,Texas,6,California,73,San Diego County,9144,5068,4076
48,Texas,6,California,75,San Francisco County,1127,931,196
48,Texas,6,California,77,San Joaquin County,1007,452,555
48,Texas,6,California,79,San Luis Obispo County,115,312,-197
48,Texas,6,California,81,San Mateo County,1398,697,701
48,Texas,6,California,83,Santa Barbara County,706,647,59
48,Texas,6,California,85,Santa Clara County,3675,2969,706
48,Texas,6,California,87,Santa Cruz County,81,113,-32
48,Texas,6,California,89,Shasta County,148,194,-46
48,Texas,6,California,91,Sierra County,0,4,-4
48,Texas,6,California,93,Siskiyou County,79,71,8
48,Texas,6,California,95,Solano County,1046,452,594
48,Texas,6,California,97,Sonoma County,524,291,233
48,Texas,6,California,99,Stanislaus County,186,188,-2
48,Texas,6,California,101,Sutter County,39,96,-57
48,Texas,6,California,103,Tehama County,89,0,89
48,Texas,6,California,105,Trinity County,14,0,14
48,Texas,6,California,107,Tulare County,421,139,282
48,Texas,6,California,109,Tuolumne County,117,0,117
48,Texas,6,California,111,Ventura County,1964,745,1219
48,Texas,6,California,113,Yolo County,79,189,-110
48,Texas,6,California,115,Yuba County,236,201,35
48,Texas,72,Puerto Rico,3,Aguada Municipio,164,0,164
48,Texas,72,Puerto Rico,5,Aguadilla Municipio,188,0,188
48,Texas,72,Puerto Rico,9,Aibonito Municipio,80,11,69
48,Texas,72,Puerto Rico,11,Añasco Municipio,0,25,-25
48,Texas,72,Puerto Rico,13,Arecibo Municipio,426,0,426
48,Texas,72,Puerto Rico,15,Arroyo Municipio,71,0,71
48,Texas,72,Puerto Rico,17,Barceloneta Municipio,27,0,27
48,Texas,72,Puerto Rico,21,Bayamón Municipio,296,58,238
48,Texas,72,Puerto Rico,23,Cabo Rojo Municipio,360,0,360
48,Texas,72,Puerto Rico,25,Caguas Municipio,266,113,153
48,Texas,72,Puerto Rico,27,Camuy Municipio,0,20,-20
48,Texas,72,Puerto Rico,29,Canóvanas Municipio,128,24,104
48,Texas,72,Puerto Rico,31,Carolina Municipio,443,45,398
48,Texas,72,Puerto Rico,33,Cataño Municipio,129,24,105
48,Texas,72,Puerto Rico,35,Cayey Municipio,131,0,131
48,Texas,72,Puerto Rico,37,Ceiba Municipio,31,0,31
48,Texas,72,Puerto Rico,39,Ciales Municipio,27,0,27
48,Texas,72,Puerto Rico,41,Cidra Municipio,130,0,130
48,Texas,72,Puerto Rico,43,Coamo Municipio,61,7,54
48,Texas,72,Puerto Rico,45,Comerío Municipio,8,0,8
48,Texas,72,Puerto Rico,47,Corozal Municipio,60,39,21
48,Texas,72,Puerto Rico,51,Dorado Municipio,0,110,-110
48,Texas,72,Puerto Rico,53,Fajardo Municipio,29,47,-18
48,Texas,72,Puerto Rico,57,Guayama Municipio,23,22,1
48,Texas,72,Puerto Rico,59,Guayanilla Municipio,0,5,-5
48,Texas,72,Puerto Rico,61,Guaynabo Municipio,129,73,56
48,Texas,72,Puerto Rico,63,Gurabo Municipio,0,86,-86
48,Texas,72,Puerto Rico,65,Hatillo Municipio,17,0,17
48,Texas,72,Puerto Rico,67,Hormigueros Municipio,21,0,21
48,Texas,72,Puerto Rico,71,Isabela Municipio,69,0,69
48,Texas,72,Puerto Rico,73,Jayuya Municipio,31,0,31
48,Texas,72,Puerto Rico,75,Juana Díaz Municipio,38,0,38
48,Texas,72,Puerto Rico,77,Juncos Municipio,43,17,26
48,Texas,72,Puerto Rico,79,Lajas Municipio,187,0,187
48,Texas,72,Puerto Rico,81,Lares Municipio,90,0,90
48,Texas,72,Puerto Rico,83,Las Marías Municipio,7,0,7
48,Texas,72,Puerto Rico,85,Las Piedras Municipio,0,33,-33
48,Texas,72,Puerto Rico,87,Loíza Municipio,65,0,65
48,Texas,72,Puerto Rico,89,Luquillo Municipio,0,21,-21
48,Texas,72,Puerto Rico,91,Manatí Municipio,61,0,61
48,Texas,72,Puerto Rico,95,Maunabo Municipio,68,0,68
48,Texas,72,Puerto Rico,97,Mayagüez Municipio,166,25,141
48,Texas,72,Puerto Rico,99,Moca Municipio,36,0,36
48,Texas,72,Puerto Rico,101,Morovis Municipio,20,0,20
48,Texas,72,Puerto Rico,103,Naguabo Municipio,158,0,158
48,Texas,72,Puerto Rico,107,Orocovis Municipio,87,17,70
48,Texas,72,Puerto Rico,111,Peñuelas Municipio,37,0,37
48,Texas,72,Puerto Rico,113,Ponce Municipio,440,7,433
48,Texas,72,Puerto Rico,115,Quebradillas Municipio,15,0,15
48,Texas,72,Puerto Rico,117,Rincón Municipio,10,41,-31
48,Texas,72,Puerto Rico,119,Río Grande Municipio,188,0,188
48,Texas,72,Puerto Rico,121,Sabana Grande Municipio,14,0,14
48,Texas,72,Puerto Rico,123,Salinas Municipio,65,0,65
48,Texas,72,Puerto Rico,127,San Juan Municipio,819,79,740
48,Texas,72,Puerto Rico,129,San Lorenzo Municipio,25,0,25
48,Texas,72,Puerto Rico,131,San Sebastián Municipio,54,0,54
48,Texas,72,Puerto Rico,135,Toa Alta Municipio,2,0,2
48,Texas,72,Puerto Rico,137,Toa Baja Municipio,168,9,159
48,Texas,72,Puerto Rico,139,Trujillo Alto Municipio,95,21,74
48,Texas,72,Puerto Rico,141,Utuado Municipio,141,58,83
48,Texas,72,Puerto Rico,143,Vega Alta Municipio,36,0,36
48,Texas,72,Puerto Rico,145,Vega Baja Municipio,111,0,111
48,Texas,72,Puerto Rico,151,Yabucoa Municipio,131,0,131
48,Texas,8,Colorado,1,Adams County,1081,1353,-272
48,Texas,8,Colorado,3,Alamosa County,65,14,51
48,Texas,8,Colorado,5,Arapahoe County,2635,1828,807
48,Texas,8,Colorado,7,Archuleta County,54,176,-122
48,Texas,8,Colorado,9,Baca County,0,3,-3
48,Texas,8,Colorado,13,Boulder County,703,862,-159
48,Texas,8,Colorado,14,Broomfield County,149,668,-519
48,Texas,8,Colorado,17,Cheyenne County,0,3,-3
48,Texas,8,Colorado,21,Conejos County,0,2,-2
48,Texas,8,Colorado,23,Costilla County,13,11,2
48,Texas,8,Colorado,25,Crowley County,55,0,55
48,Texas,8,Colorado,27,Custer County,0,4,-4
48,Texas,8,Colorado,29,Delta County,39,161,-122
48,Texas,8,Colorado,31,Denver County,2984,3332,-348
48,Texas,8,Colorado,33,Dolores County,0,4,-4
48,Texas,8,Colorado,35,Douglas County,965,1209,-244
48,Texas,8,Colorado,37,Eagle County,94,125,-31
48,Texas,8,Colorado,39,Elbert County,96,2,94
48,Texas,8,Colorado,41,El Paso County,5263,5499,-236
48,Texas,8,Colorado,43,Fremont County,184,288,-104
48,Texas,8,Colorado,45,Garfield County,92,278,-186
48,Texas,8,Colorado,47,Gilpin County,2,11,-9
48,Texas,8,Colorado,49,Grand County,0,37,-37
48,Texas,8,Colorado,51,Gunnison County,4,88,-84
48,Texas,8,Colorado,53,Hinsdale County,0,29,-29
48,Texas,8,Colorado,55,Huerfano County,32,87,-55
48,Texas,8,Colorado,59,Jefferson County,1571,1903,-332
48,Texas,8,Colorado,61,Kiowa County,0,2,-2
48,Texas,8,Colorado,63,Kit Carson County,5,18,-13
48,Texas,8,Colorado,65,Lake County,23,1,22
48,Texas,8,Colorado,67,La Plata County,153,320,-167
48,Texas,8,Colorado,69,Larimer County,774,991,-217
48,Texas,8,Colorado,71,Las Animas County,170,40,130
48,Texas,8,Colorado,73,Lincoln County,9,1,8
48,Texas,8,Colorado,75,Logan County,238,39,199
48,Texas,8,Colorado,77,Mesa County,370,486,-116
48,Texas,8,Colorado,79,Mineral County,0,5,-5
48,Texas,8,Colorado,81,Moffat County,30,31,-1
48,Texas,8,Colorado,83,Montezuma County,87,221,-134
48,Texas,8,Colorado,85,Montrose County,271,388,-117
48,Texas,8,Colorado,87,Morgan County,5,33,-28
48,Texas,8,Colorado,89,Otero County,110,47,63
48,Texas,8,Colorado,91,Ouray County,13,16,-3
48,Texas,8,Colorado,93,Park County,18,5,13
48,Texas,8,Colorado,95,Phillips County,71,0,71
48,Texas,8,Colorado,97,Pitkin County,11,36,-25
48,Texas,8,Colorado,99,Prowers County,137,90,47
48,Texas,8,Colorado,101,Pueblo County,665,578,87
48,Texas,8,Colorado,103,Rio Blanco County,0,43,-43
48,Texas,8,Colorado,105,Rio Grande County,23,100,-77
48,Texas,8,Colorado,107,Routt County,11,73,-62
48,Texas,8,Colorado,109,Saguache County,0,26,-26
48,Texas,8,Colorado,111,San Juan County,23,0,23
48,Texas,8,Colorado,113,San Miguel County,0,111,-111
48,Texas,8,Colorado,115,Sedgwick County,51,0,51
48,Texas,8,Colorado,117,Summit County,73,34,39
48,Texas,8,Colorado,119,Teller County,94,97,-3
48,Texas,8,Colorado,121,Washington County,0,63,-63
48,Texas,8,Colorado,123,Weld County,583,915,-332
48,Texas,8,Colorado,125,Yuma County,0,13,-13
48,Texas,9,Connecticut,1,Fairfield County,843,895,-52
48,Texas,9,Connecticut,3,Hartford County,524,455,69
48,Texas,9,Connecticut,5,Litchfield County,52,59,-7
48,Texas,9,Connecticut,7,Middlesex County,36,128,-92
48,Texas,9,Connecticut,9,New Haven County,883,435,448
48,Texas,9,Connecticut,11,New London County,101,318,-217
48,Texas,9,Connecticut,13,Tolland County,169,0,169
48,Texas,9,Connecticut,15,Windham County,37,28,9
48,Texas,AFR,Africa,,-,16919,0,0
48,Texas,ASI,Asia,,-,75184,0,0
48,Texas,CAM,Central America,,-,64616,0,0
48,Texas,CAR,Caribbean,,-,6781,0,0
48,Texas,EUR,Europe,,-,23497,0,0
48,Texas,ISL,U.S. Island Areas,,-,2319,0,0
48,Texas,NAM,Northern America,,-,5946,0,0
48,Texas,OCE,Oceania and At Sea,,-,3181,0,0
48,Texas,SAM,South America,,-,12707,0,0
49,Utah,1,Alabama,1,Autauga County,170,0,170
49,Utah,1,Alabama,3,Baldwin County,4,88,-84
49,Utah,1,Alabama,9,Blount County,4,0,4
49,Utah,1,Alabama,11,Bullock County,0,6,-6
49,Utah,1,Alabama,13,Butler County,0,16,-16
49,Utah,1,Alabama,45,Dale County,0,9,-9
49,Utah,1,Alabama,69,Houston County,92,132,-40
49,Utah,1,Alabama,73,Jefferson County,125,76,49
49,Utah,1,Alabama,77,Lauderdale County,0,18,-18
49,Utah,1,Alabama,89,Madison County,83,74,9
49,Utah,1,Alabama,93,Marion County,9,0,9
49,Utah,1,Alabama,97,Mobile County,0,49,-49
49,Utah,1,Alabama,101,Montgomery County,0,61,-61
49,Utah,1,Alabama,103,Morgan County,0,11,-11
49,Utah,1,Alabama,113,Russell County,0,43,-43
49,Utah,1,Alabama,117,Shelby County,0,188,-188
49,Utah,1,Alabama,125,Tuscaloosa County,0,42,-42
49,Utah,10,Delaware,1,Kent County,21,9,12
49,Utah,10,Delaware,3,New Castle County,21,5,16
49,Utah,10,Delaware,5,Sussex County,50,0,50
49,Utah,11,District of Columbia,1,District of Columbia,312,277,35
49,Utah,12,Florida,1,Alachua County,61,0,61
49,Utah,12,Florida,3,Baker County,0,36,-36
49,Utah,12,Florida,5,Bay County,9,10,-1
49,Utah,12,Florida,9,Brevard County,212,242,-30
49,Utah,12,Florida,11,Broward County,111,111,0
49,Utah,12,Florida,13,Calhoun County,0,42,-42
49,Utah,12,Florida,17,Citrus County,16,0,16
49,Utah,12,Florida,19,Clay County,23,169,-146
49,Utah,12,Florida,21,Collier County,27,285,-258
49,Utah,12,Florida,31,Duval County,115,173,-58
49,Utah,12,Florida,33,Escambia County,69,111,-42
49,Utah,12,Florida,53,Hernando County,0,6,-6
49,Utah,12,Florida,55,Highlands County,0,55,-55
49,Utah,12,Florida,57,Hillsborough County,331,108,223
49,Utah,12,Florida,61,Indian River County,0,72,-72
49,Utah,12,Florida,69,Lake County,40,21,19
49,Utah,12,Florida,71,Lee County,93,0,93
49,Utah,12,Florida,73,Leon County,28,113,-85
49,Utah,12,Florida,79,Madison County,9,0,9
49,Utah,12,Florida,81,Manatee County,0,41,-41
49,Utah,12,Florida,83,Marion County,5,0,5
49,Utah,12,Florida,86,Miami-Dade County,168,23,145
49,Utah,12,Florida,87,Monroe County,0,54,-54
49,Utah,12,Florida,89,Nassau County,0,111,-111
49,Utah,12,Florida,91,Okaloosa County,64,135,-71
49,Utah,12,Florida,93,Okeechobee County,67,0,67
49,Utah,12,Florida,95,Orange County,170,290,-120
49,Utah,12,Florida,97,Osceola County,13,103,-90
49,Utah,12,Florida,99,Palm Beach County,65,160,-95
49,Utah,12,Florida,101,Pasco County,47,0,47
49,Utah,12,Florida,103,Pinellas County,166,454,-288
49,Utah,12,Florida,105,Polk County,70,187,-117
49,Utah,12,Florida,109,St. Johns County,0,83,-83
49,Utah,12,Florida,111,St. Lucie County,0,62,-62
49,Utah,12,Florida,113,Santa Rosa County,45,0,45
49,Utah,12,Florida,115,Sarasota County,21,0,21
49,Utah,12,Florida,117,Seminole County,300,0,300
49,Utah,12,Florida,121,Suwannee County,0,18,-18
49,Utah,12,Florida,127,Volusia County,83,15,68
49,Utah,12,Florida,131,Walton County,0,19,-19
49,Utah,13,Georgia,1,Appling County,0,31,-31
49,Utah,13,Georgia,13,Barrow County,0,44,-44
49,Utah,13,Georgia,15,Bartow County,1,0,1
49,Utah,13,Georgia,21,Bibb County,34,0,34
49,Utah,13,Georgia,31,Bulloch County,8,0,8
49,Utah,13,Georgia,45,Carroll County,9,12,-3
49,Utah,13,Georgia,51,Chatham County,38,16,22
49,Utah,13,Georgia,57,Cherokee County,53,174,-121
49,Utah,13,Georgia,59,Clarke County,0,15,-15
49,Utah,13,Georgia,63,Clayton County,46,0,46
49,Utah,13,Georgia,65,Clinch County,0,29,-29
49,Utah,13,Georgia,67,Cobb County,255,94,161
49,Utah,13,Georgia,77,Coweta County,11,23,-12
49,Utah,13,Georgia,89,DeKalb County,151,56,95
49,Utah,13,Georgia,113,Fayette County,116,125,-9
49,Utah,13,Georgia,117,Forsyth County,319,60,259
49,Utah,13,Georgia,121,Fulton County,350,167,183
49,Utah,13,Georgia,127,Glynn County,4,0,4
49,Utah,13,Georgia,135,Gwinnett County,177,47,130
49,Utah,13,Georgia,145,Harris County,0,2,-2
49,Utah,13,Georgia,149,Heard County,0,7,-7
49,Utah,13,Georgia,153,Houston County,0,237,-237
49,Utah,13,Georgia,157,Jackson County,20,0,20
49,Utah,13,Georgia,169,Jones County,26,0,26
49,Utah,13,Georgia,173,Lanier County,20,77,-57
49,Utah,13,Georgia,179,Liberty County,0,27,-27
49,Utah,13,Georgia,185,Lowndes County,0,13,-13
49,Utah,13,Georgia,215,Muscogee County,6,18,-12
49,Utah,13,Georgia,217,Newton County,0,9,-9
49,Utah,13,Georgia,223,Paulding County,19,12,7
49,Utah,13,Georgia,227,Pickens County,9,0,9
49,Utah,13,Georgia,233,Polk County,0,40,-40
49,Utah,13,Georgia,245,Richmond County,27,29,-2
49,Utah,13,Georgia,261,Sumter County,21,0,21
49,Utah,13,Georgia,295,Walker County,0,71,-71
49,Utah,13,Georgia,299,Ware County,9,0,9
49,Utah,13,Georgia,311,White County,11,0,11
49,Utah,15,Hawaii,1,Hawaii County,93,0,93
49,Utah,15,Hawaii,3,Honolulu County,1303,671,632
49,Utah,15,Hawaii,7,Kauai County,0,41,-41
49,Utah,15,Hawaii,9,Maui County,101,130,-29
49,Utah,16,Idaho,1,Ada County,987,1795,-808
49,Utah,16,Idaho,5,Bannock County,563,365,198
49,Utah,16,Idaho,7,Bear Lake County,63,115,-52
49,Utah,16,Idaho,9,Benewah County,0,9,-9
49,Utah,16,Idaho,11,Bingham County,173,337,-164
49,Utah,16,Idaho,13,Blaine County,17,86,-69
49,Utah,16,Idaho,15,Boise County,2,12,-10
49,Utah,16,Idaho,17,Bonner County,68,14,54
49,Utah,16,Idaho,19,Bonneville County,895,622,273
49,Utah,16,Idaho,21,Boundary County,0,1,-1
49,Utah,16,Idaho,27,Canyon County,466,519,-53
49,Utah,16,Idaho,29,Caribou County,39,43,-4
49,Utah,16,Idaho,31,Cassia County,176,283,-107
49,Utah,16,Idaho,33,Clark County,0,14,-14
49,Utah,16,Idaho,35,Clearwater County,0,6,-6
49,Utah,16,Idaho,37,Custer County,14,10,4
49,Utah,16,Idaho,39,Elmore County,200,31,169
49,Utah,16,Idaho,41,Franklin County,273,447,-174
49,Utah,16,Idaho,43,Fremont County,0,59,-59
49,Utah,16,Idaho,45,Gem County,23,0,23
49,Utah,16,Idaho,47,Gooding County,46,5,41
49,Utah,16,Idaho,49,Idaho County,0,37,-37
49,Utah,16,Idaho,51,Jefferson County,402,162,240
49,Utah,16,Idaho,53,Jerome County,1,0,1
49,Utah,16,Idaho,55,Kootenai County,87,396,-309
49,Utah,16,Idaho,57,Latah County,90,5,85
49,Utah,16,Idaho,59,Lemhi County,25,40,-15
49,Utah,16,Idaho,61,Lewis County,0,1,-1
49,Utah,16,Idaho,65,Madison County,1802,830,972
49,Utah,16,Idaho,67,Minidoka County,61,32,29
49,Utah,16,Idaho,69,Nez Perce County,75,1,74
49,Utah,16,Idaho,71,Oneida County,21,199,-178
49,Utah,16,Idaho,73,Owyhee County,11,0,11
49,Utah,16,Idaho,75,Payette County,0,5,-5
49,Utah,16,Idaho,77,Power County,189,0,189
49,Utah,16,Idaho,79,Shoshone County,0,14,-14
49,Utah,16,Idaho,81,Teton County,21,48,-27
49,Utah,16,Idaho,83,Twin Falls County,300,264,36
49,Utah,16,Idaho,85,Valley County,14,53,-39
49,Utah,16,Idaho,87,Washington County,0,22,-22
49,Utah,17,Illinois,1,Adams County,0,39,-39
49,Utah,17,Illinois,19,Champaign County,12,43,-31
49,Utah,17,Illinois,27,Clinton County,4,0,4
49,Utah,17,Illinois,29,Coles County,11,27,-16
49,Utah,17,Illinois,31,Cook County,396,340,56
49,Utah,17,Illinois,37,DeKalb County,0,29,-29
49,Utah,17,Illinois,43,DuPage County,317,20,297
49,Utah,17,Illinois,67,Hancock County,32,21,11
49,Utah,17,Illinois,77,Jackson County,64,0,64
49,Utah,17,Illinois,83,Jersey County,30,0,30
49,Utah,17,Illinois,89,Kane County,19,0,19
49,Utah,17,Illinois,93,Kendall County,38,0,38
49,Utah,17,Illinois,97,Lake County,274,98,176
49,Utah,17,Illinois,99,LaSalle County,3,48,-45
49,Utah,17,Illinois,105,Livingston County,0,6,-6
49,Utah,17,Illinois,111,McHenry County,26,0,26
49,Utah,17,Illinois,113,McLean County,0,5,-5
49,Utah,17,Illinois,117,Macoupin County,9,0,9
49,Utah,17,Illinois,119,Madison County,58,0,58
49,Utah,17,Illinois,143,Peoria County,0,84,-84
49,Utah,17,Illinois,161,Rock Island County,27,0,27
49,Utah,17,Illinois,163,St. Clair County,2,42,-40
49,Utah,17,Illinois,175,Stark County,0,5,-5
49,Utah,17,Illinois,189,Washington County,0,3,-3
49,Utah,17,Illinois,197,Will County,47,171,-124
49,Utah,17,Illinois,201,Winnebago County,24,0,24
49,Utah,18,Indiana,1,Adams County,0,16,-16
49,Utah,18,Indiana,3,Allen County,0,14,-14
49,Utah,18,Indiana,5,Bartholomew County,2,87,-85
49,Utah,18,Indiana,29,Dearborn County,8,0,8
49,Utah,18,Indiana,35,Delaware County,0,7,-7
49,Utah,18,Indiana,39,Elkhart County,43,44,-1
49,Utah,18,Indiana,43,Floyd County,30,0,30
49,Utah,18,Indiana,57,Hamilton County,399,83,316
49,Utah,18,Indiana,63,Hendricks County,0,41,-41
49,Utah,18,Indiana,69,Huntington County,13,0,13
49,Utah,18,Indiana,73,Jasper County,0,7,-7
49,Utah,18,Indiana,75,Jay County,9,0,9
49,Utah,18,Indiana,81,Johnson County,57,0,57
49,Utah,18,Indiana,89,Lake County,18,64,-46
49,Utah,18,Indiana,93,Lawrence County,10,0,10
49,Utah,18,Indiana,97,Marion County,99,107,-8
49,Utah,18,Indiana,105,Monroe County,40,140,-100
49,Utah,18,Indiana,107,Montgomery County,1,0,1
49,Utah,18,Indiana,127,Porter County,38,0,38
49,Utah,18,Indiana,133,Putnam County,0,15,-15
49,Utah,18,Indiana,137,Ripley County,2,0,2
49,Utah,18,Indiana,141,St. Joseph County,51,97,-46
49,Utah,18,Indiana,155,Switzerland County,30,0,30
49,Utah,18,Indiana,157,Tippecanoe County,92,30,62
49,Utah,18,Indiana,163,Vanderburgh County,29,0,29
49,Utah,18,Indiana,167,Vigo County,10,90,-80
49,Utah,18,Indiana,169,Wabash County,4,0,4
49,Utah,18,Indiana,177,Wayne County,5,0,5
49,Utah,19,Iowa,7,Appanoose County,0,10,-10
49,Utah,19,Iowa,13,Black Hawk County,0,16,-16
49,Utah,19,Iowa,17,Bremer County,19,0,19
49,Utah,19,Iowa,21,Buena Vista County,0,12,-12
49,Utah,19,Iowa,39,Clarke County,0,2,-2
49,Utah,19,Iowa,43,Clayton County,8,0,8
49,Utah,19,Iowa,49,Dallas County,88,0,88
49,Utah,19,Iowa,61,Dubuque County,0,11,-11
49,Utah,19,Iowa,63,Emmet County,5,18,-13
49,Utah,19,Iowa,73,Greene County,0,26,-26
49,Utah,19,Iowa,87,Henry County,0,5,-5
49,Utah,19,Iowa,103,Johnson County,38,56,-18
49,Utah,19,Iowa,107,Keokuk County,0,9,-9
49,Utah,19,Iowa,109,Kossuth County,0,9,-9
49,Utah,19,Iowa,113,Linn County,13,87,-74
49,Utah,19,Iowa,123,Mahaska County,0,7,-7
49,Utah,19,Iowa,129,Mills County,0,6,-6
49,Utah,19,Iowa,131,Mitchell County,0,5,-5
49,Utah,19,Iowa,139,Muscatine County,0,6,-6
49,Utah,19,Iowa,153,Polk County,62,79,-17
49,Utah,19,Iowa,155,Pottawattamie County,0,31,-31
49,Utah,19,Iowa,161,Sac County,0,10,-10
49,Utah,19,Iowa,163,Scott County,76,33,43
49,Utah,19,Iowa,165,Shelby County,0,3,-3
49,Utah,19,Iowa,169,Story County,0,25,-25
49,Utah,19,Iowa,187,Webster County,5,0,5
49,Utah,19,Iowa,193,Woodbury County,0,83,-83
49,Utah,2,Alaska,16,Aleutians West Census Area,0,5,-5
49,Utah,2,Alaska,20,Anchorage Municipality,1073,185,888
49,Utah,2,Alaska,50,Bethel Census Area,39,0,39
49,Utah,2,Alaska,60,Bristol Bay Borough,0,7,-7
49,Utah,2,Alaska,68,Denali Borough,8,78,-70
49,Utah,2,Alaska,90,Fairbanks North Star Borough,129,270,-141
49,Utah,2,Alaska,100,Haines Borough,0,1,-1
49,Utah,2,Alaska,105,Hoonah-Angoon Census Area,0,14,-14
49,Utah,2,Alaska,110,Juneau City and Borough,30,13,17
49,Utah,2,Alaska,122,Kenai Peninsula Borough,69,3,66
49,Utah,2,Alaska,158,Kusilvak Census Area,0,2,-2
49,Utah,2,Alaska,170,Matanuska-Susitna Borough,43,152,-109
49,Utah,2,Alaska,180,Nome Census Area,0,9,-9
49,Utah,2,Alaska,185,North Slope Borough,0,4,-4
49,Utah,2,Alaska,195,Petersburg Borough,0,9,-9
49,Utah,2,Alaska,220,Sitka City and Borough,13,0,13
49,Utah,2,Alaska,230,Skagway Municipality,12,17,-5
49,Utah,2,Alaska,240,Southeast Fairbanks Census Area,58,0,58
49,Utah,2,Alaska,282,Yakutat City and Borough,3,0,3
49,Utah,20,Kansas,1,Allen County,0,2,-2
49,Utah,20,Kansas,5,Atchison County,0,10,-10
49,Utah,20,Kansas,11,Bourbon County,0,82,-82
49,Utah,20,Kansas,23,Cheyenne County,0,4,-4
49,Utah,20,Kansas,35,Cowley County,0,4,-4
49,Utah,20,Kansas,45,Douglas County,82,0,82
49,Utah,20,Kansas,57,Ford County,30,0,30
49,Utah,20,Kansas,61,Geary County,0,10,-10
49,Utah,20,Kansas,91,Johnson County,150,352,-202
49,Utah,20,Kansas,103,Leavenworth County,9,39,-30
49,Utah,20,Kansas,111,Lyon County,0,27,-27
49,Utah,20,Kansas,119,Meade County,0,11,-11
49,Utah,20,Kansas,123,Mitchell County,54,0,54
49,Utah,20,Kansas,127,Morris County,0,3,-3
49,Utah,20,Kansas,131,Nemaha County,0,35,-35
49,Utah,20,Kansas,147,Phillips County,0,4,-4
49,Utah,20,Kansas,155,Reno County,9,0,9
49,Utah,20,Kansas,157,Republic County,0,2,-2
49,Utah,20,Kansas,159,Rice County,0,6,-6
49,Utah,20,Kansas,161,Riley County,32,53,-21
49,Utah,20,Kansas,173,Sedgwick County,38,129,-91
49,Utah,20,Kansas,177,Shawnee County,54,19,35
49,Utah,20,Kansas,179,Sheridan County,0,23,-23
49,Utah,20,Kansas,209,Wyandotte County,13,0,13
49,Utah,21,Kentucky,1,Adair County,0,10,-10
49,Utah,21,Kentucky,3,Allen County,16,0,16
49,Utah,21,Kentucky,9,Barren County,0,7,-7
49,Utah,21,Kentucky,15,Boone County,0,21,-21
49,Utah,21,Kentucky,37,Campbell County,22,0,22
49,Utah,21,Kentucky,47,Christian County,126,0,126
49,Utah,21,Kentucky,49,Clark County,30,0,30
49,Utah,21,Kentucky,67,Fayette County,0,211,-211
49,Utah,21,Kentucky,111,Jefferson County,252,29,223
49,Utah,21,Kentucky,113,Jessamine County,44,0,44
49,Utah,21,Kentucky,117,Kenton County,0,10,-10
49,Utah,21,Kentucky,139,Livingston County,8,0,8
49,Utah,21,Kentucky,141,Logan County,0,32,-32
49,Utah,21,Kentucky,163,Meade County,0,52,-52
49,Utah,21,Kentucky,185,Oldham County,10,0,10
49,Utah,21,Kentucky,211,Shelby County,16,0,16
49,Utah,21,Kentucky,215,Spencer County,0,53,-53
49,Utah,22,Louisiana,13,Bienville Parish,46,0,46
49,Utah,22,Louisiana,15,Bossier Parish,0,55,-55
49,Utah,22,Louisiana,17,Caddo Parish,22,0,22
49,Utah,22,Louisiana,19,Calcasieu Parish,17,7,10
49,Utah,22,Louisiana,31,De Soto Parish,0,14,-14
49,Utah,22,Louisiana,33,East Baton Rouge Parish,117,45,72
49,Utah,22,Louisiana,47,Iberville Parish,0,25,-25
49,Utah,22,Louisiana,51,Jefferson Parish,52,0,52
49,Utah,22,Louisiana,55,Lafayette Parish,0,37,-37
49,Utah,22,Louisiana,69,Natchitoches Parish,0,151,-151
49,Utah,22,Louisiana,71,Orleans Parish,0,81,-81
49,Utah,22,Louisiana,73,Ouachita Parish,28,0,28
49,Utah,22,Louisiana,101,St. Mary Parish,72,0,72
49,Utah,22,Louisiana,103,St. Tammany Parish,0,5,-5
49,Utah,22,Louisiana,113,Vermilion Parish,49,0,49
49,Utah,22,Louisiana,115,Vernon Parish,26,33,-7
49,Utah,23,Maine,1,Androscoggin County,0,79,-79
49,Utah,23,Maine,3,Aroostook County,15,0,15
49,Utah,23,Maine,5,Cumberland County,19,108,-89
49,Utah,23,Maine,7,Franklin County,0,7,-7
49,Utah,23,Maine,9,Hancock County,0,10,-10
49,Utah,23,Maine,11,Kennebec County,25,13,12
49,Utah,23,Maine,13,Knox County,14,10,4
49,Utah,23,Maine,17,Oxford County,46,0,46
49,Utah,23,Maine,19,Penobscot County,0,15,-15
49,Utah,23,Maine,23,Sagadahoc County,22,28,-6
49,Utah,23,Maine,25,Somerset County,0,5,-5
49,Utah,23,Maine,31,York County,5,0,5
49,Utah,24,Maryland,3,Anne Arundel County,125,20,105
49,Utah,24,Maryland,5,Baltimore County,97,46,51
49,Utah,24,Maryland,9,Calvert County,11,0,11
49,Utah,24,Maryland,13,Carroll County,0,4,-4
49,Utah,24,Maryland,15,Cecil County,0,32,-32
49,Utah,24,Maryland,17,Charles County,19,0,19
49,Utah,24,Maryland,21,Frederick County,48,8,40
49,Utah,24,Maryland,25,Harford County,0,62,-62
49,Utah,24,Maryland,27,Howard County,20,98,-78
49,Utah,24,Maryland,31,Montgomery County,210,176,34
49,Utah,24,Maryland,33,Prince George's County,5,148,-143
49,Utah,24,Maryland,35,Queen Anne's County,29,45,-16
49,Utah,24,Maryland,37,St. Mary's County,19,0,19
49,Utah,24,Maryland,43,Washington County,14,55,-41
49,Utah,24,Maryland,510,Baltimore city,33,55,-22
49,Utah,25,Massachusetts,1,Barnstable County,0,64,-64
49,Utah,25,Massachusetts,3,Berkshire County,0,60,-60
49,Utah,25,Massachusetts,5,Bristol County,68,10,58
49,Utah,25,Massachusetts,9,Essex County,101,38,63
49,Utah,25,Massachusetts,11,Franklin County,10,0,10
49,Utah,25,Massachusetts,15,Hampshire County,16,85,-69
49,Utah,25,Massachusetts,17,Middlesex County,303,179,124
49,Utah,25,Massachusetts,21,Norfolk County,96,24,72
49,Utah,25,Massachusetts,23,Plymouth County,50,0,50
49,Utah,25,Massachusetts,25,Suffolk County,200,202,-2
49,Utah,25,Massachusetts,27,Worcester County,138,11,127
49,Utah,26,Michigan,1,Alcona County,0,12,-12
49,Utah,26,Michigan,7,Alpena County,0,6,-6
49,Utah,26,Michigan,13,Baraga County,0,11,-11
49,Utah,26,Michigan,17,Bay County,0,37,-37
49,Utah,26,Michigan,21,Berrien County,53,0,53
49,Utah,26,Michigan,27,Cass County,4,0,4
49,Utah,26,Michigan,31,Cheboygan County,0,12,-12
49,Utah,26,Michigan,37,Clinton County,6,0,6
49,Utah,26,Michigan,45,Eaton County,19,4,15
49,Utah,26,Michigan,57,Gratiot County,11,0,11
49,Utah,26,Michigan,59,Hillsdale County,0,11,-11
49,Utah,26,Michigan,61,Houghton County,21,0,21
49,Utah,26,Michigan,65,Ingham County,66,84,-18
49,Utah,26,Michigan,67,Ionia County,0,7,-7
49,Utah,26,Michigan,75,Jackson County,127,0,127
49,Utah,26,Michigan,77,Kalamazoo County,0,17,-17
49,Utah,26,Michigan,81,Kent County,69,0,69
49,Utah,26,Michigan,89,Leelanau County,30,0,30
49,Utah,26,Michigan,91,Lenawee County,2,0,2
49,Utah,26,Michigan,93,Livingston County,14,0,14
49,Utah,26,Michigan,97,Mackinac County,0,2,-2
49,Utah,26,Michigan,99,Macomb County,130,59,71
49,Utah,26,Michigan,103,Marquette County,22,0,22
49,Utah,26,Michigan,107,Mecosta County,0,49,-49
49,Utah,26,Michigan,115,Monroe County,10,0,10
49,Utah,26,Michigan,121,Muskegon County,8,0,8
49,Utah,26,Michigan,125,Oakland County,265,120,145
49,Utah,26,Michigan,127,Oceana County,0,5,-5
49,Utah,26,Michigan,139,Ottawa County,15,0,15
49,Utah,26,Michigan,147,St. Clair County,14,0,14
49,Utah,26,Michigan,149,St. Joseph County,0,16,-16
49,Utah,26,Michigan,155,Shiawassee County,0,42,-42
49,Utah,26,Michigan,161,Washtenaw County,66,200,-134
49,Utah,26,Michigan,163,Wayne County,90,47,43
49,Utah,27,Minnesota,3,Anoka County,6,210,-204
49,Utah,27,Minnesota,9,Benton County,27,9,18
49,Utah,27,Minnesota,13,Blue Earth County,0,29,-29
49,Utah,27,Minnesota,19,Carver County,96,10,86
49,Utah,27,Minnesota,21,Cass County,9,0,9
49,Utah,27,Minnesota,37,Dakota County,204,60,144
49,Utah,27,Minnesota,49,Goodhue County,12,0,12
49,Utah,27,Minnesota,53,Hennepin County,264,147,117
49,Utah,27,Minnesota,59,Isanti County,0,5,-5
49,Utah,27,Minnesota,67,Kandiyohi County,0,5,-5
49,Utah,27,Minnesota,83,Lyon County,0,4,-4
49,Utah,27,Minnesota,87,Mahnomen County,0,3,-3
49,Utah,27,Minnesota,95,Mille Lacs County,0,9,-9
49,Utah,27,Minnesota,99,Mower County,0,1,-1
49,Utah,27,Minnesota,107,Norman County,0,1,-1
49,Utah,27,Minnesota,109,Olmsted County,46,2,44
49,Utah,27,Minnesota,115,Pine County,0,23,-23
49,Utah,27,Minnesota,123,Ramsey County,48,323,-275
49,Utah,27,Minnesota,137,St. Louis County,0,35,-35
49,Utah,27,Minnesota,139,Scott County,0,112,-112
49,Utah,27,Minnesota,145,Stearns County,0,65,-65
49,Utah,27,Minnesota,153,Todd County,0,2,-2
49,Utah,27,Minnesota,159,Wadena County,0,1,-1
49,Utah,27,Minnesota,161,Waseca County,10,0,10
49,Utah,27,Minnesota,163,Washington County,36,22,14
49,Utah,27,Minnesota,169,Winona County,26,0,26
49,Utah,27,Minnesota,171,Wright County,9,27,-18
49,Utah,28,Mississippi,5,Amite County,42,0,42
49,Utah,28,Mississippi,33,DeSoto County,48,0,48
49,Utah,28,Mississippi,35,Forrest County,171,0,171
49,Utah,28,Mississippi,47,Harrison County,111,0,111
49,Utah,28,Mississippi,53,Humphreys County,97,0,97
49,Utah,28,Mississippi,59,Jackson County,97,0,97
49,Utah,28,Mississippi,73,Lamar County,9,0,9
49,Utah,28,Mississippi,91,Marion County,0,7,-7
49,Utah,28,Mississippi,103,Noxubee County,0,16,-16
49,Utah,28,Mississippi,105,Oktibbeha County,0,17,-17
49,Utah,28,Mississippi,109,Pearl River County,0,70,-70
49,Utah,28,Mississippi,121,Rankin County,20,5,15
49,Utah,28,Mississippi,131,Stone County,14,0,14
49,Utah,29,Missouri,1,Adair County,82,96,-14
49,Utah,29,Missouri,19,Boone County,134,31,103
49,Utah,29,Missouri,21,Buchanan County,78,0,78
49,Utah,29,Missouri,25,Caldwell County,49,0,49
49,Utah,29,Missouri,37,Cass County,32,0,32
49,Utah,29,Missouri,39,Cedar County,5,0,5
49,Utah,29,Missouri,47,Clay County,138,142,-4
49,Utah,29,Missouri,49,Clinton County,4,0,4
49,Utah,29,Missouri,61,Daviess County,0,52,-52
49,Utah,29,Missouri,65,Dent County,0,19,-19
49,Utah,29,Missouri,67,Douglas County,20,0,20
49,Utah,29,Missouri,71,Franklin County,38,5,33
49,Utah,29,Missouri,77,Greene County,83,31,52
49,Utah,29,Missouri,81,Harrison County,21,0,21
49,Utah,29,Missouri,83,Henry County,0,1,-1
49,Utah,29,Missouri,91,Howell County,0,28,-28
49,Utah,29,Missouri,95,Jackson County,166,155,11
49,Utah,29,Missouri,97,Jasper County,91,8,83
49,Utah,29,Missouri,99,Jefferson County,163,24,139
49,Utah,29,Missouri,101,Johnson County,20,28,-8
49,Utah,29,Missouri,107,Lafayette County,0,4,-4
49,Utah,29,Missouri,109,Lawrence County,9,0,9
49,Utah,29,Missouri,119,McDonald County,0,9,-9
49,Utah,29,Missouri,141,Morgan County,0,5,-5
49,Utah,29,Missouri,147,Nodaway County,53,0,53
49,Utah,29,Missouri,165,Platte County,94,0,94
49,Utah,29,Missouri,169,Pulaski County,26,61,-35
49,Utah,29,Missouri,175,Randolph County,5,0,5
49,Utah,29,Missouri,183,St. Charles County,85,0,85
49,Utah,29,Missouri,189,St. Louis County,129,34,95
49,Utah,29,Missouri,219,Warren County,37,0,37
49,Utah,29,Missouri,510,St. Louis city,239,26,213
49,Utah,30,Montana,3,Big Horn County,5,0,5
49,Utah,30,Montana,5,Blaine County,12,7,5
49,Utah,30,Montana,7,Broadwater County,117,0,117
49,Utah,30,Montana,9,Carbon County,27,16,11
49,Utah,30,Montana,13,Cascade County,205,38,167
49,Utah,30,Montana,15,Chouteau County,21,0,21
49,Utah,30,Montana,17,Custer County,13,29,-16
49,Utah,30,Montana,19,Daniels County,0,23,-23
49,Utah,30,Montana,21,Dawson County,0,50,-50
49,Utah,30,Montana,23,Deer Lodge County,59,39,20
49,Utah,30,Montana,27,Fergus County,0,5,-5
49,Utah,30,Montana,29,Flathead County,121,129,-8
49,Utah,30,Montana,31,Gallatin County,255,192,63
49,Utah,30,Montana,35,Glacier County,0,19,-19
49,Utah,30,Montana,41,Hill County,0,21,-21
49,Utah,30,Montana,43,Jefferson County,0,102,-102
49,Utah,30,Montana,47,Lake County,0,38,-38
49,Utah,30,Montana,49,Lewis and Clark County,116,204,-88
49,Utah,30,Montana,53,Lincoln County,0,9,-9
49,Utah,30,Montana,57,Madison County,41,0,41
49,Utah,30,Montana,61,Mineral County,0,6,-6
49,Utah,30,Montana,63,Missoula County,196,143,53
49,Utah,30,Montana,67,Park County,13,8,5
49,Utah,30,Montana,75,Powder River County,0,4,-4
49,Utah,30,Montana,81,Ravalli County,0,66,-66
49,Utah,30,Montana,83,Richland County,0,143,-143
49,Utah,30,Montana,85,Roosevelt County,0,19,-19
49,Utah,30,Montana,89,Sanders County,5,0,5
49,Utah,30,Montana,91,Sheridan County,9,7,2
49,Utah,30,Montana,93,Silver Bow County,8,5,3
49,Utah,30,Montana,99,Teton County,23,19,4
49,Utah,30,Montana,101,Toole County,46,0,46
49,Utah,30,Montana,107,Wheatland County,0,2,-2
49,Utah,30,Montana,111,Yellowstone County,460,165,295
49,Utah,31,Nebraska,1,Adams County,7,53,-46
49,Utah,31,Nebraska,19,Buffalo County,44,53,-9
49,Utah,31,Nebraska,31,Cherry County,4,0,4
49,Utah,31,Nebraska,33,Cheyenne County,0,9,-9
49,Utah,31,Nebraska,43,Dakota County,0,367,-367
49,Utah,31,Nebraska,55,Douglas County,141,379,-238
49,Utah,31,Nebraska,57,Dundy County,0,1,-1
49,Utah,31,Nebraska,61,Franklin County,0,2,-2
49,Utah,31,Nebraska,79,Hall County,98,24,74
49,Utah,31,Nebraska,109,Lancaster County,21,203,-182
49,Utah,31,Nebraska,111,Lincoln County,7,3,4
49,Utah,31,Nebraska,119,Madison County,120,51,69
49,Utah,31,Nebraska,135,Perkins County,0,6,-6
49,Utah,31,Nebraska,145,Red Willow County,0,1,-1
49,Utah,31,Nebraska,153,Sarpy County,37,45,-8
49,Utah,31,Nebraska,157,Scotts Bluff County,0,5,-5
49,Utah,31,Nebraska,159,Seward County,0,2,-2
49,Utah,31,Nebraska,161,Sheridan County,0,8,-8
49,Utah,31,Nebraska,177,Washington County,17,20,-3
49,Utah,32,Nevada,1,Churchill County,44,0,44
49,Utah,32,Nevada,3,Clark County,4197,3740,457
49,Utah,32,Nevada,5,Douglas County,210,80,130
49,Utah,32,Nevada,7,Elko County,282,331,-49
49,Utah,32,Nevada,9,Esmeralda County,6,0,6
49,Utah,32,Nevada,11,Eureka County,0,19,-19
49,Utah,32,Nevada,13,Humboldt County,29,30,-1
49,Utah,32,Nevada,15,Lander County,26,7,19
49,Utah,32,Nevada,17,Lincoln County,142,38,104
49,Utah,32,Nevada,19,Lyon County,138,92,46
49,Utah,32,Nevada,21,Mineral County,5,53,-48
49,Utah,32,Nevada,23,Nye County,56,102,-46
49,Utah,32,Nevada,27,Pershing County,0,7,-7
49,Utah,32,Nevada,31,Washoe County,530,601,-71
49,Utah,32,Nevada,33,White Pine County,12,49,-37
49,Utah,32,Nevada,510,Carson City,26,91,-65
49,Utah,33,New Hampshire,1,Belknap County,5,12,-7
49,Utah,33,New Hampshire,5,Cheshire County,0,14,-14
49,Utah,33,New Hampshire,9,Grafton County,0,67,-67
49,Utah,33,New Hampshire,11,Hillsborough County,7,45,-38
49,Utah,33,New Hampshire,13,Merrimack County,10,20,-10
49,Utah,33,New Hampshire,15,Rockingham County,63,75,-12
49,Utah,33,New Hampshire,17,Strafford County,0,16,-16
49,Utah,34,New Jersey,1,Atlantic County,27,0,27
49,Utah,34,New Jersey,3,Bergen County,101,26,75
49,Utah,34,New Jersey,5,Burlington County,31,13,18
49,Utah,34,New Jersey,9,Cape May County,26,0,26
49,Utah,34,New Jersey,13,Essex County,190,0,190
49,Utah,34,New Jersey,15,Gloucester County,6,0,6
49,Utah,34,New Jersey,17,Hudson County,115,14,101
49,Utah,34,New Jersey,19,Hunterdon County,17,0,17
49,Utah,34,New Jersey,21,Mercer County,0,60,-60
49,Utah,34,New Jersey,23,Middlesex County,48,0,48
49,Utah,34,New Jersey,25,Monmouth County,17,0,17
49,Utah,34,New Jersey,27,Morris County,66,33,33
49,Utah,34,New Jersey,29,Ocean County,57,0,57
49,Utah,34,New Jersey,35,Somerset County,35,6,29
49,Utah,34,New Jersey,37,Sussex County,0,8,-8
49,Utah,34,New Jersey,39,Union County,15,26,-11
49,Utah,35,New Mexico,1,Bernalillo County,450,308,142
49,Utah,35,New Mexico,9,Curry County,0,16,-16
49,Utah,35,New Mexico,13,Doña Ana County,159,47,112
49,Utah,35,New Mexico,17,Grant County,16,4,12
49,Utah,35,New Mexico,25,Lea County,0,27,-27
49,Utah,35,New Mexico,28,Los Alamos County,90,32,58
49,Utah,35,New Mexico,31,McKinley County,0,55,-55
49,Utah,35,New Mexico,35,Otero County,44,27,17
49,Utah,35,New Mexico,41,Roosevelt County,22,0,22
49,Utah,35,New Mexico,43,Sandoval County,271,329,-58
49,Utah,35,New Mexico,45,San Juan County,211,191,20
49,Utah,35,New Mexico,47,San Miguel County,26,0,26
49,Utah,35,New Mexico,49,Santa Fe County,14,37,-23
49,Utah,35,New Mexico,51,Sierra County,35,0,35
49,Utah,35,New Mexico,53,Socorro County,6,0,6
49,Utah,35,New Mexico,55,Taos County,13,8,5
49,Utah,35,New Mexico,61,Valencia County,47,0,47
49,Utah,36,New York,1,Albany County,75,19,56
49,Utah,36,New York,5,Bronx County,51,119,-68
49,Utah,36,New York,7,Broome County,0,16,-16
49,Utah,36,New York,9,Cattaraugus County,18,0,18
49,Utah,36,New York,13,Chautauqua County,0,16,-16
49,Utah,36,New York,19,Clinton County,0,3,-3
49,Utah,36,New York,21,Columbia County,4,0,4
49,Utah,36,New York,23,Cortland County,0,7,-7
49,Utah,36,New York,27,Dutchess County,0,18,-18
49,Utah,36,New York,29,Erie County,130,11,119
49,Utah,36,New York,31,Essex County,0,43,-43
49,Utah,36,New York,45,Jefferson County,136,12,124
49,Utah,36,New York,47,Kings County,277,164,113
49,Utah,36,New York,51,Livingston County,13,0,13
49,Utah,36,New York,55,Monroe County,89,65,24
49,Utah,36,New York,59,Nassau County,25,0,25
49,Utah,36,New York,61,New York County,643,227,416
49,Utah,36,New York,65,Oneida County,70,21,49
49,Utah,36,New York,67,Onondaga County,145,35,110
49,Utah,36,New York,69,Ontario County,25,15,10
49,Utah,36,New York,71,Orange County,0,24,-24
49,Utah,36,New York,75,Oswego County,30,0,30
49,Utah,36,New York,81,Queens County,156,35,121
49,Utah,36,New York,83,Rensselaer County,0,13,-13
49,Utah,36,New York,85,Richmond County,12,0,12
49,Utah,36,New York,89,St. Lawrence County,6,125,-119
49,Utah,36,New York,91,Saratoga County,0,9,-9
49,Utah,36,New York,93,Schenectady County,30,0,30
49,Utah,36,New York,97,Schuyler County,3,3,0
49,Utah,36,New York,103,Suffolk County,55,63,-8
49,Utah,36,New York,107,Tioga County,0,4,-4
49,Utah,36,New York,109,Tompkins County,0,19,-19
49,Utah,36,New York,117,Wayne County,0,39,-39
49,Utah,36,New York,119,Westchester County,219,71,148
49,Utah,36,New York,121,Wyoming County,11,22,-11
49,Utah,36,New York,123,Yates County,16,0,16
49,Utah,37,North Carolina,1,Alamance County,0,13,-13
49,Utah,37,North Carolina,19,Brunswick County,0,114,-114
49,Utah,37,North Carolina,21,Buncombe County,35,0,35
49,Utah,37,North Carolina,31,Carteret County,0,7,-7
49,Utah,37,North Carolina,35,Catawba County,9,0,9
49,Utah,37,North Carolina,37,Chatham County,0,21,-21
49,Utah,37,North Carolina,45,Cleveland County,0,8,-8
49,Utah,37,North Carolina,47,Columbus County,0,10,-10
49,Utah,37,North Carolina,49,Craven County,18,0,18
49,Utah,37,North Carolina,51,Cumberland County,38,55,-17
49,Utah,37,North Carolina,55,Dare County,19,96,-77
49,Utah,37,North Carolina,57,Davidson County,0,52,-52
49,Utah,37,North Carolina,63,Durham County,203,55,148
49,Utah,37,North Carolina,65,Edgecombe County,73,0,73
49,Utah,37,North Carolina,67,Forsyth County,41,88,-47
49,Utah,37,North Carolina,71,Gaston County,158,0,158
49,Utah,37,North Carolina,81,Guilford County,10,3,7
49,Utah,37,North Carolina,85,Harnett County,19,0,19
49,Utah,37,North Carolina,89,Henderson County,0,22,-22
49,Utah,37,North Carolina,99,Jackson County,4,0,4
49,Utah,37,North Carolina,101,Johnston County,8,0,8
49,Utah,37,North Carolina,105,Lee County,121,0,121
49,Utah,37,North Carolina,107,Lenoir County,9,31,-22
49,Utah,37,North Carolina,111,McDowell County,11,30,-19
49,Utah,37,North Carolina,113,Macon County,0,5,-5
49,Utah,37,North Carolina,119,Mecklenburg County,105,62,43
49,Utah,37,North Carolina,127,Nash County,11,24,-13
49,Utah,37,North Carolina,129,New Hanover County,13,0,13
49,Utah,37,North Carolina,133,Onslow County,107,124,-17
49,Utah,37,North Carolina,135,Orange County,50,23,27
49,Utah,37,North Carolina,141,Pender County,0,9,-9
49,Utah,37,North Carolina,145,Person County,13,0,13
49,Utah,37,North Carolina,147,Pitt County,56,13,43
49,Utah,37,North Carolina,173,Swain County,0,10,-10
49,Utah,37,North Carolina,179,Union County,68,49,19
49,Utah,37,North Carolina,183,Wake County,119,42,77
49,Utah,37,North Carolina,189,Watauga County,0,2,-2
49,Utah,37,North Carolina,191,Wayne County,12,9,3
49,Utah,37,North Carolina,195,Wilson County,5,0,5
49,Utah,38,North Dakota,11,Bowman County,0,17,-17
49,Utah,38,North Dakota,13,Burke County,22,0,22
49,Utah,38,North Dakota,15,Burleigh County,46,0,46
49,Utah,38,North Dakota,17,Cass County,27,9,18
49,Utah,38,North Dakota,25,Dunn County,0,2,-2
49,Utah,38,North Dakota,33,Golden Valley County,0,5,-5
49,Utah,38,North Dakota,35,Grand Forks County,119,0,119
49,Utah,38,North Dakota,41,Hettinger County,0,6,-6
49,Utah,38,North Dakota,45,LaMoure County,4,0,4
49,Utah,38,North Dakota,53,McKenzie County,0,4,-4
49,Utah,38,North Dakota,59,Morton County,26,2,24
49,Utah,38,North Dakota,61,Mountrail County,5,3,2
49,Utah,38,North Dakota,67,Pembina County,0,14,-14
49,Utah,38,North Dakota,71,Ramsey County,0,4,-4
49,Utah,38,North Dakota,75,Renville County,0,7,-7
49,Utah,38,North Dakota,87,Slope County,52,0,52
49,Utah,38,North Dakota,89,Stark County,225,20,205
49,Utah,38,North Dakota,93,Stutsman County,0,9,-9
49,Utah,38,North Dakota,97,Traill County,0,7,-7
49,Utah,38,North Dakota,99,Walsh County,12,0,12
49,Utah,38,North Dakota,101,Ward County,149,135,14
49,Utah,38,North Dakota,105,Williams County,61,46,15
49,Utah,39,Ohio,1,Adams County,0,16,-16
49,Utah,39,Ohio,3,Allen County,50,33,17
49,Utah,39,Ohio,7,Ashtabula County,0,3,-3
49,Utah,39,Ohio,17,Butler County,70,43,27
49,Utah,39,Ohio,23,Clark County,59,30,29
49,Utah,39,Ohio,33,Crawford County,12,0,12
49,Utah,39,Ohio,35,Cuyahoga County,404,298,106
49,Utah,39,Ohio,41,Delaware County,8,0,8
49,Utah,39,Ohio,43,Erie County,1,0,1
49,Utah,39,Ohio,49,Franklin County,37,173,-136
49,Utah,39,Ohio,57,Greene County,84,54,30
49,Utah,39,Ohio,61,Hamilton County,68,40,28
49,Utah,39,Ohio,63,Hancock County,6,0,6
49,Utah,39,Ohio,65,Hardin County,0,12,-12
49,Utah,39,Ohio,71,Highland County,0,21,-21
49,Utah,39,Ohio,75,Holmes County,52,0,52
49,Utah,39,Ohio,77,Huron County,0,261,-261
49,Utah,39,Ohio,85,Lake County,63,15,48
49,Utah,39,Ohio,91,Logan County,11,8,3
49,Utah,39,Ohio,93,Lorain County,2,106,-104
49,Utah,39,Ohio,95,Lucas County,79,17,62
49,Utah,39,Ohio,99,Mahoning County,0,52,-52
49,Utah,39,Ohio,103,Medina County,0,15,-15
49,Utah,39,Ohio,105,Meigs County,0,7,-7
49,Utah,39,Ohio,109,Miami County,140,18,122
49,Utah,39,Ohio,113,Montgomery County,165,98,67
49,Utah,39,Ohio,117,Morrow County,70,0,70
49,Utah,39,Ohio,119,Muskingum County,28,0,28
49,Utah,39,Ohio,125,Paulding County,9,0,9
49,Utah,39,Ohio,141,Ross County,16,0,16
49,Utah,39,Ohio,151,Stark County,9,25,-16
49,Utah,39,Ohio,153,Summit County,4,118,-114
49,Utah,39,Ohio,155,Trumbull County,24,0,24
49,Utah,39,Ohio,157,Tuscarawas County,28,0,28
49,Utah,39,Ohio,165,Warren County,21,74,-53
49,Utah,39,Ohio,171,Williams County,11,0,11
49,Utah,39,Ohio,173,Wood County,0,22,-22
49,Utah,4,Arizona,1,Apache County,41,5,36
49,Utah,4,Arizona,3,Cochise County,208,132,76
49,Utah,4,Arizona,5,Coconino County,308,301,7
49,Utah,4,Arizona,7,Gila County,47,25,22
49,Utah,4,Arizona,9,Graham County,208,235,-27
49,Utah,4,Arizona,12,La Paz County,9,0,9
49,Utah,4,Arizona,13,Maricopa County,3962,5362,-1400
49,Utah,4,Arizona,15,Mohave County,1069,1416,-347
49,Utah,4,Arizona,17,Navajo County,415,71,344
49,Utah,4,Arizona,19,Pima County,666,408,258
49,Utah,4,Arizona,21,Pinal County,416,282,134
49,Utah,4,Arizona,23,Santa Cruz County,37,0,37
49,Utah,4,Arizona,25,Yavapai County,30,63,-33
49,Utah,4,Arizona,27,Yuma County,257,88,169
49,Utah,40,Oklahoma,3,Alfalfa County,0,8,-8
49,Utah,40,Oklahoma,13,Bryan County,79,0,79
49,Utah,40,Oklahoma,17,Canadian County,134,0,134
49,Utah,40,Oklahoma,19,Carter County,0,7,-7
49,Utah,40,Oklahoma,27,Cleveland County,28,8,20
49,Utah,40,Oklahoma,31,Comanche County,44,111,-67
49,Utah,40,Oklahoma,37,Creek County,24,0,24
49,Utah,40,Oklahoma,41,Delaware County,0,4,-4
49,Utah,40,Oklahoma,47,Garfield County,0,102,-102
49,Utah,40,Oklahoma,49,Garvin County,0,15,-15
49,Utah,40,Oklahoma,53,Grant County,0,6,-6
49,Utah,40,Oklahoma,59,Harper County,0,5,-5
49,Utah,40,Oklahoma,71,Kay County,0,11,-11
49,Utah,40,Oklahoma,87,McClain County,0,17,-17
49,Utah,40,Oklahoma,93,Major County,0,7,-7
49,Utah,40,Oklahoma,101,Muskogee County,0,14,-14
49,Utah,40,Oklahoma,103,Noble County,0,8,-8
49,Utah,40,Oklahoma,107,Okfuskee County,22,0,22
49,Utah,40,Oklahoma,109,Oklahoma County,348,226,122
49,Utah,40,Oklahoma,113,Osage County,9,16,-7
49,Utah,40,Oklahoma,115,Ottawa County,12,4,8
49,Utah,40,Oklahoma,119,Payne County,14,21,-7
49,Utah,40,Oklahoma,121,Pittsburg County,16,0,16
49,Utah,40,Oklahoma,123,Pontotoc County,16,0,16
49,Utah,40,Oklahoma,131,Rogers County,6,18,-12
49,Utah,40,Oklahoma,133,Seminole County,0,10,-10
49,Utah,40,Oklahoma,137,Stephens County,18,33,-15
49,Utah,40,Oklahoma,143,Tulsa County,235,75,160
49,Utah,40,Oklahoma,147,Washington County,13,0,13
49,Utah,40,Oklahoma,151,Woods County,0,5,-5
49,Utah,41,Oregon,3,Benton County,98,127,-29
49,Utah,41,Oregon,5,Clackamas County,217,162,55
49,Utah,41,Oregon,7,Clatsop County,0,12,-12
49,Utah,41,Oregon,9,Columbia County,0,9,-9
49,Utah,41,Oregon,11,Coos County,0,117,-117
49,Utah,41,Oregon,15,Curry County,14,148,-134
49,Utah,41,Oregon,17,Deschutes County,271,108,163
49,Utah,41,Oregon,19,Douglas County,69,136,-67
49,Utah,41,Oregon,25,Harney County,0,9,-9
49,Utah,41,Oregon,27,Hood River County,3,0,3
49,Utah,41,Oregon,29,Jackson County,79,70,9
49,Utah,41,Oregon,33,Josephine County,0,32,-32
49,Utah,41,Oregon,35,Klamath County,21,159,-138
49,Utah,41,Oregon,37,Lake County,0,71,-71
49,Utah,41,Oregon,39,Lane County,257,236,21
49,Utah,41,Oregon,41,Lincoln County,48,40,8
49,Utah,41,Oregon,43,Linn County,182,1,181
49,Utah,41,Oregon,45,Malheur County,26,84,-58
49,Utah,41,Oregon,47,Marion County,141,186,-45
49,Utah,41,Oregon,49,Morrow County,43,0,43
49,Utah,41,Oregon,51,Multnomah County,491,650,-159
49,Utah,41,Oregon,53,Polk County,111,49,62
49,Utah,41,Oregon,55,Sherman County,0,1,-1
49,Utah,41,Oregon,57,Tillamook County,0,20,-20
49,Utah,41,Oregon,59,Umatilla County,56,0,56
49,Utah,41,Oregon,61,Union County,27,82,-55
49,Utah,41,Oregon,65,Wasco County,4,0,4
49,Utah,41,Oregon,67,Washington County,498,479,19
49,Utah,41,Oregon,71,Yamhill County,83,59,24
49,Utah,42,Pennsylvania,1,Adams County,9,0,9
49,Utah,42,Pennsylvania,3,Allegheny County,124,419,-295
49,Utah,42,Pennsylvania,7,Beaver County,18,53,-35
49,Utah,42,Pennsylvania,11,Berks County,18,0,18
49,Utah,42,Pennsylvania,13,Blair County,0,3,-3
49,Utah,42,Pennsylvania,15,Bradford County,0,9,-9
49,Utah,42,Pennsylvania,17,Bucks County,28,141,-113
49,Utah,42,Pennsylvania,19,Butler County,15,60,-45
49,Utah,42,Pennsylvania,27,Centre County,44,72,-28
49,Utah,42,Pennsylvania,29,Chester County,3,17,-14
49,Utah,42,Pennsylvania,31,Clarion County,12,0,12
49,Utah,42,Pennsylvania,43,Dauphin County,0,51,-51
49,Utah,42,Pennsylvania,45,Delaware County,78,35,43
49,Utah,42,Pennsylvania,49,Erie County,34,0,34
49,Utah,42,Pennsylvania,55,Franklin County,0,71,-71
49,Utah,42,Pennsylvania,61,Huntingdon County,2,0,2
49,Utah,42,Pennsylvania,63,Indiana County,6,0,6
49,Utah,42,Pennsylvania,69,Lackawanna County,0,40,-40
49,Utah,42,Pennsylvania,71,Lancaster County,11,0,11
49,Utah,42,Pennsylvania,73,Lawrence County,18,0,18
49,Utah,42,Pennsylvania,75,Lebanon County,38,0,38
49,Utah,42,Pennsylvania,77,Lehigh County,29,26,3
49,Utah,42,Pennsylvania,79,Luzerne County,9,56,-47
49,Utah,42,Pennsylvania,81,Lycoming County,0,10,-10
49,Utah,42,Pennsylvania,83,McKean County,0,27,-27
49,Utah,42,Pennsylvania,85,Mercer County,7,13,-6
49,Utah,42,Pennsylvania,89,Monroe County,3,0,3
49,Utah,42,Pennsylvania,91,Montgomery County,207,23,184
49,Utah,42,Pennsylvania,93,Montour County,10,0,10
49,Utah,42,Pennsylvania,95,Northampton County,114,0,114
49,Utah,42,Pennsylvania,99,Perry County,4,0,4
49,Utah,42,Pennsylvania,101,Philadelphia County,405,44,361
49,Utah,42,Pennsylvania,107,Schuylkill County,27,18,9
49,Utah,42,Pennsylvania,111,Somerset County,39,0,39
49,Utah,42,Pennsylvania,115,Susquehanna County,11,4,7
49,Utah,42,Pennsylvania,117,Tioga County,23,0,23
49,Utah,42,Pennsylvania,119,Union County,85,10,75
49,Utah,42,Pennsylvania,125,Washington County,8,5,3
49,Utah,42,Pennsylvania,127,Wayne County,40,0,40
49,Utah,42,Pennsylvania,129,Westmoreland County,0,57,-57
49,Utah,42,Pennsylvania,131,Wyoming County,0,3,-3
49,Utah,42,Pennsylvania,133,York County,5,91,-86
49,Utah,44,Rhode Island,1,Bristol County,0,27,-27
49,Utah,44,Rhode Island,3,Kent County,0,17,-17
49,Utah,44,Rhode Island,7,Providence County,15,88,-73
49,Utah,44,Rhode Island,9,Washington County,142,0,142
49,Utah,45,South Carolina,7,Anderson County,27,0,27
49,Utah,45,South Carolina,13,Beaufort County,27,86,-59
49,Utah,45,South Carolina,15,Berkeley County,36,91,-55
49,Utah,45,South Carolina,19,Charleston County,20,35,-15
49,Utah,45,South Carolina,21,Cherokee County,0,23,-23
49,Utah,45,South Carolina,31,Darlington County,10,17,-7
49,Utah,45,South Carolina,35,Dorchester County,63,0,63
49,Utah,45,South Carolina,41,Florence County,40,0,40
49,Utah,45,South Carolina,45,Greenville County,91,44,47
49,Utah,45,South Carolina,51,Horry County,0,15,-15
49,Utah,45,South Carolina,55,Kershaw County,0,22,-22
49,Utah,45,South Carolina,63,Lexington County,79,14,65
49,Utah,45,South Carolina,73,Oconee County,0,61,-61
49,Utah,45,South Carolina,75,Orangeburg County,12,0,12
49,Utah,45,South Carolina,77,Pickens County,157,30,127
49,Utah,45,South Carolina,79,Richland County,158,121,37
49,Utah,45,South Carolina,83,Spartanburg County,70,7,63
49,Utah,45,South Carolina,85,Sumter County,50,0,50
49,Utah,45,South Carolina,91,York County,129,5,124
49,Utah,46,South Dakota,5,Beadle County,0,33,-33
49,Utah,46,South Dakota,11,Brookings County,0,39,-39
49,Utah,46,South Dakota,13,Brown County,0,88,-88
49,Utah,46,South Dakota,23,Charles Mix County,32,0,32
49,Utah,46,South Dakota,29,Codington County,0,18,-18
49,Utah,46,South Dakota,47,Fall River County,6,0,6
49,Utah,46,South Dakota,71,Jackson County,0,9,-9
49,Utah,46,South Dakota,81,Lawrence County,0,14,-14
49,Utah,46,South Dakota,91,Marshall County,0,5,-5
49,Utah,46,South Dakota,93,Meade County,0,26,-26
49,Utah,46,South Dakota,99,Minnehaha County,106,37,69
49,Utah,46,South Dakota,102,Oglala Lakota County,0,28,-28
49,Utah,46,South Dakota,103,Pennington County,138,0,138
49,Utah,47,Tennessee,1,Anderson County,12,0,12
49,Utah,47,Tennessee,11,Bradley County,37,0,37
49,Utah,47,Tennessee,23,Chester County,7,0,7
49,Utah,47,Tennessee,37,Davidson County,148,5,143
49,Utah,47,Tennessee,47,Fayette County,0,3,-3
49,Utah,47,Tennessee,49,Fentress County,18,0,18
49,Utah,47,Tennessee,51,Franklin County,2,11,-9
49,Utah,47,Tennessee,57,Grainger County,0,16,-16
49,Utah,47,Tennessee,65,Hamilton County,10,4,6
49,Utah,47,Tennessee,73,Hawkins County,11,0,11
49,Utah,47,Tennessee,79,Henry County,13,31,-18
49,Utah,47,Tennessee,93,Knox County,172,86,86
49,Utah,47,Tennessee,105,Loudon County,0,13,-13
49,Utah,47,Tennessee,119,Maury County,0,9,-9
49,Utah,47,Tennessee,125,Montgomery County,120,27,93
49,Utah,47,Tennessee,131,Obion County,26,0,26
49,Utah,47,Tennessee,141,Putnam County,2,24,-22
49,Utah,47,Tennessee,147,Robertson County,99,0,99
49,Utah,47,Tennessee,153,Sequatchie County,0,29,-29
49,Utah,47,Tennessee,155,Sevier County,19,0,19
49,Utah,47,Tennessee,157,Shelby County,93,79,14
49,Utah,47,Tennessee,163,Sullivan County,34,10,24
49,Utah,47,Tennessee,165,Sumner County,115,70,45
49,Utah,47,Tennessee,177,Warren County,17,0,17
49,Utah,47,Tennessee,179,Washington County,0,162,-162
49,Utah,47,Tennessee,181,Wayne County,0,19,-19
49,Utah,47,Tennessee,187,Williamson County,16,15,1
49,Utah,47,Tennessee,189,Wilson County,61,0,61
49,Utah,48,Texas,7,Aransas County,0,105,-105
49,Utah,48,Texas,21,Bastrop County,13,0,13
49,Utah,48,Texas,27,Bell County,110,202,-92
49,Utah,48,Texas,29,Bexar County,500,304,196
49,Utah,48,Texas,35,Bosque County,3,0,3
49,Utah,48,Texas,37,Bowie County,107,0,107
49,Utah,48,Texas,39,Brazoria County,19,75,-56
49,Utah,48,Texas,41,Brazos County,32,48,-16
49,Utah,48,Texas,43,Brewster County,0,3,-3
49,Utah,48,Texas,55,Caldwell County,0,60,-60
49,Utah,48,Texas,61,Cameron County,7,19,-12
49,Utah,48,Texas,71,Chambers County,0,75,-75
49,Utah,48,Texas,85,Collin County,385,425,-40
49,Utah,48,Texas,91,Comal County,0,50,-50
49,Utah,48,Texas,97,Cooke County,0,11,-11
49,Utah,48,Texas,99,Coryell County,0,47,-47
49,Utah,48,Texas,113,Dallas County,450,295,155
49,Utah,48,Texas,121,Denton County,462,333,129
49,Utah,48,Texas,135,Ector County,43,0,43
49,Utah,48,Texas,139,Ellis County,0,19,-19
49,Utah,48,Texas,141,El Paso County,222,110,112
49,Utah,48,Texas,157,Fort Bend County,83,100,-17
49,Utah,48,Texas,167,Galveston County,146,122,24
49,Utah,48,Texas,171,Gillespie County,0,85,-85
49,Utah,48,Texas,177,Gonzales County,0,14,-14
49,Utah,48,Texas,179,Gray County,0,16,-16
49,Utah,48,Texas,185,Grimes County,66,16,50
49,Utah,48,Texas,187,Guadalupe County,8,0,8
49,Utah,48,Texas,201,Harris County,824,1245,-421
49,Utah,48,Texas,203,Harrison County,0,9,-9
49,Utah,48,Texas,207,Haskell County,0,8,-8
49,Utah,48,Texas,209,Hays County,94,129,-35
49,Utah,48,Texas,213,Henderson County,0,1,-1
49,Utah,48,Texas,215,Hidalgo County,91,107,-16
49,Utah,48,Texas,217,Hill County,15,67,-52
49,Utah,48,Texas,219,Hockley County,6,0,6
49,Utah,48,Texas,225,Houston County,20,28,-8
49,Utah,48,Texas,231,Hunt County,25,0,25
49,Utah,48,Texas,241,Jasper County,0,11,-11
49,Utah,48,Texas,243,Jeff Davis County,0,8,-8
49,Utah,48,Texas,245,Jefferson County,12,6,6
49,Utah,48,Texas,251,Johnson County,21,30,-9
49,Utah,48,Texas,259,Kendall County,0,2,-2
49,Utah,48,Texas,267,Kimble County,0,19,-19
49,Utah,48,Texas,277,Lamar County,21,0,21
49,Utah,48,Texas,279,Lamb County,0,9,-9
49,Utah,48,Texas,291,Liberty County,0,25,-25
49,Utah,48,Texas,299,Llano County,0,12,-12
49,Utah,48,Texas,303,Lubbock County,231,27,204
49,Utah,48,Texas,309,McLennan County,12,0,12
49,Utah,48,Texas,311,McMullen County,0,5,-5
49,Utah,48,Texas,313,Madison County,0,19,-19
49,Utah,48,Texas,321,Matagorda County,10,0,10
49,Utah,48,Texas,323,Maverick County,89,0,89
49,Utah,48,Texas,329,Midland County,70,394,-324
49,Utah,48,Texas,339,Montgomery County,129,257,-128
49,Utah,48,Texas,343,Morris County,0,3,-3
49,Utah,48,Texas,353,Nolan County,15,0,15
49,Utah,48,Texas,355,Nueces County,244,0,244
49,Utah,48,Texas,357,Ochiltree County,7,0,7
49,Utah,48,Texas,359,Oldham County,24,0,24
49,Utah,48,Texas,361,Orange County,17,0,17
49,Utah,48,Texas,367,Parker County,19,15,4
49,Utah,48,Texas,371,Pecos County,0,18,-18
49,Utah,48,Texas,375,Potter County,23,0,23
49,Utah,48,Texas,381,Randall County,101,31,70
49,Utah,48,Texas,409,San Patricio County,21,0,21
49,Utah,48,Texas,423,Smith County,31,26,5
49,Utah,48,Texas,439,Tarrant County,503,511,-8
49,Utah,48,Texas,441,Taylor County,62,110,-48
49,Utah,48,Texas,451,Tom Green County,50,127,-77
49,Utah,48,Texas,453,Travis County,446,547,-101
49,Utah,48,Texas,457,Tyler County,25,99,-74
49,Utah,48,Texas,465,Val Verde County,10,0,10
49,Utah,48,Texas,469,Victoria County,33,0,33
49,Utah,48,Texas,471,Walker County,29,0,29
49,Utah,48,Texas,473,Waller County,49,0,49
49,Utah,48,Texas,479,Webb County,0,18,-18
49,Utah,48,Texas,485,Wichita County,69,61,8
49,Utah,48,Texas,491,Williamson County,222,142,80
49,Utah,48,Texas,493,Wilson County,0,40,-40
49,Utah,48,Texas,497,Wise County,9,86,-77
49,Utah,48,Texas,499,Wood County,0,74,-74
49,Utah,48,Texas,507,Zavala County,0,8,-8
49,Utah,49,Utah,1,Beaver County,661,232,429
49,Utah,49,Utah,3,Box Elder County,2375,2270,105
49,Utah,49,Utah,5,Cache County,5060,4846,214
49,Utah,49,Utah,7,Carbon County,828,1024,-196
49,Utah,49,Utah,9,Daggett County,54,43,11
49,Utah,49,Utah,11,Davis County,14925,14716,209
49,Utah,49,Utah,13,Duchesne County,895,932,-37
49,Utah,49,Utah,15,Emery County,850,415,435
49,Utah,49,Utah,17,Garfield County,170,182,-12
49,Utah,49,Utah,19,Grand County,311,30,281
49,Utah,49,Utah,21,Iron County,2353,2680,-327
49,Utah,49,Utah,23,Juab County,558,538,20
49,Utah,49,Utah,25,Kane County,218,146,72
49,Utah,49,Utah,27,Millard County,414,366,48
49,Utah,49,Utah,29,Morgan County,652,357,295
49,Utah,49,Utah,31,Piute County,48,64,-16
49,Utah,49,Utah,33,Rich County,48,31,17
49,Utah,49,Utah,35,Salt Lake County,24970,20756,4214
49,Utah,49,Utah,37,San Juan County,695,276,419
49,Utah,49,Utah,39,Sanpete County,1915,3376,-1461
49,Utah,49,Utah,41,Sevier County,777,1014,-237
49,Utah,49,Utah,43,Summit County,1758,1044,714
49,Utah,49,Utah,45,Tooele County,2095,4145,-2050
49,Utah,49,Utah,47,Uintah County,1742,1103,639
49,Utah,49,Utah,49,Utah County,14329,16775,-2446
49,Utah,49,Utah,51,Wasatch County,1384,2018,-634
49,Utah,49,Utah,53,Washington County,5067,6051,-984
49,Utah,49,Utah,55,Wayne County,66,72,-6
49,Utah,49,Utah,57,Weber County,10629,10345,284
49,Utah,5,Arkansas,7,Benton County,37,118,-81
49,Utah,5,Arkansas,23,Cleburne County,31,0,31
49,Utah,5,Arkansas,33,Crawford County,0,8,-8
49,Utah,5,Arkansas,45,Faulkner County,9,0,9
49,Utah,5,Arkansas,51,Garland County,17,0,17
49,Utah,5,Arkansas,55,Greene County,14,0,14
49,Utah,5,Arkansas,67,Jackson County,0,4,-4
49,Utah,5,Arkansas,69,Jefferson County,21,0,21
49,Utah,5,Arkansas,81,Little River County,61,0,61
49,Utah,5,Arkansas,87,Madison County,0,18,-18
49,Utah,5,Arkansas,89,Marion County,25,0,25
49,Utah,5,Arkansas,91,Miller County,0,6,-6
49,Utah,5,Arkansas,103,Ouachita County,8,61,-53
49,Utah,5,Arkansas,113,Polk County,113,10,103
49,Utah,5,Arkansas,115,Pope County,0,32,-32
49,Utah,5,Arkansas,119,Pulaski County,101,162,-61
49,Utah,5,Arkansas,121,Randolph County,187,0,187
49,Utah,5,Arkansas,125,Saline County,0,48,-48
49,Utah,5,Arkansas,127,Scott County,0,13,-13
49,Utah,5,Arkansas,131,Sebastian County,6,50,-44
49,Utah,5,Arkansas,141,Van Buren County,0,15,-15
49,Utah,5,Arkansas,143,Washington County,4,65,-61
49,Utah,50,Vermont,1,Addison County,29,3,26
49,Utah,50,Vermont,5,Caledonia County,13,0,13
49,Utah,50,Vermont,7,Chittenden County,80,67,13
49,Utah,50,Vermont,21,Rutland County,6,9,-3
49,Utah,50,Vermont,23,Washington County,0,60,-60
49,Utah,50,Vermont,25,Windham County,8,2,6
49,Utah,50,Vermont,27,Windsor County,50,49,1
49,Utah,51,Virginia,3,Albemarle County,9,40,-31
49,Utah,51,Virginia,11,Appomattox County,6,0,6
49,Utah,51,Virginia,13,Arlington County,103,78,25
49,Utah,51,Virginia,15,Augusta County,8,0,8
49,Utah,51,Virginia,41,Chesterfield County,0,24,-24
49,Utah,51,Virginia,47,Culpeper County,19,19,0
49,Utah,51,Virginia,59,Fairfax County,721,638,83
49,Utah,51,Virginia,61,Fauquier County,12,116,-104
49,Utah,51,Virginia,83,Halifax County,0,4,-4
49,Utah,51,Virginia,87,Henrico County,0,26,-26
49,Utah,51,Virginia,93,Isle of Wight County,14,0,14
49,Utah,51,Virginia,107,Loudoun County,188,28,160
49,Utah,51,Virginia,121,Montgomery County,2,90,-88
49,Utah,51,Virginia,137,Orange County,2,22,-20
49,Utah,51,Virginia,139,Page County,14,29,-15
49,Utah,51,Virginia,145,Powhatan County,26,0,26
49,Utah,51,Virginia,149,Prince George County,12,0,12
49,Utah,51,Virginia,153,Prince William County,47,357,-310
49,Utah,51,Virginia,161,Roanoke County,7,83,-76
49,Utah,51,Virginia,163,Rockbridge County,45,0,45
49,Utah,51,Virginia,165,Rockingham County,0,70,-70
49,Utah,51,Virginia,177,Spotsylvania County,120,0,120
49,Utah,51,Virginia,179,Stafford County,20,69,-49
49,Utah,51,Virginia,185,Tazewell County,111,0,111
49,Utah,51,Virginia,510,Alexandria city,18,23,-5
49,Utah,51,Virginia,520,Bristol city,4,0,4
49,Utah,51,Virginia,530,Buena Vista city,41,125,-84
49,Utah,51,Virginia,540,Charlottesville city,7,0,7
49,Utah,51,Virginia,600,Fairfax city,0,7,-7
49,Utah,51,Virginia,630,Fredericksburg city,11,0,11
49,Utah,51,Virginia,650,Hampton city,205,0,205
49,Utah,51,Virginia,660,Harrisonburg city,13,0,13
49,Utah,51,Virginia,680,Lynchburg city,33,43,-10
49,Utah,51,Virginia,685,Manassas Park city,14,0,14
49,Utah,51,Virginia,700,Newport News city,0,45,-45
49,Utah,51,Virginia,710,Norfolk city,78,0,78
49,Utah,51,Virginia,740,Portsmouth city,14,0,14
49,Utah,51,Virginia,760,Richmond city,75,0,75
49,Utah,51,Virginia,770,Roanoke city,37,0,37
49,Utah,51,Virginia,790,Staunton city,11,0,11
49,Utah,51,Virginia,800,Suffolk city,39,0,39
49,Utah,51,Virginia,810,Virginia Beach city,91,148,-57
49,Utah,51,Virginia,830,Williamsburg city,13,0,13
49,Utah,53,Washington,3,Asotin County,17,7,10
49,Utah,53,Washington,5,Benton County,163,361,-198
49,Utah,53,Washington,7,Chelan County,82,0,82
49,Utah,53,Washington,9,Clallam County,20,110,-90
49,Utah,53,Washington,11,Clark County,526,321,205
49,Utah,53,Washington,13,Columbia County,0,19,-19
49,Utah,53,Washington,15,Cowlitz County,19,49,-30
49,Utah,53,Washington,19,Ferry County,0,3,-3
49,Utah,53,Washington,21,Franklin County,53,0,53
49,Utah,53,Washington,25,Grant County,40,120,-80
49,Utah,53,Washington,27,Grays Harbor County,104,52,52
49,Utah,53,Washington,29,Island County,24,52,-28
49,Utah,53,Washington,31,Jefferson County,37,0,37
49,Utah,53,Washington,33,King County,1872,1749,123
49,Utah,53,Washington,35,Kitsap County,178,134,44
49,Utah,53,Washington,37,Kittitas County,0,86,-86
49,Utah,53,Washington,39,Klickitat County,0,13,-13
49,Utah,53,Washington,41,Lewis County,11,49,-38
49,Utah,53,Washington,43,Lincoln County,15,0,15
49,Utah,53,Washington,45,Mason County,46,51,-5
49,Utah,53,Washington,47,Okanogan County,0,18,-18
49,Utah,53,Washington,49,Pacific County,31,0,31
49,Utah,53,Washington,53,Pierce County,676,908,-232
49,Utah,53,Washington,55,San Juan County,0,7,-7
49,Utah,53,Washington,57,Skagit County,20,58,-38
49,Utah,53,Washington,61,Snohomish County,485,524,-39
49,Utah,53,Washington,63,Spokane County,307,490,-183
49,Utah,53,Washington,65,Stevens County,0,31,-31
49,Utah,53,Washington,67,Thurston County,55,198,-143
49,Utah,53,Washington,71,Walla Walla County,30,68,-38
49,Utah,53,Washington,73,Whatcom County,27,225,-198
49,Utah,53,Washington,75,Whitman County,82,21,61
49,Utah,53,Washington,77,Yakima County,72,38,34
49,Utah,54,West Virginia,3,Berkeley County,0,11,-11
49,Utah,54,West Virginia,11,Cabell County,10,26,-16
49,Utah,54,West Virginia,19,Fayette County,0,7,-7
49,Utah,54,West Virginia,39,Kanawha County,79,24,55
49,Utah,54,West Virginia,41,Lewis County,0,8,-8
49,Utah,54,West Virginia,47,McDowell County,1,0,1
49,Utah,54,West Virginia,55,Mercer County,0,62,-62
49,Utah,54,West Virginia,61,Monongalia County,0,35,-35
49,Utah,54,West Virginia,71,Pendleton County,0,18,-18
49,Utah,54,West Virginia,77,Preston County,10,0,10
49,Utah,54,West Virginia,81,Raleigh County,0,10,-10
49,Utah,54,West Virginia,87,Roane County,0,4,-4
49,Utah,55,Wisconsin,1,Adams County,0,3,-3
49,Utah,55,Wisconsin,7,Bayfield County,0,7,-7
49,Utah,55,Wisconsin,9,Brown County,6,198,-192
49,Utah,55,Wisconsin,17,Chippewa County,0,4,-4
49,Utah,55,Wisconsin,19,Clark County,0,2,-2
49,Utah,55,Wisconsin,21,Columbia County,44,4,40
49,Utah,55,Wisconsin,25,Dane County,97,132,-35
49,Utah,55,Wisconsin,27,Dodge County,0,49,-49
49,Utah,55,Wisconsin,29,Door County,0,4,-4
49,Utah,55,Wisconsin,31,Douglas County,0,5,-5
49,Utah,55,Wisconsin,35,Eau Claire County,36,9,27
49,Utah,55,Wisconsin,39,Fond du Lac County,0,5,-5
49,Utah,55,Wisconsin,43,Grant County,21,0,21
49,Utah,55,Wisconsin,45,Green County,4,0,4
49,Utah,55,Wisconsin,49,Iowa County,0,2,-2
49,Utah,55,Wisconsin,57,Juneau County,0,5,-5
49,Utah,55,Wisconsin,61,Kewaunee County,0,4,-4
49,Utah,55,Wisconsin,63,La Crosse County,0,150,-150
49,Utah,55,Wisconsin,71,Manitowoc County,0,11,-11
49,Utah,55,Wisconsin,73,Marathon County,22,0,22
49,Utah,55,Wisconsin,79,Milwaukee County,193,21,172
49,Utah,55,Wisconsin,81,Monroe County,0,2,-2
49,Utah,55,Wisconsin,83,Oconto County,82,0,82
49,Utah,55,Wisconsin,87,Outagamie County,25,70,-45
49,Utah,55,Wisconsin,89,Ozaukee County,0,26,-26
49,Utah,55,Wisconsin,93,Pierce County,0,4,-4
49,Utah,55,Wisconsin,101,Racine County,0,56,-56
49,Utah,55,Wisconsin,105,Rock County,0,45,-45
49,Utah,55,Wisconsin,107,Rusk County,0,4,-4
49,Utah,55,Wisconsin,109,St. Croix County,7,40,-33
49,Utah,55,Wisconsin,111,Sauk County,42,50,-8
49,Utah,55,Wisconsin,117,Sheboygan County,0,68,-68
49,Utah,55,Wisconsin,121,Trempealeau County,48,0,48
49,Utah,55,Wisconsin,127,Walworth County,21,0,21
49,Utah,55,Wisconsin,129,Washburn County,0,3,-3
49,Utah,55,Wisconsin,133,Waukesha County,132,61,71
49,Utah,55,Wisconsin,137,Waushara County,0,26,-26
49,Utah,55,Wisconsin,141,Wood County,30,37,-7
49,Utah,56,Wyoming,1,Albany County,197,121,76
49,Utah,56,Wyoming,3,Big Horn County,22,71,-49
49,Utah,56,Wyoming,5,Campbell County,13,316,-303
49,Utah,56,Wyoming,7,Carbon County,146,16,130
49,Utah,56,Wyoming,9,Converse County,0,37,-37
49,Utah,56,Wyoming,13,Fremont County,89,19,70
49,Utah,56,Wyoming,21,Laramie County,145,6,139
49,Utah,56,Wyoming,23,Lincoln County,259,233,26
49,Utah,56,Wyoming,25,Natrona County,300,61,239
49,Utah,56,Wyoming,29,Park County,17,31,-14
49,Utah,56,Wyoming,33,Sheridan County,139,41,98
49,Utah,56,Wyoming,35,Sublette County,74,29,45
49,Utah,56,Wyoming,37,Sweetwater County,887,411,476
49,Utah,56,Wyoming,39,Teton County,44,0,44
49,Utah,56,Wyoming,41,Uinta County,240,283,-43
49,Utah,56,Wyoming,43,Washakie County,0,3,-3
49,Utah,56,Wyoming,45,Weston County,0,27,-27
49,Utah,6,California,1,Alameda County,772,289,483
49,Utah,6,California,5,Amador County,19,25,-6
49,Utah,6,California,7,Butte County,77,77,0
49,Utah,6,California,13,Contra Costa County,361,299,62
49,Utah,6,California,15,Del Norte County,29,0,29
49,Utah,6,California,17,El Dorado County,136,48,88
49,Utah,6,California,19,Fresno County,262,277,-15
49,Utah,6,California,21,Glenn County,33,0,33
49,Utah,6,California,23,Humboldt County,7,117,-110
49,Utah,6,California,25,Imperial County,7,13,-6
49,Utah,6,California,27,Inyo County,0,28,-28
49,Utah,6,California,29,Kern County,210,313,-103
49,Utah,6,California,31,Kings County,166,13,153
49,Utah,6,California,33,Lake County,63,0,63
49,Utah,6,California,35,Lassen County,0,38,-38
49,Utah,6,California,37,Los Angeles County,3422,1565,1857
49,Utah,6,California,39,Madera County,16,0,16
49,Utah,6,California,41,Marin County,51,163,-112
49,Utah,6,California,47,Merced County,119,0,119
49,Utah,6,California,49,Modoc County,11,0,11
49,Utah,6,California,51,Mono County,47,0,47
49,Utah,6,California,53,Monterey County,282,131,151
49,Utah,6,California,55,Napa County,44,19,25
49,Utah,6,California,57,Nevada County,89,33,56
49,Utah,6,California,59,Orange County,1594,795,799
49,Utah,6,California,61,Placer County,446,208,238
49,Utah,6,California,63,Plumas County,56,0,56
49,Utah,6,California,65,Riverside County,1481,632,849
49,Utah,6,California,67,Sacramento County,857,919,-62
49,Utah,6,California,69,San Benito County,16,32,-16
49,Utah,6,California,71,San Bernardino County,1794,729,1065
49,Utah,6,California,73,San Diego County,1910,1267,643
49,Utah,6,California,75,San Francisco County,301,274,27
49,Utah,6,California,77,San Joaquin County,74,122,-48
49,Utah,6,California,79,San Luis Obispo County,15,66,-51
49,Utah,6,California,81,San Mateo County,96,318,-222
49,Utah,6,California,83,Santa Barbara County,147,136,11
49,Utah,6,California,85,Santa Clara County,1059,930,129
49,Utah,6,California,87,Santa Cruz County,166,36,130
49,Utah,6,California,89,Shasta County,21,63,-42
49,Utah,6,California,93,Siskiyou County,27,21,6
49,Utah,6,California,95,Solano County,122,146,-24
49,Utah,6,California,97,Sonoma County,100,417,-317
49,Utah,6,California,99,Stanislaus County,0,53,-53
49,Utah,6,California,101,Sutter County,0,15,-15
49,Utah,6,California,103,Tehama County,4,0,4
49,Utah,6,California,107,Tulare County,127,190,-63
49,Utah,6,California,109,Tuolumne County,158,0,158
49,Utah,6,California,111,Ventura County,282,240,42
49,Utah,6,California,113,Yolo County,45,76,-31
49,Utah,6,California,115,Yuba County,155,0,155
49,Utah,72,Puerto Rico,21,Bayamón Municipio,65,0,65
49,Utah,72,Puerto Rico,113,Ponce Municipio,13,0,13
49,Utah,72,Puerto Rico,127,San Juan Municipio,67,0,67
49,Utah,72,Puerto Rico,131,San Sebastián Municipio,16,0,16
49,Utah,8,Colorado,1,Adams County,180,215,-35
49,Utah,8,Colorado,3,Alamosa County,40,36,4
49,Utah,8,Colorado,5,Arapahoe County,510,180,330
49,Utah,8,Colorado,9,Baca County,58,0,58
49,Utah,8,Colorado,13,Boulder County,149,378,-229
49,Utah,8,Colorado,14,Broomfield County,9,174,-165
49,Utah,8,Colorado,21,Conejos County,21,29,-8
49,Utah,8,Colorado,29,Delta County,50,24,26
49,Utah,8,Colorado,31,Denver County,493,330,163
49,Utah,8,Colorado,33,Dolores County,0,3,-3
49,Utah,8,Colorado,35,Douglas County,348,190,158
49,Utah,8,Colorado,37,Eagle County,24,0,24
49,Utah,8,Colorado,39,Elbert County,0,35,-35
49,Utah,8,Colorado,41,El Paso County,781,573,208
49,Utah,8,Colorado,43,Fremont County,11,69,-58
49,Utah,8,Colorado,45,Garfield County,60,129,-69
49,Utah,8,Colorado,49,Grand County,109,2,107
49,Utah,8,Colorado,51,Gunnison County,23,0,23
49,Utah,8,Colorado,59,Jefferson County,270,222,48
49,Utah,8,Colorado,63,Kit Carson County,0,9,-9
49,Utah,8,Colorado,67,La Plata County,208,82,126
49,Utah,8,Colorado,69,Larimer County,186,270,-84
49,Utah,8,Colorado,71,Las Animas County,0,12,-12
49,Utah,8,Colorado,73,Lincoln County,0,9,-9
49,Utah,8,Colorado,75,Logan County,8,0,8
49,Utah,8,Colorado,77,Mesa County,456,326,130
49,Utah,8,Colorado,81,Moffat County,18,77,-59
49,Utah,8,Colorado,83,Montezuma County,61,35,26
49,Utah,8,Colorado,85,Montrose County,130,0,130
49,Utah,8,Colorado,87,Morgan County,4,0,4
49,Utah,8,Colorado,89,Otero County,4,0,4
49,Utah,8,Colorado,91,Ouray County,0,6,-6
49,Utah,8,Colorado,93,Park County,2,12,-10
49,Utah,8,Colorado,97,Pitkin County,9,0,9
49,Utah,8,Colorado,99,Prowers County,0,4,-4
49,Utah,8,Colorado,101,Pueblo County,90,214,-124
49,Utah,8,Colorado,103,Rio Blanco County,142,17,125
49,Utah,8,Colorado,107,Routt County,13,10,3
49,Utah,8,Colorado,117,Summit County,18,0,18
49,Utah,8,Colorado,119,Teller County,57,0,57
49,Utah,8,Colorado,123,Weld County,81,372,-291
49,Utah,9,Connecticut,1,Fairfield County,182,105,77
49,Utah,9,Connecticut,3,Hartford County,123,0,123
49,Utah,9,Connecticut,5,Litchfield County,23,0,23
49,Utah,9,Connecticut,9,New Haven County,37,42,-5
49,Utah,9,Connecticut,11,New London County,6,33,-27
49,Utah,9,Connecticut,13,Tolland County,54,0,54
49,Utah,AFR,Africa,,-,1084,0,0
49,Utah,ASI,Asia,,-,6239,0,0
49,Utah,CAM,Central America,,-,3702,0,0
49,Utah,CAR,Caribbean,,-,366,0,0
49,Utah,EUR,Europe,,-,3790,0,0
49,Utah,ISL,U.S. Island Areas,,-,88,0,0
49,Utah,NAM,Northern America,,-,964,0,0
49,Utah,OCE,Oceania and At Sea,,-,1097,0,0
49,Utah,SAM,South America,,-,4590,0,0
50,Vermont,1,Alabama,15,Calhoun County,0,52,-52
50,Vermont,1,Alabama,47,Dallas County,0,16,-16
50,Vermont,1,Alabama,73,Jefferson County,39,0,39
50,Vermont,1,Alabama,101,Montgomery County,0,2,-2
50,Vermont,1,Alabama,125,Tuscaloosa County,4,0,4
50,Vermont,10,Delaware,1,Kent County,3,10,-7
50,Vermont,10,Delaware,3,New Castle County,9,42,-33
50,Vermont,10,Delaware,5,Sussex County,19,0,19
50,Vermont,11,District of Columbia,1,District of Columbia,156,80,76
50,Vermont,12,Florida,1,Alachua County,0,51,-51
50,Vermont,12,Florida,9,Brevard County,17,33,-16
50,Vermont,12,Florida,11,Broward County,34,55,-21
50,Vermont,12,Florida,15,Charlotte County,14,25,-11
50,Vermont,12,Florida,17,Citrus County,8,51,-43
50,Vermont,12,Florida,21,Collier County,50,85,-35
50,Vermont,12,Florida,27,DeSoto County,0,11,-11
50,Vermont,12,Florida,31,Duval County,37,0,37
50,Vermont,12,Florida,33,Escambia County,26,41,-15
50,Vermont,12,Florida,35,Flagler County,28,107,-79
50,Vermont,12,Florida,43,Glades County,9,0,9
50,Vermont,12,Florida,53,Hernando County,0,80,-80
50,Vermont,12,Florida,57,Hillsborough County,31,93,-62
50,Vermont,12,Florida,59,Holmes County,50,0,50
50,Vermont,12,Florida,61,Indian River County,0,122,-122
50,Vermont,12,Florida,69,Lake County,9,9,0
50,Vermont,12,Florida,71,Lee County,0,162,-162
50,Vermont,12,Florida,73,Leon County,11,0,11
50,Vermont,12,Florida,81,Manatee County,42,15,27
50,Vermont,12,Florida,83,Marion County,3,77,-74
50,Vermont,12,Florida,85,Martin County,16,34,-18
50,Vermont,12,Florida,86,Miami-Dade County,39,12,27
50,Vermont,12,Florida,87,Monroe County,50,0,50
50,Vermont,12,Florida,89,Nassau County,1,0,1
50,Vermont,12,Florida,91,Okaloosa County,22,24,-2
50,Vermont,12,Florida,95,Orange County,53,121,-68
50,Vermont,12,Florida,97,Osceola County,33,0,33
50,Vermont,12,Florida,99,Palm Beach County,29,98,-69
50,Vermont,12,Florida,101,Pasco County,13,34,-21
50,Vermont,12,Florida,103,Pinellas County,59,56,3
50,Vermont,12,Florida,105,Polk County,139,68,71
50,Vermont,12,Florida,109,St. Johns County,36,10,26
50,Vermont,12,Florida,111,St. Lucie County,3,30,-27
50,Vermont,12,Florida,115,Sarasota County,10,181,-171
50,Vermont,12,Florida,117,Seminole County,0,10,-10
50,Vermont,12,Florida,119,Sumter County,9,177,-168
50,Vermont,12,Florida,127,Volusia County,38,64,-26
50,Vermont,12,Florida,129,Wakulla County,0,36,-36
50,Vermont,12,Florida,131,Walton County,4,0,4
50,Vermont,13,Georgia,51,Chatham County,31,49,-18
50,Vermont,13,Georgia,57,Cherokee County,3,0,3
50,Vermont,13,Georgia,67,Cobb County,68,111,-43
50,Vermont,13,Georgia,83,Dade County,0,10,-10
50,Vermont,13,Georgia,89,DeKalb County,8,7,1
50,Vermont,13,Georgia,117,Forsyth County,0,16,-16
50,Vermont,13,Georgia,121,Fulton County,22,4,18
50,Vermont,13,Georgia,135,Gwinnett County,6,0,6
50,Vermont,13,Georgia,153,Houston County,0,29,-29
50,Vermont,13,Georgia,177,Lee County,0,10,-10
50,Vermont,13,Georgia,215,Muscogee County,0,9,-9
50,Vermont,13,Georgia,245,Richmond County,0,21,-21
50,Vermont,15,Hawaii,3,Honolulu County,29,23,6
50,Vermont,15,Hawaii,7,Kauai County,13,0,13
50,Vermont,16,Idaho,1,Ada County,54,67,-13
50,Vermont,16,Idaho,7,Bear Lake County,3,0,3
50,Vermont,16,Idaho,27,Canyon County,0,146,-146
50,Vermont,16,Idaho,57,Latah County,0,14,-14
50,Vermont,17,Illinois,19,Champaign County,6,0,6
50,Vermont,17,Illinois,31,Cook County,276,286,-10
50,Vermont,17,Illinois,37,DeKalb County,21,0,21
50,Vermont,17,Illinois,43,DuPage County,37,55,-18
50,Vermont,17,Illinois,67,Hancock County,22,0,22
50,Vermont,17,Illinois,77,Jackson County,4,0,4
50,Vermont,17,Illinois,97,Lake County,14,134,-120
50,Vermont,17,Illinois,111,McHenry County,3,0,3
50,Vermont,17,Illinois,197,Will County,12,0,12
50,Vermont,17,Illinois,201,Winnebago County,10,0,10
50,Vermont,18,Indiana,3,Allen County,0,15,-15
50,Vermont,18,Indiana,5,Bartholomew County,0,21,-21
50,Vermont,18,Indiana,17,Cass County,1,26,-25
50,Vermont,18,Indiana,27,Daviess County,0,12,-12
50,Vermont,18,Indiana,57,Hamilton County,1,0,1
50,Vermont,18,Indiana,97,Marion County,0,40,-40
50,Vermont,18,Indiana,99,Marshall County,0,10,-10
50,Vermont,18,Indiana,105,Monroe County,0,6,-6
50,Vermont,18,Indiana,127,Porter County,0,17,-17
50,Vermont,18,Indiana,147,Spencer County,0,5,-5
50,Vermont,18,Indiana,157,Tippecanoe County,17,98,-81
50,Vermont,18,Indiana,177,Wayne County,13,0,13
50,Vermont,19,Iowa,11,Benton County,20,3,17
50,Vermont,19,Iowa,21,Buena Vista County,0,4,-4
50,Vermont,19,Iowa,57,Des Moines County,0,12,-12
50,Vermont,19,Iowa,63,Emmet County,0,4,-4
50,Vermont,19,Iowa,103,Johnson County,36,130,-94
50,Vermont,19,Iowa,113,Linn County,0,19,-19
50,Vermont,19,Iowa,125,Marion County,11,0,11
50,Vermont,19,Iowa,131,Mitchell County,0,5,-5
50,Vermont,19,Iowa,149,Plymouth County,23,0,23
50,Vermont,19,Iowa,157,Poweshiek County,13,0,13
50,Vermont,19,Iowa,163,Scott County,0,13,-13
50,Vermont,19,Iowa,183,Washington County,0,17,-17
50,Vermont,19,Iowa,191,Winneshiek County,0,11,-11
50,Vermont,2,Alaska,20,Anchorage Municipality,0,18,-18
50,Vermont,2,Alaska,50,Bethel Census Area,24,0,24
50,Vermont,2,Alaska,90,Fairbanks North Star Borough,8,0,8
50,Vermont,2,Alaska,110,Juneau City and Borough,3,2,1
50,Vermont,2,Alaska,130,Ketchikan Gateway Borough,0,12,-12
50,Vermont,2,Alaska,170,Matanuska-Susitna Borough,29,0,29
50,Vermont,2,Alaska,188,Northwest Arctic Borough,0,28,-28
50,Vermont,2,Alaska,240,Southeast Fairbanks Census Area,5,0,5
50,Vermont,2,Alaska,290,Yukon-Koyukuk Census Area,0,2,-2
50,Vermont,20,Kansas,11,Bourbon County,3,6,-3
50,Vermont,20,Kansas,15,Butler County,6,0,6
50,Vermont,20,Kansas,45,Douglas County,0,28,-28
50,Vermont,20,Kansas,91,Johnson County,5,0,5
50,Vermont,20,Kansas,103,Leavenworth County,6,0,6
50,Vermont,20,Kansas,177,Shawnee County,0,10,-10
50,Vermont,21,Kentucky,5,Anderson County,2,0,2
50,Vermont,21,Kentucky,49,Clark County,0,11,-11
50,Vermont,21,Kentucky,67,Fayette County,25,20,5
50,Vermont,21,Kentucky,111,Jefferson County,20,0,20
50,Vermont,21,Kentucky,129,Lee County,59,84,-25
50,Vermont,21,Kentucky,143,Lyon County,2,0,2
50,Vermont,21,Kentucky,163,Meade County,13,0,13
50,Vermont,22,Louisiana,33,East Baton Rouge Parish,10,0,10
50,Vermont,22,Louisiana,55,Lafayette Parish,4,0,4
50,Vermont,22,Louisiana,71,Orleans Parish,19,32,-13
50,Vermont,23,Maine,1,Androscoggin County,46,56,-10
50,Vermont,23,Maine,3,Aroostook County,27,8,19
50,Vermont,23,Maine,5,Cumberland County,250,157,93
50,Vermont,23,Maine,7,Franklin County,37,76,-39
50,Vermont,23,Maine,9,Hancock County,7,17,-10
50,Vermont,23,Maine,11,Kennebec County,57,0,57
50,Vermont,23,Maine,13,Knox County,9,0,9
50,Vermont,23,Maine,15,Lincoln County,12,0,12
50,Vermont,23,Maine,17,Oxford County,58,7,51
50,Vermont,23,Maine,19,Penobscot County,63,92,-29
50,Vermont,23,Maine,21,Piscataquis County,5,0,5
50,Vermont,23,Maine,23,Sagadahoc County,20,12,8
50,Vermont,23,Maine,25,Somerset County,4,14,-10
50,Vermont,23,Maine,27,Waldo County,16,0,16
50,Vermont,23,Maine,29,Washington County,4,23,-19
50,Vermont,23,Maine,31,York County,98,394,-296
50,Vermont,24,Maryland,1,Allegany County,48,14,34
50,Vermont,24,Maryland,3,Anne Arundel County,69,56,13
50,Vermont,24,Maryland,5,Baltimore County,53,41,12
50,Vermont,24,Maryland,9,Calvert County,2,0,2
50,Vermont,24,Maryland,17,Charles County,0,19,-19
50,Vermont,24,Maryland,21,Frederick County,62,15,47
50,Vermont,24,Maryland,23,Garrett County,24,0,24
50,Vermont,24,Maryland,27,Howard County,13,10,3
50,Vermont,24,Maryland,31,Montgomery County,107,84,23
50,Vermont,24,Maryland,33,Prince George's County,7,46,-39
50,Vermont,24,Maryland,41,Talbot County,3,0,3
50,Vermont,24,Maryland,43,Washington County,4,0,4
50,Vermont,24,Maryland,510,Baltimore city,97,17,80
50,Vermont,25,Massachusetts,1,Barnstable County,86,60,26
50,Vermont,25,Massachusetts,3,Berkshire County,164,290,-126
50,Vermont,25,Massachusetts,5,Bristol County,228,32,196
50,Vermont,25,Massachusetts,7,Dukes County,64,103,-39
50,Vermont,25,Massachusetts,9,Essex County,232,146,86
50,Vermont,25,Massachusetts,11,Franklin County,193,166,27
50,Vermont,25,Massachusetts,13,Hampden County,295,241,54
50,Vermont,25,Massachusetts,15,Hampshire County,234,84,150
50,Vermont,25,Massachusetts,17,Middlesex County,967,621,346
50,Vermont,25,Massachusetts,19,Nantucket County,33,21,12
50,Vermont,25,Massachusetts,21,Norfolk County,328,101,227
50,Vermont,25,Massachusetts,23,Plymouth County,268,42,226
50,Vermont,25,Massachusetts,25,Suffolk County,289,715,-426
50,Vermont,25,Massachusetts,27,Worcester County,329,251,78
50,Vermont,26,Michigan,5,Allegan County,23,0,23
50,Vermont,26,Michigan,25,Calhoun County,0,14,-14
50,Vermont,26,Michigan,45,Eaton County,2,0,2
50,Vermont,26,Michigan,47,Emmet County,0,3,-3
50,Vermont,26,Michigan,49,Genesee County,7,0,7
50,Vermont,26,Michigan,59,Hillsdale County,0,26,-26
50,Vermont,26,Michigan,65,Ingham County,25,1,24
50,Vermont,26,Michigan,77,Kalamazoo County,0,15,-15
50,Vermont,26,Michigan,81,Kent County,8,0,8
50,Vermont,26,Michigan,91,Lenawee County,22,0,22
50,Vermont,26,Michigan,103,Marquette County,12,0,12
50,Vermont,26,Michigan,115,Monroe County,0,13,-13
50,Vermont,26,Michigan,117,Montcalm County,2,0,2
50,Vermont,26,Michigan,125,Oakland County,21,46,-25
50,Vermont,26,Michigan,139,Ottawa County,0,41,-41
50,Vermont,26,Michigan,147,St. Clair County,2,0,2
50,Vermont,26,Michigan,161,Washtenaw County,152,54,98
50,Vermont,26,Michigan,163,Wayne County,0,1,-1
50,Vermont,27,Minnesota,49,Goodhue County,0,2,-2
50,Vermont,27,Minnesota,53,Hennepin County,10,0,10
50,Vermont,27,Minnesota,99,Mower County,0,8,-8
50,Vermont,27,Minnesota,109,Olmsted County,6,0,6
50,Vermont,27,Minnesota,123,Ramsey County,0,12,-12
50,Vermont,27,Minnesota,131,Rice County,0,11,-11
50,Vermont,27,Minnesota,137,St. Louis County,3,0,3
50,Vermont,27,Minnesota,141,Sherburne County,0,8,-8
50,Vermont,27,Minnesota,145,Stearns County,1,0,1
50,Vermont,27,Minnesota,153,Todd County,0,3,-3
50,Vermont,27,Minnesota,157,Wabasha County,0,16,-16
50,Vermont,27,Minnesota,161,Waseca County,0,2,-2
50,Vermont,27,Minnesota,163,Washington County,4,16,-12
50,Vermont,28,Mississippi,47,Harrison County,7,0,7
50,Vermont,28,Mississippi,81,Lee County,8,0,8
50,Vermont,29,Missouri,47,Clay County,3,12,-9
50,Vermont,29,Missouri,77,Greene County,12,0,12
50,Vermont,29,Missouri,89,Howard County,2,0,2
50,Vermont,29,Missouri,165,Platte County,5,0,5
50,Vermont,29,Missouri,189,St. Louis County,50,0,50
50,Vermont,29,Missouri,510,St. Louis city,6,46,-40
50,Vermont,30,Montana,27,Fergus County,0,10,-10
50,Vermont,30,Montana,29,Flathead County,47,10,37
50,Vermont,30,Montana,31,Gallatin County,49,20,29
50,Vermont,30,Montana,47,Lake County,0,18,-18
50,Vermont,30,Montana,63,Missoula County,39,24,15
50,Vermont,30,Montana,67,Park County,3,0,3
50,Vermont,30,Montana,81,Ravalli County,0,4,-4
50,Vermont,30,Montana,93,Silver Bow County,0,40,-40
50,Vermont,30,Montana,95,Stillwater County,0,1,-1
50,Vermont,30,Montana,111,Yellowstone County,28,0,28
50,Vermont,31,Nebraska,1,Adams County,42,0,42
50,Vermont,31,Nebraska,55,Douglas County,9,0,9
50,Vermont,31,Nebraska,101,Keith County,0,5,-5
50,Vermont,31,Nebraska,109,Lancaster County,12,0,12
50,Vermont,31,Nebraska,185,York County,0,1,-1
50,Vermont,32,Nevada,3,Clark County,83,48,35
50,Vermont,32,Nevada,29,Storey County,0,16,-16
50,Vermont,32,Nevada,31,Washoe County,6,15,-9
50,Vermont,32,Nevada,510,Carson City,34,0,34
50,Vermont,33,New Hampshire,1,Belknap County,99,18,81
50,Vermont,33,New Hampshire,3,Carroll County,128,34,94
50,Vermont,33,New Hampshire,5,Cheshire County,251,408,-157
50,Vermont,33,New Hampshire,7,Coos County,322,75,247
50,Vermont,33,New Hampshire,9,Grafton County,805,1027,-222
50,Vermont,33,New Hampshire,11,Hillsborough County,508,205,303
50,Vermont,33,New Hampshire,13,Merrimack County,204,259,-55
50,Vermont,33,New Hampshire,15,Rockingham County,221,72,149
50,Vermont,33,New Hampshire,17,Strafford County,72,179,-107
50,Vermont,33,New Hampshire,19,Sullivan County,350,281,69
50,Vermont,34,New Jersey,1,Atlantic County,5,0,5
50,Vermont,34,New Jersey,3,Bergen County,160,13,147
50,Vermont,34,New Jersey,5,Burlington County,83,0,83
50,Vermont,34,New Jersey,7,Camden County,22,0,22
50,Vermont,34,New Jersey,9,Cape May County,4,0,4
50,Vermont,34,New Jersey,13,Essex County,46,111,-65
50,Vermont,34,New Jersey,15,Gloucester County,2,19,-17
50,Vermont,34,New Jersey,17,Hudson County,50,71,-21
50,Vermont,34,New Jersey,19,Hunterdon County,18,0,18
50,Vermont,34,New Jersey,21,Mercer County,45,14,31
50,Vermont,34,New Jersey,23,Middlesex County,7,0,7
50,Vermont,34,New Jersey,25,Monmouth County,180,20,160
50,Vermont,34,New Jersey,27,Morris County,113,26,87
50,Vermont,34,New Jersey,29,Ocean County,145,37,108
50,Vermont,34,New Jersey,31,Passaic County,21,8,13
50,Vermont,34,New Jersey,33,Salem County,4,0,4
50,Vermont,34,New Jersey,35,Somerset County,50,45,5
50,Vermont,34,New Jersey,37,Sussex County,7,0,7
50,Vermont,34,New Jersey,39,Union County,38,0,38
50,Vermont,34,New Jersey,41,Warren County,6,0,6
50,Vermont,35,New Mexico,1,Bernalillo County,46,58,-12
50,Vermont,35,New Mexico,5,Chaves County,4,0,4
50,Vermont,35,New Mexico,15,Eddy County,0,9,-9
50,Vermont,35,New Mexico,27,Lincoln County,0,1,-1
50,Vermont,35,New Mexico,49,Santa Fe County,4,7,-3
50,Vermont,35,New Mexico,57,Torrance County,16,0,16
50,Vermont,36,New York,1,Albany County,143,49,94
50,Vermont,36,New York,5,Bronx County,91,17,74
50,Vermont,36,New York,7,Broome County,5,0,5
50,Vermont,36,New York,9,Cattaraugus County,26,7,19
50,Vermont,36,New York,19,Clinton County,96,294,-198
50,Vermont,36,New York,21,Columbia County,19,30,-11
50,Vermont,36,New York,27,Dutchess County,15,16,-1
50,Vermont,36,New York,29,Erie County,64,24,40
50,Vermont,36,New York,31,Essex County,159,172,-13
50,Vermont,36,New York,33,Franklin County,29,79,-50
50,Vermont,36,New York,35,Fulton County,16,36,-20
50,Vermont,36,New York,41,Hamilton County,6,0,6
50,Vermont,36,New York,43,Herkimer County,0,28,-28
50,Vermont,36,New York,45,Jefferson County,12,20,-8
50,Vermont,36,New York,47,Kings County,368,182,186
50,Vermont,36,New York,49,Lewis County,0,11,-11
50,Vermont,36,New York,51,Livingston County,17,0,17
50,Vermont,36,New York,53,Madison County,11,32,-21
50,Vermont,36,New York,55,Monroe County,91,324,-233
50,Vermont,36,New York,57,Montgomery County,0,5,-5
50,Vermont,36,New York,59,Nassau County,141,23,118
50,Vermont,36,New York,61,New York County,211,201,10
50,Vermont,36,New York,63,Niagara County,3,0,3
50,Vermont,36,New York,65,Oneida County,3,10,-7
50,Vermont,36,New York,67,Onondaga County,14,131,-117
50,Vermont,36,New York,69,Ontario County,23,17,6
50,Vermont,36,New York,71,Orange County,26,9,17
50,Vermont,36,New York,75,Oswego County,0,10,-10
50,Vermont,36,New York,77,Otsego County,49,0,49
50,Vermont,36,New York,79,Putnam County,14,0,14
50,Vermont,36,New York,81,Queens County,52,107,-55
50,Vermont,36,New York,83,Rensselaer County,187,129,58
50,Vermont,36,New York,85,Richmond County,0,11,-11
50,Vermont,36,New York,87,Rockland County,26,0,26
50,Vermont,36,New York,89,St. Lawrence County,93,84,9
50,Vermont,36,New York,91,Saratoga County,62,89,-27
50,Vermont,36,New York,93,Schenectady County,63,56,7
50,Vermont,36,New York,95,Schoharie County,0,6,-6
50,Vermont,36,New York,99,Seneca County,16,4,12
50,Vermont,36,New York,101,Steuben County,35,2,33
50,Vermont,36,New York,103,Suffolk County,200,18,182
50,Vermont,36,New York,107,Tioga County,0,20,-20
50,Vermont,36,New York,109,Tompkins County,43,61,-18
50,Vermont,36,New York,111,Ulster County,32,5,27
50,Vermont,36,New York,113,Warren County,55,37,18
50,Vermont,36,New York,115,Washington County,322,295,27
50,Vermont,36,New York,117,Wayne County,0,9,-9
50,Vermont,36,New York,119,Westchester County,218,63,155
50,Vermont,37,North Carolina,1,Alamance County,0,16,-16
50,Vermont,37,North Carolina,9,Ashe County,0,16,-16
50,Vermont,37,North Carolina,19,Brunswick County,19,43,-24
50,Vermont,37,North Carolina,21,Buncombe County,46,22,24
50,Vermont,37,North Carolina,25,Cabarrus County,6,0,6
50,Vermont,37,North Carolina,27,Caldwell County,15,0,15
50,Vermont,37,North Carolina,31,Carteret County,55,22,33
50,Vermont,37,North Carolina,37,Chatham County,3,32,-29
50,Vermont,37,North Carolina,51,Cumberland County,24,0,24
50,Vermont,37,North Carolina,57,Davidson County,10,11,-1
50,Vermont,37,North Carolina,63,Durham County,0,7,-7
50,Vermont,37,North Carolina,81,Guilford County,0,50,-50
50,Vermont,37,North Carolina,87,Haywood County,0,3,-3
50,Vermont,37,North Carolina,97,Iredell County,0,16,-16
50,Vermont,37,North Carolina,99,Jackson County,53,0,53
50,Vermont,37,North Carolina,109,Lincoln County,7,0,7
50,Vermont,37,North Carolina,119,Mecklenburg County,8,97,-89
50,Vermont,37,North Carolina,125,Moore County,9,0,9
50,Vermont,37,North Carolina,129,New Hanover County,34,58,-24
50,Vermont,37,North Carolina,133,Onslow County,27,17,10
50,Vermont,37,North Carolina,135,Orange County,4,95,-91
50,Vermont,37,North Carolina,147,Pitt County,0,87,-87
50,Vermont,37,North Carolina,157,Rockingham County,3,0,3
50,Vermont,37,North Carolina,183,Wake County,108,32,76
50,Vermont,38,North Dakota,17,Cass County,0,22,-22
50,Vermont,38,North Dakota,101,Ward County,13,0,13
50,Vermont,38,North Dakota,105,Williams County,6,0,6
50,Vermont,39,Ohio,3,Allen County,0,27,-27
50,Vermont,39,Ohio,13,Belmont County,8,0,8
50,Vermont,39,Ohio,17,Butler County,0,6,-6
50,Vermont,39,Ohio,25,Clermont County,19,0,19
50,Vermont,39,Ohio,35,Cuyahoga County,26,46,-20
50,Vermont,39,Ohio,49,Franklin County,55,74,-19
50,Vermont,39,Ohio,55,Geauga County,4,0,4
50,Vermont,39,Ohio,57,Greene County,0,38,-38
50,Vermont,39,Ohio,61,Hamilton County,5,8,-3
50,Vermont,39,Ohio,63,Hancock County,6,0,6
50,Vermont,39,Ohio,81,Jefferson County,5,35,-30
50,Vermont,39,Ohio,83,Knox County,9,0,9
50,Vermont,39,Ohio,89,Licking County,4,0,4
50,Vermont,39,Ohio,95,Lucas County,5,0,5
50,Vermont,39,Ohio,99,Mahoning County,3,0,3
50,Vermont,39,Ohio,103,Medina County,23,0,23
50,Vermont,39,Ohio,113,Montgomery County,16,0,16
50,Vermont,39,Ohio,133,Portage County,0,11,-11
50,Vermont,39,Ohio,139,Richland County,15,0,15
50,Vermont,39,Ohio,153,Summit County,0,12,-12
50,Vermont,39,Ohio,155,Trumbull County,10,0,10
50,Vermont,39,Ohio,161,Van Wert County,1,0,1
50,Vermont,39,Ohio,167,Washington County,0,15,-15
50,Vermont,39,Ohio,169,Wayne County,0,8,-8
50,Vermont,39,Ohio,173,Wood County,9,0,9
50,Vermont,4,Arizona,3,Cochise County,0,124,-124
50,Vermont,4,Arizona,5,Coconino County,0,20,-20
50,Vermont,4,Arizona,13,Maricopa County,108,141,-33
50,Vermont,4,Arizona,15,Mohave County,0,12,-12
50,Vermont,4,Arizona,19,Pima County,26,133,-107
50,Vermont,4,Arizona,21,Pinal County,0,28,-28
50,Vermont,4,Arizona,25,Yavapai County,1,21,-20
50,Vermont,4,Arizona,27,Yuma County,3,8,-5
50,Vermont,40,Oklahoma,31,Comanche County,6,49,-43
50,Vermont,40,Oklahoma,45,Ellis County,0,5,-5
50,Vermont,40,Oklahoma,65,Jackson County,0,5,-5
50,Vermont,40,Oklahoma,109,Oklahoma County,3,0,3
50,Vermont,40,Oklahoma,143,Tulsa County,0,9,-9
50,Vermont,40,Oklahoma,151,Woods County,0,9,-9
50,Vermont,41,Oregon,3,Benton County,6,0,6
50,Vermont,41,Oregon,5,Clackamas County,48,9,39
50,Vermont,41,Oregon,7,Clatsop County,0,16,-16
50,Vermont,41,Oregon,17,Deschutes County,4,0,4
50,Vermont,41,Oregon,19,Douglas County,8,0,8
50,Vermont,41,Oregon,29,Jackson County,6,12,-6
50,Vermont,41,Oregon,33,Josephine County,3,0,3
50,Vermont,41,Oregon,39,Lane County,46,0,46
50,Vermont,41,Oregon,43,Linn County,0,20,-20
50,Vermont,41,Oregon,47,Marion County,5,24,-19
50,Vermont,41,Oregon,51,Multnomah County,151,130,21
50,Vermont,41,Oregon,67,Washington County,14,12,2
50,Vermont,42,Pennsylvania,1,Adams County,2,43,-41
50,Vermont,42,Pennsylvania,3,Allegheny County,40,196,-156
50,Vermont,42,Pennsylvania,11,Berks County,70,8,62
50,Vermont,42,Pennsylvania,13,Blair County,14,7,7
50,Vermont,42,Pennsylvania,15,Bradford County,0,15,-15
50,Vermont,42,Pennsylvania,17,Bucks County,27,31,-4
50,Vermont,42,Pennsylvania,19,Butler County,65,0,65
50,Vermont,42,Pennsylvania,25,Carbon County,0,7,-7
50,Vermont,42,Pennsylvania,27,Centre County,28,31,-3
50,Vermont,42,Pennsylvania,29,Chester County,26,8,18
50,Vermont,42,Pennsylvania,37,Columbia County,10,0,10
50,Vermont,42,Pennsylvania,39,Crawford County,48,42,6
50,Vermont,42,Pennsylvania,41,Cumberland County,30,10,20
50,Vermont,42,Pennsylvania,45,Delaware County,69,21,48
50,Vermont,42,Pennsylvania,49,Erie County,28,103,-75
50,Vermont,42,Pennsylvania,55,Franklin County,0,34,-34
50,Vermont,42,Pennsylvania,61,Huntingdon County,0,4,-4
50,Vermont,42,Pennsylvania,69,Lackawanna County,2,0,2
50,Vermont,42,Pennsylvania,71,Lancaster County,34,39,-5
50,Vermont,42,Pennsylvania,77,Lehigh County,39,24,15
50,Vermont,42,Pennsylvania,91,Montgomery County,44,54,-10
50,Vermont,42,Pennsylvania,95,Northampton County,61,8,53
50,Vermont,42,Pennsylvania,101,Philadelphia County,61,54,7
50,Vermont,42,Pennsylvania,103,Pike County,47,0,47
50,Vermont,42,Pennsylvania,111,Somerset County,6,0,6
50,Vermont,42,Pennsylvania,127,Wayne County,4,30,-26
50,Vermont,42,Pennsylvania,129,Westmoreland County,7,8,-1
50,Vermont,42,Pennsylvania,133,York County,31,65,-34
50,Vermont,44,Rhode Island,1,Bristol County,36,22,14
50,Vermont,44,Rhode Island,3,Kent County,11,0,11
50,Vermont,44,Rhode Island,5,Newport County,9,2,7
50,Vermont,44,Rhode Island,7,Providence County,225,259,-34
50,Vermont,44,Rhode Island,9,Washington County,113,25,88
50,Vermont,45,South Carolina,7,Anderson County,3,0,3
50,Vermont,45,South Carolina,13,Beaufort County,6,34,-28
50,Vermont,45,South Carolina,19,Charleston County,29,14,15
50,Vermont,45,South Carolina,37,Edgefield County,0,60,-60
50,Vermont,45,South Carolina,45,Greenville County,0,27,-27
50,Vermont,45,South Carolina,47,Greenwood County,8,0,8
50,Vermont,45,South Carolina,51,Horry County,0,29,-29
50,Vermont,45,South Carolina,57,Lancaster County,0,21,-21
50,Vermont,45,South Carolina,63,Lexington County,12,0,12
50,Vermont,45,South Carolina,77,Pickens County,10,0,10
50,Vermont,45,South Carolina,79,Richland County,15,24,-9
50,Vermont,46,South Dakota,11,Brookings County,0,4,-4
50,Vermont,46,South Dakota,27,Clay County,1,0,1
50,Vermont,46,South Dakota,39,Deuel County,10,0,10
50,Vermont,46,South Dakota,103,Pennington County,128,0,128
50,Vermont,46,South Dakota,127,Union County,2,25,-23
50,Vermont,47,Tennessee,1,Anderson County,40,0,40
50,Vermont,47,Tennessee,7,Bledsoe County,13,0,13
50,Vermont,47,Tennessee,9,Blount County,0,70,-70
50,Vermont,47,Tennessee,19,Carter County,0,11,-11
50,Vermont,47,Tennessee,21,Cheatham County,0,9,-9
50,Vermont,47,Tennessee,25,Claiborne County,0,6,-6
50,Vermont,47,Tennessee,31,Coffee County,0,90,-90
50,Vermont,47,Tennessee,37,Davidson County,42,10,32
50,Vermont,47,Tennessee,51,Franklin County,15,3,12
50,Vermont,47,Tennessee,65,Hamilton County,0,33,-33
50,Vermont,47,Tennessee,75,Haywood County,3,0,3
50,Vermont,47,Tennessee,89,Jefferson County,2,0,2
50,Vermont,47,Tennessee,117,Marshall County,3,0,3
50,Vermont,47,Tennessee,125,Montgomery County,4,0,4
50,Vermont,47,Tennessee,157,Shelby County,0,12,-12
50,Vermont,47,Tennessee,163,Sullivan County,0,33,-33
50,Vermont,47,Tennessee,165,Sumner County,0,15,-15
50,Vermont,47,Tennessee,175,Van Buren County,0,24,-24
50,Vermont,47,Tennessee,179,Washington County,13,0,13
50,Vermont,47,Tennessee,187,Williamson County,2,0,2
50,Vermont,47,Tennessee,189,Wilson County,3,0,3
50,Vermont,48,Texas,5,Angelina County,13,0,13
50,Vermont,48,Texas,21,Bastrop County,0,4,-4
50,Vermont,48,Texas,27,Bell County,7,0,7
50,Vermont,48,Texas,29,Bexar County,0,7,-7
50,Vermont,48,Texas,59,Callahan County,1,0,1
50,Vermont,48,Texas,99,Coryell County,3,88,-85
50,Vermont,48,Texas,113,Dallas County,14,165,-151
50,Vermont,48,Texas,141,El Paso County,23,0,23
50,Vermont,48,Texas,167,Galveston County,4,0,4
50,Vermont,48,Texas,181,Grayson County,4,0,4
50,Vermont,48,Texas,183,Gregg County,0,28,-28
50,Vermont,48,Texas,201,Harris County,22,40,-18
50,Vermont,48,Texas,215,Hidalgo County,67,0,67
50,Vermont,48,Texas,339,Montgomery County,2,84,-82
50,Vermont,48,Texas,373,Polk County,16,0,16
50,Vermont,48,Texas,375,Potter County,24,0,24
50,Vermont,48,Texas,381,Randall County,42,0,42
50,Vermont,48,Texas,429,Stephens County,7,0,7
50,Vermont,48,Texas,439,Tarrant County,18,5,13
50,Vermont,48,Texas,441,Taylor County,0,11,-11
50,Vermont,48,Texas,451,Tom Green County,21,0,21
50,Vermont,48,Texas,453,Travis County,57,7,50
50,Vermont,48,Texas,485,Wichita County,11,0,11
50,Vermont,49,Utah,11,Davis County,0,14,-14
50,Vermont,49,Utah,19,Grand County,6,0,6
50,Vermont,49,Utah,29,Morgan County,23,37,-14
50,Vermont,49,Utah,35,Salt Lake County,69,88,-19
50,Vermont,49,Utah,43,Summit County,27,42,-15
50,Vermont,49,Utah,49,Utah County,49,0,49
50,Vermont,49,Utah,53,Washington County,0,5,-5
50,Vermont,49,Utah,57,Weber County,16,0,16
50,Vermont,5,Arkansas,51,Garland County,0,9,-9
50,Vermont,5,Arkansas,119,Pulaski County,4,0,4
50,Vermont,50,Vermont,1,Addison County,1270,1223,47
50,Vermont,50,Vermont,3,Bennington County,572,812,-240
50,Vermont,50,Vermont,5,Caledonia County,867,1133,-266
50,Vermont,50,Vermont,7,Chittenden County,2519,3448,-929
50,Vermont,50,Vermont,9,Essex County,316,195,121
50,Vermont,50,Vermont,11,Franklin County,844,1191,-347
50,Vermont,50,Vermont,13,Grand Isle County,286,187,99
50,Vermont,50,Vermont,15,Lamoille County,1142,872,270
50,Vermont,50,Vermont,17,Orange County,925,894,31
50,Vermont,50,Vermont,19,Orleans County,688,399,289
50,Vermont,50,Vermont,21,Rutland County,919,601,318
50,Vermont,50,Vermont,23,Washington County,1423,1086,337
50,Vermont,50,Vermont,25,Windham County,923,701,222
50,Vermont,50,Vermont,27,Windsor County,1157,1109,48
50,Vermont,51,Virginia,3,Albemarle County,9,0,9
50,Vermont,51,Virginia,13,Arlington County,15,37,-22
50,Vermont,51,Virginia,23,Botetourt County,0,37,-37
50,Vermont,51,Virginia,31,Campbell County,9,0,9
50,Vermont,51,Virginia,41,Chesterfield County,0,146,-146
50,Vermont,51,Virginia,47,Culpeper County,3,69,-66
50,Vermont,51,Virginia,59,Fairfax County,59,44,15
50,Vermont,51,Virginia,61,Fauquier County,5,0,5
50,Vermont,51,Virginia,69,Frederick County,1,17,-16
50,Vermont,51,Virginia,87,Henrico County,16,0,16
50,Vermont,51,Virginia,99,King George County,0,14,-14
50,Vermont,51,Virginia,107,Loudoun County,0,91,-91
50,Vermont,51,Virginia,149,Prince George County,0,9,-9
50,Vermont,51,Virginia,153,Prince William County,43,0,43
50,Vermont,51,Virginia,171,Shenandoah County,58,0,58
50,Vermont,51,Virginia,177,Spotsylvania County,0,12,-12
50,Vermont,51,Virginia,510,Alexandria city,17,10,7
50,Vermont,51,Virginia,540,Charlottesville city,33,10,23
50,Vermont,51,Virginia,550,Chesapeake city,2,0,2
50,Vermont,51,Virginia,610,Falls Church city,31,0,31
50,Vermont,51,Virginia,680,Lynchburg city,23,0,23
50,Vermont,51,Virginia,690,Martinsville city,14,0,14
50,Vermont,51,Virginia,710,Norfolk city,0,26,-26
50,Vermont,51,Virginia,750,Radford city,7,0,7
50,Vermont,51,Virginia,760,Richmond city,20,0,20
50,Vermont,51,Virginia,800,Suffolk city,20,0,20
50,Vermont,51,Virginia,810,Virginia Beach city,11,64,-53
50,Vermont,51,Virginia,830,Williamsburg city,3,0,3
50,Vermont,53,Washington,9,Clallam County,6,0,6
50,Vermont,53,Washington,11,Clark County,27,0,27
50,Vermont,53,Washington,29,Island County,0,11,-11
50,Vermont,53,Washington,33,King County,181,149,32
50,Vermont,53,Washington,35,Kitsap County,67,0,67
50,Vermont,53,Washington,47,Okanogan County,0,160,-160
50,Vermont,53,Washington,53,Pierce County,16,28,-12
50,Vermont,53,Washington,57,Skagit County,18,0,18
50,Vermont,53,Washington,61,Snohomish County,1,5,-4
50,Vermont,53,Washington,63,Spokane County,40,11,29
50,Vermont,53,Washington,67,Thurston County,16,21,-5
50,Vermont,53,Washington,73,Whatcom County,0,144,-144
50,Vermont,54,West Virginia,1,Barbour County,0,2,-2
50,Vermont,54,West Virginia,7,Braxton County,0,4,-4
50,Vermont,54,West Virginia,25,Greenbrier County,28,0,28
50,Vermont,54,West Virginia,33,Harrison County,7,0,7
50,Vermont,54,West Virginia,51,Marshall County,0,3,-3
50,Vermont,54,West Virginia,55,Mercer County,0,15,-15
50,Vermont,54,West Virginia,61,Monongalia County,9,0,9
50,Vermont,55,Wisconsin,25,Dane County,0,36,-36
50,Vermont,55,Wisconsin,79,Milwaukee County,24,17,7
50,Vermont,55,Wisconsin,81,Monroe County,2,0,2
50,Vermont,55,Wisconsin,85,Oneida County,0,5,-5
50,Vermont,55,Wisconsin,87,Outagamie County,0,13,-13
50,Vermont,55,Wisconsin,89,Ozaukee County,4,0,4
50,Vermont,55,Wisconsin,105,Rock County,0,10,-10
50,Vermont,55,Wisconsin,127,Walworth County,3,0,3
50,Vermont,55,Wisconsin,133,Waukesha County,11,4,7
50,Vermont,56,Wyoming,1,Albany County,0,1,-1
50,Vermont,56,Wyoming,17,Hot Springs County,0,18,-18
50,Vermont,56,Wyoming,29,Park County,14,0,14
50,Vermont,56,Wyoming,31,Platte County,22,0,22
50,Vermont,56,Wyoming,39,Teton County,76,0,76
50,Vermont,56,Wyoming,41,Uinta County,4,0,4
50,Vermont,6,California,1,Alameda County,49,37,12
50,Vermont,6,California,7,Butte County,0,18,-18
50,Vermont,6,California,13,Contra Costa County,12,14,-2
50,Vermont,6,California,17,El Dorado County,9,14,-5
50,Vermont,6,California,19,Fresno County,22,0,22
50,Vermont,6,California,23,Humboldt County,4,0,4
50,Vermont,6,California,29,Kern County,8,0,8
50,Vermont,6,California,37,Los Angeles County,280,267,13
50,Vermont,6,California,41,Marin County,15,61,-46
50,Vermont,6,California,51,Mono County,4,0,4
50,Vermont,6,California,53,Monterey County,18,31,-13
50,Vermont,6,California,59,Orange County,57,24,33
50,Vermont,6,California,61,Placer County,3,5,-2
50,Vermont,6,California,63,Plumas County,8,0,8
50,Vermont,6,California,65,Riverside County,3,0,3
50,Vermont,6,California,67,Sacramento County,98,0,98
50,Vermont,6,California,71,San Bernardino County,14,50,-36
50,Vermont,6,California,73,San Diego County,73,105,-32
50,Vermont,6,California,75,San Francisco County,76,86,-10
50,Vermont,6,California,79,San Luis Obispo County,12,0,12
50,Vermont,6,California,81,San Mateo County,57,46,11
50,Vermont,6,California,83,Santa Barbara County,3,7,-4
50,Vermont,6,California,85,Santa Clara County,30,11,19
50,Vermont,6,California,87,Santa Cruz County,8,0,8
50,Vermont,6,California,97,Sonoma County,10,66,-56
50,Vermont,6,California,107,Tulare County,18,0,18
50,Vermont,6,California,111,Ventura County,92,43,49
50,Vermont,6,California,113,Yolo County,28,12,16
50,Vermont,72,Puerto Rico,1,Adjuntas Municipio,25,0,25
50,Vermont,72,Puerto Rico,61,Guaynabo Municipio,4,0,4
50,Vermont,72,Puerto Rico,113,Ponce Municipio,32,0,32
50,Vermont,72,Puerto Rico,127,San Juan Municipio,12,0,12
50,Vermont,72,Puerto Rico,137,Toa Baja Municipio,12,0,12
50,Vermont,8,Colorado,1,Adams County,4,0,4
50,Vermont,8,Colorado,5,Arapahoe County,30,0,30
50,Vermont,8,Colorado,7,Archuleta County,1,0,1
50,Vermont,8,Colorado,13,Boulder County,98,122,-24
50,Vermont,8,Colorado,31,Denver County,58,131,-73
50,Vermont,8,Colorado,35,Douglas County,40,45,-5
50,Vermont,8,Colorado,37,Eagle County,2,0,2
50,Vermont,8,Colorado,41,El Paso County,69,143,-74
50,Vermont,8,Colorado,49,Grand County,1,0,1
50,Vermont,8,Colorado,59,Jefferson County,21,29,-8
50,Vermont,8,Colorado,65,Lake County,0,34,-34
50,Vermont,8,Colorado,67,La Plata County,102,0,102
50,Vermont,8,Colorado,69,Larimer County,50,53,-3
50,Vermont,8,Colorado,77,Mesa County,1,47,-46
50,Vermont,8,Colorado,83,Montezuma County,0,3,-3
50,Vermont,8,Colorado,97,Pitkin County,38,0,38
50,Vermont,8,Colorado,117,Summit County,7,0,7
50,Vermont,8,Colorado,123,Weld County,29,50,-21
50,Vermont,9,Connecticut,1,Fairfield County,194,118,76
50,Vermont,9,Connecticut,3,Hartford County,434,145,289
50,Vermont,9,Connecticut,5,Litchfield County,95,10,85
50,Vermont,9,Connecticut,7,Middlesex County,78,38,40
50,Vermont,9,Connecticut,9,New Haven County,182,190,-8
50,Vermont,9,Connecticut,11,New London County,51,103,-52
50,Vermont,9,Connecticut,13,Tolland County,91,0,91
50,Vermont,9,Connecticut,15,Windham County,20,0,20
50,Vermont,AFR,Africa,,-,57,0,0
50,Vermont,ASI,Asia,,-,1231,0,0
50,Vermont,CAM,Central America,,-,116,0,0
50,Vermont,CAR,Caribbean,,-,78,0,0
50,Vermont,EUR,Europe,,-,595,0,0
50,Vermont,ISL,U.S. Island Areas,,-,26,0,0
50,Vermont,NAM,Northern America,,-,353,0,0
50,Vermont,OCE,Oceania and At Sea,,-,61,0,0
50,Vermont,SAM,South America,,-,61,0,0
51,Virginia,1,Alabama,1,Autauga County,103,257,-154
51,Virginia,1,Alabama,3,Baldwin County,253,354,-101
51,Virginia,1,Alabama,5,Barbour County,34,74,-40
51,Virginia,1,Alabama,9,Blount County,25,5,20
51,Virginia,1,Alabama,11,Bullock County,82,0,82
51,Virginia,1,Alabama,15,Calhoun County,31,58,-27
51,Virginia,1,Alabama,21,Chilton County,0,63,-63
51,Virginia,1,Alabama,31,Coffee County,16,41,-25
51,Virginia,1,Alabama,33,Colbert County,0,30,-30
51,Virginia,1,Alabama,39,Covington County,13,0,13
51,Virginia,1,Alabama,41,Crenshaw County,0,60,-60
51,Virginia,1,Alabama,43,Cullman County,0,3,-3
51,Virginia,1,Alabama,45,Dale County,207,48,159
51,Virginia,1,Alabama,47,Dallas County,13,10,3
51,Virginia,1,Alabama,49,DeKalb County,23,0,23
51,Virginia,1,Alabama,51,Elmore County,13,51,-38
51,Virginia,1,Alabama,53,Escambia County,22,0,22
51,Virginia,1,Alabama,55,Etowah County,39,100,-61
51,Virginia,1,Alabama,59,Franklin County,48,0,48
51,Virginia,1,Alabama,61,Geneva County,88,8,80
51,Virginia,1,Alabama,63,Greene County,43,0,43
51,Virginia,1,Alabama,69,Houston County,22,35,-13
51,Virginia,1,Alabama,73,Jefferson County,403,298,105
51,Virginia,1,Alabama,77,Lauderdale County,8,50,-42
51,Virginia,1,Alabama,81,Lee County,106,275,-169
51,Virginia,1,Alabama,83,Limestone County,0,3,-3
51,Virginia,1,Alabama,87,Macon County,0,26,-26
51,Virginia,1,Alabama,89,Madison County,324,383,-59
51,Virginia,1,Alabama,93,Marion County,91,0,91
51,Virginia,1,Alabama,95,Marshall County,0,146,-146
51,Virginia,1,Alabama,97,Mobile County,203,70,133
51,Virginia,1,Alabama,101,Montgomery County,531,400,131
51,Virginia,1,Alabama,103,Morgan County,0,11,-11
51,Virginia,1,Alabama,105,Perry County,0,4,-4
51,Virginia,1,Alabama,107,Pickens County,0,42,-42
51,Virginia,1,Alabama,109,Pike County,10,2,8
51,Virginia,1,Alabama,113,Russell County,28,0,28
51,Virginia,1,Alabama,117,Shelby County,34,134,-100
51,Virginia,1,Alabama,119,Sumter County,24,0,24
51,Virginia,1,Alabama,121,Talladega County,0,5,-5
51,Virginia,1,Alabama,123,Tallapoosa County,0,12,-12
51,Virginia,1,Alabama,125,Tuscaloosa County,213,422,-209
51,Virginia,10,Delaware,1,Kent County,353,291,62
51,Virginia,10,Delaware,3,New Castle County,630,562,68
51,Virginia,10,Delaware,5,Sussex County,300,341,-41
51,Virginia,11,District of Columbia,1,District of Columbia,10617,8623,1994
51,Virginia,12,Florida,1,Alachua County,301,327,-26
51,Virginia,12,Florida,5,Bay County,576,427,149
51,Virginia,12,Florida,7,Bradford County,220,77,143
51,Virginia,12,Florida,9,Brevard County,583,1274,-691
51,Virginia,12,Florida,11,Broward County,1137,1539,-402
51,Virginia,12,Florida,13,Calhoun County,0,2,-2
51,Virginia,12,Florida,15,Charlotte County,187,247,-60
51,Virginia,12,Florida,17,Citrus County,300,88,212
51,Virginia,12,Florida,19,Clay County,923,1343,-420
51,Virginia,12,Florida,21,Collier County,199,629,-430
51,Virginia,12,Florida,23,Columbia County,27,61,-34
51,Virginia,12,Florida,27,DeSoto County,0,16,-16
51,Virginia,12,Florida,29,Dixie County,6,84,-78
51,Virginia,12,Florida,31,Duval County,1850,2082,-232
51,Virginia,12,Florida,33,Escambia County,937,1493,-556
51,Virginia,12,Florida,35,Flagler County,51,34,17
51,Virginia,12,Florida,39,Gadsden County,100,0,100
51,Virginia,12,Florida,43,Glades County,0,2,-2
51,Virginia,12,Florida,45,Gulf County,6,54,-48
51,Virginia,12,Florida,49,Hardee County,0,1,-1
51,Virginia,12,Florida,51,Hendry County,0,19,-19
51,Virginia,12,Florida,53,Hernando County,193,118,75
51,Virginia,12,Florida,55,Highlands County,72,64,8
51,Virginia,12,Florida,57,Hillsborough County,2190,2216,-26
51,Virginia,12,Florida,59,Holmes County,0,10,-10
51,Virginia,12,Florida,61,Indian River County,43,123,-80
51,Virginia,12,Florida,63,Jackson County,81,23,58
51,Virginia,12,Florida,65,Jefferson County,0,23,-23
51,Virginia,12,Florida,69,Lake County,160,426,-266
51,Virginia,12,Florida,71,Lee County,414,655,-241
51,Virginia,12,Florida,73,Leon County,381,202,179
51,Virginia,12,Florida,75,Levy County,50,35,15
51,Virginia,12,Florida,79,Madison County,12,0,12
51,Virginia,12,Florida,81,Manatee County,126,711,-585
51,Virginia,12,Florida,83,Marion County,296,578,-282
51,Virginia,12,Florida,85,Martin County,47,114,-67
51,Virginia,12,Florida,86,Miami-Dade County,1719,829,890
51,Virginia,12,Florida,87,Monroe County,166,218,-52
51,Virginia,12,Florida,89,Nassau County,166,59,107
51,Virginia,12,Florida,91,Okaloosa County,302,743,-441
51,Virginia,12,Florida,93,Okeechobee County,0,57,-57
51,Virginia,12,Florida,95,Orange County,1078,1608,-530
51,Virginia,12,Florida,97,Osceola County,103,135,-32
51,Virginia,12,Florida,99,Palm Beach County,845,881,-36
51,Virginia,12,Florida,101,Pasco County,408,472,-64
51,Virginia,12,Florida,103,Pinellas County,1731,940,791
51,Virginia,12,Florida,105,Polk County,355,418,-63
51,Virginia,12,Florida,107,Putnam County,5,55,-50
51,Virginia,12,Florida,109,St. Johns County,426,700,-274
51,Virginia,12,Florida,111,St. Lucie County,238,203,35
51,Virginia,12,Florida,113,Santa Rosa County,302,396,-94
51,Virginia,12,Florida,115,Sarasota County,165,479,-314
51,Virginia,12,Florida,117,Seminole County,578,613,-35
51,Virginia,12,Florida,119,Sumter County,167,278,-111
51,Virginia,12,Florida,121,Suwannee County,21,0,21
51,Virginia,12,Florida,125,Union County,11,0,11
51,Virginia,12,Florida,127,Volusia County,737,637,100
51,Virginia,12,Florida,131,Walton County,0,44,-44
51,Virginia,12,Florida,133,Washington County,11,21,-10
51,Virginia,13,Georgia,9,Baldwin County,21,0,21
51,Virginia,13,Georgia,11,Banks County,16,5,11
51,Virginia,13,Georgia,13,Barrow County,22,0,22
51,Virginia,13,Georgia,15,Bartow County,0,21,-21
51,Virginia,13,Georgia,19,Berrien County,10,0,10
51,Virginia,13,Georgia,21,Bibb County,35,31,4
51,Virginia,13,Georgia,23,Bleckley County,27,0,27
51,Virginia,13,Georgia,29,Bryan County,192,179,13
51,Virginia,13,Georgia,31,Bulloch County,0,38,-38
51,Virginia,13,Georgia,35,Butts County,16,24,-8
51,Virginia,13,Georgia,39,Camden County,408,501,-93
51,Virginia,13,Georgia,43,Candler County,0,12,-12
51,Virginia,13,Georgia,45,Carroll County,52,181,-129
51,Virginia,13,Georgia,47,Catoosa County,79,48,31
51,Virginia,13,Georgia,51,Chatham County,801,564,237
51,Virginia,13,Georgia,53,Chattahoochee County,178,237,-59
51,Virginia,13,Georgia,55,Chattooga County,0,12,-12
51,Virginia,13,Georgia,57,Cherokee County,265,279,-14
51,Virginia,13,Georgia,59,Clarke County,92,235,-143
51,Virginia,13,Georgia,63,Clayton County,186,629,-443
51,Virginia,13,Georgia,67,Cobb County,968,891,77
51,Virginia,13,Georgia,71,Colquitt County,12,37,-25
51,Virginia,13,Georgia,73,Columbia County,566,445,121
51,Virginia,13,Georgia,75,Cook County,20,0,20
51,Virginia,13,Georgia,77,Coweta County,123,171,-48
51,Virginia,13,Georgia,81,Crisp County,34,9,25
51,Virginia,13,Georgia,83,Dade County,0,13,-13
51,Virginia,13,Georgia,85,Dawson County,41,0,41
51,Virginia,13,Georgia,89,DeKalb County,690,1164,-474
51,Virginia,13,Georgia,95,Dougherty County,63,6,57
51,Virginia,13,Georgia,97,Douglas County,75,32,43
51,Virginia,13,Georgia,99,Early County,0,21,-21
51,Virginia,13,Georgia,103,Effingham County,52,0,52
51,Virginia,13,Georgia,105,Elbert County,12,83,-71
51,Virginia,13,Georgia,107,Emanuel County,27,11,16
51,Virginia,13,Georgia,109,Evans County,0,10,-10
51,Virginia,13,Georgia,111,Fannin County,21,0,21
51,Virginia,13,Georgia,113,Fayette County,183,53,130
51,Virginia,13,Georgia,115,Floyd County,78,85,-7
51,Virginia,13,Georgia,117,Forsyth County,82,230,-148
51,Virginia,13,Georgia,119,Franklin County,0,4,-4
51,Virginia,13,Georgia,121,Fulton County,949,1467,-518
51,Virginia,13,Georgia,127,Glynn County,228,14,214
51,Virginia,13,Georgia,129,Gordon County,8,0,8
51,Virginia,13,Georgia,133,Greene County,12,0,12
51,Virginia,13,Georgia,135,Gwinnett County,762,1625,-863
51,Virginia,13,Georgia,137,Habersham County,0,29,-29
51,Virginia,13,Georgia,139,Hall County,184,248,-64
51,Virginia,13,Georgia,145,Harris County,0,36,-36
51,Virginia,13,Georgia,151,Henry County,77,193,-116
51,Virginia,13,Georgia,153,Houston County,37,173,-136
51,Virginia,13,Georgia,157,Jackson County,0,10,-10
51,Virginia,13,Georgia,161,Jeff Davis County,29,0,29
51,Virginia,13,Georgia,163,Jefferson County,6,11,-5
51,Virginia,13,Georgia,167,Johnson County,18,0,18
51,Virginia,13,Georgia,169,Jones County,64,0,64
51,Virginia,13,Georgia,175,Laurens County,0,26,-26
51,Virginia,13,Georgia,177,Lee County,67,10,57
51,Virginia,13,Georgia,179,Liberty County,187,87,100
51,Virginia,13,Georgia,185,Lowndes County,339,91,248
51,Virginia,13,Georgia,187,Lumpkin County,0,8,-8
51,Virginia,13,Georgia,189,McDuffie County,28,29,-1
51,Virginia,13,Georgia,191,McIntosh County,0,3,-3
51,Virginia,13,Georgia,193,Macon County,11,0,11
51,Virginia,13,Georgia,195,Madison County,0,30,-30
51,Virginia,13,Georgia,213,Murray County,0,15,-15
51,Virginia,13,Georgia,215,Muscogee County,124,544,-420
51,Virginia,13,Georgia,217,Newton County,36,0,36
51,Virginia,13,Georgia,221,Oglethorpe County,0,11,-11
51,Virginia,13,Georgia,223,Paulding County,91,12,79
51,Virginia,13,Georgia,225,Peach County,16,10,6
51,Virginia,13,Georgia,227,Pickens County,0,9,-9
51,Virginia,13,Georgia,229,Pierce County,0,2,-2
51,Virginia,13,Georgia,233,Polk County,0,8,-8
51,Virginia,13,Georgia,237,Putnam County,4,28,-24
51,Virginia,13,Georgia,241,Rabun County,9,0,9
51,Virginia,13,Georgia,245,Richmond County,227,210,17
51,Virginia,13,Georgia,247,Rockdale County,0,34,-34
51,Virginia,13,Georgia,251,Screven County,0,19,-19
51,Virginia,13,Georgia,255,Spalding County,0,8,-8
51,Virginia,13,Georgia,261,Sumter County,18,0,18
51,Virginia,13,Georgia,271,Telfair County,0,8,-8
51,Virginia,13,Georgia,273,Terrell County,34,10,24
51,Virginia,13,Georgia,275,Thomas County,13,0,13
51,Virginia,13,Georgia,277,Tift County,0,33,-33
51,Virginia,13,Georgia,279,Toombs County,4,0,4
51,Virginia,13,Georgia,281,Towns County,5,0,5
51,Virginia,13,Georgia,283,Treutlen County,55,0,55
51,Virginia,13,Georgia,285,Troup County,0,1,-1
51,Virginia,13,Georgia,291,Union County,34,0,34
51,Virginia,13,Georgia,293,Upson County,10,0,10
51,Virginia,13,Georgia,295,Walker County,6,0,6
51,Virginia,13,Georgia,297,Walton County,10,0,10
51,Virginia,13,Georgia,299,Ware County,43,23,20
51,Virginia,13,Georgia,313,Whitfield County,17,41,-24
51,Virginia,15,Hawaii,1,Hawaii County,117,19,98
51,Virginia,15,Hawaii,3,Honolulu County,3129,2337,792
51,Virginia,15,Hawaii,7,Kauai County,48,8,40
51,Virginia,15,Hawaii,9,Maui County,39,78,-39
51,Virginia,16,Idaho,1,Ada County,119,48,71
51,Virginia,16,Idaho,5,Bannock County,74,16,58
51,Virginia,16,Idaho,11,Bingham County,0,80,-80
51,Virginia,16,Idaho,13,Blaine County,7,79,-72
51,Virginia,16,Idaho,15,Boise County,0,1,-1
51,Virginia,16,Idaho,17,Bonner County,29,6,23
51,Virginia,16,Idaho,19,Bonneville County,58,100,-42
51,Virginia,16,Idaho,27,Canyon County,0,3,-3
51,Virginia,16,Idaho,31,Cassia County,0,45,-45
51,Virginia,16,Idaho,39,Elmore County,10,0,10
51,Virginia,16,Idaho,49,Idaho County,0,4,-4
51,Virginia,16,Idaho,53,Jerome County,0,2,-2
51,Virginia,16,Idaho,55,Kootenai County,0,27,-27
51,Virginia,16,Idaho,57,Latah County,11,0,11
51,Virginia,16,Idaho,65,Madison County,8,282,-274
51,Virginia,16,Idaho,69,Nez Perce County,30,0,30
51,Virginia,16,Idaho,75,Payette County,0,19,-19
51,Virginia,16,Idaho,83,Twin Falls County,21,44,-23
51,Virginia,17,Illinois,5,Bond County,29,0,29
51,Virginia,17,Illinois,7,Boone County,19,0,19
51,Virginia,17,Illinois,11,Bureau County,14,10,4
51,Virginia,17,Illinois,13,Calhoun County,0,20,-20
51,Virginia,17,Illinois,17,Cass County,0,33,-33
51,Virginia,17,Illinois,19,Champaign County,247,172,75
51,Virginia,17,Illinois,21,Christian County,6,0,6
51,Virginia,17,Illinois,31,Cook County,2118,1944,174
51,Virginia,17,Illinois,35,Cumberland County,140,0,140
51,Virginia,17,Illinois,37,DeKalb County,215,201,14
51,Virginia,17,Illinois,43,DuPage County,419,286,133
51,Virginia,17,Illinois,51,Fayette County,0,25,-25
51,Virginia,17,Illinois,67,Hancock County,0,3,-3
51,Virginia,17,Illinois,73,Henry County,35,0,35
51,Virginia,17,Illinois,77,Jackson County,12,140,-128
51,Virginia,17,Illinois,79,Jasper County,0,9,-9
51,Virginia,17,Illinois,83,Jersey County,24,0,24
51,Virginia,17,Illinois,85,Jo Daviess County,0,1,-1
51,Virginia,17,Illinois,89,Kane County,51,305,-254
51,Virginia,17,Illinois,91,Kankakee County,47,49,-2
51,Virginia,17,Illinois,93,Kendall County,0,62,-62
51,Virginia,17,Illinois,95,Knox County,11,38,-27
51,Virginia,17,Illinois,97,Lake County,2179,706,1473
51,Virginia,17,Illinois,99,LaSalle County,0,14,-14
51,Virginia,17,Illinois,103,Lee County,0,8,-8
51,Virginia,17,Illinois,105,Livingston County,0,2,-2
51,Virginia,17,Illinois,107,Logan County,0,32,-32
51,Virginia,17,Illinois,111,McHenry County,116,239,-123
51,Virginia,17,Illinois,113,McLean County,82,63,19
51,Virginia,17,Illinois,115,Macon County,0,38,-38
51,Virginia,17,Illinois,119,Madison County,37,34,3
51,Virginia,17,Illinois,131,Mercer County,0,11,-11
51,Virginia,17,Illinois,135,Montgomery County,68,46,22
51,Virginia,17,Illinois,143,Peoria County,126,7,119
51,Virginia,17,Illinois,149,Pike County,24,0,24
51,Virginia,17,Illinois,151,Pope County,0,9,-9
51,Virginia,17,Illinois,157,Randolph County,9,21,-12
51,Virginia,17,Illinois,161,Rock Island County,114,38,76
51,Virginia,17,Illinois,163,St. Clair County,374,174,200
51,Virginia,17,Illinois,167,Sangamon County,36,90,-54
51,Virginia,17,Illinois,177,Stephenson County,7,0,7
51,Virginia,17,Illinois,179,Tazewell County,0,26,-26
51,Virginia,17,Illinois,183,Vermilion County,32,18,14
51,Virginia,17,Illinois,185,Wabash County,5,0,5
51,Virginia,17,Illinois,187,Warren County,0,4,-4
51,Virginia,17,Illinois,197,Will County,171,441,-270
51,Virginia,17,Illinois,199,Williamson County,0,8,-8
51,Virginia,17,Illinois,201,Winnebago County,11,22,-11
51,Virginia,17,Illinois,203,Woodford County,0,11,-11
51,Virginia,18,Indiana,3,Allen County,72,105,-33
51,Virginia,18,Indiana,5,Bartholomew County,17,69,-52
51,Virginia,18,Indiana,11,Boone County,0,3,-3
51,Virginia,18,Indiana,19,Clark County,3,35,-32
51,Virginia,18,Indiana,21,Clay County,0,27,-27
51,Virginia,18,Indiana,27,Daviess County,0,14,-14
51,Virginia,18,Indiana,33,DeKalb County,0,7,-7
51,Virginia,18,Indiana,35,Delaware County,88,32,56
51,Virginia,18,Indiana,37,Dubois County,0,89,-89
51,Virginia,18,Indiana,39,Elkhart County,111,68,43
51,Virginia,18,Indiana,45,Fountain County,0,21,-21
51,Virginia,18,Indiana,47,Franklin County,0,14,-14
51,Virginia,18,Indiana,49,Fulton County,0,3,-3
51,Virginia,18,Indiana,53,Grant County,7,73,-66
51,Virginia,18,Indiana,57,Hamilton County,209,281,-72
51,Virginia,18,Indiana,61,Harrison County,24,0,24
51,Virginia,18,Indiana,63,Hendricks County,65,64,1
51,Virginia,18,Indiana,65,Henry County,8,0,8
51,Virginia,18,Indiana,67,Howard County,4,0,4
51,Virginia,18,Indiana,69,Huntington County,0,20,-20
51,Virginia,18,Indiana,71,Jackson County,2,0,2
51,Virginia,18,Indiana,77,Jefferson County,0,23,-23
51,Virginia,18,Indiana,81,Johnson County,16,0,16
51,Virginia,18,Indiana,83,Knox County,7,0,7
51,Virginia,18,Indiana,85,Kosciusko County,0,24,-24
51,Virginia,18,Indiana,89,Lake County,162,27,135
51,Virginia,18,Indiana,91,LaPorte County,70,45,25
51,Virginia,18,Indiana,93,Lawrence County,28,0,28
51,Virginia,18,Indiana,95,Madison County,48,49,-1
51,Virginia,18,Indiana,97,Marion County,524,373,151
51,Virginia,18,Indiana,99,Marshall County,0,5,-5
51,Virginia,18,Indiana,101,Martin County,0,11,-11
51,Virginia,18,Indiana,103,Miami County,17,0,17
51,Virginia,18,Indiana,105,Monroe County,291,283,8
51,Virginia,18,Indiana,109,Morgan County,0,21,-21
51,Virginia,18,Indiana,119,Owen County,31,0,31
51,Virginia,18,Indiana,127,Porter County,99,66,33
51,Virginia,18,Indiana,133,Putnam County,0,13,-13
51,Virginia,18,Indiana,141,St. Joseph County,208,214,-6
51,Virginia,18,Indiana,147,Spencer County,17,0,17
51,Virginia,18,Indiana,153,Sullivan County,43,0,43
51,Virginia,18,Indiana,155,Switzerland County,11,0,11
51,Virginia,18,Indiana,157,Tippecanoe County,137,171,-34
51,Virginia,18,Indiana,161,Union County,0,10,-10
51,Virginia,18,Indiana,163,Vanderburgh County,43,37,6
51,Virginia,18,Indiana,165,Vermillion County,0,18,-18
51,Virginia,18,Indiana,167,Vigo County,23,66,-43
51,Virginia,18,Indiana,173,Warrick County,0,40,-40
51,Virginia,18,Indiana,175,Washington County,0,9,-9
51,Virginia,18,Indiana,177,Wayne County,34,8,26
51,Virginia,18,Indiana,181,White County,73,5,68
51,Virginia,19,Iowa,5,Allamakee County,0,3,-3
51,Virginia,19,Iowa,13,Black Hawk County,0,9,-9
51,Virginia,19,Iowa,15,Boone County,70,0,70
51,Virginia,19,Iowa,23,Butler County,85,0,85
51,Virginia,19,Iowa,27,Carroll County,18,0,18
51,Virginia,19,Iowa,33,Cerro Gordo County,0,20,-20
51,Virginia,19,Iowa,43,Clayton County,0,2,-2
51,Virginia,19,Iowa,45,Clinton County,26,1,25
51,Virginia,19,Iowa,49,Dallas County,17,117,-100
51,Virginia,19,Iowa,51,Davis County,0,15,-15
51,Virginia,19,Iowa,57,Des Moines County,0,32,-32
51,Virginia,19,Iowa,61,Dubuque County,20,23,-3
51,Virginia,19,Iowa,63,Emmet County,2,0,2
51,Virginia,19,Iowa,101,Jefferson County,8,0,8
51,Virginia,19,Iowa,103,Johnson County,137,107,30
51,Virginia,19,Iowa,105,Jones County,0,32,-32
51,Virginia,19,Iowa,111,Lee County,15,0,15
51,Virginia,19,Iowa,113,Linn County,32,41,-9
51,Virginia,19,Iowa,127,Marshall County,0,43,-43
51,Virginia,19,Iowa,129,Mills County,24,0,24
51,Virginia,19,Iowa,141,O'Brien County,0,15,-15
51,Virginia,19,Iowa,145,Page County,90,23,67
51,Virginia,19,Iowa,147,Palo Alto County,0,31,-31
51,Virginia,19,Iowa,151,Pocahontas County,0,8,-8
51,Virginia,19,Iowa,153,Polk County,148,80,68
51,Virginia,19,Iowa,155,Pottawattamie County,0,47,-47
51,Virginia,19,Iowa,163,Scott County,20,52,-32
51,Virginia,19,Iowa,167,Sioux County,0,3,-3
51,Virginia,19,Iowa,169,Story County,163,8,155
51,Virginia,19,Iowa,171,Tama County,0,19,-19
51,Virginia,19,Iowa,173,Taylor County,0,2,-2
51,Virginia,19,Iowa,179,Wapello County,19,26,-7
51,Virginia,19,Iowa,183,Washington County,0,21,-21
51,Virginia,19,Iowa,185,Wayne County,0,5,-5
51,Virginia,19,Iowa,187,Webster County,23,0,23
51,Virginia,19,Iowa,193,Woodbury County,33,0,33
51,Virginia,2,Alaska,20,Anchorage Municipality,1074,236,838
51,Virginia,2,Alaska,50,Bethel Census Area,0,1,-1
51,Virginia,2,Alaska,60,Bristol Bay Borough,0,1,-1
51,Virginia,2,Alaska,68,Denali Borough,74,0,74
51,Virginia,2,Alaska,90,Fairbanks North Star Borough,310,150,160
51,Virginia,2,Alaska,110,Juneau City and Borough,44,18,26
51,Virginia,2,Alaska,122,Kenai Peninsula Borough,0,13,-13
51,Virginia,2,Alaska,130,Ketchikan Gateway Borough,0,12,-12
51,Virginia,2,Alaska,150,Kodiak Island Borough,78,24,54
51,Virginia,2,Alaska,164,Lake and Peninsula Borough,24,0,24
51,Virginia,2,Alaska,170,Matanuska-Susitna Borough,100,9,91
51,Virginia,2,Alaska,180,Nome Census Area,18,0,18
51,Virginia,2,Alaska,188,Northwest Arctic Borough,0,3,-3
51,Virginia,2,Alaska,198,Prince of Wales-Hyder Census Area,0,7,-7
51,Virginia,2,Alaska,220,Sitka City and Borough,0,31,-31
51,Virginia,2,Alaska,240,Southeast Fairbanks Census Area,0,18,-18
51,Virginia,2,Alaska,261,Valdez-Cordova Census Area,48,0,48
51,Virginia,20,Kansas,9,Barton County,0,2,-2
51,Virginia,20,Kansas,11,Bourbon County,0,5,-5
51,Virginia,20,Kansas,13,Brown County,0,14,-14
51,Virginia,20,Kansas,15,Butler County,0,74,-74
51,Virginia,20,Kansas,21,Cherokee County,0,12,-12
51,Virginia,20,Kansas,29,Cloud County,25,0,25
51,Virginia,20,Kansas,31,Coffey County,0,1,-1
51,Virginia,20,Kansas,37,Crawford County,38,0,38
51,Virginia,20,Kansas,45,Douglas County,224,150,74
51,Virginia,20,Kansas,59,Franklin County,15,0,15
51,Virginia,20,Kansas,61,Geary County,447,95,352
51,Virginia,20,Kansas,79,Harvey County,6,7,-1
51,Virginia,20,Kansas,85,Jackson County,12,0,12
51,Virginia,20,Kansas,91,Johnson County,481,481,0
51,Virginia,20,Kansas,99,Labette County,24,0,24
51,Virginia,20,Kansas,103,Leavenworth County,365,406,-41
51,Virginia,20,Kansas,107,Linn County,0,9,-9
51,Virginia,20,Kansas,111,Lyon County,0,38,-38
51,Virginia,20,Kansas,113,McPherson County,0,7,-7
51,Virginia,20,Kansas,127,Morris County,0,3,-3
51,Virginia,20,Kansas,133,Neosho County,0,5,-5
51,Virginia,20,Kansas,137,Norton County,0,3,-3
51,Virginia,20,Kansas,149,Pottawatomie County,0,169,-169
51,Virginia,20,Kansas,151,Pratt County,0,31,-31
51,Virginia,20,Kansas,155,Reno County,10,70,-60
51,Virginia,20,Kansas,161,Riley County,122,131,-9
51,Virginia,20,Kansas,163,Rooks County,0,5,-5
51,Virginia,20,Kansas,167,Russell County,0,44,-44
51,Virginia,20,Kansas,169,Saline County,0,5,-5
51,Virginia,20,Kansas,173,Sedgwick County,38,25,13
51,Virginia,20,Kansas,177,Shawnee County,21,0,21
51,Virginia,20,Kansas,189,Stevens County,0,65,-65
51,Virginia,20,Kansas,209,Wyandotte County,0,7,-7
51,Virginia,21,Kentucky,1,Adair County,26,15,11
51,Virginia,21,Kentucky,3,Allen County,6,0,6
51,Virginia,21,Kentucky,9,Barren County,0,151,-151
51,Virginia,21,Kentucky,13,Bell County,30,137,-107
51,Virginia,21,Kentucky,15,Boone County,0,29,-29
51,Virginia,21,Kentucky,17,Bourbon County,14,32,-18
51,Virginia,21,Kentucky,19,Boyd County,41,33,8
51,Virginia,21,Kentucky,21,Boyle County,0,3,-3
51,Virginia,21,Kentucky,29,Bullitt County,54,0,54
51,Virginia,21,Kentucky,35,Calloway County,0,8,-8
51,Virginia,21,Kentucky,37,Campbell County,42,38,4
51,Virginia,21,Kentucky,43,Carter County,5,0,5
51,Virginia,21,Kentucky,47,Christian County,122,72,50
51,Virginia,21,Kentucky,49,Clark County,48,0,48
51,Virginia,21,Kentucky,55,Crittenden County,0,20,-20
51,Virginia,21,Kentucky,57,Cumberland County,0,8,-8
51,Virginia,21,Kentucky,59,Daviess County,60,10,50
51,Virginia,21,Kentucky,61,Edmonson County,0,26,-26
51,Virginia,21,Kentucky,65,Estill County,0,1,-1
51,Virginia,21,Kentucky,67,Fayette County,540,261,279
51,Virginia,21,Kentucky,71,Floyd County,11,140,-129
51,Virginia,21,Kentucky,73,Franklin County,0,77,-77
51,Virginia,21,Kentucky,77,Gallatin County,0,39,-39
51,Virginia,21,Kentucky,81,Grant County,14,0,14
51,Virginia,21,Kentucky,83,Graves County,40,0,40
51,Virginia,21,Kentucky,85,Grayson County,0,48,-48
51,Virginia,21,Kentucky,89,Greenup County,0,2,-2
51,Virginia,21,Kentucky,93,Hardin County,185,228,-43
51,Virginia,21,Kentucky,95,Harlan County,58,0,58
51,Virginia,21,Kentucky,101,Henderson County,56,0,56
51,Virginia,21,Kentucky,103,Henry County,18,0,18
51,Virginia,21,Kentucky,111,Jefferson County,562,450,112
51,Virginia,21,Kentucky,113,Jessamine County,111,0,111
51,Virginia,21,Kentucky,117,Kenton County,0,118,-118
51,Virginia,21,Kentucky,119,Knott County,0,42,-42
51,Virginia,21,Kentucky,121,Knox County,0,8,-8
51,Virginia,21,Kentucky,123,Larue County,0,1,-1
51,Virginia,21,Kentucky,125,Laurel County,0,150,-150
51,Virginia,21,Kentucky,133,Letcher County,16,11,5
51,Virginia,21,Kentucky,135,Lewis County,15,0,15
51,Virginia,21,Kentucky,141,Logan County,51,3,48
51,Virginia,21,Kentucky,145,McCracken County,0,11,-11
51,Virginia,21,Kentucky,147,McCreary County,32,0,32
51,Virginia,21,Kentucky,151,Madison County,120,65,55
51,Virginia,21,Kentucky,153,Magoffin County,4,0,4
51,Virginia,21,Kentucky,155,Marion County,0,9,-9
51,Virginia,21,Kentucky,157,Marshall County,30,0,30
51,Virginia,21,Kentucky,159,Martin County,0,27,-27
51,Virginia,21,Kentucky,161,Mason County,0,8,-8
51,Virginia,21,Kentucky,163,Meade County,86,10,76
51,Virginia,21,Kentucky,167,Mercer County,0,25,-25
51,Virginia,21,Kentucky,173,Montgomery County,22,0,22
51,Virginia,21,Kentucky,177,Muhlenberg County,0,12,-12
51,Virginia,21,Kentucky,179,Nelson County,117,0,117
51,Virginia,21,Kentucky,183,Ohio County,5,0,5
51,Virginia,21,Kentucky,185,Oldham County,59,102,-43
51,Virginia,21,Kentucky,193,Perry County,118,9,109
51,Virginia,21,Kentucky,195,Pike County,151,157,-6
51,Virginia,21,Kentucky,199,Pulaski County,8,0,8
51,Virginia,21,Kentucky,205,Rowan County,0,78,-78
51,Virginia,21,Kentucky,209,Scott County,7,0,7
51,Virginia,21,Kentucky,211,Shelby County,27,0,27
51,Virginia,21,Kentucky,217,Taylor County,40,4,36
51,Virginia,21,Kentucky,225,Union County,0,8,-8
51,Virginia,21,Kentucky,227,Warren County,254,16,238
51,Virginia,21,Kentucky,233,Webster County,112,0,112
51,Virginia,21,Kentucky,235,Whitley County,26,0,26
51,Virginia,21,Kentucky,239,Woodford County,20,17,3
51,Virginia,22,Louisiana,5,Ascension Parish,54,0,54
51,Virginia,22,Louisiana,7,Assumption Parish,0,81,-81
51,Virginia,22,Louisiana,11,Beauregard Parish,39,7,32
51,Virginia,22,Louisiana,15,Bossier Parish,232,326,-94
51,Virginia,22,Louisiana,17,Caddo Parish,21,94,-73
51,Virginia,22,Louisiana,31,De Soto Parish,0,1,-1
51,Virginia,22,Louisiana,33,East Baton Rouge Parish,177,452,-275
51,Virginia,22,Louisiana,35,East Carroll Parish,12,0,12
51,Virginia,22,Louisiana,43,Grant Parish,0,18,-18
51,Virginia,22,Louisiana,45,Iberia Parish,59,0,59
51,Virginia,22,Louisiana,51,Jefferson Parish,193,58,135
51,Virginia,22,Louisiana,55,Lafayette Parish,46,31,15
51,Virginia,22,Louisiana,61,Lincoln Parish,57,39,18
51,Virginia,22,Louisiana,63,Livingston Parish,65,81,-16
51,Virginia,22,Louisiana,69,Natchitoches Parish,0,2,-2
51,Virginia,22,Louisiana,71,Orleans Parish,507,337,170
51,Virginia,22,Louisiana,73,Ouachita Parish,39,9,30
51,Virginia,22,Louisiana,75,Plaquemines Parish,0,180,-180
51,Virginia,22,Louisiana,79,Rapides Parish,49,111,-62
51,Virginia,22,Louisiana,89,St. Charles Parish,62,82,-20
51,Virginia,22,Louisiana,97,St. Landry Parish,0,15,-15
51,Virginia,22,Louisiana,103,St. Tammany Parish,537,238,299
51,Virginia,22,Louisiana,105,Tangipahoa Parish,41,3,38
51,Virginia,22,Louisiana,109,Terrebonne Parish,24,0,24
51,Virginia,22,Louisiana,113,Vermilion Parish,27,20,7
51,Virginia,22,Louisiana,115,Vernon Parish,65,299,-234
51,Virginia,22,Louisiana,117,Washington Parish,0,18,-18
51,Virginia,22,Louisiana,119,Webster Parish,43,12,31
51,Virginia,22,Louisiana,123,West Carroll Parish,74,0,74
51,Virginia,23,Maine,1,Androscoggin County,20,44,-24
51,Virginia,23,Maine,3,Aroostook County,27,15,12
51,Virginia,23,Maine,5,Cumberland County,151,221,-70
51,Virginia,23,Maine,7,Franklin County,84,45,39
51,Virginia,23,Maine,9,Hancock County,62,8,54
51,Virginia,23,Maine,11,Kennebec County,17,72,-55
51,Virginia,23,Maine,13,Knox County,42,18,24
51,Virginia,23,Maine,15,Lincoln County,24,0,24
51,Virginia,23,Maine,17,Oxford County,3,10,-7
51,Virginia,23,Maine,19,Penobscot County,136,79,57
51,Virginia,23,Maine,21,Piscataquis County,92,6,86
51,Virginia,23,Maine,23,Sagadahoc County,6,20,-14
51,Virginia,23,Maine,25,Somerset County,13,13,0
51,Virginia,23,Maine,27,Waldo County,95,5,90
51,Virginia,23,Maine,29,Washington County,55,14,41
51,Virginia,23,Maine,31,York County,233,112,121
51,Virginia,24,Maryland,1,Allegany County,147,189,-42
51,Virginia,24,Maryland,3,Anne Arundel County,2423,2330,93
51,Virginia,24,Maryland,5,Baltimore County,1487,1256,231
51,Virginia,24,Maryland,9,Calvert County,283,340,-57
51,Virginia,24,Maryland,11,Caroline County,26,68,-42
51,Virginia,24,Maryland,13,Carroll County,307,194,113
51,Virginia,24,Maryland,15,Cecil County,315,75,240
51,Virginia,24,Maryland,17,Charles County,1466,1492,-26
51,Virginia,24,Maryland,19,Dorchester County,23,41,-18
51,Virginia,24,Maryland,21,Frederick County,1407,1079,328
51,Virginia,24,Maryland,23,Garrett County,0,25,-25
51,Virginia,24,Maryland,25,Harford County,602,450,152
51,Virginia,24,Maryland,27,Howard County,1278,1110,168
51,Virginia,24,Maryland,29,Kent County,76,26,50
51,Virginia,24,Maryland,31,Montgomery County,7699,5025,2674
51,Virginia,24,Maryland,33,Prince George's County,5553,6368,-815
51,Virginia,24,Maryland,35,Queen Anne's County,47,77,-30
51,Virginia,24,Maryland,37,St. Mary's County,1158,811,347
51,Virginia,24,Maryland,39,Somerset County,20,43,-23
51,Virginia,24,Maryland,41,Talbot County,76,161,-85
51,Virginia,24,Maryland,43,Washington County,262,149,113
51,Virginia,24,Maryland,45,Wicomico County,386,351,35
51,Virginia,24,Maryland,47,Worcester County,377,276,101
51,Virginia,24,Maryland,510,Baltimore city,2135,1277,858
51,Virginia,25,Massachusetts,1,Barnstable County,167,70,97
51,Virginia,25,Massachusetts,3,Berkshire County,81,59,22
51,Virginia,25,Massachusetts,5,Bristol County,268,158,110
51,Virginia,25,Massachusetts,7,Dukes County,8,7,1
51,Virginia,25,Massachusetts,9,Essex County,173,252,-79
51,Virginia,25,Massachusetts,11,Franklin County,62,3,59
51,Virginia,25,Massachusetts,13,Hampden County,92,138,-46
51,Virginia,25,Massachusetts,15,Hampshire County,74,105,-31
51,Virginia,25,Massachusetts,17,Middlesex County,1248,1834,-586
51,Virginia,25,Massachusetts,21,Norfolk County,582,177,405
51,Virginia,25,Massachusetts,23,Plymouth County,248,339,-91
51,Virginia,25,Massachusetts,25,Suffolk County,684,993,-309
51,Virginia,25,Massachusetts,27,Worcester County,761,380,381
51,Virginia,26,Michigan,3,Alger County,0,49,-49
51,Virginia,26,Michigan,5,Allegan County,6,12,-6
51,Virginia,26,Michigan,7,Alpena County,107,23,84
51,Virginia,26,Michigan,9,Antrim County,0,10,-10
51,Virginia,26,Michigan,11,Arenac County,0,5,-5
51,Virginia,26,Michigan,15,Barry County,117,25,92
51,Virginia,26,Michigan,17,Bay County,50,19,31
51,Virginia,26,Michigan,21,Berrien County,108,202,-94
51,Virginia,26,Michigan,23,Branch County,0,15,-15
51,Virginia,26,Michigan,25,Calhoun County,12,41,-29
51,Virginia,26,Michigan,27,Cass County,0,10,-10
51,Virginia,26,Michigan,29,Charlevoix County,8,0,8
51,Virginia,26,Michigan,31,Cheboygan County,0,5,-5
51,Virginia,26,Michigan,33,Chippewa County,0,9,-9
51,Virginia,26,Michigan,37,Clinton County,23,2,21
51,Virginia,26,Michigan,41,Delta County,0,33,-33
51,Virginia,26,Michigan,45,Eaton County,0,14,-14
51,Virginia,26,Michigan,47,Emmet County,0,6,-6
51,Virginia,26,Michigan,49,Genesee County,65,9,56
51,Virginia,26,Michigan,55,Grand Traverse County,13,84,-71
51,Virginia,26,Michigan,59,Hillsdale County,25,6,19
51,Virginia,26,Michigan,61,Houghton County,7,11,-4
51,Virginia,26,Michigan,63,Huron County,0,6,-6
51,Virginia,26,Michigan,65,Ingham County,68,243,-175
51,Virginia,26,Michigan,67,Ionia County,0,11,-11
51,Virginia,26,Michigan,73,Isabella County,0,28,-28
51,Virginia,26,Michigan,75,Jackson County,46,30,16
51,Virginia,26,Michigan,77,Kalamazoo County,51,114,-63
51,Virginia,26,Michigan,79,Kalkaska County,0,12,-12
51,Virginia,26,Michigan,81,Kent County,341,105,236
51,Virginia,26,Michigan,83,Keweenaw County,0,9,-9
51,Virginia,26,Michigan,87,Lapeer County,23,51,-28
51,Virginia,26,Michigan,89,Leelanau County,23,3,20
51,Virginia,26,Michigan,91,Lenawee County,61,16,45
51,Virginia,26,Michigan,93,Livingston County,35,8,27
51,Virginia,26,Michigan,97,Mackinac County,0,1,-1
51,Virginia,26,Michigan,99,Macomb County,248,109,139
51,Virginia,26,Michigan,101,Manistee County,6,0,6
51,Virginia,26,Michigan,103,Marquette County,37,37,0
51,Virginia,26,Michigan,111,Midland County,29,22,7
51,Virginia,26,Michigan,115,Monroe County,185,27,158
51,Virginia,26,Michigan,117,Montcalm County,29,0,29
51,Virginia,26,Michigan,119,Montmorency County,0,8,-8
51,Virginia,26,Michigan,121,Muskegon County,33,54,-21
51,Virginia,26,Michigan,123,Newaygo County,8,0,8
51,Virginia,26,Michigan,125,Oakland County,541,459,82
51,Virginia,26,Michigan,129,Ogemaw County,0,17,-17
51,Virginia,26,Michigan,131,Ontonagon County,0,4,-4
51,Virginia,26,Michigan,139,Ottawa County,67,144,-77
51,Virginia,26,Michigan,143,Roscommon County,29,57,-28
51,Virginia,26,Michigan,145,Saginaw County,47,36,11
51,Virginia,26,Michigan,147,St. Clair County,41,16,25
51,Virginia,26,Michigan,149,St. Joseph County,72,0,72
51,Virginia,26,Michigan,151,Sanilac County,0,5,-5
51,Virginia,26,Michigan,157,Tuscola County,0,17,-17
51,Virginia,26,Michigan,159,Van Buren County,0,13,-13
51,Virginia,26,Michigan,161,Washtenaw County,246,247,-1
51,Virginia,26,Michigan,163,Wayne County,607,182,425
51,Virginia,27,Minnesota,1,Aitkin County,0,3,-3
51,Virginia,27,Minnesota,3,Anoka County,22,0,22
51,Virginia,27,Minnesota,5,Becker County,0,12,-12
51,Virginia,27,Minnesota,7,Beltrami County,20,23,-3
51,Virginia,27,Minnesota,9,Benton County,15,52,-37
51,Virginia,27,Minnesota,17,Carlton County,11,0,11
51,Virginia,27,Minnesota,25,Chisago County,0,10,-10
51,Virginia,27,Minnesota,33,Cottonwood County,8,2,6
51,Virginia,27,Minnesota,35,Crow Wing County,0,12,-12
51,Virginia,27,Minnesota,37,Dakota County,331,354,-23
51,Virginia,27,Minnesota,39,Dodge County,9,5,4
51,Virginia,27,Minnesota,47,Freeborn County,0,15,-15
51,Virginia,27,Minnesota,53,Hennepin County,937,761,176
51,Virginia,27,Minnesota,57,Hubbard County,0,8,-8
51,Virginia,27,Minnesota,63,Jackson County,0,26,-26
51,Virginia,27,Minnesota,65,Kanabec County,0,9,-9
51,Virginia,27,Minnesota,67,Kandiyohi County,0,44,-44
51,Virginia,27,Minnesota,75,Lake County,24,0,24
51,Virginia,27,Minnesota,79,Le Sueur County,44,0,44
51,Virginia,27,Minnesota,83,Lyon County,0,45,-45
51,Virginia,27,Minnesota,85,McLeod County,0,6,-6
51,Virginia,27,Minnesota,103,Nicollet County,0,15,-15
51,Virginia,27,Minnesota,105,Nobles County,7,0,7
51,Virginia,27,Minnesota,109,Olmsted County,115,0,115
51,Virginia,27,Minnesota,113,Pennington County,42,0,42
51,Virginia,27,Minnesota,117,Pipestone County,0,10,-10
51,Virginia,27,Minnesota,123,Ramsey County,343,76,267
51,Virginia,27,Minnesota,131,Rice County,0,33,-33
51,Virginia,27,Minnesota,137,St. Louis County,45,65,-20
51,Virginia,27,Minnesota,139,Scott County,7,179,-172
51,Virginia,27,Minnesota,145,Stearns County,31,12,19
51,Virginia,27,Minnesota,147,Steele County,0,1,-1
51,Virginia,27,Minnesota,149,Stevens County,0,9,-9
51,Virginia,27,Minnesota,163,Washington County,105,42,63
51,Virginia,27,Minnesota,165,Watonwan County,0,19,-19
51,Virginia,27,Minnesota,169,Winona County,144,51,93
51,Virginia,27,Minnesota,171,Wright County,11,29,-18
51,Virginia,28,Mississippi,9,Benton County,0,4,-4
51,Virginia,28,Mississippi,19,Choctaw County,7,0,7
51,Virginia,28,Mississippi,27,Coahoma County,1,0,1
51,Virginia,28,Mississippi,33,DeSoto County,136,45,91
51,Virginia,28,Mississippi,35,Forrest County,55,35,20
51,Virginia,28,Mississippi,45,Hancock County,17,0,17
51,Virginia,28,Mississippi,47,Harrison County,527,301,226
51,Virginia,28,Mississippi,49,Hinds County,8,64,-56
51,Virginia,28,Mississippi,59,Jackson County,66,31,35
51,Virginia,28,Mississippi,71,Lafayette County,70,92,-22
51,Virginia,28,Mississippi,73,Lamar County,0,33,-33
51,Virginia,28,Mississippi,75,Lauderdale County,102,109,-7
51,Virginia,28,Mississippi,81,Lee County,5,0,5
51,Virginia,28,Mississippi,87,Lowndes County,0,51,-51
51,Virginia,28,Mississippi,89,Madison County,146,82,64
51,Virginia,28,Mississippi,95,Monroe County,105,1,104
51,Virginia,28,Mississippi,99,Neshoba County,23,0,23
51,Virginia,28,Mississippi,105,Oktibbeha County,10,135,-125
51,Virginia,28,Mississippi,111,Perry County,0,29,-29
51,Virginia,28,Mississippi,113,Pike County,0,24,-24
51,Virginia,28,Mississippi,121,Rankin County,30,0,30
51,Virginia,28,Mississippi,131,Stone County,40,0,40
51,Virginia,28,Mississippi,149,Warren County,0,12,-12
51,Virginia,28,Mississippi,151,Washington County,0,14,-14
51,Virginia,28,Mississippi,163,Yazoo County,6,0,6
51,Virginia,29,Missouri,1,Adair County,0,17,-17
51,Virginia,29,Missouri,19,Boone County,102,249,-147
51,Virginia,29,Missouri,21,Buchanan County,19,29,-10
51,Virginia,29,Missouri,23,Butler County,0,7,-7
51,Virginia,29,Missouri,31,Cape Girardeau County,56,0,56
51,Virginia,29,Missouri,33,Carroll County,15,0,15
51,Virginia,29,Missouri,43,Christian County,101,3,98
51,Virginia,29,Missouri,47,Clay County,12,77,-65
51,Virginia,29,Missouri,51,Cole County,0,26,-26
51,Virginia,29,Missouri,71,Franklin County,25,47,-22
51,Virginia,29,Missouri,77,Greene County,157,230,-73
51,Virginia,29,Missouri,79,Grundy County,0,6,-6
51,Virginia,29,Missouri,95,Jackson County,149,183,-34
51,Virginia,29,Missouri,97,Jasper County,0,6,-6
51,Virginia,29,Missouri,99,Jefferson County,45,17,28
51,Virginia,29,Missouri,101,Johnson County,98,20,78
51,Virginia,29,Missouri,105,Laclede County,54,12,42
51,Virginia,29,Missouri,109,Lawrence County,0,13,-13
51,Virginia,29,Missouri,113,Lincoln County,80,0,80
51,Virginia,29,Missouri,117,Livingston County,18,0,18
51,Virginia,29,Missouri,119,McDonald County,0,11,-11
51,Virginia,29,Missouri,127,Marion County,0,17,-17
51,Virginia,29,Missouri,143,New Madrid County,49,0,49
51,Virginia,29,Missouri,145,Newton County,111,0,111
51,Virginia,29,Missouri,149,Oregon County,3,0,3
51,Virginia,29,Missouri,157,Perry County,22,0,22
51,Virginia,29,Missouri,159,Pettis County,0,3,-3
51,Virginia,29,Missouri,161,Phelps County,0,43,-43
51,Virginia,29,Missouri,165,Platte County,73,131,-58
51,Virginia,29,Missouri,169,Pulaski County,428,356,72
51,Virginia,29,Missouri,175,Randolph County,72,21,51
51,Virginia,29,Missouri,183,St. Charles County,220,70,150
51,Virginia,29,Missouri,189,St. Louis County,527,460,67
51,Virginia,29,Missouri,195,Saline County,17,0,17
51,Virginia,29,Missouri,203,Shannon County,0,4,-4
51,Virginia,29,Missouri,207,Stoddard County,0,2,-2
51,Virginia,29,Missouri,217,Vernon County,35,0,35
51,Virginia,29,Missouri,223,Wayne County,9,0,9
51,Virginia,29,Missouri,225,Webster County,0,10,-10
51,Virginia,29,Missouri,229,Wright County,15,0,15
51,Virginia,29,Missouri,510,St. Louis city,280,395,-115
51,Virginia,30,Montana,1,Beaverhead County,4,0,4
51,Virginia,30,Montana,9,Carbon County,0,14,-14
51,Virginia,30,Montana,13,Cascade County,36,53,-17
51,Virginia,30,Montana,15,Chouteau County,0,9,-9
51,Virginia,30,Montana,17,Custer County,0,16,-16
51,Virginia,30,Montana,29,Flathead County,16,130,-114
51,Virginia,30,Montana,31,Gallatin County,55,36,19
51,Virginia,30,Montana,41,Hill County,0,6,-6
51,Virginia,30,Montana,43,Jefferson County,14,8,6
51,Virginia,30,Montana,49,Lewis and Clark County,61,11,50
51,Virginia,30,Montana,53,Lincoln County,24,0,24
51,Virginia,30,Montana,57,Madison County,0,9,-9
51,Virginia,30,Montana,63,Missoula County,28,15,13
51,Virginia,30,Montana,67,Park County,0,10,-10
51,Virginia,30,Montana,73,Pondera County,0,7,-7
51,Virginia,30,Montana,81,Ravalli County,16,0,16
51,Virginia,30,Montana,85,Roosevelt County,0,17,-17
51,Virginia,30,Montana,93,Silver Bow County,0,15,-15
51,Virginia,30,Montana,111,Yellowstone County,0,15,-15
51,Virginia,31,Nebraska,19,Buffalo County,0,13,-13
51,Virginia,31,Nebraska,23,Butler County,22,0,22
51,Virginia,31,Nebraska,25,Cass County,45,0,45
51,Virginia,31,Nebraska,33,Cheyenne County,0,18,-18
51,Virginia,31,Nebraska,37,Colfax County,9,0,9
51,Virginia,31,Nebraska,45,Dawes County,9,0,9
51,Virginia,31,Nebraska,55,Douglas County,285,264,21
51,Virginia,31,Nebraska,79,Hall County,0,4,-4
51,Virginia,31,Nebraska,109,Lancaster County,156,81,75
51,Virginia,31,Nebraska,111,Lincoln County,0,40,-40
51,Virginia,31,Nebraska,113,Logan County,0,14,-14
51,Virginia,31,Nebraska,145,Red Willow County,0,15,-15
51,Virginia,31,Nebraska,151,Saline County,12,0,12
51,Virginia,31,Nebraska,153,Sarpy County,416,405,11
51,Virginia,31,Nebraska,155,Saunders County,0,23,-23
51,Virginia,31,Nebraska,157,Scotts Bluff County,0,18,-18
51,Virginia,31,Nebraska,159,Seward County,34,0,34
51,Virginia,31,Nebraska,161,Sheridan County,0,20,-20
51,Virginia,31,Nebraska,171,Thomas County,0,4,-4
51,Virginia,31,Nebraska,177,Washington County,0,12,-12
51,Virginia,32,Nevada,1,Churchill County,40,55,-15
51,Virginia,32,Nevada,3,Clark County,1088,1218,-130
51,Virginia,32,Nevada,11,Eureka County,32,0,32
51,Virginia,32,Nevada,13,Humboldt County,19,0,19
51,Virginia,32,Nevada,19,Lyon County,13,132,-119
51,Virginia,32,Nevada,23,Nye County,30,0,30
51,Virginia,32,Nevada,31,Washoe County,107,201,-94
51,Virginia,33,New Hampshire,1,Belknap County,25,33,-8
51,Virginia,33,New Hampshire,3,Carroll County,34,17,17
51,Virginia,33,New Hampshire,5,Cheshire County,23,10,13
51,Virginia,33,New Hampshire,9,Grafton County,68,59,9
51,Virginia,33,New Hampshire,11,Hillsborough County,191,239,-48
51,Virginia,33,New Hampshire,13,Merrimack County,16,43,-27
51,Virginia,33,New Hampshire,15,Rockingham County,232,137,95
51,Virginia,33,New Hampshire,17,Strafford County,153,138,15
51,Virginia,34,New Jersey,1,Atlantic County,223,33,190
51,Virginia,34,New Jersey,3,Bergen County,397,290,107
51,Virginia,34,New Jersey,5,Burlington County,793,430,363
51,Virginia,34,New Jersey,7,Camden County,623,252,371
51,Virginia,34,New Jersey,9,Cape May County,365,67,298
51,Virginia,34,New Jersey,11,Cumberland County,45,9,36
51,Virginia,34,New Jersey,13,Essex County,723,242,481
51,Virginia,34,New Jersey,15,Gloucester County,196,78,118
51,Virginia,34,New Jersey,17,Hudson County,658,622,36
51,Virginia,34,New Jersey,19,Hunterdon County,216,0,216
51,Virginia,34,New Jersey,21,Mercer County,774,350,424
51,Virginia,34,New Jersey,23,Middlesex County,705,450,255
51,Virginia,34,New Jersey,25,Monmouth County,480,380,100
51,Virginia,34,New Jersey,27,Morris County,531,183,348
51,Virginia,34,New Jersey,29,Ocean County,363,311,52
51,Virginia,34,New Jersey,31,Passaic County,632,7,625
51,Virginia,34,New Jersey,33,Salem County,123,19,104
51,Virginia,34,New Jersey,35,Somerset County,440,247,193
51,Virginia,34,New Jersey,37,Sussex County,225,76,149
51,Virginia,34,New Jersey,39,Union County,347,440,-93
51,Virginia,34,New Jersey,41,Warren County,31,163,-132
51,Virginia,35,New Mexico,1,Bernalillo County,609,707,-98
51,Virginia,35,New Mexico,5,Chaves County,0,42,-42
51,Virginia,35,New Mexico,9,Curry County,79,96,-17
51,Virginia,35,New Mexico,13,Doña Ana County,203,173,30
51,Virginia,35,New Mexico,17,Grant County,44,0,44
51,Virginia,35,New Mexico,25,Lea County,0,9,-9
51,Virginia,35,New Mexico,27,Lincoln County,0,49,-49
51,Virginia,35,New Mexico,28,Los Alamos County,110,21,89
51,Virginia,35,New Mexico,31,McKinley County,0,20,-20
51,Virginia,35,New Mexico,35,Otero County,82,6,76
51,Virginia,35,New Mexico,39,Rio Arriba County,0,16,-16
51,Virginia,35,New Mexico,43,Sandoval County,54,90,-36
51,Virginia,35,New Mexico,45,San Juan County,0,25,-25
51,Virginia,35,New Mexico,47,San Miguel County,0,52,-52
51,Virginia,35,New Mexico,49,Santa Fe County,31,69,-38
51,Virginia,35,New Mexico,51,Sierra County,30,0,30
51,Virginia,35,New Mexico,55,Taos County,22,35,-13
51,Virginia,35,New Mexico,61,Valencia County,24,0,24
51,Virginia,36,New York,1,Albany County,356,283,73
51,Virginia,36,New York,3,Allegany County,2,13,-11
51,Virginia,36,New York,5,Bronx County,968,253,715
51,Virginia,36,New York,7,Broome County,105,124,-19
51,Virginia,36,New York,9,Cattaraugus County,3,4,-1
51,Virginia,36,New York,11,Cayuga County,14,6,8
51,Virginia,36,New York,13,Chautauqua County,71,17,54
51,Virginia,36,New York,15,Chemung County,92,42,50
51,Virginia,36,New York,17,Chenango County,8,35,-27
51,Virginia,36,New York,19,Clinton County,62,0,62
51,Virginia,36,New York,21,Columbia County,0,206,-206
51,Virginia,36,New York,23,Cortland County,21,5,16
51,Virginia,36,New York,25,Delaware County,113,16,97
51,Virginia,36,New York,27,Dutchess County,208,137,71
51,Virginia,36,New York,29,Erie County,516,697,-181
51,Virginia,36,New York,31,Essex County,40,42,-2
51,Virginia,36,New York,33,Franklin County,0,14,-14
51,Virginia,36,New York,35,Fulton County,102,31,71
51,Virginia,36,New York,37,Genesee County,26,4,22
51,Virginia,36,New York,39,Greene County,81,37,44
51,Virginia,36,New York,43,Herkimer County,77,9,68
51,Virginia,36,New York,45,Jefferson County,719,355,364
51,Virginia,36,New York,47,Kings County,2481,939,1542
51,Virginia,36,New York,49,Lewis County,19,0,19
51,Virginia,36,New York,51,Livingston County,143,15,128
51,Virginia,36,New York,53,Madison County,17,41,-24
51,Virginia,36,New York,55,Monroe County,471,464,7
51,Virginia,36,New York,57,Montgomery County,95,31,64
51,Virginia,36,New York,59,Nassau County,781,358,423
51,Virginia,36,New York,61,New York County,1441,2003,-562
51,Virginia,36,New York,63,Niagara County,161,196,-35
51,Virginia,36,New York,65,Oneida County,136,79,57
51,Virginia,36,New York,67,Onondaga County,660,519,141
51,Virginia,36,New York,69,Ontario County,38,11,27
51,Virginia,36,New York,71,Orange County,181,144,37
51,Virginia,36,New York,75,Oswego County,15,154,-139
51,Virginia,36,New York,77,Otsego County,52,35,17
51,Virginia,36,New York,79,Putnam County,83,28,55
51,Virginia,36,New York,81,Queens County,1126,633,493
51,Virginia,36,New York,83,Rensselaer County,36,69,-33
51,Virginia,36,New York,85,Richmond County,253,70,183
51,Virginia,36,New York,87,Rockland County,313,16,297
51,Virginia,36,New York,89,St. Lawrence County,87,83,4
51,Virginia,36,New York,91,Saratoga County,792,404,388
51,Virginia,36,New York,93,Schenectady County,16,66,-50
51,Virginia,36,New York,95,Schoharie County,45,35,10
51,Virginia,36,New York,97,Schuyler County,0,9,-9
51,Virginia,36,New York,99,Seneca County,94,79,15
51,Virginia,36,New York,101,Steuben County,0,233,-233
51,Virginia,36,New York,103,Suffolk County,1195,322,873
51,Virginia,36,New York,105,Sullivan County,8,27,-19
51,Virginia,36,New York,107,Tioga County,28,0,28
51,Virginia,36,New York,109,Tompkins County,210,200,10
51,Virginia,36,New York,111,Ulster County,82,45,37
51,Virginia,36,New York,113,Warren County,23,31,-8
51,Virginia,36,New York,115,Washington County,50,4,46
51,Virginia,36,New York,117,Wayne County,76,68,8
51,Virginia,36,New York,119,Westchester County,455,376,79
51,Virginia,36,New York,121,Wyoming County,8,0,8
51,Virginia,36,New York,123,Yates County,12,26,-14
51,Virginia,37,North Carolina,1,Alamance County,209,806,-597
51,Virginia,37,North Carolina,3,Alexander County,0,110,-110
51,Virginia,37,North Carolina,5,Alleghany County,37,11,26
51,Virginia,37,North Carolina,7,Anson County,0,13,-13
51,Virginia,37,North Carolina,9,Ashe County,46,57,-11
51,Virginia,37,North Carolina,11,Avery County,0,62,-62
51,Virginia,37,North Carolina,13,Beaufort County,79,28,51
51,Virginia,37,North Carolina,15,Bertie County,36,26,10
51,Virginia,37,North Carolina,17,Bladen County,32,36,-4
51,Virginia,37,North Carolina,19,Brunswick County,289,644,-355
51,Virginia,37,North Carolina,21,Buncombe County,393,392,1
51,Virginia,37,North Carolina,23,Burke County,21,65,-44
51,Virginia,37,North Carolina,25,Cabarrus County,256,211,45
51,Virginia,37,North Carolina,27,Caldwell County,13,14,-1
51,Virginia,37,North Carolina,29,Camden County,11,69,-58
51,Virginia,37,North Carolina,31,Carteret County,307,487,-180
51,Virginia,37,North Carolina,33,Caswell County,219,363,-144
51,Virginia,37,North Carolina,35,Catawba County,286,310,-24
51,Virginia,37,North Carolina,37,Chatham County,36,123,-87
51,Virginia,37,North Carolina,41,Chowan County,39,99,-60
51,Virginia,37,North Carolina,43,Clay County,12,0,12
51,Virginia,37,North Carolina,45,Cleveland County,158,69,89
51,Virginia,37,North Carolina,47,Columbus County,9,275,-266
51,Virginia,37,North Carolina,49,Craven County,1008,806,202
51,Virginia,37,North Carolina,51,Cumberland County,1212,2026,-814
51,Virginia,37,North Carolina,53,Currituck County,419,793,-374
51,Virginia,37,North Carolina,55,Dare County,255,807,-552
51,Virginia,37,North Carolina,57,Davidson County,35,149,-114
51,Virginia,37,North Carolina,59,Davie County,35,42,-7
51,Virginia,37,North Carolina,61,Duplin County,54,70,-16
51,Virginia,37,North Carolina,63,Durham County,560,1154,-594
51,Virginia,37,North Carolina,65,Edgecombe County,4,24,-20
51,Virginia,37,North Carolina,67,Forsyth County,934,1240,-306
51,Virginia,37,North Carolina,69,Franklin County,47,121,-74
51,Virginia,37,North Carolina,71,Gaston County,140,88,52
51,Virginia,37,North Carolina,73,Gates County,367,163,204
51,Virginia,37,North Carolina,75,Graham County,32,125,-93
51,Virginia,37,North Carolina,77,Granville County,352,282,70
51,Virginia,37,North Carolina,79,Greene County,14,20,-6
51,Virginia,37,North Carolina,81,Guilford County,834,1515,-681
51,Virginia,37,North Carolina,83,Halifax County,136,239,-103
51,Virginia,37,North Carolina,85,Harnett County,505,624,-119
51,Virginia,37,North Carolina,87,Haywood County,39,18,21
51,Virginia,37,North Carolina,89,Henderson County,94,46,48
51,Virginia,37,North Carolina,91,Hertford County,186,462,-276
51,Virginia,37,North Carolina,93,Hoke County,176,151,25
51,Virginia,37,North Carolina,95,Hyde County,0,17,-17
51,Virginia,37,North Carolina,97,Iredell County,268,147,121
51,Virginia,37,North Carolina,99,Jackson County,94,22,72
51,Virginia,37,North Carolina,101,Johnston County,291,254,37
51,Virginia,37,North Carolina,103,Jones County,0,14,-14
51,Virginia,37,North Carolina,105,Lee County,219,20,199
51,Virginia,37,North Carolina,107,Lenoir County,4,147,-143
51,Virginia,37,North Carolina,109,Lincoln County,45,235,-190
51,Virginia,37,North Carolina,111,McDowell County,0,31,-31
51,Virginia,37,North Carolina,113,Macon County,28,47,-19
51,Virginia,37,North Carolina,115,Madison County,0,50,-50
51,Virginia,37,North Carolina,117,Martin County,15,32,-17
51,Virginia,37,North Carolina,119,Mecklenburg County,1814,2680,-866
51,Virginia,37,North Carolina,121,Mitchell County,2,90,-88
51,Virginia,37,North Carolina,123,Montgomery County,8,6,2
51,Virginia,37,North Carolina,125,Moore County,267,360,-93
51,Virginia,37,North Carolina,127,Nash County,208,182,26
51,Virginia,37,North Carolina,129,New Hanover County,560,812,-252
51,Virginia,37,North Carolina,131,Northampton County,209,121,88
51,Virginia,37,North Carolina,133,Onslow County,1645,2571,-926
51,Virginia,37,North Carolina,135,Orange County,646,419,227
51,Virginia,37,North Carolina,137,Pamlico County,12,20,-8
51,Virginia,37,North Carolina,139,Pasquotank County,412,562,-150
51,Virginia,37,North Carolina,141,Pender County,99,79,20
51,Virginia,37,North Carolina,143,Perquimans County,154,168,-14
51,Virginia,37,North Carolina,145,Person County,257,2,255
51,Virginia,37,North Carolina,147,Pitt County,397,839,-442
51,Virginia,37,North Carolina,149,Polk County,0,16,-16
51,Virginia,37,North Carolina,151,Randolph County,222,112,110
51,Virginia,37,North Carolina,153,Richmond County,7,16,-9
51,Virginia,37,North Carolina,155,Robeson County,23,109,-86
51,Virginia,37,North Carolina,157,Rockingham County,252,356,-104
51,Virginia,37,North Carolina,159,Rowan County,77,238,-161
51,Virginia,37,North Carolina,161,Rutherford County,0,145,-145
51,Virginia,37,North Carolina,163,Sampson County,46,11,35
51,Virginia,37,North Carolina,165,Scotland County,0,9,-9
51,Virginia,37,North Carolina,167,Stanly County,14,65,-51
51,Virginia,37,North Carolina,169,Stokes County,70,19,51
51,Virginia,37,North Carolina,171,Surry County,382,378,4
51,Virginia,37,North Carolina,173,Swain County,18,0,18
51,Virginia,37,North Carolina,175,Transylvania County,21,24,-3
51,Virginia,37,North Carolina,177,Tyrrell County,61,15,46
51,Virginia,37,North Carolina,179,Union County,105,327,-222
51,Virginia,37,North Carolina,181,Vance County,69,56,13
51,Virginia,37,North Carolina,183,Wake County,2035,3164,-1129
51,Virginia,37,North Carolina,185,Warren County,100,171,-71
51,Virginia,37,North Carolina,187,Washington County,30,70,-40
51,Virginia,37,North Carolina,189,Watauga County,58,120,-62
51,Virginia,37,North Carolina,191,Wayne County,196,125,71
51,Virginia,37,North Carolina,193,Wilkes County,100,15,85
51,Virginia,37,North Carolina,195,Wilson County,560,166,394
51,Virginia,37,North Carolina,197,Yadkin County,48,25,23
51,Virginia,37,North Carolina,199,Yancey County,23,0,23
51,Virginia,38,North Dakota,15,Burleigh County,25,31,-6
51,Virginia,38,North Dakota,17,Cass County,137,44,93
51,Virginia,38,North Dakota,21,Dickey County,0,9,-9
51,Virginia,38,North Dakota,23,Divide County,0,7,-7
51,Virginia,38,North Dakota,31,Foster County,0,3,-3
51,Virginia,38,North Dakota,35,Grand Forks County,64,53,11
51,Virginia,38,North Dakota,45,LaMoure County,0,2,-2
51,Virginia,38,North Dakota,47,Logan County,0,1,-1
51,Virginia,38,North Dakota,49,McHenry County,0,2,-2
51,Virginia,38,North Dakota,57,Mercer County,0,9,-9
51,Virginia,38,North Dakota,77,Richland County,0,1,-1
51,Virginia,38,North Dakota,89,Stark County,38,26,12
51,Virginia,38,North Dakota,101,Ward County,299,39,260
51,Virginia,38,North Dakota,105,Williams County,0,29,-29
51,Virginia,39,Ohio,3,Allen County,20,22,-2
51,Virginia,39,Ohio,7,Ashtabula County,0,5,-5
51,Virginia,39,Ohio,9,Athens County,64,66,-2
51,Virginia,39,Ohio,13,Belmont County,45,32,13
51,Virginia,39,Ohio,15,Brown County,0,17,-17
51,Virginia,39,Ohio,17,Butler County,144,345,-201
51,Virginia,39,Ohio,19,Carroll County,24,0,24
51,Virginia,39,Ohio,21,Champaign County,7,60,-53
51,Virginia,39,Ohio,23,Clark County,275,71,204
51,Virginia,39,Ohio,25,Clermont County,138,0,138
51,Virginia,39,Ohio,29,Columbiana County,19,241,-222
51,Virginia,39,Ohio,31,Coshocton County,28,0,28
51,Virginia,39,Ohio,33,Crawford County,8,10,-2
51,Virginia,39,Ohio,35,Cuyahoga County,572,818,-246
51,Virginia,39,Ohio,37,Darke County,0,7,-7
51,Virginia,39,Ohio,39,Defiance County,0,28,-28
51,Virginia,39,Ohio,41,Delaware County,140,213,-73
51,Virginia,39,Ohio,43,Erie County,20,42,-22
51,Virginia,39,Ohio,45,Fairfield County,100,365,-265
51,Virginia,39,Ohio,47,Fayette County,9,0,9
51,Virginia,39,Ohio,49,Franklin County,715,1260,-545
51,Virginia,39,Ohio,51,Fulton County,13,0,13
51,Virginia,39,Ohio,53,Gallia County,0,34,-34
51,Virginia,39,Ohio,55,Geauga County,7,80,-73
51,Virginia,39,Ohio,57,Greene County,235,438,-203
51,Virginia,39,Ohio,61,Hamilton County,385,392,-7
51,Virginia,39,Ohio,63,Hancock County,51,21,30
51,Virginia,39,Ohio,65,Hardin County,0,22,-22
51,Virginia,39,Ohio,73,Hocking County,34,0,34
51,Virginia,39,Ohio,75,Holmes County,4,0,4
51,Virginia,39,Ohio,77,Huron County,0,87,-87
51,Virginia,39,Ohio,79,Jackson County,45,0,45
51,Virginia,39,Ohio,81,Jefferson County,45,52,-7
51,Virginia,39,Ohio,83,Knox County,23,28,-5
51,Virginia,39,Ohio,85,Lake County,63,111,-48
51,Virginia,39,Ohio,87,Lawrence County,84,0,84
51,Virginia,39,Ohio,89,Licking County,9,55,-46
51,Virginia,39,Ohio,93,Lorain County,103,97,6
51,Virginia,39,Ohio,95,Lucas County,258,99,159
51,Virginia,39,Ohio,97,Madison County,58,0,58
51,Virginia,39,Ohio,99,Mahoning County,36,36,0
51,Virginia,39,Ohio,101,Marion County,11,8,3
51,Virginia,39,Ohio,103,Medina County,112,82,30
51,Virginia,39,Ohio,105,Meigs County,39,0,39
51,Virginia,39,Ohio,109,Miami County,19,0,19
51,Virginia,39,Ohio,111,Monroe County,2,0,2
51,Virginia,39,Ohio,113,Montgomery County,502,242,260
51,Virginia,39,Ohio,115,Morgan County,0,7,-7
51,Virginia,39,Ohio,117,Morrow County,53,0,53
51,Virginia,39,Ohio,119,Muskingum County,25,2,23
51,Virginia,39,Ohio,123,Ottawa County,84,0,84
51,Virginia,39,Ohio,127,Perry County,0,30,-30
51,Virginia,39,Ohio,129,Pickaway County,100,2,98
51,Virginia,39,Ohio,131,Pike County,0,6,-6
51,Virginia,39,Ohio,133,Portage County,142,89,53
51,Virginia,39,Ohio,135,Preble County,0,17,-17
51,Virginia,39,Ohio,139,Richland County,15,85,-70
51,Virginia,39,Ohio,141,Ross County,25,6,19
51,Virginia,39,Ohio,143,Sandusky County,81,0,81
51,Virginia,39,Ohio,145,Scioto County,6,90,-84
51,Virginia,39,Ohio,147,Seneca County,58,0,58
51,Virginia,39,Ohio,149,Shelby County,0,22,-22
51,Virginia,39,Ohio,151,Stark County,65,185,-120
51,Virginia,39,Ohio,153,Summit County,674,168,506
51,Virginia,39,Ohio,155,Trumbull County,128,29,99
51,Virginia,39,Ohio,157,Tuscarawas County,51,0,51
51,Virginia,39,Ohio,159,Union County,22,0,22
51,Virginia,39,Ohio,161,Van Wert County,0,11,-11
51,Virginia,39,Ohio,165,Warren County,198,320,-122
51,Virginia,39,Ohio,167,Washington County,41,16,25
51,Virginia,39,Ohio,169,Wayne County,50,4,46
51,Virginia,39,Ohio,171,Williams County,4,30,-26
51,Virginia,39,Ohio,173,Wood County,43,38,5
51,Virginia,4,Arizona,3,Cochise County,197,401,-204
51,Virginia,4,Arizona,5,Coconino County,82,117,-35
51,Virginia,4,Arizona,9,Graham County,15,0,15
51,Virginia,4,Arizona,12,La Paz County,0,1,-1
51,Virginia,4,Arizona,13,Maricopa County,2045,2333,-288
51,Virginia,4,Arizona,15,Mohave County,10,26,-16
51,Virginia,4,Arizona,17,Navajo County,11,3,8
51,Virginia,4,Arizona,19,Pima County,445,1038,-593
51,Virginia,4,Arizona,21,Pinal County,125,510,-385
51,Virginia,4,Arizona,25,Yavapai County,64,43,21
51,Virginia,4,Arizona,27,Yuma County,70,43,27
51,Virginia,40,Oklahoma,13,Bryan County,0,10,-10
51,Virginia,40,Oklahoma,17,Canadian County,51,27,24
51,Virginia,40,Oklahoma,19,Carter County,0,16,-16
51,Virginia,40,Oklahoma,21,Cherokee County,23,0,23
51,Virginia,40,Oklahoma,27,Cleveland County,209,80,129
51,Virginia,40,Oklahoma,31,Comanche County,216,389,-173
51,Virginia,40,Oklahoma,37,Creek County,191,17,174
51,Virginia,40,Oklahoma,47,Garfield County,83,0,83
51,Virginia,40,Oklahoma,51,Grady County,0,7,-7
51,Virginia,40,Oklahoma,55,Greer County,0,28,-28
51,Virginia,40,Oklahoma,61,Haskell County,0,5,-5
51,Virginia,40,Oklahoma,65,Jackson County,122,17,105
51,Virginia,40,Oklahoma,71,Kay County,16,0,16
51,Virginia,40,Oklahoma,83,Logan County,68,0,68
51,Virginia,40,Oklahoma,85,Love County,0,5,-5
51,Virginia,40,Oklahoma,87,McClain County,111,0,111
51,Virginia,40,Oklahoma,97,Mayes County,53,0,53
51,Virginia,40,Oklahoma,109,Oklahoma County,369,386,-17
51,Virginia,40,Oklahoma,111,Okmulgee County,6,0,6
51,Virginia,40,Oklahoma,113,Osage County,0,4,-4
51,Virginia,40,Oklahoma,119,Payne County,149,101,48
51,Virginia,40,Oklahoma,121,Pittsburg County,0,18,-18
51,Virginia,40,Oklahoma,125,Pottawatomie County,0,3,-3
51,Virginia,40,Oklahoma,131,Rogers County,67,0,67
51,Virginia,40,Oklahoma,133,Seminole County,0,11,-11
51,Virginia,40,Oklahoma,135,Sequoyah County,7,35,-28
51,Virginia,40,Oklahoma,137,Stephens County,16,0,16
51,Virginia,40,Oklahoma,139,Texas County,0,15,-15
51,Virginia,40,Oklahoma,143,Tulsa County,308,218,90
51,Virginia,40,Oklahoma,145,Wagoner County,47,0,47
51,Virginia,40,Oklahoma,149,Washita County,0,11,-11
51,Virginia,41,Oregon,3,Benton County,65,95,-30
51,Virginia,41,Oregon,5,Clackamas County,74,366,-292
51,Virginia,41,Oregon,7,Clatsop County,34,0,34
51,Virginia,41,Oregon,9,Columbia County,0,18,-18
51,Virginia,41,Oregon,11,Coos County,52,7,45
51,Virginia,41,Oregon,13,Crook County,0,79,-79
51,Virginia,41,Oregon,17,Deschutes County,29,249,-220
51,Virginia,41,Oregon,19,Douglas County,8,34,-26
51,Virginia,41,Oregon,29,Jackson County,0,67,-67
51,Virginia,41,Oregon,31,Jefferson County,0,5,-5
51,Virginia,41,Oregon,33,Josephine County,40,0,40
51,Virginia,41,Oregon,35,Klamath County,0,46,-46
51,Virginia,41,Oregon,39,Lane County,71,270,-199
51,Virginia,41,Oregon,41,Lincoln County,0,14,-14
51,Virginia,41,Oregon,43,Linn County,0,106,-106
51,Virginia,41,Oregon,45,Malheur County,17,2,15
51,Virginia,41,Oregon,47,Marion County,30,269,-239
51,Virginia,41,Oregon,51,Multnomah County,136,722,-586
51,Virginia,41,Oregon,53,Polk County,0,12,-12
51,Virginia,41,Oregon,59,Umatilla County,0,46,-46
51,Virginia,41,Oregon,63,Wallowa County,0,7,-7
51,Virginia,41,Oregon,65,Wasco County,0,2,-2
51,Virginia,41,Oregon,67,Washington County,167,313,-146
51,Virginia,41,Oregon,71,Yamhill County,10,0,10
51,Virginia,42,Pennsylvania,1,Adams County,94,188,-94
51,Virginia,42,Pennsylvania,3,Allegheny County,1189,1512,-323
51,Virginia,42,Pennsylvania,5,Armstrong County,138,9,129
51,Virginia,42,Pennsylvania,7,Beaver County,40,14,26
51,Virginia,42,Pennsylvania,9,Bedford County,193,153,40
51,Virginia,42,Pennsylvania,11,Berks County,306,143,163
51,Virginia,42,Pennsylvania,13,Blair County,388,117,271
51,Virginia,42,Pennsylvania,15,Bradford County,6,28,-22
51,Virginia,42,Pennsylvania,17,Bucks County,624,225,399
51,Virginia,42,Pennsylvania,19,Butler County,151,131,20
51,Virginia,42,Pennsylvania,21,Cambria County,153,150,3
51,Virginia,42,Pennsylvania,25,Carbon County,0,78,-78
51,Virginia,42,Pennsylvania,27,Centre County,468,369,99
51,Virginia,42,Pennsylvania,29,Chester County,873,887,-14
51,Virginia,42,Pennsylvania,31,Clarion County,16,35,-19
51,Virginia,42,Pennsylvania,33,Clearfield County,141,43,98
51,Virginia,42,Pennsylvania,35,Clinton County,5,38,-33
51,Virginia,42,Pennsylvania,37,Columbia County,90,48,42
51,Virginia,42,Pennsylvania,39,Crawford County,78,33,45
51,Virginia,42,Pennsylvania,41,Cumberland County,366,379,-13
51,Virginia,42,Pennsylvania,43,Dauphin County,338,286,52
51,Virginia,42,Pennsylvania,45,Delaware County,686,469,217
51,Virginia,42,Pennsylvania,47,Elk County,16,11,5
51,Virginia,42,Pennsylvania,49,Erie County,166,171,-5
51,Virginia,42,Pennsylvania,51,Fayette County,50,0,50
51,Virginia,42,Pennsylvania,55,Franklin County,199,98,101
51,Virginia,42,Pennsylvania,59,Greene County,53,34,19
51,Virginia,42,Pennsylvania,61,Huntingdon County,0,40,-40
51,Virginia,42,Pennsylvania,63,Indiana County,75,86,-11
51,Virginia,42,Pennsylvania,65,Jefferson County,0,10,-10
51,Virginia,42,Pennsylvania,69,Lackawanna County,98,51,47
51,Virginia,42,Pennsylvania,71,Lancaster County,769,544,225
51,Virginia,42,Pennsylvania,73,Lawrence County,28,20,8
51,Virginia,42,Pennsylvania,75,Lebanon County,74,182,-108
51,Virginia,42,Pennsylvania,77,Lehigh County,336,314,22
51,Virginia,42,Pennsylvania,79,Luzerne County,238,152,86
51,Virginia,42,Pennsylvania,81,Lycoming County,56,168,-112
51,Virginia,42,Pennsylvania,83,McKean County,3,3,0
51,Virginia,42,Pennsylvania,85,Mercer County,50,165,-115
51,Virginia,42,Pennsylvania,87,Mifflin County,0,3,-3
51,Virginia,42,Pennsylvania,89,Monroe County,84,34,50
51,Virginia,42,Pennsylvania,91,Montgomery County,1244,846,398
51,Virginia,42,Pennsylvania,93,Montour County,0,11,-11
51,Virginia,42,Pennsylvania,95,Northampton County,305,152,153
51,Virginia,42,Pennsylvania,97,Northumberland County,116,37,79
51,Virginia,42,Pennsylvania,99,Perry County,61,6,55
51,Virginia,42,Pennsylvania,101,Philadelphia County,1735,1294,441
51,Virginia,42,Pennsylvania,103,Pike County,141,0,141
51,Virginia,42,Pennsylvania,105,Potter County,11,34,-23
51,Virginia,42,Pennsylvania,107,Schuylkill County,82,4,78
51,Virginia,42,Pennsylvania,109,Snyder County,36,25,11
51,Virginia,42,Pennsylvania,111,Somerset County,24,38,-14
51,Virginia,42,Pennsylvania,113,Sullivan County,0,9,-9
51,Virginia,42,Pennsylvania,115,Susquehanna County,79,16,63
51,Virginia,42,Pennsylvania,117,Tioga County,0,29,-29
51,Virginia,42,Pennsylvania,119,Union County,94,99,-5
51,Virginia,42,Pennsylvania,121,Venango County,9,59,-50
51,Virginia,42,Pennsylvania,123,Warren County,32,26,6
51,Virginia,42,Pennsylvania,125,Washington County,156,52,104
51,Virginia,42,Pennsylvania,127,Wayne County,11,11,0
51,Virginia,42,Pennsylvania,129,Westmoreland County,333,181,152
51,Virginia,42,Pennsylvania,131,Wyoming County,14,2,12
51,Virginia,42,Pennsylvania,133,York County,449,295,154
51,Virginia,44,Rhode Island,1,Bristol County,64,16,48
51,Virginia,44,Rhode Island,3,Kent County,93,0,93
51,Virginia,44,Rhode Island,5,Newport County,1006,375,631
51,Virginia,44,Rhode Island,7,Providence County,276,246,30
51,Virginia,44,Rhode Island,9,Washington County,46,235,-189
51,Virginia,45,South Carolina,1,Abbeville County,0,8,-8
51,Virginia,45,South Carolina,3,Aiken County,279,276,3
51,Virginia,45,South Carolina,7,Anderson County,218,253,-35
51,Virginia,45,South Carolina,9,Bamberg County,0,13,-13
51,Virginia,45,South Carolina,11,Barnwell County,0,70,-70
51,Virginia,45,South Carolina,13,Beaufort County,1027,972,55
51,Virginia,45,South Carolina,15,Berkeley County,630,597,33
51,Virginia,45,South Carolina,19,Charleston County,1138,785,353
51,Virginia,45,South Carolina,21,Cherokee County,23,6,17
51,Virginia,45,South Carolina,23,Chester County,3,10,-7
51,Virginia,45,South Carolina,25,Chesterfield County,29,4,25
51,Virginia,45,South Carolina,27,Clarendon County,106,57,49
51,Virginia,45,South Carolina,29,Colleton County,0,62,-62
51,Virginia,45,South Carolina,31,Darlington County,16,72,-56
51,Virginia,45,South Carolina,33,Dillon County,14,11,3
51,Virginia,45,South Carolina,35,Dorchester County,413,149,264
51,Virginia,45,South Carolina,37,Edgefield County,69,24,45
51,Virginia,45,South Carolina,39,Fairfield County,0,19,-19
51,Virginia,45,South Carolina,41,Florence County,256,144,112
51,Virginia,45,South Carolina,43,Georgetown County,12,81,-69
51,Virginia,45,South Carolina,45,Greenville County,381,581,-200
51,Virginia,45,South Carolina,47,Greenwood County,79,0,79
51,Virginia,45,South Carolina,49,Hampton County,9,0,9
51,Virginia,45,South Carolina,51,Horry County,559,1150,-591
51,Virginia,45,South Carolina,53,Jasper County,14,34,-20
51,Virginia,45,South Carolina,55,Kershaw County,44,24,20
51,Virginia,45,South Carolina,57,Lancaster County,20,5,15
51,Virginia,45,South Carolina,63,Lexington County,265,289,-24
51,Virginia,45,South Carolina,67,Marion County,84,14,70
51,Virginia,45,South Carolina,69,Marlboro County,82,33,49
51,Virginia,45,South Carolina,71,Newberry County,27,16,11
51,Virginia,45,South Carolina,73,Oconee County,64,102,-38
51,Virginia,45,South Carolina,75,Orangeburg County,99,24,75
51,Virginia,45,South Carolina,77,Pickens County,59,105,-46
51,Virginia,45,South Carolina,79,Richland County,810,1389,-579
51,Virginia,45,South Carolina,83,Spartanburg County,104,149,-45
51,Virginia,45,South Carolina,85,Sumter County,422,169,253
51,Virginia,45,South Carolina,87,Union County,28,0,28
51,Virginia,45,South Carolina,89,Williamsburg County,69,25,44
51,Virginia,45,South Carolina,91,York County,164,354,-190
51,Virginia,46,South Dakota,19,Butte County,15,0,15
51,Virginia,46,South Dakota,27,Clay County,0,12,-12
51,Virginia,46,South Dakota,33,Custer County,0,2,-2
51,Virginia,46,South Dakota,65,Hughes County,0,62,-62
51,Virginia,46,South Dakota,83,Lincoln County,0,48,-48
51,Virginia,46,South Dakota,93,Meade County,35,0,35
51,Virginia,46,South Dakota,99,Minnehaha County,0,107,-107
51,Virginia,46,South Dakota,103,Pennington County,126,274,-148
51,Virginia,46,South Dakota,125,Turner County,0,6,-6
51,Virginia,46,South Dakota,135,Yankton County,0,26,-26
51,Virginia,47,Tennessee,1,Anderson County,0,85,-85
51,Virginia,47,Tennessee,5,Benton County,22,0,22
51,Virginia,47,Tennessee,9,Blount County,0,74,-74
51,Virginia,47,Tennessee,11,Bradley County,106,112,-6
51,Virginia,47,Tennessee,13,Campbell County,0,11,-11
51,Virginia,47,Tennessee,19,Carter County,43,23,20
51,Virginia,47,Tennessee,21,Cheatham County,0,77,-77
51,Virginia,47,Tennessee,23,Chester County,0,8,-8
51,Virginia,47,Tennessee,25,Claiborne County,91,255,-164
51,Virginia,47,Tennessee,29,Cocke County,30,0,30
51,Virginia,47,Tennessee,31,Coffee County,26,15,11
51,Virginia,47,Tennessee,35,Cumberland County,0,81,-81
51,Virginia,47,Tennessee,37,Davidson County,527,749,-222
51,Virginia,47,Tennessee,43,Dickson County,38,0,38
51,Virginia,47,Tennessee,45,Dyer County,125,0,125
51,Virginia,47,Tennessee,47,Fayette County,0,4,-4
51,Virginia,47,Tennessee,51,Franklin County,94,176,-82
51,Virginia,47,Tennessee,57,Grainger County,0,45,-45
51,Virginia,47,Tennessee,59,Greene County,211,138,73
51,Virginia,47,Tennessee,61,Grundy County,0,4,-4
51,Virginia,47,Tennessee,63,Hamblen County,22,22,0
51,Virginia,47,Tennessee,65,Hamilton County,108,238,-130
51,Virginia,47,Tennessee,67,Hancock County,9,0,9
51,Virginia,47,Tennessee,73,Hawkins County,107,246,-139
51,Virginia,47,Tennessee,79,Henry County,0,24,-24
51,Virginia,47,Tennessee,81,Hickman County,0,10,-10
51,Virginia,47,Tennessee,85,Humphreys County,0,3,-3
51,Virginia,47,Tennessee,89,Jefferson County,44,102,-58
51,Virginia,47,Tennessee,91,Johnson County,228,11,217
51,Virginia,47,Tennessee,93,Knox County,652,780,-128
51,Virginia,47,Tennessee,95,Lake County,26,12,14
51,Virginia,47,Tennessee,99,Lawrence County,0,34,-34
51,Virginia,47,Tennessee,103,Lincoln County,0,2,-2
51,Virginia,47,Tennessee,105,Loudon County,39,71,-32
51,Virginia,47,Tennessee,107,McMinn County,0,12,-12
51,Virginia,47,Tennessee,111,Macon County,0,19,-19
51,Virginia,47,Tennessee,113,Madison County,29,5,24
51,Virginia,47,Tennessee,115,Marion County,0,41,-41
51,Virginia,47,Tennessee,117,Marshall County,0,1,-1
51,Virginia,47,Tennessee,119,Maury County,0,139,-139
51,Virginia,47,Tennessee,123,Monroe County,0,19,-19
51,Virginia,47,Tennessee,125,Montgomery County,747,397,350
51,Virginia,47,Tennessee,127,Moore County,0,11,-11
51,Virginia,47,Tennessee,129,Morgan County,9,38,-29
51,Virginia,47,Tennessee,131,Obion County,0,12,-12
51,Virginia,47,Tennessee,141,Putnam County,0,6,-6
51,Virginia,47,Tennessee,143,Rhea County,0,19,-19
51,Virginia,47,Tennessee,145,Roane County,27,0,27
51,Virginia,47,Tennessee,147,Robertson County,26,0,26
51,Virginia,47,Tennessee,149,Rutherford County,161,196,-35
51,Virginia,47,Tennessee,153,Sequatchie County,0,10,-10
51,Virginia,47,Tennessee,155,Sevier County,30,67,-37
51,Virginia,47,Tennessee,157,Shelby County,586,425,161
51,Virginia,47,Tennessee,163,Sullivan County,1507,1875,-368
51,Virginia,47,Tennessee,165,Sumner County,79,45,34
51,Virginia,47,Tennessee,167,Tipton County,65,48,17
51,Virginia,47,Tennessee,171,Unicoi County,45,0,45
51,Virginia,47,Tennessee,173,Union County,0,11,-11
51,Virginia,47,Tennessee,179,Washington County,468,698,-230
51,Virginia,47,Tennessee,183,Weakley County,16,14,2
51,Virginia,47,Tennessee,187,Williamson County,63,244,-181
51,Virginia,47,Tennessee,189,Wilson County,150,68,82
51,Virginia,48,Texas,5,Angelina County,56,0,56
51,Virginia,48,Texas,7,Aransas County,0,57,-57
51,Virginia,48,Texas,9,Archer County,0,6,-6
51,Virginia,48,Texas,13,Atascosa County,4,0,4
51,Virginia,48,Texas,21,Bastrop County,11,4,7
51,Virginia,48,Texas,27,Bell County,1188,701,487
51,Virginia,48,Texas,29,Bexar County,2583,2082,501
51,Virginia,48,Texas,37,Bowie County,0,27,-27
51,Virginia,48,Texas,39,Brazoria County,57,255,-198
51,Virginia,48,Texas,41,Brazos County,254,251,3
51,Virginia,48,Texas,53,Burnet County,72,0,72
51,Virginia,48,Texas,55,Caldwell County,0,122,-122
51,Virginia,48,Texas,57,Calhoun County,0,35,-35
51,Virginia,48,Texas,61,Cameron County,218,25,193
51,Virginia,48,Texas,63,Camp County,0,38,-38
51,Virginia,48,Texas,85,Collin County,740,596,144
51,Virginia,48,Texas,89,Colorado County,0,128,-128
51,Virginia,48,Texas,91,Comal County,67,99,-32
51,Virginia,48,Texas,97,Cooke County,29,0,29
51,Virginia,48,Texas,99,Coryell County,378,267,111
51,Virginia,48,Texas,113,Dallas County,850,817,33
51,Virginia,48,Texas,121,Denton County,195,774,-579
51,Virginia,48,Texas,135,Ector County,0,48,-48
51,Virginia,48,Texas,139,Ellis County,10,0,10
51,Virginia,48,Texas,141,El Paso County,1151,827,324
51,Virginia,48,Texas,143,Erath County,13,3,10
51,Virginia,48,Texas,145,Falls County,16,8,8
51,Virginia,48,Texas,149,Fayette County,0,18,-18
51,Virginia,48,Texas,157,Fort Bend County,186,338,-152
51,Virginia,48,Texas,161,Freestone County,0,7,-7
51,Virginia,48,Texas,167,Galveston County,49,57,-8
51,Virginia,48,Texas,181,Grayson County,10,10,0
51,Virginia,48,Texas,183,Gregg County,29,28,1
51,Virginia,48,Texas,187,Guadalupe County,127,179,-52
51,Virginia,48,Texas,193,Hamilton County,0,4,-4
51,Virginia,48,Texas,201,Harris County,1357,3239,-1882
51,Virginia,48,Texas,209,Hays County,46,97,-51
51,Virginia,48,Texas,213,Henderson County,84,2,82
51,Virginia,48,Texas,215,Hidalgo County,147,64,83
51,Virginia,48,Texas,221,Hood County,5,24,-19
51,Virginia,48,Texas,223,Hopkins County,29,9,20
51,Virginia,48,Texas,227,Howard County,4,0,4
51,Virginia,48,Texas,231,Hunt County,31,65,-34
51,Virginia,48,Texas,239,Jackson County,0,6,-6
51,Virginia,48,Texas,245,Jefferson County,30,120,-90
51,Virginia,48,Texas,249,Jim Wells County,5,0,5
51,Virginia,48,Texas,251,Johnson County,0,8,-8
51,Virginia,48,Texas,257,Kaufman County,80,0,80
51,Virginia,48,Texas,259,Kendall County,9,30,-21
51,Virginia,48,Texas,265,Kerr County,161,13,148
51,Virginia,48,Texas,273,Kleberg County,94,0,94
51,Virginia,48,Texas,279,Lamb County,34,0,34
51,Virginia,48,Texas,281,Lampasas County,0,7,-7
51,Virginia,48,Texas,283,La Salle County,0,8,-8
51,Virginia,48,Texas,287,Lee County,0,32,-32
51,Virginia,48,Texas,291,Liberty County,0,6,-6
51,Virginia,48,Texas,303,Lubbock County,235,187,48
51,Virginia,48,Texas,307,McCulloch County,0,1,-1
51,Virginia,48,Texas,309,McLennan County,62,26,36
51,Virginia,48,Texas,321,Matagorda County,19,0,19
51,Virginia,48,Texas,323,Maverick County,12,0,12
51,Virginia,48,Texas,329,Midland County,20,7,13
51,Virginia,48,Texas,335,Mitchell County,0,41,-41
51,Virginia,48,Texas,339,Montgomery County,115,699,-584
51,Virginia,48,Texas,341,Moore County,5,0,5
51,Virginia,48,Texas,347,Nacogdoches County,24,0,24
51,Virginia,48,Texas,351,Newton County,0,11,-11
51,Virginia,48,Texas,353,Nolan County,0,11,-11
51,Virginia,48,Texas,355,Nueces County,579,314,265
51,Virginia,48,Texas,359,Oldham County,18,0,18
51,Virginia,48,Texas,361,Orange County,86,0,86
51,Virginia,48,Texas,365,Panola County,6,8,-2
51,Virginia,48,Texas,367,Parker County,10,19,-9
51,Virginia,48,Texas,369,Parmer County,0,3,-3
51,Virginia,48,Texas,373,Polk County,0,13,-13
51,Virginia,48,Texas,375,Potter County,88,31,57
51,Virginia,48,Texas,377,Presidio County,0,31,-31
51,Virginia,48,Texas,381,Randall County,20,16,4
51,Virginia,48,Texas,387,Red River County,67,0,67
51,Virginia,48,Texas,389,Reeves County,0,6,-6
51,Virginia,48,Texas,397,Rockwall County,17,63,-46
51,Virginia,48,Texas,403,Sabine County,0,30,-30
51,Virginia,48,Texas,409,San Patricio County,3,6,-3
51,Virginia,48,Texas,423,Smith County,7,219,-212
51,Virginia,48,Texas,429,Stephens County,0,11,-11
51,Virginia,48,Texas,439,Tarrant County,1246,1243,3
51,Virginia,48,Texas,441,Taylor County,89,86,3
51,Virginia,48,Texas,449,Titus County,18,0,18
51,Virginia,48,Texas,451,Tom Green County,258,218,40
51,Virginia,48,Texas,453,Travis County,1024,717,307
51,Virginia,48,Texas,459,Upshur County,34,25,9
51,Virginia,48,Texas,467,Van Zandt County,51,10,41
51,Virginia,48,Texas,469,Victoria County,54,8,46
51,Virginia,48,Texas,471,Walker County,78,12,66
51,Virginia,48,Texas,473,Waller County,0,3,-3
51,Virginia,48,Texas,477,Washington County,0,12,-12
51,Virginia,48,Texas,479,Webb County,68,143,-75
51,Virginia,48,Texas,481,Wharton County,0,11,-11
51,Virginia,48,Texas,485,Wichita County,54,204,-150
51,Virginia,48,Texas,487,Wilbarger County,0,1,-1
51,Virginia,48,Texas,491,Williamson County,108,1140,-1032
51,Virginia,48,Texas,493,Wilson County,8,32,-24
51,Virginia,48,Texas,497,Wise County,0,9,-9
51,Virginia,48,Texas,503,Young County,30,0,30
51,Virginia,49,Utah,5,Cache County,26,177,-151
51,Virginia,49,Utah,7,Carbon County,0,14,-14
51,Virginia,49,Utah,11,Davis County,353,93,260
51,Virginia,49,Utah,13,Duchesne County,0,4,-4
51,Virginia,49,Utah,21,Iron County,89,0,89
51,Virginia,49,Utah,35,Salt Lake County,628,703,-75
51,Virginia,49,Utah,37,San Juan County,0,108,-108
51,Virginia,49,Utah,41,Sevier County,0,1,-1
51,Virginia,49,Utah,45,Tooele County,0,127,-127
51,Virginia,49,Utah,47,Uintah County,0,69,-69
51,Virginia,49,Utah,49,Utah County,745,592,153
51,Virginia,49,Utah,51,Wasatch County,0,33,-33
51,Virginia,49,Utah,53,Washington County,135,173,-38
51,Virginia,49,Utah,57,Weber County,108,96,12
51,Virginia,5,Arkansas,5,Baxter County,0,39,-39
51,Virginia,5,Arkansas,7,Benton County,0,159,-159
51,Virginia,5,Arkansas,9,Boone County,0,60,-60
51,Virginia,5,Arkansas,31,Craighead County,13,20,-7
51,Virginia,5,Arkansas,35,Crittenden County,55,10,45
51,Virginia,5,Arkansas,45,Faulkner County,54,53,1
51,Virginia,5,Arkansas,51,Garland County,37,123,-86
51,Virginia,5,Arkansas,53,Grant County,0,16,-16
51,Virginia,5,Arkansas,55,Greene County,0,28,-28
51,Virginia,5,Arkansas,85,Lonoke County,0,154,-154
51,Virginia,5,Arkansas,91,Miller County,9,0,9
51,Virginia,5,Arkansas,105,Perry County,13,0,13
51,Virginia,5,Arkansas,109,Pike County,0,14,-14
51,Virginia,5,Arkansas,113,Polk County,0,14,-14
51,Virginia,5,Arkansas,119,Pulaski County,333,155,178
51,Virginia,5,Arkansas,123,St. Francis County,0,12,-12
51,Virginia,5,Arkansas,125,Saline County,79,3,76
51,Virginia,5,Arkansas,131,Sebastian County,0,18,-18
51,Virginia,5,Arkansas,137,Stone County,0,10,-10
51,Virginia,5,Arkansas,139,Union County,0,55,-55
51,Virginia,5,Arkansas,143,Washington County,33,62,-29
51,Virginia,5,Arkansas,145,White County,69,7,62
51,Virginia,50,Vermont,1,Addison County,14,23,-9
51,Virginia,50,Vermont,3,Bennington County,0,15,-15
51,Virginia,50,Vermont,5,Caledonia County,0,33,-33
51,Virginia,50,Vermont,7,Chittenden County,365,158,207
51,Virginia,50,Vermont,13,Grand Isle County,37,5,32
51,Virginia,50,Vermont,15,Lamoille County,24,24,0
51,Virginia,50,Vermont,19,Orleans County,0,7,-7
51,Virginia,50,Vermont,21,Rutland County,0,11,-11
51,Virginia,50,Vermont,23,Washington County,109,27,82
51,Virginia,50,Vermont,25,Windham County,17,46,-29
51,Virginia,50,Vermont,27,Windsor County,20,50,-30
51,Virginia,51,Virginia,1,Accomack County,1005,179,826
51,Virginia,51,Virginia,3,Albemarle County,6374,7600,-1226
51,Virginia,51,Virginia,5,Alleghany County,699,288,411
51,Virginia,51,Virginia,7,Amelia County,1114,343,771
51,Virginia,51,Virginia,9,Amherst County,1520,1881,-361
51,Virginia,51,Virginia,11,Appomattox County,613,108,505
51,Virginia,51,Virginia,13,Arlington County,13205,8535,4670
51,Virginia,51,Virginia,15,Augusta County,4964,3493,1471
51,Virginia,51,Virginia,17,Bath County,171,86,85
51,Virginia,51,Virginia,19,Bedford County,3576,3648,-72
51,Virginia,51,Virginia,21,Bland County,128,682,-554
51,Virginia,51,Virginia,23,Botetourt County,1538,1276,262
51,Virginia,51,Virginia,25,Brunswick County,1055,844,211
51,Virginia,51,Virginia,27,Buchanan County,954,292,662
51,Virginia,51,Virginia,29,Buckingham County,850,953,-103
51,Virginia,51,Virginia,31,Campbell County,2978,2545,433
51,Virginia,51,Virginia,33,Caroline County,1510,1861,-351
51,Virginia,51,Virginia,35,Carroll County,1055,814,241
51,Virginia,51,Virginia,36,Charles City County,215,290,-75
51,Virginia,51,Virginia,37,Charlotte County,295,400,-105
51,Virginia,51,Virginia,41,Chesterfield County,14686,14490,196
51,Virginia,51,Virginia,43,Clarke County,1021,905,116
51,Virginia,51,Virginia,45,Craig County,141,176,-35
51,Virginia,51,Virginia,47,Culpeper County,2373,2283,90
51,Virginia,51,Virginia,49,Cumberland County,398,190,208
51,Virginia,51,Virginia,51,Dickenson County,526,221,305
51,Virginia,51,Virginia,53,Dinwiddie County,1751,1443,308
51,Virginia,51,Virginia,57,Essex County,615,467,148
51,Virginia,51,Virginia,59,Fairfax County,42788,31742,11046
51,Virginia,51,Virginia,61,Fauquier County,3383,3274,109
51,Virginia,51,Virginia,63,Floyd County,664,553,111
51,Virginia,51,Virginia,65,Fluvanna County,1294,1848,-554
51,Virginia,51,Virginia,67,Franklin County,2048,2260,-212
51,Virginia,51,Virginia,69,Frederick County,3133,3861,-728
51,Virginia,51,Virginia,71,Giles County,676,398,278
51,Virginia,51,Virginia,73,Gloucester County,1171,1138,33
51,Virginia,51,Virginia,75,Goochland County,1368,1769,-401
51,Virginia,51,Virginia,77,Grayson County,868,631,237
51,Virginia,51,Virginia,79,Greene County,1182,933,249
51,Virginia,51,Virginia,81,Greensville County,1119,1840,-721
51,Virginia,51,Virginia,83,Halifax County,686,733,-47
51,Virginia,51,Virginia,85,Hanover County,4486,4320,166
51,Virginia,51,Virginia,87,Henrico County,13821,15471,-1650
51,Virginia,51,Virginia,89,Henry County,1985,2069,-84
51,Virginia,51,Virginia,91,Highland County,27,28,-1
51,Virginia,51,Virginia,93,Isle of Wight County,2284,1734,550
51,Virginia,51,Virginia,95,James City County,3626,4273,-647
51,Virginia,51,Virginia,97,King and Queen County,376,239,137
51,Virginia,51,Virginia,99,King George County,1181,1148,33
51,Virginia,51,Virginia,101,King William County,789,824,-35
51,Virginia,51,Virginia,103,Lancaster County,713,396,317
51,Virginia,51,Virginia,105,Lee County,331,455,-124
51,Virginia,51,Virginia,107,Loudoun County,11051,14370,-3319
51,Virginia,51,Virginia,109,Louisa County,1462,1803,-341
51,Virginia,51,Virginia,111,Lunenburg County,433,309,124
51,Virginia,51,Virginia,113,Madison County,942,684,258
51,Virginia,51,Virginia,115,Mathews County,358,500,-142
51,Virginia,51,Virginia,117,Mecklenburg County,687,769,-82
51,Virginia,51,Virginia,119,Middlesex County,560,582,-22
51,Virginia,51,Virginia,121,Montgomery County,5129,7535,-2406
51,Virginia,51,Virginia,125,Nelson County,351,469,-118
51,Virginia,51,Virginia,127,New Kent County,788,2056,-1268
51,Virginia,51,Virginia,131,Northampton County,296,300,-4
51,Virginia,51,Virginia,133,Northumberland County,305,680,-375
51,Virginia,51,Virginia,135,Nottoway County,1569,1080,489
51,Virginia,51,Virginia,137,Orange County,2228,2358,-130
51,Virginia,51,Virginia,139,Page County,846,833,13
51,Virginia,51,Virginia,141,Patrick County,435,1036,-601
51,Virginia,51,Virginia,143,Pittsylvania County,2368,1697,671
51,Virginia,51,Virginia,145,Powhatan County,1656,2054,-398
51,Virginia,51,Virginia,147,Prince Edward County,1445,1666,-221
51,Virginia,51,Virginia,149,Prince George County,1617,2707,-1090
51,Virginia,51,Virginia,153,Prince William County,19767,17901,1866
51,Virginia,51,Virginia,155,Pulaski County,1533,1641,-108
51,Virginia,51,Virginia,157,Rappahannock County,247,221,26
51,Virginia,51,Virginia,159,Richmond County,636,913,-277
51,Virginia,51,Virginia,161,Roanoke County,5091,5134,-43
51,Virginia,51,Virginia,163,Rockbridge County,931,1102,-171
51,Virginia,51,Virginia,165,Rockingham County,4676,2944,1732
51,Virginia,51,Virginia,167,Russell County,697,782,-85
51,Virginia,51,Virginia,169,Scott County,477,671,-194
51,Virginia,51,Virginia,171,Shenandoah County,1242,2442,-1200
51,Virginia,51,Virginia,173,Smyth County,1029,897,132
51,Virginia,51,Virginia,175,Southampton County,1502,867,635
51,Virginia,51,Virginia,177,Spotsylvania County,6237,6038,199
51,Virginia,51,Virginia,179,Stafford County,6564,7698,-1134
51,Virginia,51,Virginia,181,Surry County,432,171,261
51,Virginia,51,Virginia,183,Sussex County,962,1863,-901
51,Virginia,51,Virginia,185,Tazewell County,1041,865,176
51,Virginia,51,Virginia,187,Warren County,1714,1804,-90
51,Virginia,51,Virginia,191,Washington County,2064,2325,-261
51,Virginia,51,Virginia,193,Westmoreland County,1016,1007,9
51,Virginia,51,Virginia,195,Wise County,2166,1432,734
51,Virginia,51,Virginia,197,Wythe County,893,746,147
51,Virginia,51,Virginia,199,York County,4231,4213,18
51,Virginia,51,Virginia,510,Alexandria city,10396,9382,1014
51,Virginia,51,Virginia,520,Bristol city,812,1150,-338
51,Virginia,51,Virginia,530,Buena Vista city,465,179,286
51,Virginia,51,Virginia,540,Charlottesville city,4953,5075,-122
51,Virginia,51,Virginia,550,Chesapeake city,12353,13209,-856
51,Virginia,51,Virginia,570,Colonial Heights city,1133,1678,-545
51,Virginia,51,Virginia,580,Covington city,190,351,-161
51,Virginia,51,Virginia,590,Danville city,1449,1283,166
51,Virginia,51,Virginia,595,Emporia city,576,662,-86
51,Virginia,51,Virginia,600,Fairfax city,3625,2045,1580
51,Virginia,51,Virginia,610,Falls Church city,1051,811,240
51,Virginia,51,Virginia,620,Franklin city,368,504,-136
51,Virginia,51,Virginia,630,Fredericksburg city,3085,3945,-860
51,Virginia,51,Virginia,640,Galax city,405,402,3
51,Virginia,51,Virginia,650,Hampton city,11421,8812,2609
51,Virginia,51,Virginia,660,Harrisonburg city,3805,8178,-4373
51,Virginia,51,Virginia,670,Hopewell city,1898,1340,558
51,Virginia,51,Virginia,678,Lexington city,331,563,-232
51,Virginia,51,Virginia,680,Lynchburg city,4508,5323,-815
51,Virginia,51,Virginia,683,Manassas city,3285,3016,269
51,Virginia,51,Virginia,685,Manassas Park city,1344,1783,-439
51,Virginia,51,Virginia,690,Martinsville city,1340,1186,154
51,Virginia,51,Virginia,700,Newport News city,12300,11028,1272
51,Virginia,51,Virginia,710,Norfolk city,14901,17613,-2712
51,Virginia,51,Virginia,720,Norton city,123,601,-478
51,Virginia,51,Virginia,730,Petersburg city,3153,2816,337
51,Virginia,51,Virginia,735,Poquoson city,472,855,-383
51,Virginia,51,Virginia,740,Portsmouth city,7214,6309,905
51,Virginia,51,Virginia,750,Radford city,1748,3484,-1736
51,Virginia,51,Virginia,760,Richmond city,16128,18043,-1915
51,Virginia,51,Virginia,770,Roanoke city,6015,5499,516
51,Virginia,51,Virginia,775,Salem city,2234,2603,-369
51,Virginia,51,Virginia,790,Staunton city,875,2454,-1579
51,Virginia,51,Virginia,800,Suffolk city,4536,4475,61
51,Virginia,51,Virginia,810,Virginia Beach city,16737,16738,-1
51,Virginia,51,Virginia,820,Waynesboro city,1491,2292,-801
51,Virginia,51,Virginia,830,Williamsburg city,1442,2268,-826
51,Virginia,51,Virginia,840,Winchester city,2297,2112,185
51,Virginia,53,Washington,5,Benton County,106,70,36
51,Virginia,53,Washington,7,Chelan County,110,23,87
51,Virginia,53,Washington,11,Clark County,47,180,-133
51,Virginia,53,Washington,15,Cowlitz County,0,34,-34
51,Virginia,53,Washington,19,Ferry County,0,5,-5
51,Virginia,53,Washington,21,Franklin County,45,0,45
51,Virginia,53,Washington,23,Garfield County,0,7,-7
51,Virginia,53,Washington,25,Grant County,9,0,9
51,Virginia,53,Washington,29,Island County,401,311,90
51,Virginia,53,Washington,31,Jefferson County,24,0,24
51,Virginia,53,Washington,33,King County,917,1627,-710
51,Virginia,53,Washington,35,Kitsap County,666,807,-141
51,Virginia,53,Washington,37,Kittitas County,0,11,-11
51,Virginia,53,Washington,39,Klickitat County,0,4,-4
51,Virginia,53,Washington,41,Lewis County,0,44,-44
51,Virginia,53,Washington,43,Lincoln County,111,0,111
51,Virginia,53,Washington,45,Mason County,0,16,-16
51,Virginia,53,Washington,47,Okanogan County,4,0,4
51,Virginia,53,Washington,49,Pacific County,0,1,-1
51,Virginia,53,Washington,53,Pierce County,898,868,30
51,Virginia,53,Washington,55,San Juan County,0,5,-5
51,Virginia,53,Washington,57,Skagit County,98,59,39
51,Virginia,53,Washington,61,Snohomish County,407,555,-148
51,Virginia,53,Washington,63,Spokane County,328,222,106
51,Virginia,53,Washington,67,Thurston County,393,514,-121
51,Virginia,53,Washington,71,Walla Walla County,0,8,-8
51,Virginia,53,Washington,73,Whatcom County,159,19,140
51,Virginia,53,Washington,75,Whitman County,0,70,-70
51,Virginia,53,Washington,77,Yakima County,0,257,-257
51,Virginia,54,West Virginia,1,Barbour County,17,70,-53
51,Virginia,54,West Virginia,3,Berkeley County,936,993,-57
51,Virginia,54,West Virginia,5,Boone County,0,37,-37
51,Virginia,54,West Virginia,7,Braxton County,10,29,-19
51,Virginia,54,West Virginia,9,Brooke County,0,98,-98
51,Virginia,54,West Virginia,11,Cabell County,67,157,-90
51,Virginia,54,West Virginia,15,Clay County,13,0,13
51,Virginia,54,West Virginia,17,Doddridge County,0,13,-13
51,Virginia,54,West Virginia,19,Fayette County,56,50,6
51,Virginia,54,West Virginia,21,Gilmer County,51,40,11
51,Virginia,54,West Virginia,23,Grant County,26,48,-22
51,Virginia,54,West Virginia,25,Greenbrier County,344,139,205
51,Virginia,54,West Virginia,27,Hampshire County,181,247,-66
51,Virginia,54,West Virginia,29,Hancock County,137,32,105
51,Virginia,54,West Virginia,31,Hardy County,95,36,59
51,Virginia,54,West Virginia,33,Harrison County,30,11,19
51,Virginia,54,West Virginia,35,Jackson County,0,21,-21
51,Virginia,54,West Virginia,37,Jefferson County,387,950,-563
51,Virginia,54,West Virginia,39,Kanawha County,354,138,216
51,Virginia,54,West Virginia,41,Lewis County,32,6,26
51,Virginia,54,West Virginia,45,Logan County,23,0,23
51,Virginia,54,West Virginia,47,McDowell County,222,80,142
51,Virginia,54,West Virginia,49,Marion County,141,29,112
51,Virginia,54,West Virginia,51,Marshall County,10,1,9
51,Virginia,54,West Virginia,55,Mercer County,1064,610,454
51,Virginia,54,West Virginia,57,Mineral County,16,46,-30
51,Virginia,54,West Virginia,59,Mingo County,20,24,-4
51,Virginia,54,West Virginia,61,Monongalia County,335,869,-534
51,Virginia,54,West Virginia,63,Monroe County,332,312,20
51,Virginia,54,West Virginia,65,Morgan County,223,51,172
51,Virginia,54,West Virginia,67,Nicholas County,41,28,13
51,Virginia,54,West Virginia,69,Ohio County,70,63,7
51,Virginia,54,West Virginia,71,Pendleton County,58,19,39
51,Virginia,54,West Virginia,73,Pleasants County,0,15,-15
51,Virginia,54,West Virginia,75,Pocahontas County,16,11,5
51,Virginia,54,West Virginia,77,Preston County,192,28,164
51,Virginia,54,West Virginia,79,Putnam County,70,0,70
51,Virginia,54,West Virginia,81,Raleigh County,605,222,383
51,Virginia,54,West Virginia,83,Randolph County,46,59,-13
51,Virginia,54,West Virginia,85,Ritchie County,10,0,10
51,Virginia,54,West Virginia,89,Summers County,7,243,-236
51,Virginia,54,West Virginia,91,Taylor County,0,73,-73
51,Virginia,54,West Virginia,93,Tucker County,0,17,-17
51,Virginia,54,West Virginia,97,Upshur County,45,13,32
51,Virginia,54,West Virginia,99,Wayne County,50,31,19
51,Virginia,54,West Virginia,101,Webster County,0,55,-55
51,Virginia,54,West Virginia,107,Wood County,131,10,121
51,Virginia,54,West Virginia,109,Wyoming County,36,38,-2
51,Virginia,55,Wisconsin,1,Adams County,0,23,-23
51,Virginia,55,Wisconsin,3,Ashland County,0,3,-3
51,Virginia,55,Wisconsin,5,Barron County,10,0,10
51,Virginia,55,Wisconsin,9,Brown County,15,152,-137
51,Virginia,55,Wisconsin,15,Calumet County,6,7,-1
51,Virginia,55,Wisconsin,17,Chippewa County,15,0,15
51,Virginia,55,Wisconsin,19,Clark County,0,2,-2
51,Virginia,55,Wisconsin,23,Crawford County,0,2,-2
51,Virginia,55,Wisconsin,25,Dane County,249,266,-17
51,Virginia,55,Wisconsin,29,Door County,0,11,-11
51,Virginia,55,Wisconsin,31,Douglas County,39,0,39
51,Virginia,55,Wisconsin,35,Eau Claire County,60,10,50
51,Virginia,55,Wisconsin,39,Fond du Lac County,15,0,15
51,Virginia,55,Wisconsin,43,Grant County,63,0,63
51,Virginia,55,Wisconsin,45,Green County,0,3,-3
51,Virginia,55,Wisconsin,53,Jackson County,0,7,-7
51,Virginia,55,Wisconsin,57,Juneau County,0,1,-1
51,Virginia,55,Wisconsin,59,Kenosha County,126,44,82
51,Virginia,55,Wisconsin,61,Kewaunee County,0,4,-4
51,Virginia,55,Wisconsin,63,La Crosse County,25,19,6
51,Virginia,55,Wisconsin,69,Lincoln County,0,19,-19
51,Virginia,55,Wisconsin,73,Marathon County,0,3,-3
51,Virginia,55,Wisconsin,75,Marinette County,0,6,-6
51,Virginia,55,Wisconsin,77,Marquette County,0,3,-3
51,Virginia,55,Wisconsin,79,Milwaukee County,482,519,-37
51,Virginia,55,Wisconsin,81,Monroe County,112,5,107
51,Virginia,55,Wisconsin,83,Oconto County,7,8,-1
51,Virginia,55,Wisconsin,85,Oneida County,0,51,-51
51,Virginia,55,Wisconsin,87,Outagamie County,5,43,-38
51,Virginia,55,Wisconsin,89,Ozaukee County,0,97,-97
51,Virginia,55,Wisconsin,95,Polk County,20,0,20
51,Virginia,55,Wisconsin,97,Portage County,12,28,-16
51,Virginia,55,Wisconsin,99,Price County,0,21,-21
51,Virginia,55,Wisconsin,101,Racine County,14,11,3
51,Virginia,55,Wisconsin,105,Rock County,0,26,-26
51,Virginia,55,Wisconsin,107,Rusk County,0,2,-2
51,Virginia,55,Wisconsin,109,St. Croix County,27,6,21
51,Virginia,55,Wisconsin,111,Sauk County,0,66,-66
51,Virginia,55,Wisconsin,117,Sheboygan County,0,13,-13
51,Virginia,55,Wisconsin,119,Taylor County,0,14,-14
51,Virginia,55,Wisconsin,127,Walworth County,12,30,-18
51,Virginia,55,Wisconsin,131,Washington County,33,20,13
51,Virginia,55,Wisconsin,133,Waukesha County,75,160,-85
51,Virginia,55,Wisconsin,135,Waupaca County,28,12,16
51,Virginia,55,Wisconsin,137,Waushara County,0,2,-2
51,Virginia,55,Wisconsin,139,Winnebago County,10,28,-18
51,Virginia,55,Wisconsin,141,Wood County,38,0,38
51,Virginia,56,Wyoming,1,Albany County,105,84,21
51,Virginia,56,Wyoming,3,Big Horn County,0,11,-11
51,Virginia,56,Wyoming,5,Campbell County,0,1,-1
51,Virginia,56,Wyoming,13,Fremont County,5,9,-4
51,Virginia,56,Wyoming,15,Goshen County,5,0,5
51,Virginia,56,Wyoming,21,Laramie County,33,128,-95
51,Virginia,56,Wyoming,25,Natrona County,0,59,-59
51,Virginia,56,Wyoming,29,Park County,0,11,-11
51,Virginia,56,Wyoming,37,Sweetwater County,5,0,5
51,Virginia,56,Wyoming,39,Teton County,0,2,-2
51,Virginia,56,Wyoming,45,Weston County,0,71,-71
51,Virginia,6,California,1,Alameda County,876,817,59
51,Virginia,6,California,3,Alpine County,0,12,-12
51,Virginia,6,California,5,Amador County,79,15,64
51,Virginia,6,California,7,Butte County,0,122,-122
51,Virginia,6,California,13,Contra Costa County,273,272,1
51,Virginia,6,California,17,El Dorado County,22,56,-34
51,Virginia,6,California,19,Fresno County,169,196,-27
51,Virginia,6,California,23,Humboldt County,0,49,-49
51,Virginia,6,California,25,Imperial County,0,54,-54
51,Virginia,6,California,29,Kern County,301,242,59
51,Virginia,6,California,31,Kings County,664,456,208
51,Virginia,6,California,33,Lake County,20,0,20
51,Virginia,6,California,37,Los Angeles County,2639,2469,170
51,Virginia,6,California,41,Marin County,114,238,-124
51,Virginia,6,California,43,Mariposa County,13,0,13
51,Virginia,6,California,45,Mendocino County,0,27,-27
51,Virginia,6,California,47,Merced County,18,62,-44
51,Virginia,6,California,51,Mono County,13,0,13
51,Virginia,6,California,53,Monterey County,402,253,149
51,Virginia,6,California,55,Napa County,47,34,13
51,Virginia,6,California,57,Nevada County,12,0,12
51,Virginia,6,California,59,Orange County,968,961,7
51,Virginia,6,California,61,Placer County,239,31,208
51,Virginia,6,California,65,Riverside County,694,766,-72
51,Virginia,6,California,67,Sacramento County,623,539,84
51,Virginia,6,California,71,San Bernardino County,875,453,422
51,Virginia,6,California,73,San Diego County,5956,4634,1322
51,Virginia,6,California,75,San Francisco County,157,510,-353
51,Virginia,6,California,77,San Joaquin County,157,16,141
51,Virginia,6,California,79,San Luis Obispo County,61,64,-3
51,Virginia,6,California,81,San Mateo County,199,432,-233
51,Virginia,6,California,83,Santa Barbara County,156,224,-68
51,Virginia,6,California,85,Santa Clara County,614,977,-363
51,Virginia,6,California,87,Santa Cruz County,81,60,21
51,Virginia,6,California,89,Shasta County,0,44,-44
51,Virginia,6,California,95,Solano County,202,143,59
51,Virginia,6,California,97,Sonoma County,245,48,197
51,Virginia,6,California,99,Stanislaus County,97,44,53
51,Virginia,6,California,101,Sutter County,0,25,-25
51,Virginia,6,California,105,Trinity County,0,4,-4
51,Virginia,6,California,107,Tulare County,132,46,86
51,Virginia,6,California,109,Tuolumne County,36,0,36
51,Virginia,6,California,111,Ventura County,392,446,-54
51,Virginia,6,California,113,Yolo County,19,18,1
51,Virginia,6,California,115,Yuba County,158,41,117
51,Virginia,72,Puerto Rico,1,Adjuntas Municipio,21,46,-25
51,Virginia,72,Puerto Rico,11,Añasco Municipio,76,0,76
51,Virginia,72,Puerto Rico,13,Arecibo Municipio,0,6,-6
51,Virginia,72,Puerto Rico,21,Bayamón Municipio,162,134,28
51,Virginia,72,Puerto Rico,23,Cabo Rojo Municipio,113,0,113
51,Virginia,72,Puerto Rico,25,Caguas Municipio,59,0,59
51,Virginia,72,Puerto Rico,29,Canóvanas Municipio,25,0,25
51,Virginia,72,Puerto Rico,31,Carolina Municipio,157,10,147
51,Virginia,72,Puerto Rico,33,Cataño Municipio,66,0,66
51,Virginia,72,Puerto Rico,43,Coamo Municipio,25,0,25
51,Virginia,72,Puerto Rico,47,Corozal Municipio,10,0,10
51,Virginia,72,Puerto Rico,51,Dorado Municipio,102,0,102
51,Virginia,72,Puerto Rico,53,Fajardo Municipio,0,46,-46
51,Virginia,72,Puerto Rico,57,Guayama Municipio,28,0,28
51,Virginia,72,Puerto Rico,59,Guayanilla Municipio,25,0,25
51,Virginia,72,Puerto Rico,61,Guaynabo Municipio,26,0,26
51,Virginia,72,Puerto Rico,63,Gurabo Municipio,41,0,41
51,Virginia,72,Puerto Rico,65,Hatillo Municipio,7,0,7
51,Virginia,72,Puerto Rico,69,Humacao Municipio,0,38,-38
51,Virginia,72,Puerto Rico,71,Isabela Municipio,56,0,56
51,Virginia,72,Puerto Rico,75,Juana Díaz Municipio,81,11,70
51,Virginia,72,Puerto Rico,89,Luquillo Municipio,0,35,-35
51,Virginia,72,Puerto Rico,97,Mayagüez Municipio,30,59,-29
51,Virginia,72,Puerto Rico,99,Moca Municipio,118,0,118
51,Virginia,72,Puerto Rico,101,Morovis Municipio,31,0,31
51,Virginia,72,Puerto Rico,103,Naguabo Municipio,62,0,62
51,Virginia,72,Puerto Rico,111,Peñuelas Municipio,40,0,40
51,Virginia,72,Puerto Rico,113,Ponce Municipio,0,22,-22
51,Virginia,72,Puerto Rico,115,Quebradillas Municipio,5,0,5
51,Virginia,72,Puerto Rico,119,Río Grande Municipio,26,0,26
51,Virginia,72,Puerto Rico,123,Salinas Municipio,29,0,29
51,Virginia,72,Puerto Rico,127,San Juan Municipio,343,3,340
51,Virginia,72,Puerto Rico,133,Santa Isabel Municipio,0,32,-32
51,Virginia,72,Puerto Rico,135,Toa Alta Municipio,11,0,11
51,Virginia,72,Puerto Rico,139,Trujillo Alto Municipio,70,0,70
51,Virginia,72,Puerto Rico,141,Utuado Municipio,28,0,28
51,Virginia,72,Puerto Rico,151,Yabucoa Municipio,7,179,-172
51,Virginia,8,Colorado,1,Adams County,145,139,6
51,Virginia,8,Colorado,5,Arapahoe County,305,680,-375
51,Virginia,8,Colorado,7,Archuleta County,0,3,-3
51,Virginia,8,Colorado,13,Boulder County,250,404,-154
51,Virginia,8,Colorado,14,Broomfield County,99,70,29
51,Virginia,8,Colorado,15,Chaffee County,13,15,-2
51,Virginia,8,Colorado,17,Cheyenne County,0,13,-13
51,Virginia,8,Colorado,27,Custer County,39,0,39
51,Virginia,8,Colorado,29,Delta County,0,30,-30
51,Virginia,8,Colorado,31,Denver County,487,745,-258
51,Virginia,8,Colorado,35,Douglas County,310,994,-684
51,Virginia,8,Colorado,37,Eagle County,0,19,-19
51,Virginia,8,Colorado,39,Elbert County,16,29,-13
51,Virginia,8,Colorado,41,El Paso County,955,2136,-1181
51,Virginia,8,Colorado,43,Fremont County,59,63,-4
51,Virginia,8,Colorado,45,Garfield County,6,9,-3
51,Virginia,8,Colorado,47,Gilpin County,13,0,13
51,Virginia,8,Colorado,49,Grand County,133,0,133
51,Virginia,8,Colorado,59,Jefferson County,293,460,-167
51,Virginia,8,Colorado,65,Lake County,20,0,20
51,Virginia,8,Colorado,67,La Plata County,117,50,67
51,Virginia,8,Colorado,69,Larimer County,114,260,-146
51,Virginia,8,Colorado,77,Mesa County,155,98,57
51,Virginia,8,Colorado,81,Moffat County,41,0,41
51,Virginia,8,Colorado,83,Montezuma County,0,119,-119
51,Virginia,8,Colorado,85,Montrose County,0,135,-135
51,Virginia,8,Colorado,97,Pitkin County,38,0,38
51,Virginia,8,Colorado,101,Pueblo County,43,24,19
51,Virginia,8,Colorado,117,Summit County,43,0,43
51,Virginia,8,Colorado,119,Teller County,0,17,-17
51,Virginia,8,Colorado,123,Weld County,59,156,-97
51,Virginia,9,Connecticut,1,Fairfield County,1076,697,379
51,Virginia,9,Connecticut,3,Hartford County,427,624,-197
51,Virginia,9,Connecticut,5,Litchfield County,259,11,248
51,Virginia,9,Connecticut,7,Middlesex County,56,39,17
51,Virginia,9,Connecticut,9,New Haven County,654,350,304
51,Virginia,9,Connecticut,11,New London County,1116,629,487
51,Virginia,9,Connecticut,13,Tolland County,145,81,64
51,Virginia,9,Connecticut,15,Windham County,9,83,-74
51,Virginia,AFR,Africa,,-,6130,0,0
51,Virginia,ASI,Asia,,-,33951,0,0
51,Virginia,CAM,Central America,,-,6025,0,0
51,Virginia,CAR,Caribbean,,-,1518,0,0
51,Virginia,EUR,Europe,,-,14547,0,0
51,Virginia,ISL,U.S. Island Areas,,-,620,0,0
51,Virginia,NAM,Northern America,,-,1071,0,0
51,Virginia,OCE,Oceania and At Sea,,-,1637,0,0
51,Virginia,SAM,South America,,-,4190,0,0
53,Washington,1,Alabama,1,Autauga County,20,0,20
53,Washington,1,Alabama,3,Baldwin County,13,29,-16
53,Washington,1,Alabama,15,Calhoun County,18,18,0
53,Washington,1,Alabama,25,Clarke County,0,10,-10
53,Washington,1,Alabama,31,Coffee County,97,8,89
53,Washington,1,Alabama,45,Dale County,37,75,-38
53,Washington,1,Alabama,47,Dallas County,17,0,17
53,Washington,1,Alabama,51,Elmore County,9,12,-3
53,Washington,1,Alabama,55,Etowah County,31,28,3
53,Washington,1,Alabama,69,Houston County,0,10,-10
53,Washington,1,Alabama,73,Jefferson County,214,0,214
53,Washington,1,Alabama,77,Lauderdale County,0,2,-2
53,Washington,1,Alabama,81,Lee County,107,122,-15
53,Washington,1,Alabama,83,Limestone County,10,0,10
53,Washington,1,Alabama,87,Macon County,8,0,8
53,Washington,1,Alabama,89,Madison County,94,107,-13
53,Washington,1,Alabama,95,Marshall County,28,1,27
53,Washington,1,Alabama,97,Mobile County,118,35,83
53,Washington,1,Alabama,99,Monroe County,17,0,17
53,Washington,1,Alabama,101,Montgomery County,88,136,-48
53,Washington,1,Alabama,103,Morgan County,22,0,22
53,Washington,1,Alabama,109,Pike County,80,0,80
53,Washington,1,Alabama,113,Russell County,0,52,-52
53,Washington,1,Alabama,117,Shelby County,6,5,1
53,Washington,1,Alabama,125,Tuscaloosa County,76,98,-22
53,Washington,1,Alabama,127,Walker County,0,18,-18
53,Washington,1,Alabama,129,Washington County,0,1,-1
53,Washington,10,Delaware,1,Kent County,22,201,-179
53,Washington,10,Delaware,3,New Castle County,357,0,357
53,Washington,10,Delaware,5,Sussex County,14,6,8
53,Washington,11,District of Columbia,1,District of Columbia,628,388,240
53,Washington,12,Florida,1,Alachua County,216,92,124
53,Washington,12,Florida,5,Bay County,79,12,67
53,Washington,12,Florida,9,Brevard County,384,458,-74
53,Washington,12,Florida,11,Broward County,386,84,302
53,Washington,12,Florida,15,Charlotte County,37,132,-95
53,Washington,12,Florida,17,Citrus County,34,0,34
53,Washington,12,Florida,19,Clay County,79,150,-71
53,Washington,12,Florida,21,Collier County,202,61,141
53,Washington,12,Florida,23,Columbia County,0,27,-27
53,Washington,12,Florida,27,DeSoto County,6,0,6
53,Washington,12,Florida,31,Duval County,679,565,114
53,Washington,12,Florida,33,Escambia County,627,255,372
53,Washington,12,Florida,35,Flagler County,138,76,62
53,Washington,12,Florida,39,Gadsden County,12,0,12
53,Washington,12,Florida,45,Gulf County,16,12,4
53,Washington,12,Florida,53,Hernando County,87,72,15
53,Washington,12,Florida,55,Highlands County,36,0,36
53,Washington,12,Florida,57,Hillsborough County,766,251,515
53,Washington,12,Florida,61,Indian River County,43,123,-80
53,Washington,12,Florida,69,Lake County,147,55,92
53,Washington,12,Florida,71,Lee County,216,70,146
53,Washington,12,Florida,73,Leon County,159,27,132
53,Washington,12,Florida,81,Manatee County,68,28,40
53,Washington,12,Florida,83,Marion County,176,83,93
53,Washington,12,Florida,85,Martin County,17,79,-62
53,Washington,12,Florida,86,Miami-Dade County,704,198,506
53,Washington,12,Florida,87,Monroe County,59,51,8
53,Washington,12,Florida,89,Nassau County,63,0,63
53,Washington,12,Florida,91,Okaloosa County,294,187,107
53,Washington,12,Florida,95,Orange County,613,333,280
53,Washington,12,Florida,97,Osceola County,0,124,-124
53,Washington,12,Florida,99,Palm Beach County,424,269,155
53,Washington,12,Florida,101,Pasco County,198,230,-32
53,Washington,12,Florida,103,Pinellas County,422,494,-72
53,Washington,12,Florida,105,Polk County,198,64,134
53,Washington,12,Florida,109,St. Johns County,132,7,125
53,Washington,12,Florida,111,St. Lucie County,66,84,-18
53,Washington,12,Florida,113,Santa Rosa County,265,214,51
53,Washington,12,Florida,115,Sarasota County,187,50,137
53,Washington,12,Florida,117,Seminole County,0,9,-9
53,Washington,12,Florida,119,Sumter County,0,17,-17
53,Washington,12,Florida,121,Suwannee County,97,0,97
53,Washington,12,Florida,127,Volusia County,257,382,-125
53,Washington,12,Florida,129,Wakulla County,21,15,6
53,Washington,12,Florida,131,Walton County,30,63,-33
53,Washington,13,Georgia,9,Baldwin County,0,41,-41
53,Washington,13,Georgia,21,Bibb County,0,21,-21
53,Washington,13,Georgia,31,Bulloch County,0,7,-7
53,Washington,13,Georgia,33,Burke County,21,0,21
53,Washington,13,Georgia,39,Camden County,72,39,33
53,Washington,13,Georgia,47,Catoosa County,125,0,125
53,Washington,13,Georgia,49,Charlton County,0,14,-14
53,Washington,13,Georgia,51,Chatham County,519,200,319
53,Washington,13,Georgia,53,Chattahoochee County,174,168,6
53,Washington,13,Georgia,57,Cherokee County,48,0,48
53,Washington,13,Georgia,59,Clarke County,43,14,29
53,Washington,13,Georgia,67,Cobb County,458,143,315
53,Washington,13,Georgia,69,Coffee County,0,8,-8
53,Washington,13,Georgia,71,Colquitt County,0,39,-39
53,Washington,13,Georgia,73,Columbia County,98,59,39
53,Washington,13,Georgia,77,Coweta County,0,53,-53
53,Washington,13,Georgia,79,Crawford County,0,18,-18
53,Washington,13,Georgia,83,Dade County,0,18,-18
53,Washington,13,Georgia,89,DeKalb County,352,188,164
53,Washington,13,Georgia,107,Emanuel County,27,0,27
53,Washington,13,Georgia,113,Fayette County,107,0,107
53,Washington,13,Georgia,115,Floyd County,4,0,4
53,Washington,13,Georgia,117,Forsyth County,0,27,-27
53,Washington,13,Georgia,121,Fulton County,586,307,279
53,Washington,13,Georgia,127,Glynn County,0,29,-29
53,Washington,13,Georgia,135,Gwinnett County,474,87,387
53,Washington,13,Georgia,137,Habersham County,0,57,-57
53,Washington,13,Georgia,139,Hall County,91,12,79
53,Washington,13,Georgia,151,Henry County,17,0,17
53,Washington,13,Georgia,153,Houston County,97,14,83
53,Washington,13,Georgia,161,Jeff Davis County,239,0,239
53,Washington,13,Georgia,179,Liberty County,652,219,433
53,Washington,13,Georgia,185,Lowndes County,45,31,14
53,Washington,13,Georgia,187,Lumpkin County,34,0,34
53,Washington,13,Georgia,199,Meriwether County,0,20,-20
53,Washington,13,Georgia,215,Muscogee County,231,587,-356
53,Washington,13,Georgia,217,Newton County,14,0,14
53,Washington,13,Georgia,219,Oconee County,13,3,10
53,Washington,13,Georgia,223,Paulding County,91,0,91
53,Washington,13,Georgia,227,Pickens County,39,0,39
53,Washington,13,Georgia,231,Pike County,0,17,-17
53,Washington,13,Georgia,235,Pulaski County,0,8,-8
53,Washington,13,Georgia,245,Richmond County,234,108,126
53,Washington,13,Georgia,247,Rockdale County,0,221,-221
53,Washington,13,Georgia,257,Stephens County,0,5,-5
53,Washington,13,Georgia,259,Stewart County,0,23,-23
53,Washington,13,Georgia,275,Thomas County,51,54,-3
53,Washington,13,Georgia,277,Tift County,0,31,-31
53,Washington,13,Georgia,295,Walker County,23,0,23
53,Washington,13,Georgia,297,Walton County,14,11,3
53,Washington,13,Georgia,299,Ware County,0,2,-2
53,Washington,13,Georgia,303,Washington County,43,7,36
53,Washington,13,Georgia,305,Wayne County,18,0,18
53,Washington,13,Georgia,311,White County,15,0,15
53,Washington,15,Hawaii,1,Hawaii County,466,939,-473
53,Washington,15,Hawaii,3,Honolulu County,3385,2260,1125
53,Washington,15,Hawaii,7,Kauai County,158,111,47
53,Washington,15,Hawaii,9,Maui County,617,305,312
53,Washington,16,Idaho,1,Ada County,2016,1082,934
53,Washington,16,Idaho,3,Adams County,102,13,89
53,Washington,16,Idaho,5,Bannock County,154,104,50
53,Washington,16,Idaho,7,Bear Lake County,0,11,-11
53,Washington,16,Idaho,9,Benewah County,93,80,13
53,Washington,16,Idaho,11,Bingham County,29,43,-14
53,Washington,16,Idaho,13,Blaine County,99,21,78
53,Washington,16,Idaho,15,Boise County,46,8,38
53,Washington,16,Idaho,17,Bonner County,862,530,332
53,Washington,16,Idaho,19,Bonneville County,79,440,-361
53,Washington,16,Idaho,21,Boundary County,94,124,-30
53,Washington,16,Idaho,23,Butte County,0,4,-4
53,Washington,16,Idaho,27,Canyon County,586,714,-128
53,Washington,16,Idaho,29,Caribou County,26,25,1
53,Washington,16,Idaho,31,Cassia County,0,82,-82
53,Washington,16,Idaho,33,Clark County,0,1,-1
53,Washington,16,Idaho,35,Clearwater County,4,139,-135
53,Washington,16,Idaho,37,Custer County,0,19,-19
53,Washington,16,Idaho,39,Elmore County,122,80,42
53,Washington,16,Idaho,41,Franklin County,0,24,-24
53,Washington,16,Idaho,43,Fremont County,3,26,-23
53,Washington,16,Idaho,45,Gem County,73,52,21
53,Washington,16,Idaho,47,Gooding County,0,10,-10
53,Washington,16,Idaho,49,Idaho County,97,110,-13
53,Washington,16,Idaho,51,Jefferson County,112,6,106
53,Washington,16,Idaho,53,Jerome County,14,94,-80
53,Washington,16,Idaho,55,Kootenai County,2076,1887,189
53,Washington,16,Idaho,57,Latah County,1433,1377,56
53,Washington,16,Idaho,59,Lemhi County,5,37,-32
53,Washington,16,Idaho,61,Lewis County,26,18,8
53,Washington,16,Idaho,65,Madison County,255,389,-134
53,Washington,16,Idaho,67,Minidoka County,0,2,-2
53,Washington,16,Idaho,69,Nez Perce County,1428,930,498
53,Washington,16,Idaho,73,Owyhee County,33,204,-171
53,Washington,16,Idaho,75,Payette County,52,82,-30
53,Washington,16,Idaho,77,Power County,40,0,40
53,Washington,16,Idaho,79,Shoshone County,126,64,62
53,Washington,16,Idaho,81,Teton County,28,10,18
53,Washington,16,Idaho,83,Twin Falls County,215,192,23
53,Washington,16,Idaho,85,Valley County,185,130,55
53,Washington,16,Idaho,87,Washington County,0,8,-8
53,Washington,17,Illinois,1,Adams County,0,168,-168
53,Washington,17,Illinois,7,Boone County,0,223,-223
53,Washington,17,Illinois,17,Cass County,0,18,-18
53,Washington,17,Illinois,19,Champaign County,280,284,-4
53,Washington,17,Illinois,25,Clay County,42,0,42
53,Washington,17,Illinois,27,Clinton County,20,0,20
53,Washington,17,Illinois,29,Coles County,0,22,-22
53,Washington,17,Illinois,31,Cook County,3560,1454,2106
53,Washington,17,Illinois,33,Crawford County,0,8,-8
53,Washington,17,Illinois,43,DuPage County,410,136,274
53,Washington,17,Illinois,45,Edgar County,0,20,-20
53,Washington,17,Illinois,63,Grundy County,0,12,-12
53,Washington,17,Illinois,73,Henry County,48,0,48
53,Washington,17,Illinois,77,Jackson County,157,0,157
53,Washington,17,Illinois,81,Jefferson County,0,2,-2
53,Washington,17,Illinois,83,Jersey County,0,30,-30
53,Washington,17,Illinois,89,Kane County,377,85,292
53,Washington,17,Illinois,91,Kankakee County,7,24,-17
53,Washington,17,Illinois,93,Kendall County,20,2,18
53,Washington,17,Illinois,95,Knox County,76,29,47
53,Washington,17,Illinois,97,Lake County,634,529,105
53,Washington,17,Illinois,99,LaSalle County,28,11,17
53,Washington,17,Illinois,101,Lawrence County,17,0,17
53,Washington,17,Illinois,103,Lee County,0,25,-25
53,Washington,17,Illinois,105,Livingston County,0,10,-10
53,Washington,17,Illinois,107,Logan County,0,2,-2
53,Washington,17,Illinois,109,McDonough County,4,26,-22
53,Washington,17,Illinois,111,McHenry County,19,17,2
53,Washington,17,Illinois,113,McLean County,0,51,-51
53,Washington,17,Illinois,115,Macon County,20,0,20
53,Washington,17,Illinois,117,Macoupin County,0,20,-20
53,Washington,17,Illinois,119,Madison County,97,31,66
53,Washington,17,Illinois,121,Marion County,0,8,-8
53,Washington,17,Illinois,133,Monroe County,0,5,-5
53,Washington,17,Illinois,141,Ogle County,14,0,14
53,Washington,17,Illinois,143,Peoria County,30,0,30
53,Washington,17,Illinois,149,Pike County,14,0,14
53,Washington,17,Illinois,155,Putnam County,6,0,6
53,Washington,17,Illinois,157,Randolph County,20,2,18
53,Washington,17,Illinois,161,Rock Island County,31,27,4
53,Washington,17,Illinois,163,St. Clair County,189,274,-85
53,Washington,17,Illinois,165,Saline County,30,0,30
53,Washington,17,Illinois,167,Sangamon County,98,0,98
53,Washington,17,Illinois,179,Tazewell County,16,35,-19
53,Washington,17,Illinois,183,Vermilion County,12,10,2
53,Washington,17,Illinois,187,Warren County,23,0,23
53,Washington,17,Illinois,195,Whiteside County,0,12,-12
53,Washington,17,Illinois,197,Will County,113,64,49
53,Washington,17,Illinois,201,Winnebago County,423,145,278
53,Washington,18,Indiana,3,Allen County,74,33,41
53,Washington,18,Indiana,5,Bartholomew County,9,144,-135
53,Washington,18,Indiana,29,Dearborn County,23,0,23
53,Washington,18,Indiana,31,Decatur County,0,43,-43
53,Washington,18,Indiana,33,DeKalb County,0,16,-16
53,Washington,18,Indiana,35,Delaware County,21,11,10
53,Washington,18,Indiana,37,Dubois County,0,5,-5
53,Washington,18,Indiana,39,Elkhart County,141,75,66
53,Washington,18,Indiana,41,Fayette County,8,0,8
53,Washington,18,Indiana,53,Grant County,29,38,-9
53,Washington,18,Indiana,57,Hamilton County,120,124,-4
53,Washington,18,Indiana,59,Hancock County,16,0,16
53,Washington,18,Indiana,63,Hendricks County,16,26,-10
53,Washington,18,Indiana,67,Howard County,20,0,20
53,Washington,18,Indiana,69,Huntington County,0,215,-215
53,Washington,18,Indiana,73,Jasper County,0,37,-37
53,Washington,18,Indiana,77,Jefferson County,0,55,-55
53,Washington,18,Indiana,81,Johnson County,8,6,2
53,Washington,18,Indiana,83,Knox County,0,18,-18
53,Washington,18,Indiana,89,Lake County,97,98,-1
53,Washington,18,Indiana,91,LaPorte County,33,3,30
53,Washington,18,Indiana,95,Madison County,0,9,-9
53,Washington,18,Indiana,97,Marion County,177,76,101
53,Washington,18,Indiana,103,Miami County,0,18,-18
53,Washington,18,Indiana,105,Monroe County,290,111,179
53,Washington,18,Indiana,107,Montgomery County,25,47,-22
53,Washington,18,Indiana,119,Owen County,0,29,-29
53,Washington,18,Indiana,127,Porter County,37,0,37
53,Washington,18,Indiana,133,Putnam County,15,0,15
53,Washington,18,Indiana,137,Ripley County,11,0,11
53,Washington,18,Indiana,141,St. Joseph County,173,294,-121
53,Washington,18,Indiana,143,Scott County,9,0,9
53,Washington,18,Indiana,145,Shelby County,0,26,-26
53,Washington,18,Indiana,151,Steuben County,0,170,-170
53,Washington,18,Indiana,153,Sullivan County,0,7,-7
53,Washington,18,Indiana,157,Tippecanoe County,127,316,-189
53,Washington,18,Indiana,163,Vanderburgh County,0,21,-21
53,Washington,18,Indiana,167,Vigo County,16,24,-8
53,Washington,18,Indiana,173,Warrick County,14,0,14
53,Washington,19,Iowa,9,Audubon County,0,19,-19
53,Washington,19,Iowa,11,Benton County,0,32,-32
53,Washington,19,Iowa,13,Black Hawk County,42,0,42
53,Washington,19,Iowa,15,Boone County,0,150,-150
53,Washington,19,Iowa,17,Bremer County,0,3,-3
53,Washington,19,Iowa,25,Calhoun County,17,0,17
53,Washington,19,Iowa,27,Carroll County,20,0,20
53,Washington,19,Iowa,31,Cedar County,0,3,-3
53,Washington,19,Iowa,33,Cerro Gordo County,0,25,-25
53,Washington,19,Iowa,35,Cherokee County,0,13,-13
53,Washington,19,Iowa,45,Clinton County,0,13,-13
53,Washington,19,Iowa,47,Crawford County,0,1,-1
53,Washington,19,Iowa,49,Dallas County,0,18,-18
53,Washington,19,Iowa,53,Decatur County,0,14,-14
53,Washington,19,Iowa,57,Des Moines County,0,7,-7
53,Washington,19,Iowa,61,Dubuque County,60,82,-22
53,Washington,19,Iowa,65,Fayette County,12,33,-21
53,Washington,19,Iowa,69,Franklin County,3,0,3
53,Washington,19,Iowa,77,Guthrie County,24,5,19
53,Washington,19,Iowa,85,Harrison County,0,8,-8
53,Washington,19,Iowa,101,Jefferson County,50,0,50
53,Washington,19,Iowa,103,Johnson County,127,157,-30
53,Washington,19,Iowa,113,Linn County,83,212,-129
53,Washington,19,Iowa,117,Lucas County,0,46,-46
53,Washington,19,Iowa,123,Mahaska County,0,2,-2
53,Washington,19,Iowa,127,Marshall County,175,13,162
53,Washington,19,Iowa,137,Montgomery County,0,19,-19
53,Washington,19,Iowa,139,Muscatine County,8,0,8
53,Washington,19,Iowa,141,O'Brien County,0,11,-11
53,Washington,19,Iowa,145,Page County,2,0,2
53,Washington,19,Iowa,153,Polk County,27,371,-344
53,Washington,19,Iowa,155,Pottawattamie County,72,26,46
53,Washington,19,Iowa,157,Poweshiek County,0,4,-4
53,Washington,19,Iowa,161,Sac County,0,3,-3
53,Washington,19,Iowa,163,Scott County,66,81,-15
53,Washington,19,Iowa,165,Shelby County,0,9,-9
53,Washington,19,Iowa,167,Sioux County,40,31,9
53,Washington,19,Iowa,169,Story County,147,57,90
53,Washington,19,Iowa,179,Wapello County,4,0,4
53,Washington,19,Iowa,183,Washington County,0,6,-6
53,Washington,19,Iowa,187,Webster County,0,2,-2
53,Washington,19,Iowa,189,Winnebago County,0,4,-4
53,Washington,19,Iowa,193,Woodbury County,214,44,170
53,Washington,2,Alaska,13,Aleutians East Borough,42,68,-26
53,Washington,2,Alaska,16,Aleutians West Census Area,182,199,-17
53,Washington,2,Alaska,20,Anchorage Municipality,2227,1177,1050
53,Washington,2,Alaska,50,Bethel Census Area,2,26,-24
53,Washington,2,Alaska,60,Bristol Bay Borough,16,2,14
53,Washington,2,Alaska,68,Denali Borough,0,14,-14
53,Washington,2,Alaska,70,Dillingham Census Area,27,0,27
53,Washington,2,Alaska,90,Fairbanks North Star Borough,770,624,146
53,Washington,2,Alaska,100,Haines Borough,0,2,-2
53,Washington,2,Alaska,105,Hoonah-Angoon Census Area,9,9,0
53,Washington,2,Alaska,110,Juneau City and Borough,438,293,145
53,Washington,2,Alaska,122,Kenai Peninsula Borough,521,151,370
53,Washington,2,Alaska,130,Ketchikan Gateway Borough,225,127,98
53,Washington,2,Alaska,150,Kodiak Island Borough,226,36,190
53,Washington,2,Alaska,158,Kusilvak Census Area,0,52,-52
53,Washington,2,Alaska,170,Matanuska-Susitna Borough,319,351,-32
53,Washington,2,Alaska,180,Nome Census Area,23,59,-36
53,Washington,2,Alaska,185,North Slope Borough,0,64,-64
53,Washington,2,Alaska,188,Northwest Arctic Borough,0,18,-18
53,Washington,2,Alaska,195,Petersburg Borough,51,17,34
53,Washington,2,Alaska,198,Prince of Wales-Hyder Census Area,0,62,-62
53,Washington,2,Alaska,220,Sitka City and Borough,22,11,11
53,Washington,2,Alaska,230,Skagway Municipality,0,4,-4
53,Washington,2,Alaska,240,Southeast Fairbanks Census Area,40,14,26
53,Washington,2,Alaska,261,Valdez-Cordova Census Area,118,253,-135
53,Washington,2,Alaska,275,Wrangell City and Borough,6,9,-3
53,Washington,2,Alaska,290,Yukon-Koyukuk Census Area,0,27,-27
53,Washington,20,Kansas,5,Atchison County,3,0,3
53,Washington,20,Kansas,9,Barton County,4,0,4
53,Washington,20,Kansas,13,Brown County,46,0,46
53,Washington,20,Kansas,15,Butler County,82,21,61
53,Washington,20,Kansas,27,Clay County,0,2,-2
53,Washington,20,Kansas,37,Crawford County,14,0,14
53,Washington,20,Kansas,45,Douglas County,197,18,179
53,Washington,20,Kansas,51,Ellis County,6,0,6
53,Washington,20,Kansas,55,Finney County,0,4,-4
53,Washington,20,Kansas,59,Franklin County,24,0,24
53,Washington,20,Kansas,61,Geary County,190,168,22
53,Washington,20,Kansas,77,Harper County,0,30,-30
53,Washington,20,Kansas,79,Harvey County,0,13,-13
53,Washington,20,Kansas,81,Haskell County,0,4,-4
53,Washington,20,Kansas,85,Jackson County,12,0,12
53,Washington,20,Kansas,87,Jefferson County,74,0,74
53,Washington,20,Kansas,91,Johnson County,395,402,-7
53,Washington,20,Kansas,93,Kearny County,9,0,9
53,Washington,20,Kansas,103,Leavenworth County,427,269,158
53,Washington,20,Kansas,107,Linn County,10,0,10
53,Washington,20,Kansas,111,Lyon County,10,0,10
53,Washington,20,Kansas,115,Marion County,14,9,5
53,Washington,20,Kansas,119,Meade County,0,1,-1
53,Washington,20,Kansas,125,Montgomery County,0,91,-91
53,Washington,20,Kansas,127,Morris County,0,4,-4
53,Washington,20,Kansas,139,Osage County,0,30,-30
53,Washington,20,Kansas,147,Phillips County,5,0,5
53,Washington,20,Kansas,153,Rawlins County,0,2,-2
53,Washington,20,Kansas,155,Reno County,3,20,-17
53,Washington,20,Kansas,161,Riley County,232,97,135
53,Washington,20,Kansas,163,Rooks County,0,5,-5
53,Washington,20,Kansas,167,Russell County,0,23,-23
53,Washington,20,Kansas,169,Saline County,6,7,-1
53,Washington,20,Kansas,173,Sedgwick County,306,142,164
53,Washington,20,Kansas,177,Shawnee County,35,43,-8
53,Washington,20,Kansas,185,Stafford County,0,9,-9
53,Washington,20,Kansas,189,Stevens County,57,0,57
53,Washington,20,Kansas,191,Sumner County,31,0,31
53,Washington,20,Kansas,197,Wabaunsee County,0,14,-14
53,Washington,20,Kansas,209,Wyandotte County,19,16,3
53,Washington,21,Kentucky,1,Adair County,0,40,-40
53,Washington,21,Kentucky,5,Anderson County,13,0,13
53,Washington,21,Kentucky,15,Boone County,17,14,3
53,Washington,21,Kentucky,17,Bourbon County,0,72,-72
53,Washington,21,Kentucky,19,Boyd County,51,0,51
53,Washington,21,Kentucky,21,Boyle County,22,0,22
53,Washington,21,Kentucky,29,Bullitt County,0,41,-41
53,Washington,21,Kentucky,47,Christian County,107,113,-6
53,Washington,21,Kentucky,49,Clark County,0,47,-47
53,Washington,21,Kentucky,59,Daviess County,23,142,-119
53,Washington,21,Kentucky,67,Fayette County,113,63,50
53,Washington,21,Kentucky,73,Franklin County,0,23,-23
53,Washington,21,Kentucky,93,Hardin County,152,243,-91
53,Washington,21,Kentucky,97,Harrison County,0,11,-11
53,Washington,21,Kentucky,101,Henderson County,0,17,-17
53,Washington,21,Kentucky,107,Hopkins County,0,4,-4
53,Washington,21,Kentucky,111,Jefferson County,454,98,356
53,Washington,21,Kentucky,117,Kenton County,9,31,-22
53,Washington,21,Kentucky,119,Knott County,11,0,11
53,Washington,21,Kentucky,121,Knox County,0,67,-67
53,Washington,21,Kentucky,143,Lyon County,0,6,-6
53,Washington,21,Kentucky,145,McCracken County,2,0,2
53,Washington,21,Kentucky,147,McCreary County,14,0,14
53,Washington,21,Kentucky,151,Madison County,42,13,29
53,Washington,21,Kentucky,157,Marshall County,0,41,-41
53,Washington,21,Kentucky,163,Meade County,234,0,234
53,Washington,21,Kentucky,181,Nicholas County,0,78,-78
53,Washington,21,Kentucky,185,Oldham County,59,24,35
53,Washington,21,Kentucky,199,Pulaski County,18,0,18
53,Washington,21,Kentucky,209,Scott County,0,52,-52
53,Washington,21,Kentucky,221,Trigg County,0,58,-58
53,Washington,21,Kentucky,227,Warren County,53,119,-66
53,Washington,21,Kentucky,239,Woodford County,0,10,-10
53,Washington,22,Louisiana,1,Acadia Parish,0,55,-55
53,Washington,22,Louisiana,5,Ascension Parish,45,165,-120
53,Washington,22,Louisiana,11,Beauregard Parish,14,48,-34
53,Washington,22,Louisiana,15,Bossier Parish,85,96,-11
53,Washington,22,Louisiana,17,Caddo Parish,36,148,-112
53,Washington,22,Louisiana,19,Calcasieu Parish,22,10,12
53,Washington,22,Louisiana,25,Catahoula Parish,0,97,-97
53,Washington,22,Louisiana,27,Claiborne Parish,0,8,-8
53,Washington,22,Louisiana,33,East Baton Rouge Parish,82,270,-188
53,Washington,22,Louisiana,43,Grant Parish,0,11,-11
53,Washington,22,Louisiana,45,Iberia Parish,18,0,18
53,Washington,22,Louisiana,51,Jefferson Parish,100,0,100
53,Washington,22,Louisiana,55,Lafayette Parish,5,45,-40
53,Washington,22,Louisiana,57,Lafourche Parish,8,0,8
53,Washington,22,Louisiana,61,Lincoln Parish,0,6,-6
53,Washington,22,Louisiana,63,Livingston Parish,48,0,48
53,Washington,22,Louisiana,65,Madison Parish,0,8,-8
53,Washington,22,Louisiana,71,Orleans Parish,93,171,-78
53,Washington,22,Louisiana,73,Ouachita Parish,9,0,9
53,Washington,22,Louisiana,75,Plaquemines Parish,25,45,-20
53,Washington,22,Louisiana,79,Rapides Parish,26,28,-2
53,Washington,22,Louisiana,85,Sabine Parish,0,9,-9
53,Washington,22,Louisiana,95,St. John the Baptist Parish,124,0,124
53,Washington,22,Louisiana,103,St. Tammany Parish,42,38,4
53,Washington,22,Louisiana,109,Terrebonne Parish,60,0,60
53,Washington,22,Louisiana,115,Vernon Parish,223,293,-70
53,Washington,22,Louisiana,117,Washington Parish,0,15,-15
53,Washington,22,Louisiana,123,West Carroll Parish,0,2,-2
53,Washington,22,Louisiana,125,West Feliciana Parish,4,0,4
53,Washington,23,Maine,1,Androscoggin County,139,22,117
53,Washington,23,Maine,3,Aroostook County,0,22,-22
53,Washington,23,Maine,5,Cumberland County,169,186,-17
53,Washington,23,Maine,7,Franklin County,0,4,-4
53,Washington,23,Maine,9,Hancock County,29,1,28
53,Washington,23,Maine,11,Kennebec County,10,63,-53
53,Washington,23,Maine,15,Lincoln County,3,0,3
53,Washington,23,Maine,19,Penobscot County,20,65,-45
53,Washington,23,Maine,21,Piscataquis County,0,15,-15
53,Washington,23,Maine,23,Sagadahoc County,0,66,-66
53,Washington,23,Maine,27,Waldo County,12,24,-12
53,Washington,23,Maine,29,Washington County,0,10,-10
53,Washington,23,Maine,31,York County,189,195,-6
53,Washington,24,Maryland,1,Allegany County,16,0,16
53,Washington,24,Maryland,3,Anne Arundel County,601,226,375
53,Washington,24,Maryland,5,Baltimore County,245,103,142
53,Washington,24,Maryland,9,Calvert County,23,0,23
53,Washington,24,Maryland,15,Cecil County,74,0,74
53,Washington,24,Maryland,17,Charles County,11,0,11
53,Washington,24,Maryland,21,Frederick County,149,131,18
53,Washington,24,Maryland,23,Garrett County,37,0,37
53,Washington,24,Maryland,25,Harford County,73,194,-121
53,Washington,24,Maryland,27,Howard County,140,113,27
53,Washington,24,Maryland,31,Montgomery County,558,702,-144
53,Washington,24,Maryland,33,Prince George's County,366,61,305
53,Washington,24,Maryland,35,Queen Anne's County,0,19,-19
53,Washington,24,Maryland,37,St. Mary's County,102,150,-48
53,Washington,24,Maryland,41,Talbot County,23,37,-14
53,Washington,24,Maryland,43,Washington County,25,0,25
53,Washington,24,Maryland,47,Worcester County,0,10,-10
53,Washington,24,Maryland,510,Baltimore city,383,190,193
53,Washington,25,Massachusetts,1,Barnstable County,207,23,184
53,Washington,25,Massachusetts,3,Berkshire County,181,44,137
53,Washington,25,Massachusetts,5,Bristol County,21,16,5
53,Washington,25,Massachusetts,9,Essex County,270,103,167
53,Washington,25,Massachusetts,11,Franklin County,27,0,27
53,Washington,25,Massachusetts,13,Hampden County,121,27,94
53,Washington,25,Massachusetts,15,Hampshire County,15,90,-75
53,Washington,25,Massachusetts,17,Middlesex County,1337,398,939
53,Washington,25,Massachusetts,19,Nantucket County,70,0,70
53,Washington,25,Massachusetts,21,Norfolk County,146,156,-10
53,Washington,25,Massachusetts,23,Plymouth County,35,71,-36
53,Washington,25,Massachusetts,25,Suffolk County,370,395,-25
53,Washington,25,Massachusetts,27,Worcester County,274,141,133
53,Washington,26,Michigan,5,Allegan County,5,0,5
53,Washington,26,Michigan,7,Alpena County,12,15,-3
53,Washington,26,Michigan,9,Antrim County,0,11,-11
53,Washington,26,Michigan,11,Arenac County,17,0,17
53,Washington,26,Michigan,17,Bay County,14,0,14
53,Washington,26,Michigan,21,Berrien County,42,14,28
53,Washington,26,Michigan,25,Calhoun County,21,16,5
53,Washington,26,Michigan,29,Charlevoix County,158,0,158
53,Washington,26,Michigan,33,Chippewa County,61,22,39
53,Washington,26,Michigan,35,Clare County,0,11,-11
53,Washington,26,Michigan,37,Clinton County,0,11,-11
53,Washington,26,Michigan,41,Delta County,19,24,-5
53,Washington,26,Michigan,43,Dickinson County,0,8,-8
53,Washington,26,Michigan,45,Eaton County,9,22,-13
53,Washington,26,Michigan,47,Emmet County,36,0,36
53,Washington,26,Michigan,49,Genesee County,100,38,62
53,Washington,26,Michigan,55,Grand Traverse County,64,54,10
53,Washington,26,Michigan,59,Hillsdale County,0,27,-27
53,Washington,26,Michigan,65,Ingham County,223,103,120
53,Washington,26,Michigan,69,Iosco County,10,6,4
53,Washington,26,Michigan,71,Iron County,0,6,-6
53,Washington,26,Michigan,73,Isabella County,55,12,43
53,Washington,26,Michigan,75,Jackson County,3,30,-27
53,Washington,26,Michigan,77,Kalamazoo County,56,162,-106
53,Washington,26,Michigan,81,Kent County,295,242,53
53,Washington,26,Michigan,85,Lake County,2,0,2
53,Washington,26,Michigan,87,Lapeer County,0,15,-15
53,Washington,26,Michigan,89,Leelanau County,120,18,102
53,Washington,26,Michigan,91,Lenawee County,4,0,4
53,Washington,26,Michigan,93,Livingston County,98,14,84
53,Washington,26,Michigan,99,Macomb County,7,93,-86
53,Washington,26,Michigan,103,Marquette County,64,40,24
53,Washington,26,Michigan,105,Mason County,60,10,50
53,Washington,26,Michigan,107,Mecosta County,23,0,23
53,Washington,26,Michigan,111,Midland County,5,0,5
53,Washington,26,Michigan,113,Missaukee County,77,0,77
53,Washington,26,Michigan,115,Monroe County,19,10,9
53,Washington,26,Michigan,117,Montcalm County,17,0,17
53,Washington,26,Michigan,121,Muskegon County,12,5,7
53,Washington,26,Michigan,123,Newaygo County,15,9,6
53,Washington,26,Michigan,125,Oakland County,493,240,253
53,Washington,26,Michigan,127,Oceana County,0,7,-7
53,Washington,26,Michigan,133,Osceola County,18,24,-6
53,Washington,26,Michigan,135,Oscoda County,0,28,-28
53,Washington,26,Michigan,139,Ottawa County,76,5,71
53,Washington,26,Michigan,145,Saginaw County,27,46,-19
53,Washington,26,Michigan,147,St. Clair County,16,0,16
53,Washington,26,Michigan,149,St. Joseph County,3,0,3
53,Washington,26,Michigan,151,Sanilac County,0,9,-9
53,Washington,26,Michigan,155,Shiawassee County,0,17,-17
53,Washington,26,Michigan,157,Tuscola County,69,11,58
53,Washington,26,Michigan,159,Van Buren County,0,4,-4
53,Washington,26,Michigan,161,Washtenaw County,579,147,432
53,Washington,26,Michigan,163,Wayne County,353,333,20
53,Washington,27,Minnesota,1,Aitkin County,0,2,-2
53,Washington,27,Minnesota,3,Anoka County,101,263,-162
53,Washington,27,Minnesota,5,Becker County,0,51,-51
53,Washington,27,Minnesota,7,Beltrami County,9,48,-39
53,Washington,27,Minnesota,9,Benton County,16,37,-21
53,Washington,27,Minnesota,13,Blue Earth County,81,16,65
53,Washington,27,Minnesota,17,Carlton County,0,43,-43
53,Washington,27,Minnesota,19,Carver County,125,3,122
53,Washington,27,Minnesota,21,Cass County,0,6,-6
53,Washington,27,Minnesota,23,Chippewa County,0,2,-2
53,Washington,27,Minnesota,25,Chisago County,0,22,-22
53,Washington,27,Minnesota,27,Clay County,73,2,71
53,Washington,27,Minnesota,33,Cottonwood County,0,2,-2
53,Washington,27,Minnesota,35,Crow Wing County,57,21,36
53,Washington,27,Minnesota,37,Dakota County,390,172,218
53,Washington,27,Minnesota,41,Douglas County,0,23,-23
53,Washington,27,Minnesota,43,Faribault County,0,17,-17
53,Washington,27,Minnesota,47,Freeborn County,11,6,5
53,Washington,27,Minnesota,49,Goodhue County,23,0,23
53,Washington,27,Minnesota,53,Hennepin County,942,762,180
53,Washington,27,Minnesota,59,Isanti County,0,12,-12
53,Washington,27,Minnesota,61,Itasca County,0,79,-79
53,Washington,27,Minnesota,63,Jackson County,0,7,-7
53,Washington,27,Minnesota,67,Kandiyohi County,35,0,35
53,Washington,27,Minnesota,71,Koochiching County,0,5,-5
53,Washington,27,Minnesota,79,Le Sueur County,0,14,-14
53,Washington,27,Minnesota,85,McLeod County,30,10,20
53,Washington,27,Minnesota,91,Martin County,22,0,22
53,Washington,27,Minnesota,97,Morrison County,14,2,12
53,Washington,27,Minnesota,99,Mower County,0,4,-4
53,Washington,27,Minnesota,103,Nicollet County,0,17,-17
53,Washington,27,Minnesota,109,Olmsted County,9,57,-48
53,Washington,27,Minnesota,111,Otter Tail County,90,6,84
53,Washington,27,Minnesota,115,Pine County,0,11,-11
53,Washington,27,Minnesota,119,Polk County,0,15,-15
53,Washington,27,Minnesota,121,Pope County,0,6,-6
53,Washington,27,Minnesota,123,Ramsey County,580,181,399
53,Washington,27,Minnesota,127,Redwood County,0,5,-5
53,Washington,27,Minnesota,131,Rice County,36,131,-95
53,Washington,27,Minnesota,135,Roseau County,113,5,108
53,Washington,27,Minnesota,137,St. Louis County,133,65,68
53,Washington,27,Minnesota,139,Scott County,158,17,141
53,Washington,27,Minnesota,141,Sherburne County,0,269,-269
53,Washington,27,Minnesota,145,Stearns County,50,17,33
53,Washington,27,Minnesota,147,Steele County,0,8,-8
53,Washington,27,Minnesota,153,Todd County,0,42,-42
53,Washington,27,Minnesota,159,Wadena County,0,15,-15
53,Washington,27,Minnesota,163,Washington County,200,61,139
53,Washington,27,Minnesota,167,Wilkin County,0,2,-2
53,Washington,27,Minnesota,169,Winona County,0,11,-11
53,Washington,27,Minnesota,171,Wright County,48,24,24
53,Washington,28,Mississippi,33,DeSoto County,35,58,-23
53,Washington,28,Mississippi,45,Hancock County,0,11,-11
53,Washington,28,Mississippi,47,Harrison County,161,437,-276
53,Washington,28,Mississippi,49,Hinds County,40,16,24
53,Washington,28,Mississippi,59,Jackson County,33,21,12
53,Washington,28,Mississippi,71,Lafayette County,58,3,55
53,Washington,28,Mississippi,73,Lamar County,0,8,-8
53,Washington,28,Mississippi,75,Lauderdale County,34,196,-162
53,Washington,28,Mississippi,81,Lee County,9,26,-17
53,Washington,28,Mississippi,87,Lowndes County,0,18,-18
53,Washington,28,Mississippi,121,Rankin County,76,168,-92
53,Washington,28,Mississippi,125,Sharkey County,82,0,82
53,Washington,28,Mississippi,127,Simpson County,4,46,-42
53,Washington,28,Mississippi,137,Tate County,5,0,5
53,Washington,28,Mississippi,141,Tishomingo County,0,31,-31
53,Washington,28,Mississippi,149,Warren County,18,0,18
53,Washington,28,Mississippi,155,Webster County,0,37,-37
53,Washington,29,Missouri,1,Adair County,15,60,-45
53,Washington,29,Missouri,7,Audrain County,12,0,12
53,Washington,29,Missouri,13,Bates County,0,10,-10
53,Washington,29,Missouri,15,Benton County,0,2,-2
53,Washington,29,Missouri,19,Boone County,265,39,226
53,Washington,29,Missouri,21,Buchanan County,0,2,-2
53,Washington,29,Missouri,23,Butler County,15,0,15
53,Washington,29,Missouri,27,Callaway County,11,11,0
53,Washington,29,Missouri,31,Cape Girardeau County,41,50,-9
53,Washington,29,Missouri,43,Christian County,121,15,106
53,Washington,29,Missouri,45,Clark County,0,1,-1
53,Washington,29,Missouri,47,Clay County,64,70,-6
53,Washington,29,Missouri,51,Cole County,62,0,62
53,Washington,29,Missouri,53,Cooper County,0,14,-14
53,Washington,29,Missouri,59,Dallas County,72,0,72
53,Washington,29,Missouri,69,Dunklin County,0,3,-3
53,Washington,29,Missouri,71,Franklin County,108,32,76
53,Washington,29,Missouri,77,Greene County,99,318,-219
53,Washington,29,Missouri,79,Grundy County,9,0,9
53,Washington,29,Missouri,89,Howard County,3,1,2
53,Washington,29,Missouri,95,Jackson County,172,332,-160
53,Washington,29,Missouri,97,Jasper County,27,24,3
53,Washington,29,Missouri,99,Jefferson County,0,45,-45
53,Washington,29,Missouri,101,Johnson County,45,35,10
53,Washington,29,Missouri,105,Laclede County,5,17,-12
53,Washington,29,Missouri,109,Lawrence County,24,0,24
53,Washington,29,Missouri,119,McDonald County,15,4,11
53,Washington,29,Missouri,123,Madison County,7,0,7
53,Washington,29,Missouri,131,Miller County,39,0,39
53,Washington,29,Missouri,141,Morgan County,0,17,-17
53,Washington,29,Missouri,145,Newton County,28,0,28
53,Washington,29,Missouri,147,Nodaway County,16,0,16
53,Washington,29,Missouri,161,Phelps County,11,138,-127
53,Washington,29,Missouri,163,Pike County,0,2,-2
53,Washington,29,Missouri,165,Platte County,64,21,43
53,Washington,29,Missouri,169,Pulaski County,530,338,192
53,Washington,29,Missouri,171,Putnam County,19,0,19
53,Washington,29,Missouri,181,Ripley County,0,101,-101
53,Washington,29,Missouri,183,St. Charles County,119,97,22
53,Washington,29,Missouri,185,St. Clair County,0,11,-11
53,Washington,29,Missouri,187,St. Francois County,14,0,14
53,Washington,29,Missouri,189,St. Louis County,469,360,109
53,Washington,29,Missouri,201,Scott County,136,34,102
53,Washington,29,Missouri,203,Shannon County,0,8,-8
53,Washington,29,Missouri,213,Taney County,31,209,-178
53,Washington,29,Missouri,215,Texas County,17,0,17
53,Washington,29,Missouri,217,Vernon County,0,20,-20
53,Washington,29,Missouri,219,Warren County,107,0,107
53,Washington,29,Missouri,225,Webster County,19,2,17
53,Washington,29,Missouri,229,Wright County,0,6,-6
53,Washington,29,Missouri,510,St. Louis city,180,120,60
53,Washington,30,Montana,1,Beaverhead County,0,47,-47
53,Washington,30,Montana,3,Big Horn County,14,1,13
53,Washington,30,Montana,5,Blaine County,0,59,-59
53,Washington,30,Montana,9,Carbon County,0,28,-28
53,Washington,30,Montana,13,Cascade County,411,248,163
53,Washington,30,Montana,15,Chouteau County,0,35,-35
53,Washington,30,Montana,17,Custer County,39,14,25
53,Washington,30,Montana,21,Dawson County,43,28,15
53,Washington,30,Montana,23,Deer Lodge County,76,33,43
53,Washington,30,Montana,27,Fergus County,228,13,215
53,Washington,30,Montana,29,Flathead County,365,366,-1
53,Washington,30,Montana,31,Gallatin County,690,839,-149
53,Washington,30,Montana,35,Glacier County,23,11,12
53,Washington,30,Montana,39,Granite County,0,24,-24
53,Washington,30,Montana,41,Hill County,15,74,-59
53,Washington,30,Montana,43,Jefferson County,11,20,-9
53,Washington,30,Montana,45,Judith Basin County,0,9,-9
53,Washington,30,Montana,47,Lake County,44,175,-131
53,Washington,30,Montana,49,Lewis and Clark County,110,342,-232
53,Washington,30,Montana,53,Lincoln County,75,351,-276
53,Washington,30,Montana,57,Madison County,0,117,-117
53,Washington,30,Montana,61,Mineral County,10,180,-170
53,Washington,30,Montana,63,Missoula County,613,998,-385
53,Washington,30,Montana,65,Musselshell County,0,7,-7
53,Washington,30,Montana,67,Park County,64,112,-48
53,Washington,30,Montana,73,Pondera County,0,31,-31
53,Washington,30,Montana,75,Powder River County,11,2,9
53,Washington,30,Montana,77,Powell County,2,4,-2
53,Washington,30,Montana,81,Ravalli County,249,221,28
53,Washington,30,Montana,83,Richland County,8,16,-8
53,Washington,30,Montana,85,Roosevelt County,8,8,0
53,Washington,30,Montana,87,Rosebud County,0,4,-4
53,Washington,30,Montana,89,Sanders County,39,63,-24
53,Washington,30,Montana,91,Sheridan County,76,1,75
53,Washington,30,Montana,93,Silver Bow County,96,92,4
53,Washington,30,Montana,95,Stillwater County,179,48,131
53,Washington,30,Montana,97,Sweet Grass County,0,3,-3
53,Washington,30,Montana,99,Teton County,21,0,21
53,Washington,30,Montana,101,Toole County,8,16,-8
53,Washington,30,Montana,105,Valley County,83,2,81
53,Washington,30,Montana,107,Wheatland County,0,4,-4
53,Washington,30,Montana,109,Wibaux County,0,4,-4
53,Washington,30,Montana,111,Yellowstone County,684,249,435
53,Washington,31,Nebraska,15,Boyd County,0,1,-1
53,Washington,31,Nebraska,19,Buffalo County,0,20,-20
53,Washington,31,Nebraska,21,Burt County,0,3,-3
53,Washington,31,Nebraska,23,Butler County,0,5,-5
53,Washington,31,Nebraska,25,Cass County,37,0,37
53,Washington,31,Nebraska,33,Cheyenne County,35,0,35
53,Washington,31,Nebraska,35,Clay County,0,6,-6
53,Washington,31,Nebraska,39,Cuming County,0,5,-5
53,Washington,31,Nebraska,41,Custer County,30,0,30
53,Washington,31,Nebraska,45,Dawes County,10,36,-26
53,Washington,31,Nebraska,55,Douglas County,395,130,265
53,Washington,31,Nebraska,63,Frontier County,7,1,6
53,Washington,31,Nebraska,67,Gage County,2,0,2
53,Washington,31,Nebraska,79,Hall County,0,11,-11
53,Washington,31,Nebraska,101,Keith County,0,2,-2
53,Washington,31,Nebraska,107,Knox County,8,0,8
53,Washington,31,Nebraska,109,Lancaster County,56,120,-64
53,Washington,31,Nebraska,111,Lincoln County,0,9,-9
53,Washington,31,Nebraska,127,Nemaha County,0,5,-5
53,Washington,31,Nebraska,143,Polk County,0,7,-7
53,Washington,31,Nebraska,153,Sarpy County,234,69,165
53,Washington,31,Nebraska,157,Scotts Bluff County,0,26,-26
53,Washington,31,Nebraska,159,Seward County,0,7,-7
53,Washington,31,Nebraska,161,Sheridan County,0,7,-7
53,Washington,31,Nebraska,167,Stanton County,16,0,16
53,Washington,31,Nebraska,185,York County,18,12,6
53,Washington,32,Nevada,1,Churchill County,70,420,-350
53,Washington,32,Nevada,3,Clark County,2557,3299,-742
53,Washington,32,Nevada,5,Douglas County,48,75,-27
53,Washington,32,Nevada,7,Elko County,115,74,41
53,Washington,32,Nevada,13,Humboldt County,80,18,62
53,Washington,32,Nevada,19,Lyon County,29,0,29
53,Washington,32,Nevada,21,Mineral County,0,7,-7
53,Washington,32,Nevada,23,Nye County,0,286,-286
53,Washington,32,Nevada,27,Pershing County,14,0,14
53,Washington,32,Nevada,29,Storey County,8,20,-12
53,Washington,32,Nevada,31,Washoe County,1274,1019,255
53,Washington,32,Nevada,510,Carson City,93,326,-233
53,Washington,33,New Hampshire,1,Belknap County,74,0,74
53,Washington,33,New Hampshire,3,Carroll County,14,0,14
53,Washington,33,New Hampshire,5,Cheshire County,14,13,1
53,Washington,33,New Hampshire,7,Coos County,0,3,-3
53,Washington,33,New Hampshire,9,Grafton County,30,47,-17
53,Washington,33,New Hampshire,11,Hillsborough County,59,82,-23
53,Washington,33,New Hampshire,13,Merrimack County,0,14,-14
53,Washington,33,New Hampshire,15,Rockingham County,224,39,185
53,Washington,33,New Hampshire,17,Strafford County,24,0,24
53,Washington,34,New Jersey,1,Atlantic County,67,17,50
53,Washington,34,New Jersey,3,Bergen County,345,124,221
53,Washington,34,New Jersey,5,Burlington County,202,159,43
53,Washington,34,New Jersey,7,Camden County,152,0,152
53,Washington,34,New Jersey,9,Cape May County,53,57,-4
53,Washington,34,New Jersey,11,Cumberland County,33,0,33
53,Washington,34,New Jersey,13,Essex County,245,65,180
53,Washington,34,New Jersey,17,Hudson County,536,133,403
53,Washington,34,New Jersey,21,Mercer County,165,73,92
53,Washington,34,New Jersey,23,Middlesex County,273,124,149
53,Washington,34,New Jersey,25,Monmouth County,61,83,-22
53,Washington,34,New Jersey,27,Morris County,121,51,70
53,Washington,34,New Jersey,29,Ocean County,112,30,82
53,Washington,34,New Jersey,31,Passaic County,80,32,48
53,Washington,34,New Jersey,35,Somerset County,82,0,82
53,Washington,34,New Jersey,37,Sussex County,92,0,92
53,Washington,34,New Jersey,39,Union County,69,0,69
53,Washington,35,New Mexico,1,Bernalillo County,914,421,493
53,Washington,35,New Mexico,5,Chaves County,10,83,-73
53,Washington,35,New Mexico,6,Cibola County,21,21,0
53,Washington,35,New Mexico,7,Colfax County,11,3,8
53,Washington,35,New Mexico,9,Curry County,9,25,-16
53,Washington,35,New Mexico,13,Doña Ana County,87,137,-50
53,Washington,35,New Mexico,15,Eddy County,0,140,-140
53,Washington,35,New Mexico,17,Grant County,42,12,30
53,Washington,35,New Mexico,27,Lincoln County,26,0,26
53,Washington,35,New Mexico,28,Los Alamos County,0,41,-41
53,Washington,35,New Mexico,31,McKinley County,176,0,176
53,Washington,35,New Mexico,35,Otero County,30,42,-12
53,Washington,35,New Mexico,39,Rio Arriba County,58,17,41
53,Washington,35,New Mexico,41,Roosevelt County,18,8,10
53,Washington,35,New Mexico,43,Sandoval County,131,138,-7
53,Washington,35,New Mexico,45,San Juan County,19,39,-20
53,Washington,35,New Mexico,49,Santa Fe County,152,142,10
53,Washington,35,New Mexico,51,Sierra County,23,0,23
53,Washington,35,New Mexico,53,Socorro County,133,0,133
53,Washington,35,New Mexico,55,Taos County,32,28,4
53,Washington,35,New Mexico,61,Valencia County,15,8,7
53,Washington,36,New York,1,Albany County,55,54,1
53,Washington,36,New York,3,Allegany County,0,45,-45
53,Washington,36,New York,5,Bronx County,333,30,303
53,Washington,36,New York,7,Broome County,0,46,-46
53,Washington,36,New York,9,Cattaraugus County,0,29,-29
53,Washington,36,New York,11,Cayuga County,0,7,-7
53,Washington,36,New York,13,Chautauqua County,3,17,-14
53,Washington,36,New York,15,Chemung County,31,0,31
53,Washington,36,New York,17,Chenango County,0,24,-24
53,Washington,36,New York,19,Clinton County,24,93,-69
53,Washington,36,New York,21,Columbia County,9,23,-14
53,Washington,36,New York,23,Cortland County,0,5,-5
53,Washington,36,New York,25,Delaware County,14,0,14
53,Washington,36,New York,27,Dutchess County,48,7,41
53,Washington,36,New York,29,Erie County,230,115,115
53,Washington,36,New York,31,Essex County,31,13,18
53,Washington,36,New York,33,Franklin County,8,0,8
53,Washington,36,New York,35,Fulton County,24,0,24
53,Washington,36,New York,37,Genesee County,38,0,38
53,Washington,36,New York,43,Herkimer County,0,15,-15
53,Washington,36,New York,45,Jefferson County,480,199,281
53,Washington,36,New York,47,Kings County,1475,427,1048
53,Washington,36,New York,51,Livingston County,11,60,-49
53,Washington,36,New York,53,Madison County,30,15,15
53,Washington,36,New York,55,Monroe County,118,158,-40
53,Washington,36,New York,57,Montgomery County,28,5,23
53,Washington,36,New York,59,Nassau County,171,101,70
53,Washington,36,New York,61,New York County,602,1677,-1075
53,Washington,36,New York,63,Niagara County,110,0,110
53,Washington,36,New York,65,Oneida County,68,33,35
53,Washington,36,New York,67,Onondaga County,156,27,129
53,Washington,36,New York,69,Ontario County,111,22,89
53,Washington,36,New York,71,Orange County,218,130,88
53,Washington,36,New York,75,Oswego County,37,26,11
53,Washington,36,New York,77,Otsego County,0,1,-1
53,Washington,36,New York,79,Putnam County,16,0,16
53,Washington,36,New York,81,Queens County,300,328,-28
53,Washington,36,New York,83,Rensselaer County,51,10,41
53,Washington,36,New York,85,Richmond County,40,5,35
53,Washington,36,New York,87,Rockland County,26,0,26
53,Washington,36,New York,89,St. Lawrence County,30,27,3
53,Washington,36,New York,91,Saratoga County,430,85,345
53,Washington,36,New York,93,Schenectady County,71,15,56
53,Washington,36,New York,95,Schoharie County,0,8,-8
53,Washington,36,New York,101,Steuben County,0,18,-18
53,Washington,36,New York,103,Suffolk County,113,60,53
53,Washington,36,New York,105,Sullivan County,19,0,19
53,Washington,36,New York,109,Tompkins County,115,153,-38
53,Washington,36,New York,115,Washington County,0,16,-16
53,Washington,36,New York,117,Wayne County,16,0,16
53,Washington,36,New York,119,Westchester County,119,147,-28
53,Washington,37,North Carolina,1,Alamance County,46,0,46
53,Washington,37,North Carolina,3,Alexander County,0,89,-89
53,Washington,37,North Carolina,9,Ashe County,0,2,-2
53,Washington,37,North Carolina,19,Brunswick County,55,12,43
53,Washington,37,North Carolina,21,Buncombe County,173,86,87
53,Washington,37,North Carolina,23,Burke County,0,22,-22
53,Washington,37,North Carolina,25,Cabarrus County,165,0,165
53,Washington,37,North Carolina,31,Carteret County,82,27,55
53,Washington,37,North Carolina,37,Chatham County,0,112,-112
53,Washington,37,North Carolina,39,Cherokee County,29,0,29
53,Washington,37,North Carolina,41,Chowan County,0,11,-11
53,Washington,37,North Carolina,49,Craven County,93,151,-58
53,Washington,37,North Carolina,51,Cumberland County,1511,882,629
53,Washington,37,North Carolina,53,Currituck County,3,0,3
53,Washington,37,North Carolina,55,Dare County,18,0,18
53,Washington,37,North Carolina,57,Davidson County,0,12,-12
53,Washington,37,North Carolina,63,Durham County,453,76,377
53,Washington,37,North Carolina,65,Edgecombe County,0,11,-11
53,Washington,37,North Carolina,67,Forsyth County,28,145,-117
53,Washington,37,North Carolina,71,Gaston County,135,5,130
53,Washington,37,North Carolina,77,Granville County,83,0,83
53,Washington,37,North Carolina,81,Guilford County,49,56,-7
53,Washington,37,North Carolina,85,Harnett County,78,260,-182
53,Washington,37,North Carolina,89,Henderson County,22,0,22
53,Washington,37,North Carolina,91,Hertford County,0,8,-8
53,Washington,37,North Carolina,93,Hoke County,190,0,190
53,Washington,37,North Carolina,97,Iredell County,105,14,91
53,Washington,37,North Carolina,101,Johnston County,82,0,82
53,Washington,37,North Carolina,105,Lee County,0,18,-18
53,Washington,37,North Carolina,109,Lincoln County,57,22,35
53,Washington,37,North Carolina,111,McDowell County,60,0,60
53,Washington,37,North Carolina,119,Mecklenburg County,279,552,-273
53,Washington,37,North Carolina,125,Moore County,29,52,-23
53,Washington,37,North Carolina,127,Nash County,18,0,18
53,Washington,37,North Carolina,129,New Hanover County,65,10,55
53,Washington,37,North Carolina,133,Onslow County,246,189,57
53,Washington,37,North Carolina,135,Orange County,172,115,57
53,Washington,37,North Carolina,139,Pasquotank County,15,15,0
53,Washington,37,North Carolina,141,Pender County,15,57,-42
53,Washington,37,North Carolina,147,Pitt County,3,31,-28
53,Washington,37,North Carolina,151,Randolph County,17,31,-14
53,Washington,37,North Carolina,155,Robeson County,0,50,-50
53,Washington,37,North Carolina,157,Rockingham County,0,4,-4
53,Washington,37,North Carolina,159,Rowan County,30,13,17
53,Washington,37,North Carolina,163,Sampson County,8,27,-19
53,Washington,37,North Carolina,165,Scotland County,76,0,76
53,Washington,37,North Carolina,167,Stanly County,168,0,168
53,Washington,37,North Carolina,173,Swain County,9,0,9
53,Washington,37,North Carolina,175,Transylvania County,0,13,-13
53,Washington,37,North Carolina,179,Union County,63,19,44
53,Washington,37,North Carolina,181,Vance County,0,15,-15
53,Washington,37,North Carolina,183,Wake County,485,282,203
53,Washington,37,North Carolina,189,Watauga County,26,37,-11
53,Washington,37,North Carolina,191,Wayne County,31,69,-38
53,Washington,37,North Carolina,195,Wilson County,0,44,-44
53,Washington,38,North Dakota,3,Barnes County,14,0,14
53,Washington,38,North Dakota,9,Bottineau County,29,6,23
53,Washington,38,North Dakota,13,Burke County,0,16,-16
53,Washington,38,North Dakota,15,Burleigh County,182,167,15
53,Washington,38,North Dakota,17,Cass County,251,145,106
53,Washington,38,North Dakota,19,Cavalier County,0,1,-1
53,Washington,38,North Dakota,21,Dickey County,45,0,45
53,Washington,38,North Dakota,25,Dunn County,76,2,74
53,Washington,38,North Dakota,27,Eddy County,0,5,-5
53,Washington,38,North Dakota,35,Grand Forks County,39,141,-102
53,Washington,38,North Dakota,43,Kidder County,0,7,-7
53,Washington,38,North Dakota,49,McHenry County,0,11,-11
53,Washington,38,North Dakota,53,McKenzie County,38,32,6
53,Washington,38,North Dakota,55,McLean County,0,4,-4
53,Washington,38,North Dakota,59,Morton County,37,2,35
53,Washington,38,North Dakota,61,Mountrail County,57,14,43
53,Washington,38,North Dakota,69,Pierce County,0,4,-4
53,Washington,38,North Dakota,75,Renville County,0,1,-1
53,Washington,38,North Dakota,77,Richland County,8,0,8
53,Washington,38,North Dakota,79,Rolette County,9,0,9
53,Washington,38,North Dakota,85,Sioux County,0,4,-4
53,Washington,38,North Dakota,89,Stark County,95,334,-239
53,Washington,38,North Dakota,93,Stutsman County,0,22,-22
53,Washington,38,North Dakota,97,Traill County,0,11,-11
53,Washington,38,North Dakota,99,Walsh County,0,1,-1
53,Washington,38,North Dakota,101,Ward County,234,98,136
53,Washington,38,North Dakota,105,Williams County,242,73,169
53,Washington,39,Ohio,3,Allen County,37,7,30
53,Washington,39,Ohio,5,Ashland County,31,21,10
53,Washington,39,Ohio,9,Athens County,24,12,12
53,Washington,39,Ohio,11,Auglaize County,0,66,-66
53,Washington,39,Ohio,13,Belmont County,0,12,-12
53,Washington,39,Ohio,17,Butler County,172,151,21
53,Washington,39,Ohio,23,Clark County,0,64,-64
53,Washington,39,Ohio,25,Clermont County,62,31,31
53,Washington,39,Ohio,29,Columbiana County,111,0,111
53,Washington,39,Ohio,33,Crawford County,0,19,-19
53,Washington,39,Ohio,35,Cuyahoga County,514,197,317
53,Washington,39,Ohio,41,Delaware County,37,11,26
53,Washington,39,Ohio,43,Erie County,26,3,23
53,Washington,39,Ohio,45,Fairfield County,0,79,-79
53,Washington,39,Ohio,47,Fayette County,0,21,-21
53,Washington,39,Ohio,49,Franklin County,575,810,-235
53,Washington,39,Ohio,55,Geauga County,0,82,-82
53,Washington,39,Ohio,57,Greene County,75,202,-127
53,Washington,39,Ohio,59,Guernsey County,0,15,-15
53,Washington,39,Ohio,61,Hamilton County,432,171,261
53,Washington,39,Ohio,69,Henry County,0,30,-30
53,Washington,39,Ohio,75,Holmes County,0,49,-49
53,Washington,39,Ohio,81,Jefferson County,0,72,-72
53,Washington,39,Ohio,83,Knox County,27,11,16
53,Washington,39,Ohio,85,Lake County,32,19,13
53,Washington,39,Ohio,89,Licking County,30,89,-59
53,Washington,39,Ohio,91,Logan County,21,0,21
53,Washington,39,Ohio,93,Lorain County,8,125,-117
53,Washington,39,Ohio,95,Lucas County,132,126,6
53,Washington,39,Ohio,99,Mahoning County,49,131,-82
53,Washington,39,Ohio,107,Mercer County,0,9,-9
53,Washington,39,Ohio,109,Miami County,13,26,-13
53,Washington,39,Ohio,113,Montgomery County,180,205,-25
53,Washington,39,Ohio,133,Portage County,34,35,-1
53,Washington,39,Ohio,135,Preble County,15,0,15
53,Washington,39,Ohio,139,Richland County,19,5,14
53,Washington,39,Ohio,145,Scioto County,8,21,-13
53,Washington,39,Ohio,149,Shelby County,0,51,-51
53,Washington,39,Ohio,151,Stark County,19,11,8
53,Washington,39,Ohio,153,Summit County,255,79,176
53,Washington,39,Ohio,155,Trumbull County,18,0,18
53,Washington,39,Ohio,165,Warren County,91,136,-45
53,Washington,39,Ohio,167,Washington County,0,43,-43
53,Washington,39,Ohio,169,Wayne County,54,0,54
53,Washington,4,Arizona,1,Apache County,0,27,-27
53,Washington,4,Arizona,3,Cochise County,300,309,-9
53,Washington,4,Arizona,5,Coconino County,512,355,157
53,Washington,4,Arizona,7,Gila County,42,11,31
53,Washington,4,Arizona,9,Graham County,0,24,-24
53,Washington,4,Arizona,11,Greenlee County,12,7,5
53,Washington,4,Arizona,13,Maricopa County,6698,7780,-1082
53,Washington,4,Arizona,15,Mohave County,308,553,-245
53,Washington,4,Arizona,17,Navajo County,95,104,-9
53,Washington,4,Arizona,19,Pima County,1828,2271,-443
53,Washington,4,Arizona,21,Pinal County,604,1254,-650
53,Washington,4,Arizona,23,Santa Cruz County,35,23,12
53,Washington,4,Arizona,25,Yavapai County,338,519,-181
53,Washington,4,Arizona,27,Yuma County,240,625,-385
53,Washington,40,Oklahoma,5,Atoka County,0,2,-2
53,Washington,40,Oklahoma,7,Beaver County,10,0,10
53,Washington,40,Oklahoma,11,Blaine County,0,21,-21
53,Washington,40,Oklahoma,13,Bryan County,3,17,-14
53,Washington,40,Oklahoma,15,Caddo County,27,9,18
53,Washington,40,Oklahoma,17,Canadian County,33,80,-47
53,Washington,40,Oklahoma,23,Choctaw County,0,28,-28
53,Washington,40,Oklahoma,27,Cleveland County,215,97,118
53,Washington,40,Oklahoma,31,Comanche County,380,367,13
53,Washington,40,Oklahoma,37,Creek County,0,6,-6
53,Washington,40,Oklahoma,43,Dewey County,0,13,-13
53,Washington,40,Oklahoma,47,Garfield County,27,6,21
53,Washington,40,Oklahoma,59,Harper County,252,0,252
53,Washington,40,Oklahoma,65,Jackson County,105,0,105
53,Washington,40,Oklahoma,71,Kay County,37,30,7
53,Washington,40,Oklahoma,77,Latimer County,0,2,-2
53,Washington,40,Oklahoma,79,Le Flore County,0,16,-16
53,Washington,40,Oklahoma,81,Lincoln County,0,3,-3
53,Washington,40,Oklahoma,83,Logan County,0,19,-19
53,Washington,40,Oklahoma,89,McCurtain County,0,11,-11
53,Washington,40,Oklahoma,97,Mayes County,0,4,-4
53,Washington,40,Oklahoma,101,Muskogee County,149,45,104
53,Washington,40,Oklahoma,103,Noble County,164,0,164
53,Washington,40,Oklahoma,107,Okfuskee County,0,8,-8
53,Washington,40,Oklahoma,109,Oklahoma County,763,334,429
53,Washington,40,Oklahoma,111,Okmulgee County,0,23,-23
53,Washington,40,Oklahoma,113,Osage County,0,20,-20
53,Washington,40,Oklahoma,115,Ottawa County,72,28,44
53,Washington,40,Oklahoma,117,Pawnee County,28,7,21
53,Washington,40,Oklahoma,119,Payne County,31,61,-30
53,Washington,40,Oklahoma,121,Pittsburg County,0,18,-18
53,Washington,40,Oklahoma,123,Pontotoc County,0,63,-63
53,Washington,40,Oklahoma,125,Pottawatomie County,0,47,-47
53,Washington,40,Oklahoma,127,Pushmataha County,0,14,-14
53,Washington,40,Oklahoma,135,Sequoyah County,0,159,-159
53,Washington,40,Oklahoma,137,Stephens County,0,6,-6
53,Washington,40,Oklahoma,143,Tulsa County,465,179,286
53,Washington,40,Oklahoma,145,Wagoner County,3,0,3
53,Washington,40,Oklahoma,147,Washington County,58,71,-13
53,Washington,40,Oklahoma,149,Washita County,0,14,-14
53,Washington,41,Oregon,1,Baker County,85,75,10
53,Washington,41,Oregon,3,Benton County,571,480,91
53,Washington,41,Oregon,5,Clackamas County,2240,2555,-315
53,Washington,41,Oregon,7,Clatsop County,609,495,114
53,Washington,41,Oregon,9,Columbia County,852,609,243
53,Washington,41,Oregon,11,Coos County,199,134,65
53,Washington,41,Oregon,13,Crook County,18,108,-90
53,Washington,41,Oregon,15,Curry County,74,185,-111
53,Washington,41,Oregon,17,Deschutes County,1018,673,345
53,Washington,41,Oregon,19,Douglas County,300,369,-69
53,Washington,41,Oregon,21,Gilliam County,3,10,-7
53,Washington,41,Oregon,23,Grant County,0,14,-14
53,Washington,41,Oregon,25,Harney County,0,3,-3
53,Washington,41,Oregon,27,Hood River County,466,204,262
53,Washington,41,Oregon,29,Jackson County,543,837,-294
53,Washington,41,Oregon,31,Jefferson County,305,102,203
53,Washington,41,Oregon,33,Josephine County,171,215,-44
53,Washington,41,Oregon,35,Klamath County,206,259,-53
53,Washington,41,Oregon,37,Lake County,127,66,61
53,Washington,41,Oregon,39,Lane County,1673,2052,-379
53,Washington,41,Oregon,41,Lincoln County,305,371,-66
53,Washington,41,Oregon,43,Linn County,673,414,259
53,Washington,41,Oregon,45,Malheur County,204,125,79
53,Washington,41,Oregon,47,Marion County,1396,1258,138
53,Washington,41,Oregon,49,Morrow County,310,370,-60
53,Washington,41,Oregon,51,Multnomah County,10227,7131,3096
53,Washington,41,Oregon,53,Polk County,216,396,-180
53,Washington,41,Oregon,55,Sherman County,0,9,-9
53,Washington,41,Oregon,57,Tillamook County,202,160,42
53,Washington,41,Oregon,59,Umatilla County,1072,726,346
53,Washington,41,Oregon,61,Union County,104,287,-183
53,Washington,41,Oregon,63,Wallowa County,18,94,-76
53,Washington,41,Oregon,65,Wasco County,236,304,-68
53,Washington,41,Oregon,67,Washington County,4020,3681,339
53,Washington,41,Oregon,69,Wheeler County,0,1,-1
53,Washington,41,Oregon,71,Yamhill County,427,609,-182
53,Washington,42,Pennsylvania,1,Adams County,53,0,53
53,Washington,42,Pennsylvania,3,Allegheny County,610,485,125
53,Washington,42,Pennsylvania,7,Beaver County,29,0,29
53,Washington,42,Pennsylvania,9,Bedford County,38,0,38
53,Washington,42,Pennsylvania,11,Berks County,33,4,29
53,Washington,42,Pennsylvania,17,Bucks County,62,62,0
53,Washington,42,Pennsylvania,21,Cambria County,66,15,51
53,Washington,42,Pennsylvania,25,Carbon County,0,41,-41
53,Washington,42,Pennsylvania,27,Centre County,54,147,-93
53,Washington,42,Pennsylvania,29,Chester County,23,207,-184
53,Washington,42,Pennsylvania,39,Crawford County,72,11,61
53,Washington,42,Pennsylvania,41,Cumberland County,0,59,-59
53,Washington,42,Pennsylvania,43,Dauphin County,3,58,-55
53,Washington,42,Pennsylvania,45,Delaware County,162,55,107
53,Washington,42,Pennsylvania,49,Erie County,0,167,-167
53,Washington,42,Pennsylvania,55,Franklin County,5,0,5
53,Washington,42,Pennsylvania,57,Fulton County,11,0,11
53,Washington,42,Pennsylvania,59,Greene County,25,4,21
53,Washington,42,Pennsylvania,61,Huntingdon County,112,0,112
53,Washington,42,Pennsylvania,65,Jefferson County,0,3,-3
53,Washington,42,Pennsylvania,69,Lackawanna County,0,43,-43
53,Washington,42,Pennsylvania,71,Lancaster County,326,26,300
53,Washington,42,Pennsylvania,75,Lebanon County,27,0,27
53,Washington,42,Pennsylvania,77,Lehigh County,71,0,71
53,Washington,42,Pennsylvania,79,Luzerne County,33,0,33
53,Washington,42,Pennsylvania,81,Lycoming County,27,0,27
53,Washington,42,Pennsylvania,83,McKean County,10,0,10
53,Washington,42,Pennsylvania,85,Mercer County,50,5,45
53,Washington,42,Pennsylvania,89,Monroe County,8,0,8
53,Washington,42,Pennsylvania,91,Montgomery County,110,147,-37
53,Washington,42,Pennsylvania,93,Montour County,21,0,21
53,Washington,42,Pennsylvania,95,Northampton County,146,44,102
53,Washington,42,Pennsylvania,101,Philadelphia County,371,684,-313
53,Washington,42,Pennsylvania,103,Pike County,118,0,118
53,Washington,42,Pennsylvania,107,Schuylkill County,4,27,-23
53,Washington,42,Pennsylvania,109,Snyder County,0,53,-53
53,Washington,42,Pennsylvania,111,Somerset County,7,0,7
53,Washington,42,Pennsylvania,115,Susquehanna County,0,8,-8
53,Washington,42,Pennsylvania,121,Venango County,0,15,-15
53,Washington,42,Pennsylvania,125,Washington County,70,40,30
53,Washington,42,Pennsylvania,133,York County,170,27,143
53,Washington,44,Rhode Island,1,Bristol County,56,0,56
53,Washington,44,Rhode Island,3,Kent County,44,68,-24
53,Washington,44,Rhode Island,5,Newport County,421,266,155
53,Washington,44,Rhode Island,7,Providence County,89,130,-41
53,Washington,44,Rhode Island,9,Washington County,38,0,38
53,Washington,45,South Carolina,3,Aiken County,105,102,3
53,Washington,45,South Carolina,7,Anderson County,9,85,-76
53,Washington,45,South Carolina,13,Beaufort County,36,256,-220
53,Washington,45,South Carolina,15,Berkeley County,668,496,172
53,Washington,45,South Carolina,19,Charleston County,457,160,297
53,Washington,45,South Carolina,21,Cherokee County,69,1,68
53,Washington,45,South Carolina,23,Chester County,0,13,-13
53,Washington,45,South Carolina,27,Clarendon County,0,4,-4
53,Washington,45,South Carolina,31,Darlington County,28,0,28
53,Washington,45,South Carolina,33,Dillon County,84,0,84
53,Washington,45,South Carolina,35,Dorchester County,208,100,108
53,Washington,45,South Carolina,39,Fairfield County,20,0,20
53,Washington,45,South Carolina,45,Greenville County,119,75,44
53,Washington,45,South Carolina,51,Horry County,95,33,62
53,Washington,45,South Carolina,53,Jasper County,0,21,-21
53,Washington,45,South Carolina,55,Kershaw County,12,0,12
53,Washington,45,South Carolina,57,Lancaster County,0,14,-14
53,Washington,45,South Carolina,61,Lee County,0,8,-8
53,Washington,45,South Carolina,63,Lexington County,38,49,-11
53,Washington,45,South Carolina,73,Oconee County,33,28,5
53,Washington,45,South Carolina,75,Orangeburg County,0,2,-2
53,Washington,45,South Carolina,77,Pickens County,0,15,-15
53,Washington,45,South Carolina,79,Richland County,268,560,-292
53,Washington,45,South Carolina,83,Spartanburg County,66,100,-34
53,Washington,45,South Carolina,85,Sumter County,25,0,25
53,Washington,45,South Carolina,87,Union County,0,8,-8
53,Washington,45,South Carolina,91,York County,176,111,65
53,Washington,46,South Dakota,5,Beadle County,8,0,8
53,Washington,46,South Dakota,11,Brookings County,0,15,-15
53,Washington,46,South Dakota,13,Brown County,0,22,-22
53,Washington,46,South Dakota,23,Charles Mix County,0,5,-5
53,Washington,46,South Dakota,27,Clay County,256,0,256
53,Washington,46,South Dakota,35,Davison County,0,97,-97
53,Washington,46,South Dakota,47,Fall River County,37,0,37
53,Washington,46,South Dakota,53,Gregory County,21,0,21
53,Washington,46,South Dakota,57,Hamlin County,10,11,-1
53,Washington,46,South Dakota,61,Hanson County,20,2,18
53,Washington,46,South Dakota,65,Hughes County,166,0,166
53,Washington,46,South Dakota,73,Jerauld County,0,2,-2
53,Washington,46,South Dakota,77,Kingsbury County,0,4,-4
53,Washington,46,South Dakota,79,Lake County,10,3,7
53,Washington,46,South Dakota,83,Lincoln County,36,217,-181
53,Washington,46,South Dakota,93,Meade County,0,18,-18
53,Washington,46,South Dakota,99,Minnehaha County,265,24,241
53,Washington,46,South Dakota,101,Moody County,0,5,-5
53,Washington,46,South Dakota,103,Pennington County,140,20,120
53,Washington,46,South Dakota,105,Perkins County,18,0,18
53,Washington,46,South Dakota,111,Sanborn County,0,12,-12
53,Washington,46,South Dakota,115,Spink County,23,0,23
53,Washington,46,South Dakota,117,Stanley County,16,0,16
53,Washington,46,South Dakota,129,Walworth County,0,36,-36
53,Washington,46,South Dakota,135,Yankton County,49,0,49
53,Washington,47,Tennessee,1,Anderson County,36,10,26
53,Washington,47,Tennessee,3,Bedford County,0,2,-2
53,Washington,47,Tennessee,9,Blount County,18,8,10
53,Washington,47,Tennessee,11,Bradley County,130,56,74
53,Washington,47,Tennessee,15,Cannon County,0,25,-25
53,Washington,47,Tennessee,27,Clay County,0,2,-2
53,Washington,47,Tennessee,31,Coffee County,26,0,26
53,Washington,47,Tennessee,33,Crockett County,0,4,-4
53,Washington,47,Tennessee,35,Cumberland County,0,24,-24
53,Washington,47,Tennessee,37,Davidson County,174,329,-155
53,Washington,47,Tennessee,41,DeKalb County,0,13,-13
53,Washington,47,Tennessee,43,Dickson County,12,0,12
53,Washington,47,Tennessee,65,Hamilton County,71,40,31
53,Washington,47,Tennessee,67,Hancock County,10,0,10
53,Washington,47,Tennessee,71,Hardin County,0,80,-80
53,Washington,47,Tennessee,73,Hawkins County,11,0,11
53,Washington,47,Tennessee,75,Haywood County,0,15,-15
53,Washington,47,Tennessee,81,Hickman County,21,0,21
53,Washington,47,Tennessee,93,Knox County,85,257,-172
53,Washington,47,Tennessee,99,Lawrence County,26,0,26
53,Washington,47,Tennessee,105,Loudon County,25,0,25
53,Washington,47,Tennessee,109,McNairy County,12,0,12
53,Washington,47,Tennessee,113,Madison County,29,28,1
53,Washington,47,Tennessee,115,Marion County,27,0,27
53,Washington,47,Tennessee,119,Maury County,0,37,-37
53,Washington,47,Tennessee,125,Montgomery County,557,477,80
53,Washington,47,Tennessee,143,Rhea County,6,0,6
53,Washington,47,Tennessee,145,Roane County,94,0,94
53,Washington,47,Tennessee,147,Robertson County,30,0,30
53,Washington,47,Tennessee,149,Rutherford County,237,8,229
53,Washington,47,Tennessee,157,Shelby County,260,203,57
53,Washington,47,Tennessee,161,Stewart County,0,213,-213
53,Washington,47,Tennessee,163,Sullivan County,0,1,-1
53,Washington,47,Tennessee,165,Sumner County,36,10,26
53,Washington,47,Tennessee,179,Washington County,0,22,-22
53,Washington,47,Tennessee,181,Wayne County,0,16,-16
53,Washington,47,Tennessee,187,Williamson County,46,30,16
53,Washington,47,Tennessee,189,Wilson County,21,37,-16
53,Washington,48,Texas,1,Anderson County,16,0,16
53,Washington,48,Texas,5,Angelina County,18,0,18
53,Washington,48,Texas,7,Aransas County,34,0,34
53,Washington,48,Texas,9,Archer County,0,7,-7
53,Washington,48,Texas,13,Atascosa County,11,0,11
53,Washington,48,Texas,15,Austin County,106,21,85
53,Washington,48,Texas,21,Bastrop County,31,0,31
53,Washington,48,Texas,27,Bell County,854,1389,-535
53,Washington,48,Texas,29,Bexar County,1417,1709,-292
53,Washington,48,Texas,37,Bowie County,82,46,36
53,Washington,48,Texas,39,Brazoria County,67,327,-260
53,Washington,48,Texas,41,Brazos County,258,146,112
53,Washington,48,Texas,43,Brewster County,3,0,3
53,Washington,48,Texas,47,Brooks County,0,7,-7
53,Washington,48,Texas,49,Brown County,58,6,52
53,Washington,48,Texas,51,Burleson County,6,0,6
53,Washington,48,Texas,53,Burnet County,21,0,21
53,Washington,48,Texas,55,Caldwell County,7,0,7
53,Washington,48,Texas,61,Cameron County,0,112,-112
53,Washington,48,Texas,69,Castro County,37,0,37
53,Washington,48,Texas,71,Chambers County,11,0,11
53,Washington,48,Texas,73,Cherokee County,0,36,-36
53,Washington,48,Texas,85,Collin County,737,376,361
53,Washington,48,Texas,91,Comal County,6,46,-40
53,Washington,48,Texas,93,Comanche County,0,6,-6
53,Washington,48,Texas,95,Concho County,0,7,-7
53,Washington,48,Texas,99,Coryell County,82,186,-104
53,Washington,48,Texas,109,Culberson County,8,0,8
53,Washington,48,Texas,113,Dallas County,820,762,58
53,Washington,48,Texas,115,Dawson County,92,0,92
53,Washington,48,Texas,121,Denton County,209,253,-44
53,Washington,48,Texas,135,Ector County,0,52,-52
53,Washington,48,Texas,139,Ellis County,55,9,46
53,Washington,48,Texas,141,El Paso County,975,399,576
53,Washington,48,Texas,143,Erath County,10,0,10
53,Washington,48,Texas,145,Falls County,0,9,-9
53,Washington,48,Texas,147,Fannin County,12,0,12
53,Washington,48,Texas,157,Fort Bend County,347,50,297
53,Washington,48,Texas,167,Galveston County,15,54,-39
53,Washington,48,Texas,171,Gillespie County,0,24,-24
53,Washington,48,Texas,173,Glasscock County,0,8,-8
53,Washington,48,Texas,179,Gray County,2,55,-53
53,Washington,48,Texas,181,Grayson County,30,11,19
53,Washington,48,Texas,183,Gregg County,24,0,24
53,Washington,48,Texas,187,Guadalupe County,45,62,-17
53,Washington,48,Texas,193,Hamilton County,11,0,11
53,Washington,48,Texas,199,Hardin County,23,0,23
53,Washington,48,Texas,201,Harris County,1824,1319,505
53,Washington,48,Texas,203,Harrison County,0,15,-15
53,Washington,48,Texas,205,Hartley County,0,28,-28
53,Washington,48,Texas,209,Hays County,99,85,14
53,Washington,48,Texas,215,Hidalgo County,345,416,-71
53,Washington,48,Texas,221,Hood County,24,0,24
53,Washington,48,Texas,223,Hopkins County,22,0,22
53,Washington,48,Texas,227,Howard County,29,3,26
53,Washington,48,Texas,241,Jasper County,15,0,15
53,Washington,48,Texas,245,Jefferson County,90,125,-35
53,Washington,48,Texas,251,Johnson County,0,17,-17
53,Washington,48,Texas,253,Jones County,12,52,-40
53,Washington,48,Texas,257,Kaufman County,0,4,-4
53,Washington,48,Texas,259,Kendall County,2,0,2
53,Washington,48,Texas,273,Kleberg County,5,0,5
53,Washington,48,Texas,277,Lamar County,19,11,8
53,Washington,48,Texas,281,Lampasas County,0,10,-10
53,Washington,48,Texas,283,La Salle County,0,8,-8
53,Washington,48,Texas,291,Liberty County,0,6,-6
53,Washington,48,Texas,299,Llano County,0,3,-3
53,Washington,48,Texas,303,Lubbock County,66,97,-31
53,Washington,48,Texas,309,McLennan County,106,129,-23
53,Washington,48,Texas,321,Matagorda County,26,33,-7
53,Washington,48,Texas,327,Menard County,4,0,4
53,Washington,48,Texas,329,Midland County,55,63,-8
53,Washington,48,Texas,339,Montgomery County,125,199,-74
53,Washington,48,Texas,347,Nacogdoches County,8,5,3
53,Washington,48,Texas,349,Navarro County,67,9,58
53,Washington,48,Texas,355,Nueces County,225,365,-140
53,Washington,48,Texas,361,Orange County,13,6,7
53,Washington,48,Texas,365,Panola County,16,26,-10
53,Washington,48,Texas,367,Parker County,19,33,-14
53,Washington,48,Texas,369,Parmer County,0,4,-4
53,Washington,48,Texas,373,Polk County,30,0,30
53,Washington,48,Texas,375,Potter County,132,93,39
53,Washington,48,Texas,379,Rains County,0,12,-12
53,Washington,48,Texas,381,Randall County,189,89,100
53,Washington,48,Texas,397,Rockwall County,6,23,-17
53,Washington,48,Texas,401,Rusk County,0,26,-26
53,Washington,48,Texas,409,San Patricio County,0,2,-2
53,Washington,48,Texas,415,Scurry County,0,20,-20
53,Washington,48,Texas,419,Shelby County,0,28,-28
53,Washington,48,Texas,423,Smith County,134,202,-68
53,Washington,48,Texas,439,Tarrant County,1402,392,1010
53,Washington,48,Texas,441,Taylor County,5,0,5
53,Washington,48,Texas,445,Terry County,0,24,-24
53,Washington,48,Texas,449,Titus County,0,15,-15
53,Washington,48,Texas,451,Tom Green County,0,139,-139
53,Washington,48,Texas,453,Travis County,1499,963,536
53,Washington,48,Texas,459,Upshur County,0,37,-37
53,Washington,48,Texas,465,Val Verde County,38,8,30
53,Washington,48,Texas,467,Van Zandt County,11,60,-49
53,Washington,48,Texas,471,Walker County,19,0,19
53,Washington,48,Texas,479,Webb County,19,8,11
53,Washington,48,Texas,485,Wichita County,72,86,-14
53,Washington,48,Texas,491,Williamson County,340,358,-18
53,Washington,48,Texas,493,Wilson County,17,0,17
53,Washington,48,Texas,497,Wise County,10,4,6
53,Washington,48,Texas,499,Wood County,82,0,82
53,Washington,49,Utah,1,Beaver County,0,9,-9
53,Washington,49,Utah,3,Box Elder County,119,76,43
53,Washington,49,Utah,5,Cache County,321,208,113
53,Washington,49,Utah,7,Carbon County,0,4,-4
53,Washington,49,Utah,11,Davis County,495,575,-80
53,Washington,49,Utah,13,Duchesne County,5,22,-17
53,Washington,49,Utah,15,Emery County,2,12,-10
53,Washington,49,Utah,19,Grand County,0,3,-3
53,Washington,49,Utah,21,Iron County,91,60,31
53,Washington,49,Utah,25,Kane County,0,69,-69
53,Washington,49,Utah,27,Millard County,48,26,22
53,Washington,49,Utah,29,Morgan County,0,3,-3
53,Washington,49,Utah,31,Piute County,0,1,-1
53,Washington,49,Utah,35,Salt Lake County,2321,1626,695
53,Washington,49,Utah,37,San Juan County,0,10,-10
53,Washington,49,Utah,39,Sanpete County,112,11,101
53,Washington,49,Utah,41,Sevier County,5,0,5
53,Washington,49,Utah,43,Summit County,131,35,96
53,Washington,49,Utah,45,Tooele County,78,99,-21
53,Washington,49,Utah,47,Uintah County,0,9,-9
53,Washington,49,Utah,49,Utah County,1247,1376,-129
53,Washington,49,Utah,51,Wasatch County,93,9,84
53,Washington,49,Utah,53,Washington County,516,387,129
53,Washington,49,Utah,55,Wayne County,0,3,-3
53,Washington,49,Utah,57,Weber County,178,359,-181
53,Washington,5,Arkansas,5,Baxter County,42,0,42
53,Washington,5,Arkansas,7,Benton County,0,151,-151
53,Washington,5,Arkansas,9,Boone County,0,64,-64
53,Washington,5,Arkansas,15,Carroll County,0,6,-6
53,Washington,5,Arkansas,23,Cleburne County,99,0,99
53,Washington,5,Arkansas,29,Conway County,137,54,83
53,Washington,5,Arkansas,31,Craighead County,23,24,-1
53,Washington,5,Arkansas,33,Crawford County,0,13,-13
53,Washington,5,Arkansas,41,Desha County,0,31,-31
53,Washington,5,Arkansas,43,Drew County,0,195,-195
53,Washington,5,Arkansas,45,Faulkner County,13,52,-39
53,Washington,5,Arkansas,47,Franklin County,0,45,-45
53,Washington,5,Arkansas,49,Fulton County,16,0,16
53,Washington,5,Arkansas,51,Garland County,0,35,-35
53,Washington,5,Arkansas,59,Hot Spring County,133,0,133
53,Washington,5,Arkansas,63,Independence County,42,0,42
53,Washington,5,Arkansas,75,Lawrence County,0,17,-17
53,Washington,5,Arkansas,81,Little River County,12,0,12
53,Washington,5,Arkansas,87,Madison County,14,0,14
53,Washington,5,Arkansas,89,Marion County,0,42,-42
53,Washington,5,Arkansas,91,Miller County,46,0,46
53,Washington,5,Arkansas,115,Pope County,68,26,42
53,Washington,5,Arkansas,119,Pulaski County,423,38,385
53,Washington,5,Arkansas,129,Searcy County,43,4,39
53,Washington,5,Arkansas,131,Sebastian County,29,105,-76
53,Washington,5,Arkansas,143,Washington County,89,102,-13
53,Washington,5,Arkansas,145,White County,0,24,-24
53,Washington,50,Vermont,1,Addison County,0,39,-39
53,Washington,50,Vermont,3,Bennington County,55,18,37
53,Washington,50,Vermont,5,Caledonia County,0,71,-71
53,Washington,50,Vermont,7,Chittenden County,239,38,201
53,Washington,50,Vermont,11,Franklin County,0,64,-64
53,Washington,50,Vermont,15,Lamoille County,11,0,11
53,Washington,50,Vermont,17,Orange County,10,18,-8
53,Washington,50,Vermont,19,Orleans County,0,8,-8
53,Washington,50,Vermont,21,Rutland County,162,1,161
53,Washington,50,Vermont,23,Washington County,37,51,-14
53,Washington,50,Vermont,25,Windham County,15,57,-42
53,Washington,50,Vermont,27,Windsor County,0,7,-7
53,Washington,51,Virginia,3,Albemarle County,67,77,-10
53,Washington,51,Virginia,13,Arlington County,304,53,251
53,Washington,51,Virginia,15,Augusta County,45,0,45
53,Washington,51,Virginia,19,Bedford County,12,116,-104
53,Washington,51,Virginia,25,Brunswick County,0,9,-9
53,Washington,51,Virginia,33,Caroline County,7,24,-17
53,Washington,51,Virginia,41,Chesterfield County,60,146,-86
53,Washington,51,Virginia,47,Culpeper County,115,50,65
53,Washington,51,Virginia,59,Fairfax County,1162,877,285
53,Washington,51,Virginia,61,Fauquier County,64,1,63
53,Washington,51,Virginia,69,Frederick County,21,0,21
53,Washington,51,Virginia,75,Goochland County,0,2,-2
53,Washington,51,Virginia,85,Hanover County,0,19,-19
53,Washington,51,Virginia,87,Henrico County,21,275,-254
53,Washington,51,Virginia,95,James City County,21,41,-20
53,Washington,51,Virginia,99,King George County,0,7,-7
53,Washington,51,Virginia,107,Loudoun County,324,81,243
53,Washington,51,Virginia,109,Louisa County,63,23,40
53,Washington,51,Virginia,115,Mathews County,8,26,-18
53,Washington,51,Virginia,121,Montgomery County,116,21,95
53,Washington,51,Virginia,145,Powhatan County,0,12,-12
53,Washington,51,Virginia,149,Prince George County,299,11,288
53,Washington,51,Virginia,153,Prince William County,268,364,-96
53,Washington,51,Virginia,161,Roanoke County,17,0,17
53,Washington,51,Virginia,163,Rockbridge County,0,14,-14
53,Washington,51,Virginia,173,Smyth County,47,0,47
53,Washington,51,Virginia,177,Spotsylvania County,0,29,-29
53,Washington,51,Virginia,179,Stafford County,27,95,-68
53,Washington,51,Virginia,191,Washington County,39,0,39
53,Washington,51,Virginia,197,Wythe County,38,0,38
53,Washington,51,Virginia,199,York County,0,185,-185
53,Washington,51,Virginia,510,Alexandria city,239,79,160
53,Washington,51,Virginia,520,Bristol city,8,0,8
53,Washington,51,Virginia,530,Buena Vista city,0,2,-2
53,Washington,51,Virginia,540,Charlottesville city,142,20,122
53,Washington,51,Virginia,550,Chesapeake city,126,186,-60
53,Washington,51,Virginia,600,Fairfax city,0,27,-27
53,Washington,51,Virginia,630,Fredericksburg city,0,22,-22
53,Washington,51,Virginia,650,Hampton city,109,71,38
53,Washington,51,Virginia,660,Harrisonburg city,11,11,0
53,Washington,51,Virginia,670,Hopewell city,12,0,12
53,Washington,51,Virginia,680,Lynchburg city,0,169,-169
53,Washington,51,Virginia,683,Manassas city,22,0,22
53,Washington,51,Virginia,700,Newport News city,163,186,-23
53,Washington,51,Virginia,710,Norfolk city,313,447,-134
53,Washington,51,Virginia,730,Petersburg city,33,38,-5
53,Washington,51,Virginia,735,Poquoson city,0,21,-21
53,Washington,51,Virginia,740,Portsmouth city,318,84,234
53,Washington,51,Virginia,750,Radford city,28,20,8
53,Washington,51,Virginia,760,Richmond city,86,58,28
53,Washington,51,Virginia,770,Roanoke city,0,67,-67
53,Washington,51,Virginia,775,Salem city,0,15,-15
53,Washington,51,Virginia,790,Staunton city,10,7,3
53,Washington,51,Virginia,800,Suffolk city,63,40,23
53,Washington,51,Virginia,810,Virginia Beach city,850,595,255
53,Washington,51,Virginia,830,Williamsburg city,39,0,39
53,Washington,53,Washington,1,Adams County,2247,570,1677
53,Washington,53,Washington,3,Asotin County,212,237,-25
53,Washington,53,Washington,5,Benton County,8874,6410,2464
53,Washington,53,Washington,7,Chelan County,3775,3140,635
53,Washington,53,Washington,9,Clallam County,2060,1619,441
53,Washington,53,Washington,11,Clark County,7918,6014,1904
53,Washington,53,Washington,13,Columbia County,109,229,-120
53,Washington,53,Washington,15,Cowlitz County,3445,3083,362
53,Washington,53,Washington,17,Douglas County,2256,2208,48
53,Washington,53,Washington,19,Ferry County,655,575,80
53,Washington,53,Washington,21,Franklin County,4450,6295,-1845
53,Washington,53,Washington,23,Garfield County,24,17,7
53,Washington,53,Washington,25,Grant County,3337,3569,-232
53,Washington,53,Washington,27,Grays Harbor County,2884,3312,-428
53,Washington,53,Washington,29,Island County,3671,3772,-101
53,Washington,53,Washington,31,Jefferson County,1031,1632,-601
53,Washington,53,Washington,33,King County,57522,40308,17214
53,Washington,53,Washington,35,Kitsap County,8860,8016,844
53,Washington,53,Washington,37,Kittitas County,2227,5483,-3256
53,Washington,53,Washington,39,Klickitat County,438,586,-148
53,Washington,53,Washington,41,Lewis County,2907,3602,-695
53,Washington,53,Washington,43,Lincoln County,1038,425,613
53,Washington,53,Washington,45,Mason County,3634,4362,-728
53,Washington,53,Washington,47,Okanogan County,1555,1434,121
53,Washington,53,Washington,49,Pacific County,1160,762,398
53,Washington,53,Washington,51,Pend Oreille County,333,597,-264
53,Washington,53,Washington,53,Pierce County,25493,28464,-2971
53,Washington,53,Washington,55,San Juan County,573,418,155
53,Washington,53,Washington,57,Skagit County,4487,5042,-555
53,Washington,53,Washington,59,Skamania County,451,398,53
53,Washington,53,Washington,61,Snohomish County,26481,27652,-1171
53,Washington,53,Washington,63,Spokane County,9205,15466,-6261
53,Washington,53,Washington,65,Stevens County,1988,1464,524
53,Washington,53,Washington,67,Thurston County,8639,12813,-4174
53,Washington,53,Washington,69,Wahkiakum County,218,117,101
53,Washington,53,Washington,71,Walla Walla County,2970,2942,28
53,Washington,53,Washington,73,Whatcom County,6010,7559,-1549
53,Washington,53,Washington,75,Whitman County,3107,6727,-3620
53,Washington,53,Washington,77,Yakima County,5109,4034,1075
53,Washington,54,West Virginia,11,Cabell County,18,30,-12
53,Washington,54,West Virginia,19,Fayette County,0,10,-10
53,Washington,54,West Virginia,29,Hancock County,11,0,11
53,Washington,54,West Virginia,33,Harrison County,28,0,28
53,Washington,54,West Virginia,37,Jefferson County,0,35,-35
53,Washington,54,West Virginia,39,Kanawha County,218,6,212
53,Washington,54,West Virginia,51,Marshall County,26,0,26
53,Washington,54,West Virginia,55,Mercer County,0,4,-4
53,Washington,54,West Virginia,61,Monongalia County,98,58,40
53,Washington,54,West Virginia,77,Preston County,0,3,-3
53,Washington,54,West Virginia,87,Roane County,0,7,-7
53,Washington,54,West Virginia,89,Summers County,16,0,16
53,Washington,54,West Virginia,107,Wood County,0,10,-10
53,Washington,54,West Virginia,109,Wyoming County,20,0,20
53,Washington,55,Wisconsin,3,Ashland County,15,10,5
53,Washington,55,Wisconsin,5,Barron County,0,15,-15
53,Washington,55,Wisconsin,7,Bayfield County,0,8,-8
53,Washington,55,Wisconsin,9,Brown County,121,93,28
53,Washington,55,Wisconsin,11,Buffalo County,0,1,-1
53,Washington,55,Wisconsin,13,Burnett County,0,13,-13
53,Washington,55,Wisconsin,17,Chippewa County,86,35,51
53,Washington,55,Wisconsin,21,Columbia County,0,6,-6
53,Washington,55,Wisconsin,23,Crawford County,0,31,-31
53,Washington,55,Wisconsin,25,Dane County,599,225,374
53,Washington,55,Wisconsin,27,Dodge County,50,41,9
53,Washington,55,Wisconsin,29,Door County,0,40,-40
53,Washington,55,Wisconsin,31,Douglas County,13,0,13
53,Washington,55,Wisconsin,33,Dunn County,4,11,-7
53,Washington,55,Wisconsin,35,Eau Claire County,0,24,-24
53,Washington,55,Wisconsin,39,Fond du Lac County,5,3,2
53,Washington,55,Wisconsin,43,Grant County,6,0,6
53,Washington,55,Wisconsin,49,Iowa County,4,0,4
53,Washington,55,Wisconsin,55,Jefferson County,0,28,-28
53,Washington,55,Wisconsin,57,Juneau County,17,0,17
53,Washington,55,Wisconsin,59,Kenosha County,133,51,82
53,Washington,55,Wisconsin,63,La Crosse County,59,19,40
53,Washington,55,Wisconsin,65,Lafayette County,0,2,-2
53,Washington,55,Wisconsin,69,Lincoln County,22,0,22
53,Washington,55,Wisconsin,71,Manitowoc County,55,46,9
53,Washington,55,Wisconsin,73,Marathon County,80,36,44
53,Washington,55,Wisconsin,75,Marinette County,0,3,-3
53,Washington,55,Wisconsin,77,Marquette County,0,28,-28
53,Washington,55,Wisconsin,79,Milwaukee County,380,297,83
53,Washington,55,Wisconsin,81,Monroe County,77,50,27
53,Washington,55,Wisconsin,85,Oneida County,10,1,9
53,Washington,55,Wisconsin,87,Outagamie County,63,32,31
53,Washington,55,Wisconsin,89,Ozaukee County,26,0,26
53,Washington,55,Wisconsin,91,Pepin County,20,12,8
53,Washington,55,Wisconsin,95,Polk County,32,13,19
53,Washington,55,Wisconsin,97,Portage County,104,5,99
53,Washington,55,Wisconsin,101,Racine County,69,147,-78
53,Washington,55,Wisconsin,103,Richland County,0,12,-12
53,Washington,55,Wisconsin,105,Rock County,14,22,-8
53,Washington,55,Wisconsin,109,St. Croix County,91,54,37
53,Washington,55,Wisconsin,111,Sauk County,0,8,-8
53,Washington,55,Wisconsin,113,Sawyer County,0,2,-2
53,Washington,55,Wisconsin,117,Sheboygan County,5,0,5
53,Washington,55,Wisconsin,119,Taylor County,4,1,3
53,Washington,55,Wisconsin,121,Trempealeau County,0,7,-7
53,Washington,55,Wisconsin,123,Vernon County,0,4,-4
53,Washington,55,Wisconsin,125,Vilas County,94,30,64
53,Washington,55,Wisconsin,127,Walworth County,0,4,-4
53,Washington,55,Wisconsin,129,Washburn County,62,2,60
53,Washington,55,Wisconsin,131,Washington County,27,0,27
53,Washington,55,Wisconsin,133,Waukesha County,191,188,3
53,Washington,55,Wisconsin,135,Waupaca County,19,99,-80
53,Washington,55,Wisconsin,137,Waushara County,68,9,59
53,Washington,55,Wisconsin,139,Winnebago County,5,109,-104
53,Washington,55,Wisconsin,141,Wood County,0,2,-2
53,Washington,56,Wyoming,1,Albany County,110,173,-63
53,Washington,56,Wyoming,3,Big Horn County,4,115,-111
53,Washington,56,Wyoming,5,Campbell County,12,79,-67
53,Washington,56,Wyoming,7,Carbon County,0,13,-13
53,Washington,56,Wyoming,9,Converse County,11,34,-23
53,Washington,56,Wyoming,11,Crook County,4,6,-2
53,Washington,56,Wyoming,13,Fremont County,112,53,59
53,Washington,56,Wyoming,15,Goshen County,9,76,-67
53,Washington,56,Wyoming,17,Hot Springs County,0,56,-56
53,Washington,56,Wyoming,21,Laramie County,200,139,61
53,Washington,56,Wyoming,23,Lincoln County,14,84,-70
53,Washington,56,Wyoming,25,Natrona County,81,104,-23
53,Washington,56,Wyoming,29,Park County,30,45,-15
53,Washington,56,Wyoming,31,Platte County,14,0,14
53,Washington,56,Wyoming,33,Sheridan County,103,14,89
53,Washington,56,Wyoming,37,Sweetwater County,9,62,-53
53,Washington,56,Wyoming,39,Teton County,70,82,-12
53,Washington,6,California,1,Alameda County,2334,1370,964
53,Washington,6,California,5,Amador County,158,33,125
53,Washington,6,California,7,Butte County,74,161,-87
53,Washington,6,California,9,Calaveras County,81,47,34
53,Washington,6,California,11,Colusa County,26,16,10
53,Washington,6,California,13,Contra Costa County,1237,856,381
53,Washington,6,California,15,Del Norte County,25,25,0
53,Washington,6,California,17,El Dorado County,166,28,138
53,Washington,6,California,19,Fresno County,704,631,73
53,Washington,6,California,23,Humboldt County,309,83,226
53,Washington,6,California,25,Imperial County,300,40,260
53,Washington,6,California,27,Inyo County,15,37,-22
53,Washington,6,California,29,Kern County,830,916,-86
53,Washington,6,California,31,Kings County,394,280,114
53,Washington,6,California,33,Lake County,96,12,84
53,Washington,6,California,35,Lassen County,16,0,16
53,Washington,6,California,37,Los Angeles County,9257,5357,3900
53,Washington,6,California,39,Madera County,340,36,304
53,Washington,6,California,41,Marin County,291,223,68
53,Washington,6,California,43,Mariposa County,26,21,5
53,Washington,6,California,45,Mendocino County,160,204,-44
53,Washington,6,California,47,Merced County,254,71,183
53,Washington,6,California,49,Modoc County,16,50,-34
53,Washington,6,California,51,Mono County,0,2,-2
53,Washington,6,California,53,Monterey County,683,776,-93
53,Washington,6,California,55,Napa County,67,86,-19
53,Washington,6,California,57,Nevada County,96,98,-2
53,Washington,6,California,59,Orange County,3023,2596,427
53,Washington,6,California,61,Placer County,517,508,9
53,Washington,6,California,63,Plumas County,0,6,-6
53,Washington,6,California,65,Riverside County,2126,2051,75
53,Washington,6,California,67,Sacramento County,1260,1363,-103
53,Washington,6,California,69,San Benito County,55,12,43
53,Washington,6,California,71,San Bernardino County,2064,1595,469
53,Washington,6,California,73,San Diego County,5473,4053,1420
53,Washington,6,California,75,San Francisco County,1971,1368,603
53,Washington,6,California,77,San Joaquin County,740,804,-64
53,Washington,6,California,79,San Luis Obispo County,532,377,155
53,Washington,6,California,81,San Mateo County,818,777,41
53,Washington,6,California,83,Santa Barbara County,360,343,17
53,Washington,6,California,85,Santa Clara County,3233,2315,918
53,Washington,6,California,87,Santa Cruz County,473,327,146
53,Washington,6,California,89,Shasta County,510,314,196
53,Washington,6,California,91,Sierra County,57,0,57
53,Washington,6,California,93,Siskiyou County,53,45,8
53,Washington,6,California,95,Solano County,381,583,-202
53,Washington,6,California,97,Sonoma County,896,480,416
53,Washington,6,California,99,Stanislaus County,655,445,210
53,Washington,6,California,101,Sutter County,56,21,35
53,Washington,6,California,103,Tehama County,67,56,11
53,Washington,6,California,107,Tulare County,292,335,-43
53,Washington,6,California,109,Tuolumne County,116,20,96
53,Washington,6,California,111,Ventura County,1422,820,602
53,Washington,6,California,113,Yolo County,197,185,12
53,Washington,6,California,115,Yuba County,52,153,-101
53,Washington,72,Puerto Rico,13,Arecibo Municipio,105,0,105
53,Washington,72,Puerto Rico,25,Caguas Municipio,27,0,27
53,Washington,72,Puerto Rico,31,Carolina Municipio,26,0,26
53,Washington,72,Puerto Rico,75,Juana Díaz Municipio,26,80,-54
53,Washington,72,Puerto Rico,81,Lares Municipio,9,0,9
53,Washington,72,Puerto Rico,115,Quebradillas Municipio,77,0,77
53,Washington,72,Puerto Rico,127,San Juan Municipio,178,69,109
53,Washington,72,Puerto Rico,139,Trujillo Alto Municipio,4,0,4
53,Washington,8,Colorado,1,Adams County,636,168,468
53,Washington,8,Colorado,3,Alamosa County,0,14,-14
53,Washington,8,Colorado,5,Arapahoe County,867,635,232
53,Washington,8,Colorado,13,Boulder County,828,665,163
53,Washington,8,Colorado,14,Broomfield County,70,0,70
53,Washington,8,Colorado,19,Clear Creek County,0,7,-7
53,Washington,8,Colorado,29,Delta County,9,48,-39
53,Washington,8,Colorado,31,Denver County,1312,785,527
53,Washington,8,Colorado,35,Douglas County,442,419,23
53,Washington,8,Colorado,37,Eagle County,36,0,36
53,Washington,8,Colorado,41,El Paso County,1786,2069,-283
53,Washington,8,Colorado,43,Fremont County,19,24,-5
53,Washington,8,Colorado,45,Garfield County,98,61,37
53,Washington,8,Colorado,49,Grand County,0,49,-49
53,Washington,8,Colorado,51,Gunnison County,12,14,-2
53,Washington,8,Colorado,55,Huerfano County,25,0,25
53,Washington,8,Colorado,59,Jefferson County,427,614,-187
53,Washington,8,Colorado,67,La Plata County,67,40,27
53,Washington,8,Colorado,69,Larimer County,230,349,-119
53,Washington,8,Colorado,75,Logan County,0,53,-53
53,Washington,8,Colorado,77,Mesa County,104,226,-122
53,Washington,8,Colorado,81,Moffat County,93,0,93
53,Washington,8,Colorado,83,Montezuma County,0,21,-21
53,Washington,8,Colorado,85,Montrose County,57,0,57
53,Washington,8,Colorado,87,Morgan County,43,0,43
53,Washington,8,Colorado,93,Park County,12,0,12
53,Washington,8,Colorado,97,Pitkin County,9,29,-20
53,Washington,8,Colorado,101,Pueblo County,97,110,-13
53,Washington,8,Colorado,103,Rio Blanco County,0,12,-12
53,Washington,8,Colorado,107,Routt County,40,9,31
53,Washington,8,Colorado,113,San Miguel County,0,18,-18
53,Washington,8,Colorado,117,Summit County,109,0,109
53,Washington,8,Colorado,119,Teller County,87,12,75
53,Washington,8,Colorado,123,Weld County,216,256,-40
53,Washington,8,Colorado,125,Yuma County,0,37,-37
53,Washington,9,Connecticut,1,Fairfield County,213,63,150
53,Washington,9,Connecticut,3,Hartford County,116,153,-37
53,Washington,9,Connecticut,5,Litchfield County,71,27,44
53,Washington,9,Connecticut,7,Middlesex County,36,24,12
53,Washington,9,Connecticut,9,New Haven County,130,190,-60
53,Washington,9,Connecticut,11,New London County,558,198,360
53,Washington,9,Connecticut,13,Tolland County,3,49,-46
53,Washington,AFR,Africa,,-,3723,0,0
53,Washington,ASI,Asia,,-,31496,0,0
53,Washington,CAM,Central America,,-,6634,0,0
53,Washington,CAR,Caribbean,,-,327,0,0
53,Washington,EUR,Europe,,-,9947,0,0
53,Washington,ISL,U.S. Island Areas,,-,963,0,0
53,Washington,NAM,Northern America,,-,3267,0,0
53,Washington,OCE,Oceania and At Sea,,-,2014,0,0
53,Washington,SAM,South America,,-,1992,0,0
54,West Virginia,1,Alabama,1,Autauga County,0,37,-37
54,West Virginia,1,Alabama,5,Barbour County,8,0,8
54,West Virginia,1,Alabama,15,Calhoun County,0,10,-10
54,West Virginia,1,Alabama,31,Coffee County,0,4,-4
54,West Virginia,1,Alabama,33,Colbert County,4,0,4
54,West Virginia,1,Alabama,41,Crenshaw County,6,60,-54
54,West Virginia,1,Alabama,43,Cullman County,21,0,21
54,West Virginia,1,Alabama,51,Elmore County,0,175,-175
54,West Virginia,1,Alabama,55,Etowah County,0,42,-42
54,West Virginia,1,Alabama,59,Franklin County,18,0,18
54,West Virginia,1,Alabama,69,Houston County,0,8,-8
54,West Virginia,1,Alabama,73,Jefferson County,19,0,19
54,West Virginia,1,Alabama,77,Lauderdale County,0,117,-117
54,West Virginia,1,Alabama,81,Lee County,76,0,76
54,West Virginia,1,Alabama,89,Madison County,0,35,-35
54,West Virginia,1,Alabama,95,Marshall County,0,6,-6
54,West Virginia,1,Alabama,97,Mobile County,39,0,39
54,West Virginia,1,Alabama,99,Monroe County,0,3,-3
54,West Virginia,1,Alabama,101,Montgomery County,11,10,1
54,West Virginia,1,Alabama,107,Pickens County,18,12,6
54,West Virginia,1,Alabama,117,Shelby County,0,22,-22
54,West Virginia,1,Alabama,123,Tallapoosa County,0,5,-5
54,West Virginia,1,Alabama,125,Tuscaloosa County,48,37,11
54,West Virginia,1,Alabama,127,Walker County,0,2,-2
54,West Virginia,10,Delaware,1,Kent County,60,16,44
54,West Virginia,10,Delaware,3,New Castle County,60,133,-73
54,West Virginia,10,Delaware,5,Sussex County,78,30,48
54,West Virginia,11,District of Columbia,1,District of Columbia,581,338,243
54,West Virginia,12,Florida,1,Alachua County,11,158,-147
54,West Virginia,12,Florida,5,Bay County,47,31,16
54,West Virginia,12,Florida,9,Brevard County,75,143,-68
54,West Virginia,12,Florida,11,Broward County,143,53,90
54,West Virginia,12,Florida,15,Charlotte County,112,93,19
54,West Virginia,12,Florida,17,Citrus County,27,94,-67
54,West Virginia,12,Florida,19,Clay County,54,220,-166
54,West Virginia,12,Florida,21,Collier County,7,85,-78
54,West Virginia,12,Florida,31,Duval County,165,27,138
54,West Virginia,12,Florida,33,Escambia County,71,106,-35
54,West Virginia,12,Florida,35,Flagler County,0,39,-39
54,West Virginia,12,Florida,39,Gadsden County,3,0,3
54,West Virginia,12,Florida,53,Hernando County,9,45,-36
54,West Virginia,12,Florida,55,Highlands County,0,69,-69
54,West Virginia,12,Florida,57,Hillsborough County,89,255,-166
54,West Virginia,12,Florida,61,Indian River County,59,0,59
54,West Virginia,12,Florida,63,Jackson County,8,0,8
54,West Virginia,12,Florida,69,Lake County,17,111,-94
54,West Virginia,12,Florida,71,Lee County,22,41,-19
54,West Virginia,12,Florida,73,Leon County,56,0,56
54,West Virginia,12,Florida,81,Manatee County,60,99,-39
54,West Virginia,12,Florida,83,Marion County,63,83,-20
54,West Virginia,12,Florida,85,Martin County,56,65,-9
54,West Virginia,12,Florida,86,Miami-Dade County,132,72,60
54,West Virginia,12,Florida,87,Monroe County,0,19,-19
54,West Virginia,12,Florida,91,Okaloosa County,24,14,10
54,West Virginia,12,Florida,95,Orange County,205,81,124
54,West Virginia,12,Florida,97,Osceola County,29,25,4
54,West Virginia,12,Florida,99,Palm Beach County,148,48,100
54,West Virginia,12,Florida,101,Pasco County,168,145,23
54,West Virginia,12,Florida,103,Pinellas County,115,82,33
54,West Virginia,12,Florida,105,Polk County,63,190,-127
54,West Virginia,12,Florida,107,Putnam County,53,0,53
54,West Virginia,12,Florida,109,St. Johns County,102,14,88
54,West Virginia,12,Florida,111,St. Lucie County,46,0,46
54,West Virginia,12,Florida,113,Santa Rosa County,70,93,-23
54,West Virginia,12,Florida,115,Sarasota County,63,248,-185
54,West Virginia,12,Florida,117,Seminole County,12,111,-99
54,West Virginia,12,Florida,119,Sumter County,0,144,-144
54,West Virginia,12,Florida,127,Volusia County,212,63,149
54,West Virginia,13,Georgia,13,Barrow County,58,0,58
54,West Virginia,13,Georgia,19,Berrien County,0,11,-11
54,West Virginia,13,Georgia,21,Bibb County,0,16,-16
54,West Virginia,13,Georgia,29,Bryan County,26,0,26
54,West Virginia,13,Georgia,31,Bulloch County,4,18,-14
54,West Virginia,13,Georgia,39,Camden County,3,10,-7
54,West Virginia,13,Georgia,43,Candler County,0,4,-4
54,West Virginia,13,Georgia,45,Carroll County,0,36,-36
54,West Virginia,13,Georgia,51,Chatham County,0,31,-31
54,West Virginia,13,Georgia,53,Chattahoochee County,0,10,-10
54,West Virginia,13,Georgia,55,Chattooga County,0,1,-1
54,West Virginia,13,Georgia,57,Cherokee County,32,3,29
54,West Virginia,13,Georgia,59,Clarke County,19,0,19
54,West Virginia,13,Georgia,65,Clinch County,17,0,17
54,West Virginia,13,Georgia,67,Cobb County,34,46,-12
54,West Virginia,13,Georgia,71,Colquitt County,0,14,-14
54,West Virginia,13,Georgia,73,Columbia County,0,43,-43
54,West Virginia,13,Georgia,77,Coweta County,0,14,-14
54,West Virginia,13,Georgia,87,Decatur County,0,54,-54
54,West Virginia,13,Georgia,89,DeKalb County,93,21,72
54,West Virginia,13,Georgia,97,Douglas County,168,1,167
54,West Virginia,13,Georgia,103,Effingham County,0,24,-24
54,West Virginia,13,Georgia,107,Emanuel County,0,1,-1
54,West Virginia,13,Georgia,113,Fayette County,29,8,21
54,West Virginia,13,Georgia,115,Floyd County,21,0,21
54,West Virginia,13,Georgia,117,Forsyth County,6,9,-3
54,West Virginia,13,Georgia,121,Fulton County,32,70,-38
54,West Virginia,13,Georgia,135,Gwinnett County,83,88,-5
54,West Virginia,13,Georgia,145,Harris County,0,7,-7
54,West Virginia,13,Georgia,151,Henry County,51,0,51
54,West Virginia,13,Georgia,157,Jackson County,0,96,-96
54,West Virginia,13,Georgia,175,Laurens County,8,0,8
54,West Virginia,13,Georgia,179,Liberty County,47,8,39
54,West Virginia,13,Georgia,185,Lowndes County,0,10,-10
54,West Virginia,13,Georgia,189,McDuffie County,15,0,15
54,West Virginia,13,Georgia,201,Miller County,0,4,-4
54,West Virginia,13,Georgia,215,Muscogee County,0,71,-71
54,West Virginia,13,Georgia,217,Newton County,0,5,-5
54,West Virginia,13,Georgia,219,Oconee County,0,74,-74
54,West Virginia,13,Georgia,223,Paulding County,13,0,13
54,West Virginia,13,Georgia,245,Richmond County,0,6,-6
54,West Virginia,13,Georgia,257,Stephens County,0,5,-5
54,West Virginia,13,Georgia,279,Toombs County,26,0,26
54,West Virginia,13,Georgia,281,Towns County,0,12,-12
54,West Virginia,13,Georgia,285,Troup County,40,11,29
54,West Virginia,13,Georgia,291,Union County,0,1,-1
54,West Virginia,13,Georgia,311,White County,96,0,96
54,West Virginia,13,Georgia,313,Whitfield County,0,1,-1
54,West Virginia,15,Hawaii,3,Honolulu County,0,27,-27
54,West Virginia,16,Idaho,1,Ada County,24,47,-23
54,West Virginia,16,Idaho,19,Bonneville County,5,0,5
54,West Virginia,16,Idaho,27,Canyon County,19,70,-51
54,West Virginia,16,Idaho,33,Clark County,0,20,-20
54,West Virginia,16,Idaho,65,Madison County,46,0,46
54,West Virginia,17,Illinois,11,Bureau County,8,3,5
54,West Virginia,17,Illinois,31,Cook County,88,122,-34
54,West Virginia,17,Illinois,37,DeKalb County,0,22,-22
54,West Virginia,17,Illinois,43,DuPage County,0,9,-9
54,West Virginia,17,Illinois,53,Ford County,0,20,-20
54,West Virginia,17,Illinois,59,Gallatin County,0,3,-3
54,West Virginia,17,Illinois,61,Greene County,0,7,-7
54,West Virginia,17,Illinois,77,Jackson County,0,16,-16
54,West Virginia,17,Illinois,89,Kane County,13,0,13
54,West Virginia,17,Illinois,91,Kankakee County,10,0,10
54,West Virginia,17,Illinois,97,Lake County,30,70,-40
54,West Virginia,17,Illinois,111,McHenry County,28,56,-28
54,West Virginia,17,Illinois,113,McLean County,0,18,-18
54,West Virginia,17,Illinois,117,Macoupin County,0,21,-21
54,West Virginia,17,Illinois,119,Madison County,9,0,9
54,West Virginia,17,Illinois,143,Peoria County,0,26,-26
54,West Virginia,17,Illinois,145,Perry County,24,0,24
54,West Virginia,17,Illinois,159,Richland County,1,0,1
54,West Virginia,17,Illinois,161,Rock Island County,0,133,-133
54,West Virginia,17,Illinois,163,St. Clair County,28,0,28
54,West Virginia,17,Illinois,167,Sangamon County,11,0,11
54,West Virginia,17,Illinois,179,Tazewell County,0,54,-54
54,West Virginia,17,Illinois,183,Vermilion County,0,27,-27
54,West Virginia,17,Illinois,197,Will County,32,0,32
54,West Virginia,17,Illinois,199,Williamson County,26,16,10
54,West Virginia,17,Illinois,201,Winnebago County,0,19,-19
54,West Virginia,18,Indiana,1,Adams County,1,8,-7
54,West Virginia,18,Indiana,3,Allen County,6,19,-13
54,West Virginia,18,Indiana,5,Bartholomew County,21,0,21
54,West Virginia,18,Indiana,11,Boone County,5,0,5
54,West Virginia,18,Indiana,17,Cass County,0,7,-7
54,West Virginia,18,Indiana,35,Delaware County,7,0,7
54,West Virginia,18,Indiana,39,Elkhart County,9,4,5
54,West Virginia,18,Indiana,43,Floyd County,3,0,3
54,West Virginia,18,Indiana,53,Grant County,0,15,-15
54,West Virginia,18,Indiana,57,Hamilton County,60,0,60
54,West Virginia,18,Indiana,61,Harrison County,0,4,-4
54,West Virginia,18,Indiana,63,Hendricks County,5,0,5
54,West Virginia,18,Indiana,67,Howard County,19,0,19
54,West Virginia,18,Indiana,79,Jennings County,6,0,6
54,West Virginia,18,Indiana,81,Johnson County,0,33,-33
54,West Virginia,18,Indiana,83,Knox County,13,0,13
54,West Virginia,18,Indiana,89,Lake County,116,0,116
54,West Virginia,18,Indiana,91,LaPorte County,52,178,-126
54,West Virginia,18,Indiana,95,Madison County,12,2,10
54,West Virginia,18,Indiana,97,Marion County,77,0,77
54,West Virginia,18,Indiana,109,Morgan County,8,0,8
54,West Virginia,18,Indiana,131,Pulaski County,0,16,-16
54,West Virginia,18,Indiana,141,St. Joseph County,6,0,6
54,West Virginia,18,Indiana,157,Tippecanoe County,25,8,17
54,West Virginia,18,Indiana,163,Vanderburgh County,20,0,20
54,West Virginia,18,Indiana,167,Vigo County,51,0,51
54,West Virginia,18,Indiana,177,Wayne County,14,0,14
54,West Virginia,19,Iowa,13,Black Hawk County,0,55,-55
54,West Virginia,19,Iowa,33,Cerro Gordo County,0,2,-2
54,West Virginia,19,Iowa,49,Dallas County,32,0,32
54,West Virginia,19,Iowa,57,Des Moines County,0,19,-19
54,West Virginia,19,Iowa,113,Linn County,0,8,-8
54,West Virginia,19,Iowa,127,Marshall County,6,0,6
54,West Virginia,19,Iowa,153,Polk County,2,50,-48
54,West Virginia,19,Iowa,155,Pottawattamie County,0,8,-8
54,West Virginia,19,Iowa,163,Scott County,0,35,-35
54,West Virginia,19,Iowa,169,Story County,0,10,-10
54,West Virginia,19,Iowa,187,Webster County,12,24,-12
54,West Virginia,2,Alaska,20,Anchorage Municipality,592,23,569
54,West Virginia,2,Alaska,90,Fairbanks North Star Borough,0,18,-18
54,West Virginia,2,Alaska,122,Kenai Peninsula Borough,30,0,30
54,West Virginia,2,Alaska,130,Ketchikan Gateway Borough,0,8,-8
54,West Virginia,20,Kansas,15,Butler County,6,0,6
54,West Virginia,20,Kansas,27,Clay County,0,17,-17
54,West Virginia,20,Kansas,35,Cowley County,0,25,-25
54,West Virginia,20,Kansas,45,Douglas County,0,31,-31
54,West Virginia,20,Kansas,51,Ellis County,32,0,32
54,West Virginia,20,Kansas,61,Geary County,0,5,-5
54,West Virginia,20,Kansas,91,Johnson County,0,35,-35
54,West Virginia,20,Kansas,113,McPherson County,20,0,20
54,West Virginia,20,Kansas,161,Riley County,36,62,-26
54,West Virginia,20,Kansas,209,Wyandotte County,25,0,25
54,West Virginia,21,Kentucky,1,Adair County,0,6,-6
54,West Virginia,21,Kentucky,9,Barren County,0,7,-7
54,West Virginia,21,Kentucky,15,Boone County,49,66,-17
54,West Virginia,21,Kentucky,19,Boyd County,447,298,149
54,West Virginia,21,Kentucky,21,Boyle County,0,6,-6
54,West Virginia,21,Kentucky,27,Breckinridge County,0,4,-4
54,West Virginia,21,Kentucky,29,Bullitt County,0,9,-9
54,West Virginia,21,Kentucky,33,Caldwell County,18,0,18
54,West Virginia,21,Kentucky,35,Calloway County,11,0,11
54,West Virginia,21,Kentucky,37,Campbell County,8,1,7
54,West Virginia,21,Kentucky,43,Carter County,67,94,-27
54,West Virginia,21,Kentucky,45,Casey County,0,5,-5
54,West Virginia,21,Kentucky,47,Christian County,0,51,-51
54,West Virginia,21,Kentucky,49,Clark County,0,81,-81
54,West Virginia,21,Kentucky,55,Crittenden County,0,2,-2
54,West Virginia,21,Kentucky,59,Daviess County,0,33,-33
54,West Virginia,21,Kentucky,67,Fayette County,77,224,-147
54,West Virginia,21,Kentucky,69,Fleming County,0,13,-13
54,West Virginia,21,Kentucky,71,Floyd County,10,43,-33
54,West Virginia,21,Kentucky,73,Franklin County,0,1,-1
54,West Virginia,21,Kentucky,89,Greenup County,46,79,-33
54,West Virginia,21,Kentucky,93,Hardin County,65,0,65
54,West Virginia,21,Kentucky,95,Harlan County,31,0,31
54,West Virginia,21,Kentucky,97,Harrison County,49,0,49
54,West Virginia,21,Kentucky,101,Henderson County,0,8,-8
54,West Virginia,21,Kentucky,103,Henry County,0,13,-13
54,West Virginia,21,Kentucky,111,Jefferson County,112,93,19
54,West Virginia,21,Kentucky,113,Jessamine County,0,43,-43
54,West Virginia,21,Kentucky,115,Johnson County,8,46,-38
54,West Virginia,21,Kentucky,117,Kenton County,38,0,38
54,West Virginia,21,Kentucky,119,Knott County,0,7,-7
54,West Virginia,21,Kentucky,121,Knox County,75,71,4
54,West Virginia,21,Kentucky,125,Laurel County,12,7,5
54,West Virginia,21,Kentucky,127,Lawrence County,13,228,-215
54,West Virginia,21,Kentucky,133,Letcher County,25,40,-15
54,West Virginia,21,Kentucky,135,Lewis County,13,40,-27
54,West Virginia,21,Kentucky,147,McCreary County,0,58,-58
54,West Virginia,21,Kentucky,151,Madison County,29,67,-38
54,West Virginia,21,Kentucky,153,Magoffin County,5,0,5
54,West Virginia,21,Kentucky,159,Martin County,127,150,-23
54,West Virginia,21,Kentucky,161,Mason County,0,40,-40
54,West Virginia,21,Kentucky,163,Meade County,0,15,-15
54,West Virginia,21,Kentucky,167,Mercer County,0,13,-13
54,West Virginia,21,Kentucky,173,Montgomery County,0,7,-7
54,West Virginia,21,Kentucky,185,Oldham County,0,31,-31
54,West Virginia,21,Kentucky,195,Pike County,165,331,-166
54,West Virginia,21,Kentucky,199,Pulaski County,0,22,-22
54,West Virginia,21,Kentucky,205,Rowan County,0,26,-26
54,West Virginia,21,Kentucky,209,Scott County,0,11,-11
54,West Virginia,21,Kentucky,225,Union County,62,25,37
54,West Virginia,21,Kentucky,227,Warren County,0,50,-50
54,West Virginia,21,Kentucky,235,Whitley County,34,0,34
54,West Virginia,22,Louisiana,1,Acadia Parish,29,0,29
54,West Virginia,22,Louisiana,5,Ascension Parish,32,0,32
54,West Virginia,22,Louisiana,15,Bossier Parish,0,6,-6
54,West Virginia,22,Louisiana,19,Calcasieu Parish,4,151,-147
54,West Virginia,22,Louisiana,33,East Baton Rouge Parish,0,63,-63
54,West Virginia,22,Louisiana,55,Lafayette Parish,0,15,-15
54,West Virginia,22,Louisiana,71,Orleans Parish,0,113,-113
54,West Virginia,22,Louisiana,79,Rapides Parish,50,0,50
54,West Virginia,23,Maine,1,Androscoggin County,0,27,-27
54,West Virginia,23,Maine,3,Aroostook County,0,7,-7
54,West Virginia,23,Maine,7,Franklin County,13,0,13
54,West Virginia,23,Maine,9,Hancock County,7,0,7
54,West Virginia,23,Maine,11,Kennebec County,0,11,-11
54,West Virginia,23,Maine,13,Knox County,36,1,35
54,West Virginia,23,Maine,17,Oxford County,13,19,-6
54,West Virginia,23,Maine,19,Penobscot County,52,1,51
54,West Virginia,23,Maine,25,Somerset County,0,6,-6
54,West Virginia,23,Maine,29,Washington County,0,3,-3
54,West Virginia,23,Maine,31,York County,14,0,14
54,West Virginia,24,Maryland,1,Allegany County,622,492,130
54,West Virginia,24,Maryland,3,Anne Arundel County,300,196,104
54,West Virginia,24,Maryland,5,Baltimore County,326,340,-14
54,West Virginia,24,Maryland,9,Calvert County,48,26,22
54,West Virginia,24,Maryland,11,Caroline County,30,0,30
54,West Virginia,24,Maryland,13,Carroll County,56,68,-12
54,West Virginia,24,Maryland,15,Cecil County,82,33,49
54,West Virginia,24,Maryland,17,Charles County,112,0,112
54,West Virginia,24,Maryland,19,Dorchester County,20,0,20
54,West Virginia,24,Maryland,21,Frederick County,806,458,348
54,West Virginia,24,Maryland,23,Garrett County,145,309,-164
54,West Virginia,24,Maryland,25,Harford County,62,98,-36
54,West Virginia,24,Maryland,27,Howard County,119,88,31
54,West Virginia,24,Maryland,29,Kent County,0,21,-21
54,West Virginia,24,Maryland,31,Montgomery County,422,309,113
54,West Virginia,24,Maryland,33,Prince George's County,783,343,440
54,West Virginia,24,Maryland,35,Queen Anne's County,6,45,-39
54,West Virginia,24,Maryland,37,St. Mary's County,171,1,170
54,West Virginia,24,Maryland,39,Somerset County,25,0,25
54,West Virginia,24,Maryland,41,Talbot County,8,2,6
54,West Virginia,24,Maryland,43,Washington County,1724,629,1095
54,West Virginia,24,Maryland,45,Wicomico County,0,11,-11
54,West Virginia,24,Maryland,47,Worcester County,0,16,-16
54,West Virginia,24,Maryland,510,Baltimore city,335,42,293
54,West Virginia,25,Massachusetts,1,Barnstable County,22,0,22
54,West Virginia,25,Massachusetts,5,Bristol County,0,38,-38
54,West Virginia,25,Massachusetts,13,Hampden County,46,11,35
54,West Virginia,25,Massachusetts,15,Hampshire County,13,0,13
54,West Virginia,25,Massachusetts,17,Middlesex County,10,60,-50
54,West Virginia,25,Massachusetts,21,Norfolk County,20,48,-28
54,West Virginia,25,Massachusetts,23,Plymouth County,11,0,11
54,West Virginia,25,Massachusetts,25,Suffolk County,7,7,0
54,West Virginia,25,Massachusetts,27,Worcester County,41,66,-25
54,West Virginia,26,Michigan,21,Berrien County,141,97,44
54,West Virginia,26,Michigan,29,Charlevoix County,0,6,-6
54,West Virginia,26,Michigan,33,Chippewa County,37,0,37
54,West Virginia,26,Michigan,39,Crawford County,7,0,7
54,West Virginia,26,Michigan,43,Dickinson County,0,8,-8
54,West Virginia,26,Michigan,49,Genesee County,39,2,37
54,West Virginia,26,Michigan,51,Gladwin County,0,2,-2
54,West Virginia,26,Michigan,55,Grand Traverse County,0,35,-35
54,West Virginia,26,Michigan,63,Huron County,18,24,-6
54,West Virginia,26,Michigan,65,Ingham County,27,0,27
54,West Virginia,26,Michigan,73,Isabella County,0,43,-43
54,West Virginia,26,Michigan,75,Jackson County,7,10,-3
54,West Virginia,26,Michigan,81,Kent County,70,23,47
54,West Virginia,26,Michigan,87,Lapeer County,29,0,29
54,West Virginia,26,Michigan,91,Lenawee County,0,4,-4
54,West Virginia,26,Michigan,93,Livingston County,22,0,22
54,West Virginia,26,Michigan,99,Macomb County,63,38,25
54,West Virginia,26,Michigan,103,Marquette County,16,0,16
54,West Virginia,26,Michigan,107,Mecosta County,12,0,12
54,West Virginia,26,Michigan,115,Monroe County,7,0,7
54,West Virginia,26,Michigan,125,Oakland County,63,42,21
54,West Virginia,26,Michigan,127,Oceana County,0,10,-10
54,West Virginia,26,Michigan,149,St. Joseph County,0,8,-8
54,West Virginia,26,Michigan,151,Sanilac County,36,0,36
54,West Virginia,26,Michigan,153,Schoolcraft County,0,1,-1
54,West Virginia,26,Michigan,161,Washtenaw County,7,84,-77
54,West Virginia,26,Michigan,163,Wayne County,125,94,31
54,West Virginia,27,Minnesota,27,Clay County,0,94,-94
54,West Virginia,27,Minnesota,35,Crow Wing County,17,0,17
54,West Virginia,27,Minnesota,37,Dakota County,18,29,-11
54,West Virginia,27,Minnesota,39,Dodge County,0,2,-2
54,West Virginia,27,Minnesota,45,Fillmore County,0,7,-7
54,West Virginia,27,Minnesota,49,Goodhue County,8,0,8
54,West Virginia,27,Minnesota,53,Hennepin County,41,190,-149
54,West Virginia,27,Minnesota,73,Lac qui Parle County,0,2,-2
54,West Virginia,27,Minnesota,111,Otter Tail County,0,2,-2
54,West Virginia,27,Minnesota,141,Sherburne County,29,19,10
54,West Virginia,27,Minnesota,143,Sibley County,0,13,-13
54,West Virginia,27,Minnesota,145,Stearns County,0,39,-39
54,West Virginia,27,Minnesota,161,Waseca County,0,9,-9
54,West Virginia,27,Minnesota,163,Washington County,26,0,26
54,West Virginia,28,Mississippi,1,Adams County,0,9,-9
54,West Virginia,28,Mississippi,3,Alcorn County,0,5,-5
54,West Virginia,28,Mississippi,11,Bolivar County,0,51,-51
54,West Virginia,28,Mississippi,29,Copiah County,0,12,-12
54,West Virginia,28,Mississippi,47,Harrison County,70,40,30
54,West Virginia,28,Mississippi,49,Hinds County,5,23,-18
54,West Virginia,28,Mississippi,59,Jackson County,0,13,-13
54,West Virginia,28,Mississippi,67,Jones County,96,0,96
54,West Virginia,28,Mississippi,73,Lamar County,0,34,-34
54,West Virginia,28,Mississippi,75,Lauderdale County,0,2,-2
54,West Virginia,28,Mississippi,89,Madison County,0,7,-7
54,West Virginia,28,Mississippi,121,Rankin County,0,29,-29
54,West Virginia,28,Mississippi,129,Smith County,0,13,-13
54,West Virginia,28,Mississippi,135,Tallahatchie County,0,74,-74
54,West Virginia,28,Mississippi,149,Warren County,0,37,-37
54,West Virginia,28,Mississippi,163,Yazoo County,1,146,-145
54,West Virginia,29,Missouri,13,Bates County,0,28,-28
54,West Virginia,29,Missouri,21,Buchanan County,12,0,12
54,West Virginia,29,Missouri,27,Callaway County,0,22,-22
54,West Virginia,29,Missouri,37,Cass County,0,4,-4
54,West Virginia,29,Missouri,47,Clay County,0,27,-27
54,West Virginia,29,Missouri,49,Clinton County,0,7,-7
54,West Virginia,29,Missouri,77,Greene County,63,0,63
54,West Virginia,29,Missouri,95,Jackson County,24,83,-59
54,West Virginia,29,Missouri,97,Jasper County,4,32,-28
54,West Virginia,29,Missouri,107,Lafayette County,51,0,51
54,West Virginia,29,Missouri,113,Lincoln County,0,6,-6
54,West Virginia,29,Missouri,161,Phelps County,0,19,-19
54,West Virginia,29,Missouri,167,Polk County,0,2,-2
54,West Virginia,29,Missouri,169,Pulaski County,14,159,-145
54,West Virginia,29,Missouri,171,Putnam County,0,1,-1
54,West Virginia,29,Missouri,183,St. Charles County,0,12,-12
54,West Virginia,29,Missouri,189,St. Louis County,87,17,70
54,West Virginia,29,Missouri,207,Stoddard County,0,11,-11
54,West Virginia,29,Missouri,510,St. Louis city,0,8,-8
54,West Virginia,30,Montana,9,Carbon County,0,6,-6
54,West Virginia,30,Montana,13,Cascade County,0,21,-21
54,West Virginia,30,Montana,31,Gallatin County,0,11,-11
54,West Virginia,30,Montana,39,Granite County,0,4,-4
54,West Virginia,30,Montana,47,Lake County,11,0,11
54,West Virginia,30,Montana,55,McCone County,0,3,-3
54,West Virginia,30,Montana,63,Missoula County,9,0,9
54,West Virginia,30,Montana,67,Park County,23,4,19
54,West Virginia,30,Montana,81,Ravalli County,36,2,34
54,West Virginia,30,Montana,83,Richland County,0,1,-1
54,West Virginia,30,Montana,85,Roosevelt County,0,9,-9
54,West Virginia,30,Montana,93,Silver Bow County,0,1,-1
54,West Virginia,30,Montana,111,Yellowstone County,10,0,10
54,West Virginia,31,Nebraska,41,Custer County,0,6,-6
54,West Virginia,31,Nebraska,55,Douglas County,0,9,-9
54,West Virginia,31,Nebraska,109,Lancaster County,0,13,-13
54,West Virginia,31,Nebraska,153,Sarpy County,0,20,-20
54,West Virginia,31,Nebraska,157,Scotts Bluff County,55,0,55
54,West Virginia,31,Nebraska,159,Seward County,42,0,42
54,West Virginia,32,Nevada,3,Clark County,11,141,-130
54,West Virginia,32,Nevada,7,Elko County,36,0,36
54,West Virginia,32,Nevada,21,Mineral County,0,1,-1
54,West Virginia,32,Nevada,31,Washoe County,4,39,-35
54,West Virginia,33,New Hampshire,5,Cheshire County,63,0,63
54,West Virginia,33,New Hampshire,7,Coos County,0,67,-67
54,West Virginia,33,New Hampshire,9,Grafton County,35,6,29
54,West Virginia,33,New Hampshire,11,Hillsborough County,0,169,-169
54,West Virginia,33,New Hampshire,15,Rockingham County,22,0,22
54,West Virginia,33,New Hampshire,17,Strafford County,0,7,-7
54,West Virginia,33,New Hampshire,19,Sullivan County,36,0,36
54,West Virginia,34,New Jersey,3,Bergen County,35,0,35
54,West Virginia,34,New Jersey,5,Burlington County,76,37,39
54,West Virginia,34,New Jersey,7,Camden County,62,0,62
54,West Virginia,34,New Jersey,9,Cape May County,0,34,-34
54,West Virginia,34,New Jersey,11,Cumberland County,20,49,-29
54,West Virginia,34,New Jersey,13,Essex County,9,23,-14
54,West Virginia,34,New Jersey,15,Gloucester County,20,37,-17
54,West Virginia,34,New Jersey,17,Hudson County,17,18,-1
54,West Virginia,34,New Jersey,19,Hunterdon County,36,0,36
54,West Virginia,34,New Jersey,21,Mercer County,59,0,59
54,West Virginia,34,New Jersey,23,Middlesex County,45,22,23
54,West Virginia,34,New Jersey,25,Monmouth County,112,39,73
54,West Virginia,34,New Jersey,27,Morris County,36,99,-63
54,West Virginia,34,New Jersey,29,Ocean County,17,25,-8
54,West Virginia,34,New Jersey,31,Passaic County,19,37,-18
54,West Virginia,34,New Jersey,33,Salem County,48,0,48
54,West Virginia,34,New Jersey,35,Somerset County,38,17,21
54,West Virginia,34,New Jersey,37,Sussex County,22,0,22
54,West Virginia,34,New Jersey,39,Union County,21,0,21
54,West Virginia,34,New Jersey,41,Warren County,47,7,40
54,West Virginia,35,New Mexico,1,Bernalillo County,79,0,79
54,West Virginia,35,New Mexico,5,Chaves County,0,7,-7
54,West Virginia,35,New Mexico,7,Colfax County,22,0,22
54,West Virginia,35,New Mexico,13,Doña Ana County,14,0,14
54,West Virginia,35,New Mexico,15,Eddy County,0,6,-6
54,West Virginia,35,New Mexico,17,Grant County,0,28,-28
54,West Virginia,35,New Mexico,25,Lea County,0,14,-14
54,West Virginia,35,New Mexico,35,Otero County,0,7,-7
54,West Virginia,35,New Mexico,37,Quay County,0,16,-16
54,West Virginia,35,New Mexico,49,Santa Fe County,0,1,-1
54,West Virginia,36,New York,1,Albany County,8,81,-73
54,West Virginia,36,New York,3,Allegany County,0,17,-17
54,West Virginia,36,New York,5,Bronx County,143,9,134
54,West Virginia,36,New York,7,Broome County,23,17,6
54,West Virginia,36,New York,9,Cattaraugus County,22,0,22
54,West Virginia,36,New York,13,Chautauqua County,0,6,-6
54,West Virginia,36,New York,19,Clinton County,15,0,15
54,West Virginia,36,New York,21,Columbia County,0,5,-5
54,West Virginia,36,New York,25,Delaware County,0,12,-12
54,West Virginia,36,New York,27,Dutchess County,0,2,-2
54,West Virginia,36,New York,29,Erie County,28,9,19
54,West Virginia,36,New York,31,Essex County,26,0,26
54,West Virginia,36,New York,33,Franklin County,33,11,22
54,West Virginia,36,New York,35,Fulton County,5,0,5
54,West Virginia,36,New York,37,Genesee County,0,5,-5
54,West Virginia,36,New York,43,Herkimer County,0,8,-8
54,West Virginia,36,New York,45,Jefferson County,38,0,38
54,West Virginia,36,New York,47,Kings County,32,57,-25
54,West Virginia,36,New York,55,Monroe County,47,55,-8
54,West Virginia,36,New York,59,Nassau County,62,73,-11
54,West Virginia,36,New York,61,New York County,40,8,32
54,West Virginia,36,New York,63,Niagara County,58,17,41
54,West Virginia,36,New York,67,Onondaga County,29,0,29
54,West Virginia,36,New York,69,Ontario County,8,0,8
54,West Virginia,36,New York,71,Orange County,16,13,3
54,West Virginia,36,New York,73,Orleans County,0,26,-26
54,West Virginia,36,New York,75,Oswego County,0,3,-3
54,West Virginia,36,New York,77,Otsego County,0,49,-49
54,West Virginia,36,New York,79,Putnam County,23,0,23
54,West Virginia,36,New York,81,Queens County,32,427,-395
54,West Virginia,36,New York,85,Richmond County,13,13,0
54,West Virginia,36,New York,87,Rockland County,9,0,9
54,West Virginia,36,New York,89,St. Lawrence County,7,3,4
54,West Virginia,36,New York,93,Schenectady County,0,12,-12
54,West Virginia,36,New York,99,Seneca County,0,15,-15
54,West Virginia,36,New York,103,Suffolk County,40,24,16
54,West Virginia,36,New York,105,Sullivan County,0,4,-4
54,West Virginia,36,New York,111,Ulster County,0,4,-4
54,West Virginia,36,New York,117,Wayne County,93,0,93
54,West Virginia,36,New York,119,Westchester County,26,0,26
54,West Virginia,37,North Carolina,1,Alamance County,10,24,-14
54,West Virginia,37,North Carolina,7,Anson County,0,15,-15
54,West Virginia,37,North Carolina,13,Beaufort County,0,26,-26
54,West Virginia,37,North Carolina,15,Bertie County,0,2,-2
54,West Virginia,37,North Carolina,19,Brunswick County,0,60,-60
54,West Virginia,37,North Carolina,21,Buncombe County,291,28,263
54,West Virginia,37,North Carolina,23,Burke County,69,26,43
54,West Virginia,37,North Carolina,25,Cabarrus County,0,5,-5
54,West Virginia,37,North Carolina,27,Caldwell County,132,33,99
54,West Virginia,37,North Carolina,31,Carteret County,0,13,-13
54,West Virginia,37,North Carolina,35,Catawba County,54,52,2
54,West Virginia,37,North Carolina,39,Cherokee County,56,0,56
54,West Virginia,37,North Carolina,45,Cleveland County,95,22,73
54,West Virginia,37,North Carolina,47,Columbus County,0,3,-3
54,West Virginia,37,North Carolina,49,Craven County,45,41,4
54,West Virginia,37,North Carolina,51,Cumberland County,33,110,-77
54,West Virginia,37,North Carolina,53,Currituck County,1,0,1
54,West Virginia,37,North Carolina,55,Dare County,0,29,-29
54,West Virginia,37,North Carolina,57,Davidson County,206,170,36
54,West Virginia,37,North Carolina,59,Davie County,0,214,-214
54,West Virginia,37,North Carolina,61,Duplin County,0,4,-4
54,West Virginia,37,North Carolina,63,Durham County,86,81,5
54,West Virginia,37,North Carolina,67,Forsyth County,199,453,-254
54,West Virginia,37,North Carolina,69,Franklin County,30,0,30
54,West Virginia,37,North Carolina,71,Gaston County,11,9,2
54,West Virginia,37,North Carolina,77,Granville County,19,13,6
54,West Virginia,37,North Carolina,79,Greene County,0,10,-10
54,West Virginia,37,North Carolina,81,Guilford County,57,198,-141
54,West Virginia,37,North Carolina,83,Halifax County,29,40,-11
54,West Virginia,37,North Carolina,85,Harnett County,0,82,-82
54,West Virginia,37,North Carolina,87,Haywood County,8,0,8
54,West Virginia,37,North Carolina,89,Henderson County,0,27,-27
54,West Virginia,37,North Carolina,91,Hertford County,7,59,-52
54,West Virginia,37,North Carolina,97,Iredell County,36,343,-307
54,West Virginia,37,North Carolina,99,Jackson County,0,1,-1
54,West Virginia,37,North Carolina,101,Johnston County,0,17,-17
54,West Virginia,37,North Carolina,107,Lenoir County,5,0,5
54,West Virginia,37,North Carolina,109,Lincoln County,8,19,-11
54,West Virginia,37,North Carolina,113,Macon County,0,32,-32
54,West Virginia,37,North Carolina,119,Mecklenburg County,152,228,-76
54,West Virginia,37,North Carolina,125,Moore County,44,1,43
54,West Virginia,37,North Carolina,129,New Hanover County,96,23,73
54,West Virginia,37,North Carolina,133,Onslow County,48,137,-89
54,West Virginia,37,North Carolina,135,Orange County,26,41,-15
54,West Virginia,37,North Carolina,141,Pender County,1,0,1
54,West Virginia,37,North Carolina,143,Perquimans County,0,18,-18
54,West Virginia,37,North Carolina,145,Person County,8,3,5
54,West Virginia,37,North Carolina,147,Pitt County,0,16,-16
54,West Virginia,37,North Carolina,151,Randolph County,36,49,-13
54,West Virginia,37,North Carolina,155,Robeson County,0,48,-48
54,West Virginia,37,North Carolina,157,Rockingham County,17,33,-16
54,West Virginia,37,North Carolina,159,Rowan County,227,23,204
54,West Virginia,37,North Carolina,161,Rutherford County,0,1,-1
54,West Virginia,37,North Carolina,163,Sampson County,8,62,-54
54,West Virginia,37,North Carolina,167,Stanly County,14,28,-14
54,West Virginia,37,North Carolina,169,Stokes County,26,0,26
54,West Virginia,37,North Carolina,171,Surry County,4,39,-35
54,West Virginia,37,North Carolina,173,Swain County,0,23,-23
54,West Virginia,37,North Carolina,179,Union County,25,170,-145
54,West Virginia,37,North Carolina,183,Wake County,149,244,-95
54,West Virginia,37,North Carolina,185,Warren County,44,0,44
54,West Virginia,37,North Carolina,191,Wayne County,7,0,7
54,West Virginia,37,North Carolina,193,Wilkes County,12,136,-124
54,West Virginia,37,North Carolina,195,Wilson County,0,4,-4
54,West Virginia,37,North Carolina,199,Yancey County,0,17,-17
54,West Virginia,38,North Dakota,13,Burke County,0,11,-11
54,West Virginia,38,North Dakota,17,Cass County,0,34,-34
54,West Virginia,38,North Dakota,35,Grand Forks County,12,0,12
54,West Virginia,38,North Dakota,89,Stark County,0,22,-22
54,West Virginia,38,North Dakota,101,Ward County,13,0,13
54,West Virginia,39,Ohio,3,Allen County,19,4,15
54,West Virginia,39,Ohio,5,Ashland County,21,6,15
54,West Virginia,39,Ohio,7,Ashtabula County,15,4,11
54,West Virginia,39,Ohio,9,Athens County,267,81,186
54,West Virginia,39,Ohio,13,Belmont County,730,908,-178
54,West Virginia,39,Ohio,15,Brown County,0,111,-111
54,West Virginia,39,Ohio,17,Butler County,93,43,50
54,West Virginia,39,Ohio,19,Carroll County,0,12,-12
54,West Virginia,39,Ohio,21,Champaign County,0,2,-2
54,West Virginia,39,Ohio,23,Clark County,104,8,96
54,West Virginia,39,Ohio,25,Clermont County,9,124,-115
54,West Virginia,39,Ohio,27,Clinton County,0,28,-28
54,West Virginia,39,Ohio,29,Columbiana County,345,208,137
54,West Virginia,39,Ohio,31,Coshocton County,13,36,-23
54,West Virginia,39,Ohio,33,Crawford County,0,41,-41
54,West Virginia,39,Ohio,35,Cuyahoga County,344,554,-210
54,West Virginia,39,Ohio,41,Delaware County,52,59,-7
54,West Virginia,39,Ohio,45,Fairfield County,130,296,-166
54,West Virginia,39,Ohio,47,Fayette County,0,13,-13
54,West Virginia,39,Ohio,49,Franklin County,519,919,-400
54,West Virginia,39,Ohio,53,Gallia County,135,466,-331
54,West Virginia,39,Ohio,55,Geauga County,10,0,10
54,West Virginia,39,Ohio,57,Greene County,9,67,-58
54,West Virginia,39,Ohio,59,Guernsey County,0,57,-57
54,West Virginia,39,Ohio,61,Hamilton County,59,161,-102
54,West Virginia,39,Ohio,63,Hancock County,46,8,38
54,West Virginia,39,Ohio,65,Hardin County,0,5,-5
54,West Virginia,39,Ohio,67,Harrison County,35,83,-48
54,West Virginia,39,Ohio,73,Hocking County,7,25,-18
54,West Virginia,39,Ohio,77,Huron County,0,11,-11
54,West Virginia,39,Ohio,79,Jackson County,24,71,-47
54,West Virginia,39,Ohio,81,Jefferson County,433,576,-143
54,West Virginia,39,Ohio,83,Knox County,0,15,-15
54,West Virginia,39,Ohio,85,Lake County,39,20,19
54,West Virginia,39,Ohio,87,Lawrence County,913,1229,-316
54,West Virginia,39,Ohio,89,Licking County,55,51,4
54,West Virginia,39,Ohio,91,Logan County,9,0,9
54,West Virginia,39,Ohio,93,Lorain County,102,104,-2
54,West Virginia,39,Ohio,95,Lucas County,12,81,-69
54,West Virginia,39,Ohio,97,Madison County,5,0,5
54,West Virginia,39,Ohio,99,Mahoning County,112,12,100
54,West Virginia,39,Ohio,101,Marion County,0,9,-9
54,West Virginia,39,Ohio,103,Medina County,54,27,27
54,West Virginia,39,Ohio,105,Meigs County,156,145,11
54,West Virginia,39,Ohio,107,Mercer County,0,37,-37
54,West Virginia,39,Ohio,109,Miami County,10,0,10
54,West Virginia,39,Ohio,111,Monroe County,75,151,-76
54,West Virginia,39,Ohio,113,Montgomery County,63,333,-270
54,West Virginia,39,Ohio,115,Morgan County,40,8,32
54,West Virginia,39,Ohio,117,Morrow County,0,29,-29
54,West Virginia,39,Ohio,119,Muskingum County,11,22,-11
54,West Virginia,39,Ohio,121,Noble County,79,46,33
54,West Virginia,39,Ohio,127,Perry County,8,2,6
54,West Virginia,39,Ohio,129,Pickaway County,23,18,5
54,West Virginia,39,Ohio,131,Pike County,0,9,-9
54,West Virginia,39,Ohio,133,Portage County,26,10,16
54,West Virginia,39,Ohio,137,Putnam County,0,4,-4
54,West Virginia,39,Ohio,139,Richland County,35,5,30
54,West Virginia,39,Ohio,141,Ross County,70,24,46
54,West Virginia,39,Ohio,143,Sandusky County,19,11,8
54,West Virginia,39,Ohio,145,Scioto County,152,109,43
54,West Virginia,39,Ohio,147,Seneca County,0,36,-36
54,West Virginia,39,Ohio,151,Stark County,313,81,232
54,West Virginia,39,Ohio,153,Summit County,174,162,12
54,West Virginia,39,Ohio,155,Trumbull County,210,70,140
54,West Virginia,39,Ohio,157,Tuscarawas County,97,272,-175
54,West Virginia,39,Ohio,159,Union County,3,8,-5
54,West Virginia,39,Ohio,163,Vinton County,75,0,75
54,West Virginia,39,Ohio,165,Warren County,50,23,27
54,West Virginia,39,Ohio,167,Washington County,742,746,-4
54,West Virginia,39,Ohio,169,Wayne County,0,76,-76
54,West Virginia,39,Ohio,171,Williams County,0,11,-11
54,West Virginia,39,Ohio,175,Wyandot County,0,17,-17
54,West Virginia,4,Arizona,3,Cochise County,0,24,-24
54,West Virginia,4,Arizona,9,Graham County,0,6,-6
54,West Virginia,4,Arizona,13,Maricopa County,93,145,-52
54,West Virginia,4,Arizona,19,Pima County,3,170,-167
54,West Virginia,4,Arizona,21,Pinal County,0,62,-62
54,West Virginia,4,Arizona,27,Yuma County,14,0,14
54,West Virginia,40,Oklahoma,11,Blaine County,30,0,30
54,West Virginia,40,Oklahoma,17,Canadian County,18,0,18
54,West Virginia,40,Oklahoma,31,Comanche County,32,84,-52
54,West Virginia,40,Oklahoma,71,Kay County,0,54,-54
54,West Virginia,40,Oklahoma,75,Kiowa County,0,29,-29
54,West Virginia,40,Oklahoma,79,Le Flore County,7,0,7
54,West Virginia,40,Oklahoma,83,Logan County,13,0,13
54,West Virginia,40,Oklahoma,101,Muskogee County,0,3,-3
54,West Virginia,40,Oklahoma,109,Oklahoma County,65,31,34
54,West Virginia,40,Oklahoma,119,Payne County,0,6,-6
54,West Virginia,40,Oklahoma,121,Pittsburg County,0,3,-3
54,West Virginia,40,Oklahoma,139,Texas County,0,14,-14
54,West Virginia,40,Oklahoma,143,Tulsa County,0,70,-70
54,West Virginia,40,Oklahoma,153,Woodward County,0,2,-2
54,West Virginia,41,Oregon,7,Clatsop County,7,9,-2
54,West Virginia,41,Oregon,29,Jackson County,7,8,-1
54,West Virginia,41,Oregon,33,Josephine County,12,0,12
54,West Virginia,41,Oregon,35,Klamath County,1,0,1
54,West Virginia,41,Oregon,39,Lane County,0,31,-31
54,West Virginia,41,Oregon,51,Multnomah County,54,23,31
54,West Virginia,41,Oregon,67,Washington County,10,11,-1
54,West Virginia,42,Pennsylvania,1,Adams County,40,128,-88
54,West Virginia,42,Pennsylvania,3,Allegheny County,929,843,86
54,West Virginia,42,Pennsylvania,5,Armstrong County,92,51,41
54,West Virginia,42,Pennsylvania,7,Beaver County,265,48,217
54,West Virginia,42,Pennsylvania,9,Bedford County,96,36,60
54,West Virginia,42,Pennsylvania,11,Berks County,27,63,-36
54,West Virginia,42,Pennsylvania,13,Blair County,0,8,-8
54,West Virginia,42,Pennsylvania,15,Bradford County,37,14,23
54,West Virginia,42,Pennsylvania,17,Bucks County,56,36,20
54,West Virginia,42,Pennsylvania,19,Butler County,52,55,-3
54,West Virginia,42,Pennsylvania,21,Cambria County,88,8,80
54,West Virginia,42,Pennsylvania,27,Centre County,1,38,-37
54,West Virginia,42,Pennsylvania,29,Chester County,77,87,-10
54,West Virginia,42,Pennsylvania,31,Clarion County,0,12,-12
54,West Virginia,42,Pennsylvania,33,Clearfield County,0,5,-5
54,West Virginia,42,Pennsylvania,35,Clinton County,0,1,-1
54,West Virginia,42,Pennsylvania,37,Columbia County,0,1,-1
54,West Virginia,42,Pennsylvania,39,Crawford County,2,11,-9
54,West Virginia,42,Pennsylvania,41,Cumberland County,125,29,96
54,West Virginia,42,Pennsylvania,43,Dauphin County,11,130,-119
54,West Virginia,42,Pennsylvania,45,Delaware County,43,34,9
54,West Virginia,42,Pennsylvania,49,Erie County,119,156,-37
54,West Virginia,42,Pennsylvania,51,Fayette County,182,301,-119
54,West Virginia,42,Pennsylvania,53,Forest County,0,12,-12
54,West Virginia,42,Pennsylvania,55,Franklin County,461,75,386
54,West Virginia,42,Pennsylvania,57,Fulton County,0,30,-30
54,West Virginia,42,Pennsylvania,59,Greene County,444,239,205
54,West Virginia,42,Pennsylvania,63,Indiana County,10,0,10
54,West Virginia,42,Pennsylvania,65,Jefferson County,0,3,-3
54,West Virginia,42,Pennsylvania,69,Lackawanna County,0,101,-101
54,West Virginia,42,Pennsylvania,71,Lancaster County,62,60,2
54,West Virginia,42,Pennsylvania,73,Lawrence County,9,24,-15
54,West Virginia,42,Pennsylvania,75,Lebanon County,5,31,-26
54,West Virginia,42,Pennsylvania,77,Lehigh County,70,9,61
54,West Virginia,42,Pennsylvania,79,Luzerne County,26,0,26
54,West Virginia,42,Pennsylvania,81,Lycoming County,0,3,-3
54,West Virginia,42,Pennsylvania,83,McKean County,27,25,2
54,West Virginia,42,Pennsylvania,85,Mercer County,19,165,-146
54,West Virginia,42,Pennsylvania,87,Mifflin County,14,13,1
54,West Virginia,42,Pennsylvania,89,Monroe County,0,36,-36
54,West Virginia,42,Pennsylvania,91,Montgomery County,135,107,28
54,West Virginia,42,Pennsylvania,93,Montour County,0,2,-2
54,West Virginia,42,Pennsylvania,95,Northampton County,30,14,16
54,West Virginia,42,Pennsylvania,97,Northumberland County,23,25,-2
54,West Virginia,42,Pennsylvania,99,Perry County,5,0,5
54,West Virginia,42,Pennsylvania,101,Philadelphia County,238,60,178
54,West Virginia,42,Pennsylvania,103,Pike County,0,7,-7
54,West Virginia,42,Pennsylvania,105,Potter County,0,1,-1
54,West Virginia,42,Pennsylvania,107,Schuylkill County,0,114,-114
54,West Virginia,42,Pennsylvania,111,Somerset County,64,58,6
54,West Virginia,42,Pennsylvania,117,Tioga County,0,4,-4
54,West Virginia,42,Pennsylvania,119,Union County,38,96,-58
54,West Virginia,42,Pennsylvania,121,Venango County,4,8,-4
54,West Virginia,42,Pennsylvania,123,Warren County,0,15,-15
54,West Virginia,42,Pennsylvania,125,Washington County,405,348,57
54,West Virginia,42,Pennsylvania,127,Wayne County,11,26,-15
54,West Virginia,42,Pennsylvania,129,Westmoreland County,246,339,-93
54,West Virginia,42,Pennsylvania,131,Wyoming County,0,12,-12
54,West Virginia,42,Pennsylvania,133,York County,92,150,-58
54,West Virginia,44,Rhode Island,5,Newport County,0,13,-13
54,West Virginia,44,Rhode Island,7,Providence County,59,7,52
54,West Virginia,45,South Carolina,3,Aiken County,189,33,156
54,West Virginia,45,South Carolina,7,Anderson County,0,4,-4
54,West Virginia,45,South Carolina,13,Beaufort County,27,38,-11
54,West Virginia,45,South Carolina,15,Berkeley County,47,150,-103
54,West Virginia,45,South Carolina,19,Charleston County,96,113,-17
54,West Virginia,45,South Carolina,23,Chester County,5,8,-3
54,West Virginia,45,South Carolina,25,Chesterfield County,0,4,-4
54,West Virginia,45,South Carolina,27,Clarendon County,0,1,-1
54,West Virginia,45,South Carolina,31,Darlington County,21,0,21
54,West Virginia,45,South Carolina,35,Dorchester County,107,68,39
54,West Virginia,45,South Carolina,37,Edgefield County,0,14,-14
54,West Virginia,45,South Carolina,41,Florence County,36,13,23
54,West Virginia,45,South Carolina,43,Georgetown County,5,0,5
54,West Virginia,45,South Carolina,45,Greenville County,34,118,-84
54,West Virginia,45,South Carolina,47,Greenwood County,0,13,-13
54,West Virginia,45,South Carolina,51,Horry County,173,550,-377
54,West Virginia,45,South Carolina,53,Jasper County,7,5,2
54,West Virginia,45,South Carolina,59,Laurens County,56,6,50
54,West Virginia,45,South Carolina,63,Lexington County,23,57,-34
54,West Virginia,45,South Carolina,67,Marion County,0,207,-207
54,West Virginia,45,South Carolina,71,Newberry County,4,19,-15
54,West Virginia,45,South Carolina,73,Oconee County,0,18,-18
54,West Virginia,45,South Carolina,75,Orangeburg County,0,222,-222
54,West Virginia,45,South Carolina,77,Pickens County,0,137,-137
54,West Virginia,45,South Carolina,79,Richland County,80,80,0
54,West Virginia,45,South Carolina,83,Spartanburg County,43,0,43
54,West Virginia,45,South Carolina,85,Sumter County,15,0,15
54,West Virginia,45,South Carolina,91,York County,14,12,2
54,West Virginia,46,South Dakota,29,Codington County,0,6,-6
54,West Virginia,46,South Dakota,37,Day County,0,29,-29
54,West Virginia,46,South Dakota,99,Minnehaha County,15,0,15
54,West Virginia,46,South Dakota,103,Pennington County,11,0,11
54,West Virginia,46,South Dakota,121,Todd County,0,3,-3
54,West Virginia,47,Tennessee,1,Anderson County,0,2,-2
54,West Virginia,47,Tennessee,3,Bedford County,0,122,-122
54,West Virginia,47,Tennessee,9,Blount County,0,60,-60
54,West Virginia,47,Tennessee,11,Bradley County,12,75,-63
54,West Virginia,47,Tennessee,13,Campbell County,0,25,-25
54,West Virginia,47,Tennessee,17,Carroll County,0,18,-18
54,West Virginia,47,Tennessee,19,Carter County,12,86,-74
54,West Virginia,47,Tennessee,23,Chester County,28,0,28
54,West Virginia,47,Tennessee,29,Cocke County,9,8,1
54,West Virginia,47,Tennessee,37,Davidson County,101,64,37
54,West Virginia,47,Tennessee,41,DeKalb County,10,0,10
54,West Virginia,47,Tennessee,49,Fentress County,0,15,-15
54,West Virginia,47,Tennessee,51,Franklin County,0,35,-35
54,West Virginia,47,Tennessee,55,Giles County,0,37,-37
54,West Virginia,47,Tennessee,57,Grainger County,26,0,26
54,West Virginia,47,Tennessee,63,Hamblen County,7,0,7
54,West Virginia,47,Tennessee,65,Hamilton County,118,46,72
54,West Virginia,47,Tennessee,69,Hardeman County,0,3,-3
54,West Virginia,47,Tennessee,73,Hawkins County,11,46,-35
54,West Virginia,47,Tennessee,79,Henry County,11,0,11
54,West Virginia,47,Tennessee,85,Humphreys County,0,4,-4
54,West Virginia,47,Tennessee,89,Jefferson County,175,7,168
54,West Virginia,47,Tennessee,93,Knox County,50,84,-34
54,West Virginia,47,Tennessee,103,Lincoln County,12,0,12
54,West Virginia,47,Tennessee,109,McNairy County,10,0,10
54,West Virginia,47,Tennessee,125,Montgomery County,189,70,119
54,West Virginia,47,Tennessee,137,Pickett County,0,4,-4
54,West Virginia,47,Tennessee,141,Putnam County,0,1,-1
54,West Virginia,47,Tennessee,145,Roane County,21,0,21
54,West Virginia,47,Tennessee,149,Rutherford County,81,15,66
54,West Virginia,47,Tennessee,155,Sevier County,0,25,-25
54,West Virginia,47,Tennessee,157,Shelby County,17,39,-22
54,West Virginia,47,Tennessee,159,Smith County,35,0,35
54,West Virginia,47,Tennessee,163,Sullivan County,41,94,-53
54,West Virginia,47,Tennessee,165,Sumner County,43,0,43
54,West Virginia,47,Tennessee,167,Tipton County,19,0,19
54,West Virginia,47,Tennessee,177,Warren County,13,0,13
54,West Virginia,47,Tennessee,179,Washington County,81,101,-20
54,West Virginia,47,Tennessee,187,Williamson County,0,152,-152
54,West Virginia,48,Texas,27,Bell County,31,42,-11
54,West Virginia,48,Texas,29,Bexar County,105,161,-56
54,West Virginia,48,Texas,41,Brazos County,11,16,-5
54,West Virginia,48,Texas,53,Burnet County,48,105,-57
54,West Virginia,48,Texas,61,Cameron County,0,15,-15
54,West Virginia,48,Texas,85,Collin County,45,18,27
54,West Virginia,48,Texas,99,Coryell County,13,0,13
54,West Virginia,48,Texas,113,Dallas County,79,81,-2
54,West Virginia,48,Texas,121,Denton County,62,1,61
54,West Virginia,48,Texas,139,Ellis County,0,8,-8
54,West Virginia,48,Texas,141,El Paso County,0,186,-186
54,West Virginia,48,Texas,157,Fort Bend County,0,58,-58
54,West Virginia,48,Texas,167,Galveston County,0,11,-11
54,West Virginia,48,Texas,183,Gregg County,0,21,-21
54,West Virginia,48,Texas,187,Guadalupe County,0,84,-84
54,West Virginia,48,Texas,201,Harris County,394,138,256
54,West Virginia,48,Texas,213,Henderson County,0,2,-2
54,West Virginia,48,Texas,221,Hood County,46,0,46
54,West Virginia,48,Texas,227,Howard County,10,0,10
54,West Virginia,48,Texas,231,Hunt County,5,0,5
54,West Virginia,48,Texas,233,Hutchinson County,0,14,-14
54,West Virginia,48,Texas,245,Jefferson County,0,15,-15
54,West Virginia,48,Texas,251,Johnson County,46,0,46
54,West Virginia,48,Texas,303,Lubbock County,139,0,139
54,West Virginia,48,Texas,329,Midland County,2,38,-36
54,West Virginia,48,Texas,339,Montgomery County,0,256,-256
54,West Virginia,48,Texas,347,Nacogdoches County,32,0,32
54,West Virginia,48,Texas,355,Nueces County,18,0,18
54,West Virginia,48,Texas,361,Orange County,16,0,16
54,West Virginia,48,Texas,367,Parker County,18,4,14
54,West Virginia,48,Texas,373,Polk County,0,7,-7
54,West Virginia,48,Texas,381,Randall County,10,0,10
54,West Virginia,48,Texas,439,Tarrant County,50,118,-68
54,West Virginia,48,Texas,441,Taylor County,50,33,17
54,West Virginia,48,Texas,451,Tom Green County,0,22,-22
54,West Virginia,48,Texas,453,Travis County,56,87,-31
54,West Virginia,48,Texas,457,Tyler County,43,0,43
54,West Virginia,48,Texas,459,Upshur County,0,25,-25
54,West Virginia,48,Texas,469,Victoria County,0,115,-115
54,West Virginia,48,Texas,479,Webb County,24,0,24
54,West Virginia,48,Texas,485,Wichita County,0,46,-46
54,West Virginia,48,Texas,489,Willacy County,13,0,13
54,West Virginia,48,Texas,491,Williamson County,0,49,-49
54,West Virginia,48,Texas,499,Wood County,0,47,-47
54,West Virginia,49,Utah,5,Cache County,8,0,8
54,West Virginia,49,Utah,11,Davis County,18,29,-11
54,West Virginia,49,Utah,35,Salt Lake County,119,10,109
54,West Virginia,49,Utah,37,San Juan County,0,1,-1
54,West Virginia,49,Utah,49,Utah County,42,60,-18
54,West Virginia,49,Utah,53,Washington County,18,0,18
54,West Virginia,5,Arkansas,19,Clark County,0,16,-16
54,West Virginia,5,Arkansas,23,Cleburne County,10,0,10
54,West Virginia,5,Arkansas,31,Craighead County,0,22,-22
54,West Virginia,5,Arkansas,33,Crawford County,1,0,1
54,West Virginia,5,Arkansas,43,Drew County,1,0,1
54,West Virginia,5,Arkansas,45,Faulkner County,31,9,22
54,West Virginia,5,Arkansas,57,Hempstead County,0,1,-1
54,West Virginia,5,Arkansas,83,Logan County,0,12,-12
54,West Virginia,5,Arkansas,119,Pulaski County,8,0,8
54,West Virginia,5,Arkansas,137,Stone County,0,10,-10
54,West Virginia,5,Arkansas,139,Union County,0,59,-59
54,West Virginia,5,Arkansas,141,Van Buren County,116,0,116
54,West Virginia,5,Arkansas,145,White County,0,17,-17
54,West Virginia,50,Vermont,7,Chittenden County,0,4,-4
54,West Virginia,50,Vermont,11,Franklin County,0,5,-5
54,West Virginia,50,Vermont,15,Lamoille County,2,9,-7
54,West Virginia,50,Vermont,19,Orleans County,0,7,-7
54,West Virginia,50,Vermont,23,Washington County,3,0,3
54,West Virginia,50,Vermont,25,Windham County,19,19,0
54,West Virginia,51,Virginia,1,Accomack County,38,0,38
54,West Virginia,51,Virginia,3,Albemarle County,0,17,-17
54,West Virginia,51,Virginia,5,Alleghany County,112,303,-191
54,West Virginia,51,Virginia,9,Amherst County,25,44,-19
54,West Virginia,51,Virginia,13,Arlington County,102,111,-9
54,West Virginia,51,Virginia,15,Augusta County,14,28,-14
54,West Virginia,51,Virginia,17,Bath County,0,3,-3
54,West Virginia,51,Virginia,19,Bedford County,7,13,-6
54,West Virginia,51,Virginia,21,Bland County,79,33,46
54,West Virginia,51,Virginia,23,Botetourt County,90,0,90
54,West Virginia,51,Virginia,25,Brunswick County,0,4,-4
54,West Virginia,51,Virginia,27,Buchanan County,40,0,40
54,West Virginia,51,Virginia,29,Buckingham County,5,0,5
54,West Virginia,51,Virginia,33,Caroline County,0,74,-74
54,West Virginia,51,Virginia,35,Carroll County,0,25,-25
54,West Virginia,51,Virginia,36,Charles City County,0,10,-10
54,West Virginia,51,Virginia,41,Chesterfield County,185,200,-15
54,West Virginia,51,Virginia,43,Clarke County,32,39,-7
54,West Virginia,51,Virginia,45,Craig County,0,11,-11
54,West Virginia,51,Virginia,47,Culpeper County,0,46,-46
54,West Virginia,51,Virginia,49,Cumberland County,0,23,-23
54,West Virginia,51,Virginia,51,Dickenson County,0,11,-11
54,West Virginia,51,Virginia,53,Dinwiddie County,0,10,-10
54,West Virginia,51,Virginia,57,Essex County,20,0,20
54,West Virginia,51,Virginia,59,Fairfax County,504,214,290
54,West Virginia,51,Virginia,61,Fauquier County,137,7,130
54,West Virginia,51,Virginia,65,Fluvanna County,0,13,-13
54,West Virginia,51,Virginia,67,Franklin County,11,0,11
54,West Virginia,51,Virginia,69,Frederick County,586,523,63
54,West Virginia,51,Virginia,71,Giles County,284,188,96
54,West Virginia,51,Virginia,73,Gloucester County,8,6,2
54,West Virginia,51,Virginia,75,Goochland County,0,2,-2
54,West Virginia,51,Virginia,81,Greensville County,0,11,-11
54,West Virginia,51,Virginia,85,Hanover County,0,34,-34
54,West Virginia,51,Virginia,87,Henrico County,52,28,24
54,West Virginia,51,Virginia,89,Henry County,7,29,-22
54,West Virginia,51,Virginia,93,Isle of Wight County,0,13,-13
54,West Virginia,51,Virginia,95,James City County,37,7,30
54,West Virginia,51,Virginia,99,King George County,6,0,6
54,West Virginia,51,Virginia,105,Lee County,32,104,-72
54,West Virginia,51,Virginia,107,Loudoun County,730,396,334
54,West Virginia,51,Virginia,109,Louisa County,37,0,37
54,West Virginia,51,Virginia,113,Madison County,0,58,-58
54,West Virginia,51,Virginia,121,Montgomery County,139,157,-18
54,West Virginia,51,Virginia,125,Nelson County,27,0,27
54,West Virginia,51,Virginia,127,New Kent County,70,0,70
54,West Virginia,51,Virginia,131,Northampton County,6,1,5
54,West Virginia,51,Virginia,137,Orange County,0,13,-13
54,West Virginia,51,Virginia,139,Page County,27,23,4
54,West Virginia,51,Virginia,143,Pittsylvania County,0,100,-100
54,West Virginia,51,Virginia,145,Powhatan County,0,20,-20
54,West Virginia,51,Virginia,147,Prince Edward County,9,29,-20
54,West Virginia,51,Virginia,149,Prince George County,42,95,-53
54,West Virginia,51,Virginia,153,Prince William County,421,108,313
54,West Virginia,51,Virginia,155,Pulaski County,102,30,72
54,West Virginia,51,Virginia,161,Roanoke County,96,203,-107
54,West Virginia,51,Virginia,163,Rockbridge County,46,22,24
54,West Virginia,51,Virginia,165,Rockingham County,19,35,-16
54,West Virginia,51,Virginia,167,Russell County,0,60,-60
54,West Virginia,51,Virginia,169,Scott County,10,0,10
54,West Virginia,51,Virginia,171,Shenandoah County,38,122,-84
54,West Virginia,51,Virginia,173,Smyth County,0,3,-3
54,West Virginia,51,Virginia,177,Spotsylvania County,138,155,-17
54,West Virginia,51,Virginia,179,Stafford County,103,31,72
54,West Virginia,51,Virginia,183,Sussex County,0,1,-1
54,West Virginia,51,Virginia,185,Tazewell County,435,627,-192
54,West Virginia,51,Virginia,187,Warren County,53,44,9
54,West Virginia,51,Virginia,191,Washington County,27,122,-95
54,West Virginia,51,Virginia,193,Westmoreland County,5,11,-6
54,West Virginia,51,Virginia,195,Wise County,0,13,-13
54,West Virginia,51,Virginia,197,Wythe County,36,100,-64
54,West Virginia,51,Virginia,199,York County,64,20,44
54,West Virginia,51,Virginia,510,Alexandria city,85,50,35
54,West Virginia,51,Virginia,520,Bristol city,0,58,-58
54,West Virginia,51,Virginia,540,Charlottesville city,1,11,-10
54,West Virginia,51,Virginia,550,Chesapeake city,80,145,-65
54,West Virginia,51,Virginia,570,Colonial Heights city,12,28,-16
54,West Virginia,51,Virginia,580,Covington city,91,19,72
54,West Virginia,51,Virginia,590,Danville city,0,12,-12
54,West Virginia,51,Virginia,595,Emporia city,0,49,-49
54,West Virginia,51,Virginia,600,Fairfax city,8,8,0
54,West Virginia,51,Virginia,610,Falls Church city,6,0,6
54,West Virginia,51,Virginia,630,Fredericksburg city,31,0,31
54,West Virginia,51,Virginia,640,Galax city,11,0,11
54,West Virginia,51,Virginia,650,Hampton city,30,141,-111
54,West Virginia,51,Virginia,660,Harrisonburg city,42,84,-42
54,West Virginia,51,Virginia,670,Hopewell city,7,13,-6
54,West Virginia,51,Virginia,678,Lexington city,0,15,-15
54,West Virginia,51,Virginia,680,Lynchburg city,0,62,-62
54,West Virginia,51,Virginia,683,Manassas city,33,0,33
54,West Virginia,51,Virginia,685,Manassas Park city,0,5,-5
54,West Virginia,51,Virginia,690,Martinsville city,0,9,-9
54,West Virginia,51,Virginia,700,Newport News city,56,9,47
54,West Virginia,51,Virginia,710,Norfolk city,32,9,23
54,West Virginia,51,Virginia,730,Petersburg city,40,0,40
54,West Virginia,51,Virginia,735,Poquoson city,0,23,-23
54,West Virginia,51,Virginia,740,Portsmouth city,28,47,-19
54,West Virginia,51,Virginia,750,Radford city,17,35,-18
54,West Virginia,51,Virginia,760,Richmond city,4,64,-60
54,West Virginia,51,Virginia,770,Roanoke city,70,246,-176
54,West Virginia,51,Virginia,775,Salem city,4,33,-29
54,West Virginia,51,Virginia,800,Suffolk city,0,81,-81
54,West Virginia,51,Virginia,810,Virginia Beach city,90,163,-73
54,West Virginia,51,Virginia,820,Waynesboro city,0,107,-107
54,West Virginia,51,Virginia,830,Williamsburg city,0,11,-11
54,West Virginia,51,Virginia,840,Winchester city,191,179,12
54,West Virginia,53,Washington,9,Clallam County,35,0,35
54,West Virginia,53,Washington,11,Clark County,0,82,-82
54,West Virginia,53,Washington,23,Garfield County,0,18,-18
54,West Virginia,53,Washington,33,King County,80,157,-77
54,West Virginia,53,Washington,35,Kitsap County,0,28,-28
54,West Virginia,53,Washington,41,Lewis County,0,26,-26
54,West Virginia,53,Washington,47,Okanogan County,0,16,-16
54,West Virginia,53,Washington,53,Pierce County,7,75,-68
54,West Virginia,53,Washington,57,Skagit County,0,11,-11
54,West Virginia,53,Washington,61,Snohomish County,25,22,3
54,West Virginia,53,Washington,77,Yakima County,16,0,16
54,West Virginia,54,West Virginia,1,Barbour County,1170,520,650
54,West Virginia,54,West Virginia,3,Berkeley County,1710,1813,-103
54,West Virginia,54,West Virginia,5,Boone County,456,596,-140
54,West Virginia,54,West Virginia,7,Braxton County,307,556,-249
54,West Virginia,54,West Virginia,9,Brooke County,719,610,109
54,West Virginia,54,West Virginia,11,Cabell County,2155,3948,-1793
54,West Virginia,54,West Virginia,13,Calhoun County,351,205,146
54,West Virginia,54,West Virginia,15,Clay County,218,229,-11
54,West Virginia,54,West Virginia,17,Doddridge County,143,822,-679
54,West Virginia,54,West Virginia,19,Fayette County,2347,590,1757
54,West Virginia,54,West Virginia,21,Gilmer County,477,333,144
54,West Virginia,54,West Virginia,23,Grant County,338,211,127
54,West Virginia,54,West Virginia,25,Greenbrier County,1269,955,314
54,West Virginia,54,West Virginia,27,Hampshire County,327,500,-173
54,West Virginia,54,West Virginia,29,Hancock County,428,628,-200
54,West Virginia,54,West Virginia,31,Hardy County,265,283,-18
54,West Virginia,54,West Virginia,33,Harrison County,2198,1654,544
54,West Virginia,54,West Virginia,35,Jackson County,801,597,204
54,West Virginia,54,West Virginia,37,Jefferson County,1468,1064,404
54,West Virginia,54,West Virginia,39,Kanawha County,3956,3945,11
54,West Virginia,54,West Virginia,41,Lewis County,721,896,-175
54,West Virginia,54,West Virginia,43,Lincoln County,706,492,214
54,West Virginia,54,West Virginia,45,Logan County,1353,721,632
54,West Virginia,54,West Virginia,47,McDowell County,645,435,210
54,West Virginia,54,West Virginia,49,Marion County,1339,2296,-957
54,West Virginia,54,West Virginia,51,Marshall County,607,602,5
54,West Virginia,54,West Virginia,53,Mason County,415,743,-328
54,West Virginia,54,West Virginia,55,Mercer County,866,927,-61
54,West Virginia,54,West Virginia,57,Mineral County,375,218,157
54,West Virginia,54,West Virginia,59,Mingo County,563,331,232
54,West Virginia,54,West Virginia,61,Monongalia County,2102,4241,-2139
54,West Virginia,54,West Virginia,63,Monroe County,428,352,76
54,West Virginia,54,West Virginia,65,Morgan County,396,211,185
54,West Virginia,54,West Virginia,67,Nicholas County,696,300,396
54,West Virginia,54,West Virginia,69,Ohio County,720,904,-184
54,West Virginia,54,West Virginia,71,Pendleton County,123,111,12
54,West Virginia,54,West Virginia,73,Pleasants County,364,593,-229
54,West Virginia,54,West Virginia,75,Pocahontas County,320,304,16
54,West Virginia,54,West Virginia,77,Preston County,880,991,-111
54,West Virginia,54,West Virginia,79,Putnam County,2269,1212,1057
54,West Virginia,54,West Virginia,81,Raleigh County,2167,2713,-546
54,West Virginia,54,West Virginia,83,Randolph County,941,1209,-268
54,West Virginia,54,West Virginia,85,Ritchie County,339,180,159
54,West Virginia,54,West Virginia,87,Roane County,657,722,-65
54,West Virginia,54,West Virginia,89,Summers County,162,556,-394
54,West Virginia,54,West Virginia,91,Taylor County,655,876,-221
54,West Virginia,54,West Virginia,93,Tucker County,117,214,-97
54,West Virginia,54,West Virginia,95,Tyler County,287,166,121
54,West Virginia,54,West Virginia,97,Upshur County,835,770,65
54,West Virginia,54,West Virginia,99,Wayne County,1329,1081,248
54,West Virginia,54,West Virginia,101,Webster County,540,258,282
54,West Virginia,54,West Virginia,103,Wetzel County,423,240,183
54,West Virginia,54,West Virginia,105,Wirt County,166,153,13
54,West Virginia,54,West Virginia,107,Wood County,1658,1373,285
54,West Virginia,54,West Virginia,109,Wyoming County,480,297,183
54,West Virginia,55,Wisconsin,1,Adams County,13,0,13
54,West Virginia,55,Wisconsin,11,Buffalo County,0,13,-13
54,West Virginia,55,Wisconsin,13,Burnett County,0,5,-5
54,West Virginia,55,Wisconsin,19,Clark County,0,3,-3
54,West Virginia,55,Wisconsin,25,Dane County,0,80,-80
54,West Virginia,55,Wisconsin,55,Jefferson County,10,0,10
54,West Virginia,55,Wisconsin,57,Juneau County,8,0,8
54,West Virginia,55,Wisconsin,59,Kenosha County,21,0,21
54,West Virginia,55,Wisconsin,77,Marquette County,9,0,9
54,West Virginia,55,Wisconsin,79,Milwaukee County,27,16,11
54,West Virginia,55,Wisconsin,95,Polk County,0,2,-2
54,West Virginia,55,Wisconsin,105,Rock County,19,12,7
54,West Virginia,55,Wisconsin,111,Sauk County,73,0,73
54,West Virginia,55,Wisconsin,133,Waukesha County,13,0,13
54,West Virginia,55,Wisconsin,139,Winnebago County,0,69,-69
54,West Virginia,56,Wyoming,21,Laramie County,0,35,-35
54,West Virginia,56,Wyoming,25,Natrona County,0,5,-5
54,West Virginia,56,Wyoming,41,Uinta County,0,3,-3
54,West Virginia,6,California,1,Alameda County,7,68,-61
54,West Virginia,6,California,7,Butte County,92,0,92
54,West Virginia,6,California,13,Contra Costa County,82,0,82
54,West Virginia,6,California,17,El Dorado County,28,0,28
54,West Virginia,6,California,19,Fresno County,0,8,-8
54,West Virginia,6,California,25,Imperial County,17,0,17
54,West Virginia,6,California,29,Kern County,0,19,-19
54,West Virginia,6,California,31,Kings County,17,0,17
54,West Virginia,6,California,37,Los Angeles County,128,56,72
54,West Virginia,6,California,53,Monterey County,78,0,78
54,West Virginia,6,California,59,Orange County,69,12,57
54,West Virginia,6,California,61,Placer County,20,45,-25
54,West Virginia,6,California,65,Riverside County,22,17,5
54,West Virginia,6,California,67,Sacramento County,72,23,49
54,West Virginia,6,California,71,San Bernardino County,194,35,159
54,West Virginia,6,California,73,San Diego County,284,184,100
54,West Virginia,6,California,75,San Francisco County,15,3,12
54,West Virginia,6,California,77,San Joaquin County,0,21,-21
54,West Virginia,6,California,81,San Mateo County,0,74,-74
54,West Virginia,6,California,83,Santa Barbara County,0,7,-7
54,West Virginia,6,California,85,Santa Clara County,1,50,-49
54,West Virginia,6,California,89,Shasta County,0,12,-12
54,West Virginia,6,California,95,Solano County,50,0,50
54,West Virginia,6,California,99,Stanislaus County,2,0,2
54,West Virginia,6,California,107,Tulare County,0,62,-62
54,West Virginia,6,California,111,Ventura County,23,0,23
54,West Virginia,6,California,113,Yolo County,6,6,0
54,West Virginia,6,California,115,Yuba County,18,0,18
54,West Virginia,72,Puerto Rico,21,Bayamón Municipio,3,0,3
54,West Virginia,72,Puerto Rico,29,Canóvanas Municipio,23,0,23
54,West Virginia,72,Puerto Rico,53,Fajardo Municipio,16,0,16
54,West Virginia,72,Puerto Rico,69,Humacao Municipio,9,0,9
54,West Virginia,72,Puerto Rico,113,Ponce Municipio,21,0,21
54,West Virginia,72,Puerto Rico,125,San Germán Municipio,100,0,100
54,West Virginia,72,Puerto Rico,127,San Juan Municipio,50,0,50
54,West Virginia,72,Puerto Rico,135,Toa Alta Municipio,4,0,4
54,West Virginia,8,Colorado,1,Adams County,70,7,63
54,West Virginia,8,Colorado,3,Alamosa County,16,2,14
54,West Virginia,8,Colorado,14,Broomfield County,0,4,-4
54,West Virginia,8,Colorado,23,Costilla County,21,0,21
54,West Virginia,8,Colorado,31,Denver County,30,267,-237
54,West Virginia,8,Colorado,35,Douglas County,8,0,8
54,West Virginia,8,Colorado,41,El Paso County,118,70,48
54,West Virginia,8,Colorado,45,Garfield County,79,0,79
54,West Virginia,8,Colorado,59,Jefferson County,30,0,30
54,West Virginia,8,Colorado,69,Larimer County,68,0,68
54,West Virginia,8,Colorado,71,Las Animas County,0,3,-3
54,West Virginia,8,Colorado,79,Mineral County,0,5,-5
54,West Virginia,8,Colorado,99,Prowers County,18,0,18
54,West Virginia,8,Colorado,101,Pueblo County,0,2,-2
54,West Virginia,8,Colorado,123,Weld County,0,8,-8
54,West Virginia,9,Connecticut,1,Fairfield County,67,9,58
54,West Virginia,9,Connecticut,3,Hartford County,116,0,116
54,West Virginia,9,Connecticut,5,Litchfield County,27,65,-38
54,West Virginia,9,Connecticut,7,Middlesex County,11,0,11
54,West Virginia,9,Connecticut,9,New Haven County,53,8,45
54,West Virginia,9,Connecticut,11,New London County,65,8,57
54,West Virginia,9,Connecticut,13,Tolland County,6,0,6
54,West Virginia,9,Connecticut,15,Windham County,7,0,7
54,West Virginia,AFR,Africa,,-,315,0,0
54,West Virginia,ASI,Asia,,-,1731,0,0
54,West Virginia,CAM,Central America,,-,246,0,0
54,West Virginia,CAR,Caribbean,,-,92,0,0
54,West Virginia,EUR,Europe,,-,742,0,0
54,West Virginia,ISL,U.S. Island Areas,,-,4,0,0
54,West Virginia,NAM,Northern America,,-,89,0,0
54,West Virginia,OCE,Oceania and At Sea,,-,36,0,0
54,West Virginia,SAM,South America,,-,31,0,0
55,Wisconsin,1,Alabama,3,Baldwin County,29,101,-72
55,Wisconsin,1,Alabama,15,Calhoun County,22,0,22
55,Wisconsin,1,Alabama,17,Chambers County,11,0,11
55,Wisconsin,1,Alabama,19,Cherokee County,0,11,-11
55,Wisconsin,1,Alabama,23,Choctaw County,3,0,3
55,Wisconsin,1,Alabama,29,Cleburne County,9,0,9
55,Wisconsin,1,Alabama,31,Coffee County,55,0,55
55,Wisconsin,1,Alabama,45,Dale County,18,0,18
55,Wisconsin,1,Alabama,47,Dallas County,17,0,17
55,Wisconsin,1,Alabama,49,DeKalb County,10,24,-14
55,Wisconsin,1,Alabama,53,Escambia County,0,34,-34
55,Wisconsin,1,Alabama,59,Franklin County,8,8,0
55,Wisconsin,1,Alabama,69,Houston County,0,29,-29
55,Wisconsin,1,Alabama,71,Jackson County,20,0,20
55,Wisconsin,1,Alabama,73,Jefferson County,77,52,25
55,Wisconsin,1,Alabama,75,Lamar County,0,29,-29
55,Wisconsin,1,Alabama,81,Lee County,30,27,3
55,Wisconsin,1,Alabama,87,Macon County,0,7,-7
55,Wisconsin,1,Alabama,89,Madison County,3,0,3
55,Wisconsin,1,Alabama,93,Marion County,0,88,-88
55,Wisconsin,1,Alabama,95,Marshall County,0,23,-23
55,Wisconsin,1,Alabama,97,Mobile County,24,0,24
55,Wisconsin,1,Alabama,101,Montgomery County,18,26,-8
55,Wisconsin,1,Alabama,103,Morgan County,3,0,3
55,Wisconsin,1,Alabama,113,Russell County,9,15,-6
55,Wisconsin,1,Alabama,117,Shelby County,38,0,38
55,Wisconsin,1,Alabama,121,Talladega County,13,0,13
55,Wisconsin,1,Alabama,125,Tuscaloosa County,111,89,22
55,Wisconsin,1,Alabama,127,Walker County,10,0,10
55,Wisconsin,10,Delaware,1,Kent County,28,0,28
55,Wisconsin,10,Delaware,3,New Castle County,83,100,-17
55,Wisconsin,10,Delaware,5,Sussex County,11,0,11
55,Wisconsin,11,District of Columbia,1,District of Columbia,260,234,26
55,Wisconsin,12,Florida,1,Alachua County,120,56,64
55,Wisconsin,12,Florida,3,Baker County,0,17,-17
55,Wisconsin,12,Florida,5,Bay County,56,12,44
55,Wisconsin,12,Florida,7,Bradford County,22,0,22
55,Wisconsin,12,Florida,9,Brevard County,139,282,-143
55,Wisconsin,12,Florida,11,Broward County,176,405,-229
55,Wisconsin,12,Florida,15,Charlotte County,87,323,-236
55,Wisconsin,12,Florida,17,Citrus County,18,56,-38
55,Wisconsin,12,Florida,19,Clay County,14,240,-226
55,Wisconsin,12,Florida,21,Collier County,150,106,44
55,Wisconsin,12,Florida,23,Columbia County,0,14,-14
55,Wisconsin,12,Florida,31,Duval County,207,385,-178
55,Wisconsin,12,Florida,33,Escambia County,0,218,-218
55,Wisconsin,12,Florida,35,Flagler County,28,23,5
55,Wisconsin,12,Florida,45,Gulf County,0,16,-16
55,Wisconsin,12,Florida,47,Hamilton County,7,5,2
55,Wisconsin,12,Florida,49,Hardee County,13,28,-15
55,Wisconsin,12,Florida,53,Hernando County,162,69,93
55,Wisconsin,12,Florida,55,Highlands County,8,102,-94
55,Wisconsin,12,Florida,57,Hillsborough County,413,516,-103
55,Wisconsin,12,Florida,59,Holmes County,0,14,-14
55,Wisconsin,12,Florida,61,Indian River County,6,29,-23
55,Wisconsin,12,Florida,69,Lake County,191,263,-72
55,Wisconsin,12,Florida,71,Lee County,181,1118,-937
55,Wisconsin,12,Florida,73,Leon County,126,89,37
55,Wisconsin,12,Florida,75,Levy County,0,149,-149
55,Wisconsin,12,Florida,81,Manatee County,72,114,-42
55,Wisconsin,12,Florida,83,Marion County,36,243,-207
55,Wisconsin,12,Florida,85,Martin County,98,44,54
55,Wisconsin,12,Florida,86,Miami-Dade County,185,102,83
55,Wisconsin,12,Florida,87,Monroe County,16,66,-50
55,Wisconsin,12,Florida,89,Nassau County,10,17,-7
55,Wisconsin,12,Florida,91,Okaloosa County,46,87,-41
55,Wisconsin,12,Florida,95,Orange County,413,525,-112
55,Wisconsin,12,Florida,97,Osceola County,48,264,-216
55,Wisconsin,12,Florida,99,Palm Beach County,174,58,116
55,Wisconsin,12,Florida,101,Pasco County,38,390,-352
55,Wisconsin,12,Florida,103,Pinellas County,181,715,-534
55,Wisconsin,12,Florida,105,Polk County,170,293,-123
55,Wisconsin,12,Florida,107,Putnam County,5,46,-41
55,Wisconsin,12,Florida,109,St. Johns County,37,92,-55
55,Wisconsin,12,Florida,111,St. Lucie County,74,47,27
55,Wisconsin,12,Florida,113,Santa Rosa County,14,138,-124
55,Wisconsin,12,Florida,115,Sarasota County,78,266,-188
55,Wisconsin,12,Florida,117,Seminole County,27,46,-19
55,Wisconsin,12,Florida,119,Sumter County,79,125,-46
55,Wisconsin,12,Florida,121,Suwannee County,0,63,-63
55,Wisconsin,12,Florida,127,Volusia County,346,140,206
55,Wisconsin,12,Florida,131,Walton County,34,25,9
55,Wisconsin,13,Georgia,1,Appling County,0,2,-2
55,Wisconsin,13,Georgia,13,Barrow County,0,10,-10
55,Wisconsin,13,Georgia,15,Bartow County,21,0,21
55,Wisconsin,13,Georgia,17,Ben Hill County,16,0,16
55,Wisconsin,13,Georgia,21,Bibb County,12,52,-40
55,Wisconsin,13,Georgia,31,Bulloch County,16,0,16
55,Wisconsin,13,Georgia,39,Camden County,41,0,41
55,Wisconsin,13,Georgia,45,Carroll County,39,29,10
55,Wisconsin,13,Georgia,51,Chatham County,79,119,-40
55,Wisconsin,13,Georgia,53,Chattahoochee County,24,0,24
55,Wisconsin,13,Georgia,57,Cherokee County,53,29,24
55,Wisconsin,13,Georgia,59,Clarke County,65,40,25
55,Wisconsin,13,Georgia,63,Clayton County,0,3,-3
55,Wisconsin,13,Georgia,67,Cobb County,179,358,-179
55,Wisconsin,13,Georgia,69,Coffee County,0,12,-12
55,Wisconsin,13,Georgia,73,Columbia County,19,0,19
55,Wisconsin,13,Georgia,77,Coweta County,0,88,-88
55,Wisconsin,13,Georgia,85,Dawson County,0,56,-56
55,Wisconsin,13,Georgia,89,DeKalb County,126,124,2
55,Wisconsin,13,Georgia,95,Dougherty County,0,18,-18
55,Wisconsin,13,Georgia,97,Douglas County,0,2,-2
55,Wisconsin,13,Georgia,103,Effingham County,0,16,-16
55,Wisconsin,13,Georgia,111,Fannin County,0,17,-17
55,Wisconsin,13,Georgia,113,Fayette County,12,0,12
55,Wisconsin,13,Georgia,115,Floyd County,0,19,-19
55,Wisconsin,13,Georgia,117,Forsyth County,7,79,-72
55,Wisconsin,13,Georgia,119,Franklin County,0,18,-18
55,Wisconsin,13,Georgia,121,Fulton County,236,615,-379
55,Wisconsin,13,Georgia,123,Gilmer County,0,3,-3
55,Wisconsin,13,Georgia,127,Glynn County,0,113,-113
55,Wisconsin,13,Georgia,135,Gwinnett County,112,256,-144
55,Wisconsin,13,Georgia,139,Hall County,28,33,-5
55,Wisconsin,13,Georgia,143,Haralson County,18,0,18
55,Wisconsin,13,Georgia,145,Harris County,0,7,-7
55,Wisconsin,13,Georgia,147,Hart County,0,23,-23
55,Wisconsin,13,Georgia,151,Henry County,100,14,86
55,Wisconsin,13,Georgia,153,Houston County,0,18,-18
55,Wisconsin,13,Georgia,157,Jackson County,0,23,-23
55,Wisconsin,13,Georgia,163,Jefferson County,0,1,-1
55,Wisconsin,13,Georgia,171,Lamar County,0,130,-130
55,Wisconsin,13,Georgia,173,Lanier County,0,60,-60
55,Wisconsin,13,Georgia,175,Laurens County,30,20,10
55,Wisconsin,13,Georgia,177,Lee County,0,12,-12
55,Wisconsin,13,Georgia,179,Liberty County,0,15,-15
55,Wisconsin,13,Georgia,185,Lowndes County,18,0,18
55,Wisconsin,13,Georgia,189,McDuffie County,9,0,9
55,Wisconsin,13,Georgia,215,Muscogee County,39,150,-111
55,Wisconsin,13,Georgia,217,Newton County,10,7,3
55,Wisconsin,13,Georgia,219,Oconee County,38,0,38
55,Wisconsin,13,Georgia,235,Pulaski County,0,47,-47
55,Wisconsin,13,Georgia,245,Richmond County,58,8,50
55,Wisconsin,13,Georgia,247,Rockdale County,84,15,69
55,Wisconsin,13,Georgia,255,Spalding County,0,1,-1
55,Wisconsin,13,Georgia,275,Thomas County,12,0,12
55,Wisconsin,13,Georgia,285,Troup County,0,1,-1
55,Wisconsin,13,Georgia,295,Walker County,17,2,15
55,Wisconsin,13,Georgia,297,Walton County,0,28,-28
55,Wisconsin,13,Georgia,305,Wayne County,0,19,-19
55,Wisconsin,13,Georgia,313,Whitfield County,6,294,-288
55,Wisconsin,15,Hawaii,1,Hawaii County,87,29,58
55,Wisconsin,15,Hawaii,3,Honolulu County,376,177,199
55,Wisconsin,15,Hawaii,7,Kauai County,0,21,-21
55,Wisconsin,15,Hawaii,9,Maui County,33,12,21
55,Wisconsin,16,Idaho,1,Ada County,246,24,222
55,Wisconsin,16,Idaho,9,Benewah County,0,4,-4
55,Wisconsin,16,Idaho,11,Bingham County,7,63,-56
55,Wisconsin,16,Idaho,13,Blaine County,35,46,-11
55,Wisconsin,16,Idaho,17,Bonner County,4,0,4
55,Wisconsin,16,Idaho,19,Bonneville County,0,41,-41
55,Wisconsin,16,Idaho,21,Boundary County,0,5,-5
55,Wisconsin,16,Idaho,27,Canyon County,31,22,9
55,Wisconsin,16,Idaho,49,Idaho County,3,0,3
55,Wisconsin,16,Idaho,55,Kootenai County,12,0,12
55,Wisconsin,16,Idaho,57,Latah County,0,38,-38
55,Wisconsin,16,Idaho,59,Lemhi County,0,20,-20
55,Wisconsin,16,Idaho,61,Lewis County,0,8,-8
55,Wisconsin,16,Idaho,67,Minidoka County,0,4,-4
55,Wisconsin,16,Idaho,79,Shoshone County,0,2,-2
55,Wisconsin,16,Idaho,81,Teton County,5,0,5
55,Wisconsin,16,Idaho,83,Twin Falls County,40,0,40
55,Wisconsin,17,Illinois,1,Adams County,53,9,44
55,Wisconsin,17,Illinois,5,Bond County,11,12,-1
55,Wisconsin,17,Illinois,7,Boone County,371,50,321
55,Wisconsin,17,Illinois,11,Bureau County,9,8,1
55,Wisconsin,17,Illinois,15,Carroll County,53,6,47
55,Wisconsin,17,Illinois,17,Cass County,35,0,35
55,Wisconsin,17,Illinois,19,Champaign County,524,172,352
55,Wisconsin,17,Illinois,21,Christian County,6,22,-16
55,Wisconsin,17,Illinois,25,Clay County,15,0,15
55,Wisconsin,17,Illinois,27,Clinton County,42,2,40
55,Wisconsin,17,Illinois,29,Coles County,51,0,51
55,Wisconsin,17,Illinois,31,Cook County,9845,5189,4656
55,Wisconsin,17,Illinois,33,Crawford County,5,0,5
55,Wisconsin,17,Illinois,35,Cumberland County,6,0,6
55,Wisconsin,17,Illinois,37,DeKalb County,441,85,356
55,Wisconsin,17,Illinois,39,De Witt County,23,0,23
55,Wisconsin,17,Illinois,41,Douglas County,23,0,23
55,Wisconsin,17,Illinois,43,DuPage County,1678,762,916
55,Wisconsin,17,Illinois,45,Edgar County,27,0,27
55,Wisconsin,17,Illinois,49,Effingham County,4,0,4
55,Wisconsin,17,Illinois,53,Ford County,0,86,-86
55,Wisconsin,17,Illinois,57,Fulton County,30,0,30
55,Wisconsin,17,Illinois,61,Greene County,17,0,17
55,Wisconsin,17,Illinois,63,Grundy County,28,27,1
55,Wisconsin,17,Illinois,67,Hancock County,7,0,7
55,Wisconsin,17,Illinois,71,Henderson County,3,0,3
55,Wisconsin,17,Illinois,73,Henry County,73,0,73
55,Wisconsin,17,Illinois,75,Iroquois County,0,43,-43
55,Wisconsin,17,Illinois,77,Jackson County,62,174,-112
55,Wisconsin,17,Illinois,81,Jefferson County,10,0,10
55,Wisconsin,17,Illinois,83,Jersey County,49,8,41
55,Wisconsin,17,Illinois,85,Jo Daviess County,148,149,-1
55,Wisconsin,17,Illinois,87,Johnson County,3,2,1
55,Wisconsin,17,Illinois,89,Kane County,1172,505,667
55,Wisconsin,17,Illinois,91,Kankakee County,149,32,117
55,Wisconsin,17,Illinois,93,Kendall County,299,33,266
55,Wisconsin,17,Illinois,95,Knox County,55,26,29
55,Wisconsin,17,Illinois,97,Lake County,4436,2437,1999
55,Wisconsin,17,Illinois,99,LaSalle County,191,44,147
55,Wisconsin,17,Illinois,101,Lawrence County,8,0,8
55,Wisconsin,17,Illinois,103,Lee County,189,8,181
55,Wisconsin,17,Illinois,105,Livingston County,3,44,-41
55,Wisconsin,17,Illinois,107,Logan County,24,8,16
55,Wisconsin,17,Illinois,109,McDonough County,16,22,-6
55,Wisconsin,17,Illinois,111,McHenry County,1969,878,1091
55,Wisconsin,17,Illinois,113,McLean County,105,197,-92
55,Wisconsin,17,Illinois,115,Macon County,16,194,-178
55,Wisconsin,17,Illinois,119,Madison County,89,209,-120
55,Wisconsin,17,Illinois,125,Mason County,8,0,8
55,Wisconsin,17,Illinois,137,Morgan County,13,0,13
55,Wisconsin,17,Illinois,141,Ogle County,248,109,139
55,Wisconsin,17,Illinois,143,Peoria County,318,236,82
55,Wisconsin,17,Illinois,145,Perry County,42,0,42
55,Wisconsin,17,Illinois,147,Piatt County,12,6,6
55,Wisconsin,17,Illinois,149,Pike County,0,2,-2
55,Wisconsin,17,Illinois,157,Randolph County,0,2,-2
55,Wisconsin,17,Illinois,161,Rock Island County,128,239,-111
55,Wisconsin,17,Illinois,163,St. Clair County,114,39,75
55,Wisconsin,17,Illinois,165,Saline County,0,1,-1
55,Wisconsin,17,Illinois,167,Sangamon County,112,122,-10
55,Wisconsin,17,Illinois,171,Scott County,0,3,-3
55,Wisconsin,17,Illinois,177,Stephenson County,484,200,284
55,Wisconsin,17,Illinois,179,Tazewell County,183,21,162
55,Wisconsin,17,Illinois,181,Union County,3,0,3
55,Wisconsin,17,Illinois,183,Vermilion County,41,80,-39
55,Wisconsin,17,Illinois,185,Wabash County,9,0,9
55,Wisconsin,17,Illinois,187,Warren County,10,3,7
55,Wisconsin,17,Illinois,195,Whiteside County,73,97,-24
55,Wisconsin,17,Illinois,197,Will County,930,378,552
55,Wisconsin,17,Illinois,199,Williamson County,3,39,-36
55,Wisconsin,17,Illinois,201,Winnebago County,2040,1293,747
55,Wisconsin,17,Illinois,203,Woodford County,4,14,-10
55,Wisconsin,18,Indiana,3,Allen County,215,289,-74
55,Wisconsin,18,Indiana,5,Bartholomew County,89,0,89
55,Wisconsin,18,Indiana,11,Boone County,89,0,89
55,Wisconsin,18,Indiana,13,Brown County,0,19,-19
55,Wisconsin,18,Indiana,15,Carroll County,26,12,14
55,Wisconsin,18,Indiana,19,Clark County,56,71,-15
55,Wisconsin,18,Indiana,23,Clinton County,27,12,15
55,Wisconsin,18,Indiana,25,Crawford County,28,0,28
55,Wisconsin,18,Indiana,27,Daviess County,0,46,-46
55,Wisconsin,18,Indiana,35,Delaware County,37,136,-99
55,Wisconsin,18,Indiana,37,Dubois County,0,12,-12
55,Wisconsin,18,Indiana,39,Elkhart County,16,16,0
55,Wisconsin,18,Indiana,43,Floyd County,7,31,-24
55,Wisconsin,18,Indiana,45,Fountain County,36,0,36
55,Wisconsin,18,Indiana,47,Franklin County,5,0,5
55,Wisconsin,18,Indiana,51,Gibson County,6,0,6
55,Wisconsin,18,Indiana,53,Grant County,16,13,3
55,Wisconsin,18,Indiana,57,Hamilton County,167,92,75
55,Wisconsin,18,Indiana,59,Hancock County,5,0,5
55,Wisconsin,18,Indiana,63,Hendricks County,35,52,-17
55,Wisconsin,18,Indiana,67,Howard County,36,18,18
55,Wisconsin,18,Indiana,69,Huntington County,23,32,-9
55,Wisconsin,18,Indiana,71,Jackson County,6,0,6
55,Wisconsin,18,Indiana,73,Jasper County,73,8,65
55,Wisconsin,18,Indiana,75,Jay County,0,9,-9
55,Wisconsin,18,Indiana,77,Jefferson County,0,9,-9
55,Wisconsin,18,Indiana,81,Johnson County,16,92,-76
55,Wisconsin,18,Indiana,85,Kosciusko County,12,33,-21
55,Wisconsin,18,Indiana,87,LaGrange County,16,15,1
55,Wisconsin,18,Indiana,89,Lake County,469,141,328
55,Wisconsin,18,Indiana,91,LaPorte County,46,54,-8
55,Wisconsin,18,Indiana,93,Lawrence County,22,0,22
55,Wisconsin,18,Indiana,95,Madison County,17,0,17
55,Wisconsin,18,Indiana,97,Marion County,284,552,-268
55,Wisconsin,18,Indiana,99,Marshall County,0,9,-9
55,Wisconsin,18,Indiana,105,Monroe County,152,293,-141
55,Wisconsin,18,Indiana,107,Montgomery County,1,122,-121
55,Wisconsin,18,Indiana,109,Morgan County,0,23,-23
55,Wisconsin,18,Indiana,111,Newton County,0,11,-11
55,Wisconsin,18,Indiana,113,Noble County,32,0,32
55,Wisconsin,18,Indiana,121,Parke County,9,0,9
55,Wisconsin,18,Indiana,125,Pike County,7,0,7
55,Wisconsin,18,Indiana,127,Porter County,81,265,-184
55,Wisconsin,18,Indiana,129,Posey County,5,0,5
55,Wisconsin,18,Indiana,131,Pulaski County,5,0,5
55,Wisconsin,18,Indiana,133,Putnam County,0,9,-9
55,Wisconsin,18,Indiana,137,Ripley County,5,3,2
55,Wisconsin,18,Indiana,139,Rush County,2,0,2
55,Wisconsin,18,Indiana,141,St. Joseph County,141,199,-58
55,Wisconsin,18,Indiana,145,Shelby County,0,151,-151
55,Wisconsin,18,Indiana,149,Starke County,8,0,8
55,Wisconsin,18,Indiana,151,Steuben County,54,3,51
55,Wisconsin,18,Indiana,153,Sullivan County,6,0,6
55,Wisconsin,18,Indiana,157,Tippecanoe County,70,97,-27
55,Wisconsin,18,Indiana,161,Union County,6,0,6
55,Wisconsin,18,Indiana,163,Vanderburgh County,20,74,-54
55,Wisconsin,18,Indiana,165,Vermillion County,0,3,-3
55,Wisconsin,18,Indiana,167,Vigo County,41,31,10
55,Wisconsin,18,Indiana,171,Warren County,4,0,4
55,Wisconsin,18,Indiana,173,Warrick County,4,0,4
55,Wisconsin,18,Indiana,177,Wayne County,0,28,-28
55,Wisconsin,18,Indiana,181,White County,7,0,7
55,Wisconsin,18,Indiana,183,Whitley County,2,0,2
55,Wisconsin,19,Iowa,1,Adair County,3,9,-6
55,Wisconsin,19,Iowa,5,Allamakee County,57,27,30
55,Wisconsin,19,Iowa,7,Appanoose County,0,11,-11
55,Wisconsin,19,Iowa,11,Benton County,7,0,7
55,Wisconsin,19,Iowa,13,Black Hawk County,155,103,52
55,Wisconsin,19,Iowa,15,Boone County,31,7,24
55,Wisconsin,19,Iowa,17,Bremer County,61,22,39
55,Wisconsin,19,Iowa,19,Buchanan County,60,0,60
55,Wisconsin,19,Iowa,21,Buena Vista County,0,52,-52
55,Wisconsin,19,Iowa,25,Calhoun County,4,0,4
55,Wisconsin,19,Iowa,29,Cass County,6,0,6
55,Wisconsin,19,Iowa,33,Cerro Gordo County,21,50,-29
55,Wisconsin,19,Iowa,37,Chickasaw County,43,2,41
55,Wisconsin,19,Iowa,41,Clay County,158,0,158
55,Wisconsin,19,Iowa,43,Clayton County,161,100,61
55,Wisconsin,19,Iowa,45,Clinton County,91,45,46
55,Wisconsin,19,Iowa,47,Crawford County,3,0,3
55,Wisconsin,19,Iowa,49,Dallas County,19,175,-156
55,Wisconsin,19,Iowa,55,Delaware County,9,0,9
55,Wisconsin,19,Iowa,57,Des Moines County,0,5,-5
55,Wisconsin,19,Iowa,61,Dubuque County,674,625,49
55,Wisconsin,19,Iowa,63,Emmet County,0,15,-15
55,Wisconsin,19,Iowa,65,Fayette County,4,31,-27
55,Wisconsin,19,Iowa,67,Floyd County,24,0,24
55,Wisconsin,19,Iowa,77,Guthrie County,2,0,2
55,Wisconsin,19,Iowa,79,Hamilton County,14,0,14
55,Wisconsin,19,Iowa,81,Hancock County,19,0,19
55,Wisconsin,19,Iowa,83,Hardin County,2,114,-112
55,Wisconsin,19,Iowa,87,Henry County,12,19,-7
55,Wisconsin,19,Iowa,89,Howard County,0,43,-43
55,Wisconsin,19,Iowa,91,Humboldt County,0,9,-9
55,Wisconsin,19,Iowa,95,Iowa County,56,0,56
55,Wisconsin,19,Iowa,97,Jackson County,22,25,-3
55,Wisconsin,19,Iowa,99,Jasper County,39,53,-14
55,Wisconsin,19,Iowa,101,Jefferson County,47,0,47
55,Wisconsin,19,Iowa,103,Johnson County,340,406,-66
55,Wisconsin,19,Iowa,105,Jones County,22,3,19
55,Wisconsin,19,Iowa,113,Linn County,558,331,227
55,Wisconsin,19,Iowa,121,Madison County,0,21,-21
55,Wisconsin,19,Iowa,123,Mahaska County,12,9,3
55,Wisconsin,19,Iowa,125,Marion County,1,26,-25
55,Wisconsin,19,Iowa,127,Marshall County,3,16,-13
55,Wisconsin,19,Iowa,129,Mills County,2,0,2
55,Wisconsin,19,Iowa,131,Mitchell County,15,0,15
55,Wisconsin,19,Iowa,137,Montgomery County,16,0,16
55,Wisconsin,19,Iowa,139,Muscatine County,104,210,-106
55,Wisconsin,19,Iowa,141,O'Brien County,0,5,-5
55,Wisconsin,19,Iowa,143,Osceola County,2,0,2
55,Wisconsin,19,Iowa,147,Palo Alto County,4,14,-10
55,Wisconsin,19,Iowa,153,Polk County,471,620,-149
55,Wisconsin,19,Iowa,155,Pottawattamie County,58,36,22
55,Wisconsin,19,Iowa,157,Poweshiek County,8,7,1
55,Wisconsin,19,Iowa,163,Scott County,521,129,392
55,Wisconsin,19,Iowa,165,Shelby County,17,0,17
55,Wisconsin,19,Iowa,167,Sioux County,0,43,-43
55,Wisconsin,19,Iowa,169,Story County,203,257,-54
55,Wisconsin,19,Iowa,171,Tama County,35,3,32
55,Wisconsin,19,Iowa,179,Wapello County,16,7,9
55,Wisconsin,19,Iowa,181,Warren County,32,4,28
55,Wisconsin,19,Iowa,183,Washington County,6,3,3
55,Wisconsin,19,Iowa,185,Wayne County,0,12,-12
55,Wisconsin,19,Iowa,187,Webster County,24,19,5
55,Wisconsin,19,Iowa,189,Winnebago County,13,6,7
55,Wisconsin,19,Iowa,191,Winneshiek County,104,150,-46
55,Wisconsin,19,Iowa,193,Woodbury County,72,3,69
55,Wisconsin,19,Iowa,195,Worth County,6,2,4
55,Wisconsin,2,Alaska,16,Aleutians West Census Area,0,1,-1
55,Wisconsin,2,Alaska,20,Anchorage Municipality,230,373,-143
55,Wisconsin,2,Alaska,50,Bethel Census Area,5,0,5
55,Wisconsin,2,Alaska,68,Denali Borough,5,11,-6
55,Wisconsin,2,Alaska,70,Dillingham Census Area,0,6,-6
55,Wisconsin,2,Alaska,90,Fairbanks North Star Borough,31,62,-31
55,Wisconsin,2,Alaska,110,Juneau City and Borough,0,2,-2
55,Wisconsin,2,Alaska,122,Kenai Peninsula Borough,8,68,-60
55,Wisconsin,2,Alaska,150,Kodiak Island Borough,28,0,28
55,Wisconsin,2,Alaska,170,Matanuska-Susitna Borough,135,21,114
55,Wisconsin,2,Alaska,180,Nome Census Area,4,0,4
55,Wisconsin,2,Alaska,240,Southeast Fairbanks Census Area,43,0,43
55,Wisconsin,2,Alaska,290,Yukon-Koyukuk Census Area,0,4,-4
55,Wisconsin,20,Kansas,9,Barton County,0,26,-26
55,Wisconsin,20,Kansas,11,Bourbon County,24,0,24
55,Wisconsin,20,Kansas,15,Butler County,4,0,4
55,Wisconsin,20,Kansas,31,Coffey County,4,8,-4
55,Wisconsin,20,Kansas,35,Cowley County,0,6,-6
55,Wisconsin,20,Kansas,39,Decatur County,5,9,-4
55,Wisconsin,20,Kansas,45,Douglas County,85,32,53
55,Wisconsin,20,Kansas,57,Ford County,0,4,-4
55,Wisconsin,20,Kansas,61,Geary County,6,84,-78
55,Wisconsin,20,Kansas,63,Gove County,7,0,7
55,Wisconsin,20,Kansas,79,Harvey County,37,0,37
55,Wisconsin,20,Kansas,85,Jackson County,0,16,-16
55,Wisconsin,20,Kansas,91,Johnson County,151,64,87
55,Wisconsin,20,Kansas,99,Labette County,16,3,13
55,Wisconsin,20,Kansas,103,Leavenworth County,68,0,68
55,Wisconsin,20,Kansas,125,Montgomery County,0,8,-8
55,Wisconsin,20,Kansas,127,Morris County,12,10,2
55,Wisconsin,20,Kansas,129,Morton County,0,5,-5
55,Wisconsin,20,Kansas,137,Norton County,10,0,10
55,Wisconsin,20,Kansas,145,Pawnee County,0,40,-40
55,Wisconsin,20,Kansas,149,Pottawatomie County,4,47,-43
55,Wisconsin,20,Kansas,161,Riley County,21,18,3
55,Wisconsin,20,Kansas,173,Sedgwick County,87,17,70
55,Wisconsin,20,Kansas,177,Shawnee County,10,0,10
55,Wisconsin,20,Kansas,209,Wyandotte County,3,0,3
55,Wisconsin,21,Kentucky,1,Adair County,0,13,-13
55,Wisconsin,21,Kentucky,15,Boone County,3,41,-38
55,Wisconsin,21,Kentucky,19,Boyd County,0,77,-77
55,Wisconsin,21,Kentucky,27,Breckinridge County,0,7,-7
55,Wisconsin,21,Kentucky,29,Bullitt County,9,0,9
55,Wisconsin,21,Kentucky,37,Campbell County,43,15,28
55,Wisconsin,21,Kentucky,47,Christian County,71,60,11
55,Wisconsin,21,Kentucky,51,Clay County,0,14,-14
55,Wisconsin,21,Kentucky,59,Daviess County,49,7,42
55,Wisconsin,21,Kentucky,67,Fayette County,88,124,-36
55,Wisconsin,21,Kentucky,73,Franklin County,5,0,5
55,Wisconsin,21,Kentucky,85,Grayson County,0,48,-48
55,Wisconsin,21,Kentucky,93,Hardin County,21,76,-55
55,Wisconsin,21,Kentucky,101,Henderson County,20,21,-1
55,Wisconsin,21,Kentucky,107,Hopkins County,5,0,5
55,Wisconsin,21,Kentucky,109,Jackson County,26,0,26
55,Wisconsin,21,Kentucky,111,Jefferson County,163,128,35
55,Wisconsin,21,Kentucky,117,Kenton County,48,6,42
55,Wisconsin,21,Kentucky,119,Knott County,0,4,-4
55,Wisconsin,21,Kentucky,125,Laurel County,0,67,-67
55,Wisconsin,21,Kentucky,137,Lincoln County,76,0,76
55,Wisconsin,21,Kentucky,145,McCracken County,26,0,26
55,Wisconsin,21,Kentucky,149,McLean County,0,3,-3
55,Wisconsin,21,Kentucky,151,Madison County,24,124,-100
55,Wisconsin,21,Kentucky,155,Marion County,2,0,2
55,Wisconsin,21,Kentucky,159,Martin County,0,34,-34
55,Wisconsin,21,Kentucky,163,Meade County,73,0,73
55,Wisconsin,21,Kentucky,167,Mercer County,3,0,3
55,Wisconsin,21,Kentucky,169,Metcalfe County,0,31,-31
55,Wisconsin,21,Kentucky,179,Nelson County,49,0,49
55,Wisconsin,21,Kentucky,183,Ohio County,0,8,-8
55,Wisconsin,21,Kentucky,185,Oldham County,12,0,12
55,Wisconsin,21,Kentucky,209,Scott County,62,11,51
55,Wisconsin,21,Kentucky,221,Trigg County,0,5,-5
55,Wisconsin,21,Kentucky,225,Union County,0,13,-13
55,Wisconsin,21,Kentucky,227,Warren County,4,102,-98
55,Wisconsin,22,Louisiana,7,Assumption Parish,0,19,-19
55,Wisconsin,22,Louisiana,11,Beauregard Parish,0,35,-35
55,Wisconsin,22,Louisiana,13,Bienville Parish,0,4,-4
55,Wisconsin,22,Louisiana,17,Caddo Parish,52,11,41
55,Wisconsin,22,Louisiana,19,Calcasieu Parish,9,13,-4
55,Wisconsin,22,Louisiana,31,De Soto Parish,0,9,-9
55,Wisconsin,22,Louisiana,33,East Baton Rouge Parish,76,71,5
55,Wisconsin,22,Louisiana,39,Evangeline Parish,0,2,-2
55,Wisconsin,22,Louisiana,43,Grant Parish,3,17,-14
55,Wisconsin,22,Louisiana,51,Jefferson Parish,57,88,-31
55,Wisconsin,22,Louisiana,55,Lafayette Parish,5,0,5
55,Wisconsin,22,Louisiana,61,Lincoln Parish,9,0,9
55,Wisconsin,22,Louisiana,63,Livingston Parish,3,0,3
55,Wisconsin,22,Louisiana,65,Madison Parish,0,1,-1
55,Wisconsin,22,Louisiana,71,Orleans Parish,16,79,-63
55,Wisconsin,22,Louisiana,73,Ouachita Parish,82,0,82
55,Wisconsin,22,Louisiana,79,Rapides Parish,16,0,16
55,Wisconsin,22,Louisiana,83,Richland Parish,25,17,8
55,Wisconsin,22,Louisiana,101,St. Mary Parish,0,11,-11
55,Wisconsin,22,Louisiana,103,St. Tammany Parish,122,75,47
55,Wisconsin,22,Louisiana,105,Tangipahoa Parish,15,0,15
55,Wisconsin,22,Louisiana,109,Terrebonne Parish,0,24,-24
55,Wisconsin,22,Louisiana,115,Vernon Parish,63,2,61
55,Wisconsin,22,Louisiana,117,Washington Parish,0,50,-50
55,Wisconsin,22,Louisiana,121,West Baton Rouge Parish,0,6,-6
55,Wisconsin,23,Maine,1,Androscoggin County,102,0,102
55,Wisconsin,23,Maine,5,Cumberland County,83,102,-19
55,Wisconsin,23,Maine,11,Kennebec County,57,1,56
55,Wisconsin,23,Maine,13,Knox County,0,47,-47
55,Wisconsin,23,Maine,15,Lincoln County,0,4,-4
55,Wisconsin,23,Maine,17,Oxford County,74,0,74
55,Wisconsin,23,Maine,19,Penobscot County,10,0,10
55,Wisconsin,23,Maine,25,Somerset County,0,75,-75
55,Wisconsin,23,Maine,29,Washington County,0,7,-7
55,Wisconsin,23,Maine,31,York County,107,0,107
55,Wisconsin,24,Maryland,1,Allegany County,0,29,-29
55,Wisconsin,24,Maryland,3,Anne Arundel County,171,65,106
55,Wisconsin,24,Maryland,5,Baltimore County,43,153,-110
55,Wisconsin,24,Maryland,9,Calvert County,28,11,17
55,Wisconsin,24,Maryland,13,Carroll County,17,0,17
55,Wisconsin,24,Maryland,17,Charles County,0,9,-9
55,Wisconsin,24,Maryland,19,Dorchester County,0,9,-9
55,Wisconsin,24,Maryland,21,Frederick County,19,58,-39
55,Wisconsin,24,Maryland,25,Harford County,35,14,21
55,Wisconsin,24,Maryland,27,Howard County,25,73,-48
55,Wisconsin,24,Maryland,29,Kent County,0,16,-16
55,Wisconsin,24,Maryland,31,Montgomery County,90,235,-145
55,Wisconsin,24,Maryland,33,Prince George's County,95,56,39
55,Wisconsin,24,Maryland,37,St. Mary's County,11,239,-228
55,Wisconsin,24,Maryland,45,Wicomico County,7,0,7
55,Wisconsin,24,Maryland,510,Baltimore city,15,154,-139
55,Wisconsin,25,Massachusetts,1,Barnstable County,0,8,-8
55,Wisconsin,25,Massachusetts,3,Berkshire County,6,12,-6
55,Wisconsin,25,Massachusetts,5,Bristol County,35,10,25
55,Wisconsin,25,Massachusetts,7,Dukes County,0,3,-3
55,Wisconsin,25,Massachusetts,9,Essex County,63,48,15
55,Wisconsin,25,Massachusetts,13,Hampden County,13,25,-12
55,Wisconsin,25,Massachusetts,15,Hampshire County,77,20,57
55,Wisconsin,25,Massachusetts,17,Middlesex County,382,468,-86
55,Wisconsin,25,Massachusetts,21,Norfolk County,101,92,9
55,Wisconsin,25,Massachusetts,23,Plymouth County,5,16,-11
55,Wisconsin,25,Massachusetts,25,Suffolk County,56,152,-96
55,Wisconsin,25,Massachusetts,27,Worcester County,17,163,-146
55,Wisconsin,26,Michigan,3,Alger County,0,73,-73
55,Wisconsin,26,Michigan,5,Allegan County,18,16,2
55,Wisconsin,26,Michigan,7,Alpena County,93,6,87
55,Wisconsin,26,Michigan,9,Antrim County,0,9,-9
55,Wisconsin,26,Michigan,13,Baraga County,37,10,27
55,Wisconsin,26,Michigan,15,Barry County,35,6,29
55,Wisconsin,26,Michigan,19,Benzie County,9,10,-1
55,Wisconsin,26,Michigan,21,Berrien County,107,148,-41
55,Wisconsin,26,Michigan,23,Branch County,11,7,4
55,Wisconsin,26,Michigan,25,Calhoun County,70,42,28
55,Wisconsin,26,Michigan,27,Cass County,8,12,-4
55,Wisconsin,26,Michigan,29,Charlevoix County,11,3,8
55,Wisconsin,26,Michigan,31,Cheboygan County,19,2,17
55,Wisconsin,26,Michigan,33,Chippewa County,30,40,-10
55,Wisconsin,26,Michigan,35,Clare County,0,6,-6
55,Wisconsin,26,Michigan,37,Clinton County,1,61,-60
55,Wisconsin,26,Michigan,39,Crawford County,16,0,16
55,Wisconsin,26,Michigan,41,Delta County,156,213,-57
55,Wisconsin,26,Michigan,43,Dickinson County,536,247,289
55,Wisconsin,26,Michigan,45,Eaton County,5,57,-52
55,Wisconsin,26,Michigan,47,Emmet County,0,3,-3
55,Wisconsin,26,Michigan,49,Genesee County,142,128,14
55,Wisconsin,26,Michigan,51,Gladwin County,0,20,-20
55,Wisconsin,26,Michigan,53,Gogebic County,248,136,112
55,Wisconsin,26,Michigan,55,Grand Traverse County,103,3,100
55,Wisconsin,26,Michigan,57,Gratiot County,0,4,-4
55,Wisconsin,26,Michigan,59,Hillsdale County,20,31,-11
55,Wisconsin,26,Michigan,61,Houghton County,242,231,11
55,Wisconsin,26,Michigan,63,Huron County,0,26,-26
55,Wisconsin,26,Michigan,65,Ingham County,136,89,47
55,Wisconsin,26,Michigan,67,Ionia County,4,32,-28
55,Wisconsin,26,Michigan,69,Iosco County,0,18,-18
55,Wisconsin,26,Michigan,71,Iron County,72,112,-40
55,Wisconsin,26,Michigan,73,Isabella County,7,8,-1
55,Wisconsin,26,Michigan,75,Jackson County,17,9,8
55,Wisconsin,26,Michigan,77,Kalamazoo County,37,51,-14
55,Wisconsin,26,Michigan,81,Kent County,271,381,-110
55,Wisconsin,26,Michigan,83,Keweenaw County,0,3,-3
55,Wisconsin,26,Michigan,87,Lapeer County,84,19,65
55,Wisconsin,26,Michigan,89,Leelanau County,24,9,15
55,Wisconsin,26,Michigan,91,Lenawee County,2,0,2
55,Wisconsin,26,Michigan,93,Livingston County,23,89,-66
55,Wisconsin,26,Michigan,95,Luce County,0,4,-4
55,Wisconsin,26,Michigan,99,Macomb County,130,105,25
55,Wisconsin,26,Michigan,101,Manistee County,2,13,-11
55,Wisconsin,26,Michigan,103,Marquette County,304,314,-10
55,Wisconsin,26,Michigan,105,Mason County,0,11,-11
55,Wisconsin,26,Michigan,107,Mecosta County,46,7,39
55,Wisconsin,26,Michigan,109,Menominee County,478,486,-8
55,Wisconsin,26,Michigan,111,Midland County,57,69,-12
55,Wisconsin,26,Michigan,113,Missaukee County,0,2,-2
55,Wisconsin,26,Michigan,115,Monroe County,13,0,13
55,Wisconsin,26,Michigan,117,Montcalm County,0,30,-30
55,Wisconsin,26,Michigan,119,Montmorency County,0,2,-2
55,Wisconsin,26,Michigan,121,Muskegon County,65,0,65
55,Wisconsin,26,Michigan,123,Newaygo County,64,0,64
55,Wisconsin,26,Michigan,125,Oakland County,435,167,268
55,Wisconsin,26,Michigan,127,Oceana County,0,8,-8
55,Wisconsin,26,Michigan,131,Ontonagon County,51,13,38
55,Wisconsin,26,Michigan,133,Osceola County,0,44,-44
55,Wisconsin,26,Michigan,137,Otsego County,45,0,45
55,Wisconsin,26,Michigan,139,Ottawa County,181,142,39
55,Wisconsin,26,Michigan,141,Presque Isle County,0,38,-38
55,Wisconsin,26,Michigan,143,Roscommon County,15,41,-26
55,Wisconsin,26,Michigan,145,Saginaw County,42,5,37
55,Wisconsin,26,Michigan,147,St. Clair County,6,26,-20
55,Wisconsin,26,Michigan,149,St. Joseph County,17,10,7
55,Wisconsin,26,Michigan,151,Sanilac County,22,13,9
55,Wisconsin,26,Michigan,153,Schoolcraft County,21,0,21
55,Wisconsin,26,Michigan,155,Shiawassee County,0,12,-12
55,Wisconsin,26,Michigan,157,Tuscola County,7,0,7
55,Wisconsin,26,Michigan,159,Van Buren County,0,4,-4
55,Wisconsin,26,Michigan,161,Washtenaw County,330,610,-280
55,Wisconsin,26,Michigan,163,Wayne County,366,276,90
55,Wisconsin,26,Michigan,165,Wexford County,98,0,98
55,Wisconsin,27,Minnesota,1,Aitkin County,0,7,-7
55,Wisconsin,27,Minnesota,3,Anoka County,832,596,236
55,Wisconsin,27,Minnesota,5,Becker County,0,28,-28
55,Wisconsin,27,Minnesota,7,Beltrami County,94,117,-23
55,Wisconsin,27,Minnesota,9,Benton County,89,4,85
55,Wisconsin,27,Minnesota,11,Big Stone County,0,13,-13
55,Wisconsin,27,Minnesota,13,Blue Earth County,195,438,-243
55,Wisconsin,27,Minnesota,15,Brown County,48,230,-182
55,Wisconsin,27,Minnesota,17,Carlton County,73,104,-31
55,Wisconsin,27,Minnesota,19,Carver County,402,150,252
55,Wisconsin,27,Minnesota,21,Cass County,17,11,6
55,Wisconsin,27,Minnesota,23,Chippewa County,11,3,8
55,Wisconsin,27,Minnesota,25,Chisago County,453,198,255
55,Wisconsin,27,Minnesota,27,Clay County,23,121,-98
55,Wisconsin,27,Minnesota,29,Clearwater County,25,5,20
55,Wisconsin,27,Minnesota,31,Cook County,40,2,38
55,Wisconsin,27,Minnesota,33,Cottonwood County,28,15,13
55,Wisconsin,27,Minnesota,35,Crow Wing County,59,91,-32
55,Wisconsin,27,Minnesota,37,Dakota County,1589,1357,232
55,Wisconsin,27,Minnesota,39,Dodge County,57,20,37
55,Wisconsin,27,Minnesota,41,Douglas County,54,70,-16
55,Wisconsin,27,Minnesota,43,Faribault County,18,0,18
55,Wisconsin,27,Minnesota,45,Fillmore County,145,10,135
55,Wisconsin,27,Minnesota,47,Freeborn County,87,12,75
55,Wisconsin,27,Minnesota,49,Goodhue County,334,485,-151
55,Wisconsin,27,Minnesota,51,Grant County,0,31,-31
55,Wisconsin,27,Minnesota,53,Hennepin County,3514,5176,-1662
55,Wisconsin,27,Minnesota,55,Houston County,385,343,42
55,Wisconsin,27,Minnesota,57,Hubbard County,18,31,-13
55,Wisconsin,27,Minnesota,59,Isanti County,106,35,71
55,Wisconsin,27,Minnesota,61,Itasca County,104,110,-6
55,Wisconsin,27,Minnesota,63,Jackson County,7,3,4
55,Wisconsin,27,Minnesota,65,Kanabec County,13,15,-2
55,Wisconsin,27,Minnesota,67,Kandiyohi County,36,7,29
55,Wisconsin,27,Minnesota,71,Koochiching County,7,14,-7
55,Wisconsin,27,Minnesota,75,Lake County,26,48,-22
55,Wisconsin,27,Minnesota,79,Le Sueur County,86,47,39
55,Wisconsin,27,Minnesota,81,Lincoln County,0,23,-23
55,Wisconsin,27,Minnesota,83,Lyon County,46,26,20
55,Wisconsin,27,Minnesota,85,McLeod County,40,23,17
55,Wisconsin,27,Minnesota,89,Marshall County,2,23,-21
55,Wisconsin,27,Minnesota,91,Martin County,30,45,-15
55,Wisconsin,27,Minnesota,93,Meeker County,57,13,44
55,Wisconsin,27,Minnesota,95,Mille Lacs County,17,43,-26
55,Wisconsin,27,Minnesota,97,Morrison County,33,11,22
55,Wisconsin,27,Minnesota,99,Mower County,131,113,18
55,Wisconsin,27,Minnesota,103,Nicollet County,17,126,-109
55,Wisconsin,27,Minnesota,105,Nobles County,72,2,70
55,Wisconsin,27,Minnesota,109,Olmsted County,706,935,-229
55,Wisconsin,27,Minnesota,111,Otter Tail County,61,55,6
55,Wisconsin,27,Minnesota,113,Pennington County,48,2,46
55,Wisconsin,27,Minnesota,115,Pine County,122,38,84
55,Wisconsin,27,Minnesota,119,Polk County,78,19,59
55,Wisconsin,27,Minnesota,121,Pope County,0,2,-2
55,Wisconsin,27,Minnesota,123,Ramsey County,1948,2322,-374
55,Wisconsin,27,Minnesota,127,Redwood County,12,0,12
55,Wisconsin,27,Minnesota,129,Renville County,5,1,4
55,Wisconsin,27,Minnesota,131,Rice County,257,251,6
55,Wisconsin,27,Minnesota,133,Rock County,0,3,-3
55,Wisconsin,27,Minnesota,135,Roseau County,2,37,-35
55,Wisconsin,27,Minnesota,137,St. Louis County,1367,1196,171
55,Wisconsin,27,Minnesota,139,Scott County,392,40,352
55,Wisconsin,27,Minnesota,141,Sherburne County,134,195,-61
55,Wisconsin,27,Minnesota,143,Sibley County,74,5,69
55,Wisconsin,27,Minnesota,145,Stearns County,353,604,-251
55,Wisconsin,27,Minnesota,147,Steele County,113,39,74
55,Wisconsin,27,Minnesota,149,Stevens County,14,34,-20
55,Wisconsin,27,Minnesota,151,Swift County,0,16,-16
55,Wisconsin,27,Minnesota,153,Todd County,40,26,14
55,Wisconsin,27,Minnesota,157,Wabasha County,117,46,71
55,Wisconsin,27,Minnesota,159,Wadena County,50,0,50
55,Wisconsin,27,Minnesota,161,Waseca County,39,8,31
55,Wisconsin,27,Minnesota,163,Washington County,1741,1399,342
55,Wisconsin,27,Minnesota,165,Watonwan County,26,5,21
55,Wisconsin,27,Minnesota,169,Winona County,824,1205,-381
55,Wisconsin,27,Minnesota,171,Wright County,262,62,200
55,Wisconsin,28,Mississippi,9,Benton County,0,3,-3
55,Wisconsin,28,Mississippi,11,Bolivar County,10,0,10
55,Wisconsin,28,Mississippi,33,DeSoto County,15,111,-96
55,Wisconsin,28,Mississippi,35,Forrest County,11,0,11
55,Wisconsin,28,Mississippi,43,Grenada County,0,6,-6
55,Wisconsin,28,Mississippi,45,Hancock County,53,16,37
55,Wisconsin,28,Mississippi,47,Harrison County,128,196,-68
55,Wisconsin,28,Mississippi,49,Hinds County,68,37,31
55,Wisconsin,28,Mississippi,51,Holmes County,0,6,-6
55,Wisconsin,28,Mississippi,57,Itawamba County,0,1,-1
55,Wisconsin,28,Mississippi,59,Jackson County,5,0,5
55,Wisconsin,28,Mississippi,65,Jefferson Davis County,0,7,-7
55,Wisconsin,28,Mississippi,69,Kemper County,0,6,-6
55,Wisconsin,28,Mississippi,81,Lee County,34,29,5
55,Wisconsin,28,Mississippi,83,Leflore County,26,0,26
55,Wisconsin,28,Mississippi,87,Lowndes County,0,7,-7
55,Wisconsin,28,Mississippi,93,Marshall County,0,11,-11
55,Wisconsin,28,Mississippi,95,Monroe County,3,0,3
55,Wisconsin,28,Mississippi,99,Neshoba County,0,16,-16
55,Wisconsin,28,Mississippi,101,Newton County,20,9,11
55,Wisconsin,28,Mississippi,105,Oktibbeha County,27,0,27
55,Wisconsin,28,Mississippi,107,Panola County,58,0,58
55,Wisconsin,28,Mississippi,109,Pearl River County,2,0,2
55,Wisconsin,28,Mississippi,117,Prentiss County,9,0,9
55,Wisconsin,28,Mississippi,119,Quitman County,21,0,21
55,Wisconsin,28,Mississippi,121,Rankin County,0,22,-22
55,Wisconsin,28,Mississippi,137,Tate County,0,22,-22
55,Wisconsin,28,Mississippi,143,Tunica County,0,24,-24
55,Wisconsin,28,Mississippi,145,Union County,32,0,32
55,Wisconsin,28,Mississippi,151,Washington County,84,30,54
55,Wisconsin,28,Mississippi,163,Yazoo County,12,20,-8
55,Wisconsin,29,Missouri,1,Adair County,16,32,-16
55,Wisconsin,29,Missouri,9,Barry County,4,0,4
55,Wisconsin,29,Missouri,11,Barton County,0,23,-23
55,Wisconsin,29,Missouri,13,Bates County,28,0,28
55,Wisconsin,29,Missouri,15,Benton County,16,0,16
55,Wisconsin,29,Missouri,19,Boone County,67,169,-102
55,Wisconsin,29,Missouri,21,Buchanan County,52,1,51
55,Wisconsin,29,Missouri,27,Callaway County,14,0,14
55,Wisconsin,29,Missouri,29,Camden County,12,33,-21
55,Wisconsin,29,Missouri,31,Cape Girardeau County,6,6,0
55,Wisconsin,29,Missouri,41,Chariton County,26,0,26
55,Wisconsin,29,Missouri,43,Christian County,98,0,98
55,Wisconsin,29,Missouri,45,Clark County,0,8,-8
55,Wisconsin,29,Missouri,47,Clay County,45,62,-17
55,Wisconsin,29,Missouri,49,Clinton County,0,8,-8
55,Wisconsin,29,Missouri,51,Cole County,0,31,-31
55,Wisconsin,29,Missouri,53,Cooper County,9,0,9
55,Wisconsin,29,Missouri,55,Crawford County,0,13,-13
55,Wisconsin,29,Missouri,57,Dade County,0,3,-3
55,Wisconsin,29,Missouri,59,Dallas County,8,0,8
55,Wisconsin,29,Missouri,61,Daviess County,0,8,-8
55,Wisconsin,29,Missouri,65,Dent County,0,18,-18
55,Wisconsin,29,Missouri,71,Franklin County,7,40,-33
55,Wisconsin,29,Missouri,73,Gasconade County,4,0,4
55,Wisconsin,29,Missouri,77,Greene County,230,87,143
55,Wisconsin,29,Missouri,91,Howell County,20,8,12
55,Wisconsin,29,Missouri,93,Iron County,0,3,-3
55,Wisconsin,29,Missouri,95,Jackson County,172,418,-246
55,Wisconsin,29,Missouri,97,Jasper County,94,0,94
55,Wisconsin,29,Missouri,99,Jefferson County,0,50,-50
55,Wisconsin,29,Missouri,101,Johnson County,2,19,-17
55,Wisconsin,29,Missouri,105,Laclede County,9,105,-96
55,Wisconsin,29,Missouri,119,McDonald County,37,0,37
55,Wisconsin,29,Missouri,121,Macon County,0,5,-5
55,Wisconsin,29,Missouri,131,Miller County,0,13,-13
55,Wisconsin,29,Missouri,135,Moniteau County,3,0,3
55,Wisconsin,29,Missouri,145,Newton County,0,5,-5
55,Wisconsin,29,Missouri,147,Nodaway County,76,0,76
55,Wisconsin,29,Missouri,155,Pemiscot County,0,14,-14
55,Wisconsin,29,Missouri,157,Perry County,3,0,3
55,Wisconsin,29,Missouri,161,Phelps County,0,30,-30
55,Wisconsin,29,Missouri,165,Platte County,92,1,91
55,Wisconsin,29,Missouri,167,Polk County,1,3,-2
55,Wisconsin,29,Missouri,169,Pulaski County,25,116,-91
55,Wisconsin,29,Missouri,177,Ray County,0,4,-4
55,Wisconsin,29,Missouri,179,Reynolds County,0,11,-11
55,Wisconsin,29,Missouri,183,St. Charles County,51,169,-118
55,Wisconsin,29,Missouri,187,St. Francois County,3,71,-68
55,Wisconsin,29,Missouri,189,St. Louis County,326,299,27
55,Wisconsin,29,Missouri,195,Saline County,8,4,4
55,Wisconsin,29,Missouri,201,Scott County,0,19,-19
55,Wisconsin,29,Missouri,209,Stone County,48,12,36
55,Wisconsin,29,Missouri,213,Taney County,32,0,32
55,Wisconsin,29,Missouri,219,Warren County,0,7,-7
55,Wisconsin,29,Missouri,225,Webster County,12,0,12
55,Wisconsin,29,Missouri,510,St. Louis city,120,79,41
55,Wisconsin,30,Montana,1,Beaverhead County,0,11,-11
55,Wisconsin,30,Montana,5,Blaine County,0,4,-4
55,Wisconsin,30,Montana,7,Broadwater County,0,7,-7
55,Wisconsin,30,Montana,9,Carbon County,3,0,3
55,Wisconsin,30,Montana,13,Cascade County,23,125,-102
55,Wisconsin,30,Montana,15,Chouteau County,0,6,-6
55,Wisconsin,30,Montana,17,Custer County,0,20,-20
55,Wisconsin,30,Montana,21,Dawson County,0,5,-5
55,Wisconsin,30,Montana,23,Deer Lodge County,6,0,6
55,Wisconsin,30,Montana,29,Flathead County,37,36,1
55,Wisconsin,30,Montana,31,Gallatin County,34,23,11
55,Wisconsin,30,Montana,33,Garfield County,0,4,-4
55,Wisconsin,30,Montana,35,Glacier County,13,0,13
55,Wisconsin,30,Montana,47,Lake County,15,2,13
55,Wisconsin,30,Montana,49,Lewis and Clark County,52,42,10
55,Wisconsin,30,Montana,53,Lincoln County,13,0,13
55,Wisconsin,30,Montana,57,Madison County,0,14,-14
55,Wisconsin,30,Montana,63,Missoula County,19,147,-128
55,Wisconsin,30,Montana,71,Phillips County,0,18,-18
55,Wisconsin,30,Montana,81,Ravalli County,20,0,20
55,Wisconsin,30,Montana,85,Roosevelt County,1,0,1
55,Wisconsin,30,Montana,97,Sweet Grass County,1,0,1
55,Wisconsin,30,Montana,111,Yellowstone County,101,24,77
55,Wisconsin,31,Nebraska,19,Buffalo County,8,8,0
55,Wisconsin,31,Nebraska,25,Cass County,0,9,-9
55,Wisconsin,31,Nebraska,33,Cheyenne County,0,1,-1
55,Wisconsin,31,Nebraska,41,Custer County,0,18,-18
55,Wisconsin,31,Nebraska,45,Dawes County,0,11,-11
55,Wisconsin,31,Nebraska,47,Dawson County,60,0,60
55,Wisconsin,31,Nebraska,51,Dixon County,3,0,3
55,Wisconsin,31,Nebraska,55,Douglas County,193,314,-121
55,Wisconsin,31,Nebraska,67,Gage County,0,7,-7
55,Wisconsin,31,Nebraska,79,Hall County,9,0,9
55,Wisconsin,31,Nebraska,95,Jefferson County,88,0,88
55,Wisconsin,31,Nebraska,109,Lancaster County,55,110,-55
55,Wisconsin,31,Nebraska,111,Lincoln County,6,17,-11
55,Wisconsin,31,Nebraska,119,Madison County,15,7,8
55,Wisconsin,31,Nebraska,127,Nemaha County,6,0,6
55,Wisconsin,31,Nebraska,131,Otoe County,0,19,-19
55,Wisconsin,31,Nebraska,141,Platte County,0,9,-9
55,Wisconsin,31,Nebraska,145,Red Willow County,14,0,14
55,Wisconsin,31,Nebraska,151,Saline County,7,0,7
55,Wisconsin,31,Nebraska,153,Sarpy County,11,28,-17
55,Wisconsin,31,Nebraska,155,Saunders County,0,5,-5
55,Wisconsin,31,Nebraska,157,Scotts Bluff County,16,20,-4
55,Wisconsin,31,Nebraska,159,Seward County,2,0,2
55,Wisconsin,31,Nebraska,161,Sheridan County,0,7,-7
55,Wisconsin,31,Nebraska,177,Washington County,3,0,3
55,Wisconsin,31,Nebraska,179,Wayne County,0,6,-6
55,Wisconsin,31,Nebraska,185,York County,25,11,14
55,Wisconsin,32,Nevada,3,Clark County,660,668,-8
55,Wisconsin,32,Nevada,5,Douglas County,45,57,-12
55,Wisconsin,32,Nevada,7,Elko County,0,52,-52
55,Wisconsin,32,Nevada,13,Humboldt County,7,0,7
55,Wisconsin,32,Nevada,19,Lyon County,0,10,-10
55,Wisconsin,32,Nevada,27,Pershing County,0,7,-7
55,Wisconsin,32,Nevada,29,Storey County,0,6,-6
55,Wisconsin,32,Nevada,31,Washoe County,94,94,0
55,Wisconsin,32,Nevada,33,White Pine County,0,38,-38
55,Wisconsin,33,New Hampshire,1,Belknap County,4,9,-5
55,Wisconsin,33,New Hampshire,3,Carroll County,0,37,-37
55,Wisconsin,33,New Hampshire,5,Cheshire County,3,4,-1
55,Wisconsin,33,New Hampshire,9,Grafton County,72,58,14
55,Wisconsin,33,New Hampshire,11,Hillsborough County,40,26,14
55,Wisconsin,33,New Hampshire,13,Merrimack County,14,0,14
55,Wisconsin,33,New Hampshire,15,Rockingham County,71,55,16
55,Wisconsin,33,New Hampshire,17,Strafford County,17,8,9
55,Wisconsin,33,New Hampshire,19,Sullivan County,12,0,12
55,Wisconsin,34,New Jersey,3,Bergen County,60,188,-128
55,Wisconsin,34,New Jersey,5,Burlington County,31,15,16
55,Wisconsin,34,New Jersey,7,Camden County,57,0,57
55,Wisconsin,34,New Jersey,9,Cape May County,17,24,-7
55,Wisconsin,34,New Jersey,11,Cumberland County,21,0,21
55,Wisconsin,34,New Jersey,13,Essex County,126,12,114
55,Wisconsin,34,New Jersey,17,Hudson County,61,42,19
55,Wisconsin,34,New Jersey,19,Hunterdon County,0,10,-10
55,Wisconsin,34,New Jersey,21,Mercer County,32,57,-25
55,Wisconsin,34,New Jersey,23,Middlesex County,64,207,-143
55,Wisconsin,34,New Jersey,25,Monmouth County,26,12,14
55,Wisconsin,34,New Jersey,27,Morris County,21,25,-4
55,Wisconsin,34,New Jersey,29,Ocean County,184,11,173
55,Wisconsin,34,New Jersey,31,Passaic County,63,0,63
55,Wisconsin,34,New Jersey,33,Salem County,3,0,3
55,Wisconsin,34,New Jersey,35,Somerset County,60,11,49
55,Wisconsin,34,New Jersey,37,Sussex County,14,1,13
55,Wisconsin,34,New Jersey,39,Union County,16,7,9
55,Wisconsin,34,New Jersey,41,Warren County,13,0,13
55,Wisconsin,35,New Mexico,1,Bernalillo County,91,116,-25
55,Wisconsin,35,New Mexico,9,Curry County,0,10,-10
55,Wisconsin,35,New Mexico,11,De Baca County,0,4,-4
55,Wisconsin,35,New Mexico,13,Doña Ana County,29,42,-13
55,Wisconsin,35,New Mexico,17,Grant County,6,0,6
55,Wisconsin,35,New Mexico,27,Lincoln County,11,0,11
55,Wisconsin,35,New Mexico,28,Los Alamos County,15,0,15
55,Wisconsin,35,New Mexico,29,Luna County,83,0,83
55,Wisconsin,35,New Mexico,31,McKinley County,11,11,0
55,Wisconsin,35,New Mexico,35,Otero County,0,28,-28
55,Wisconsin,35,New Mexico,41,Roosevelt County,4,7,-3
55,Wisconsin,35,New Mexico,43,Sandoval County,120,84,36
55,Wisconsin,35,New Mexico,45,San Juan County,0,25,-25
55,Wisconsin,35,New Mexico,49,Santa Fe County,115,100,15
55,Wisconsin,35,New Mexico,61,Valencia County,19,27,-8
55,Wisconsin,36,New York,1,Albany County,17,22,-5
55,Wisconsin,36,New York,5,Bronx County,36,30,6
55,Wisconsin,36,New York,7,Broome County,0,9,-9
55,Wisconsin,36,New York,17,Chenango County,0,10,-10
55,Wisconsin,36,New York,19,Clinton County,2,0,2
55,Wisconsin,36,New York,21,Columbia County,0,2,-2
55,Wisconsin,36,New York,27,Dutchess County,16,35,-19
55,Wisconsin,36,New York,29,Erie County,70,58,12
55,Wisconsin,36,New York,31,Essex County,7,21,-14
55,Wisconsin,36,New York,33,Franklin County,0,1,-1
55,Wisconsin,36,New York,43,Herkimer County,0,27,-27
55,Wisconsin,36,New York,45,Jefferson County,51,47,4
55,Wisconsin,36,New York,47,Kings County,443,93,350
55,Wisconsin,36,New York,51,Livingston County,0,4,-4
55,Wisconsin,36,New York,53,Madison County,0,41,-41
55,Wisconsin,36,New York,55,Monroe County,81,139,-58
55,Wisconsin,36,New York,59,Nassau County,74,69,5
55,Wisconsin,36,New York,61,New York County,171,484,-313
55,Wisconsin,36,New York,63,Niagara County,0,27,-27
55,Wisconsin,36,New York,65,Oneida County,0,51,-51
55,Wisconsin,36,New York,67,Onondaga County,151,59,92
55,Wisconsin,36,New York,71,Orange County,79,4,75
55,Wisconsin,36,New York,75,Oswego County,0,24,-24
55,Wisconsin,36,New York,77,Otsego County,18,0,18
55,Wisconsin,36,New York,81,Queens County,314,123,191
55,Wisconsin,36,New York,83,Rensselaer County,0,18,-18
55,Wisconsin,36,New York,87,Rockland County,55,11,44
55,Wisconsin,36,New York,89,St. Lawrence County,0,58,-58
55,Wisconsin,36,New York,91,Saratoga County,19,1,18
55,Wisconsin,36,New York,93,Schenectady County,10,16,-6
55,Wisconsin,36,New York,99,Seneca County,24,0,24
55,Wisconsin,36,New York,101,Steuben County,0,22,-22
55,Wisconsin,36,New York,103,Suffolk County,41,43,-2
55,Wisconsin,36,New York,105,Sullivan County,15,7,8
55,Wisconsin,36,New York,107,Tioga County,0,13,-13
55,Wisconsin,36,New York,109,Tompkins County,19,54,-35
55,Wisconsin,36,New York,111,Ulster County,14,7,7
55,Wisconsin,36,New York,117,Wayne County,7,0,7
55,Wisconsin,36,New York,119,Westchester County,73,183,-110
55,Wisconsin,36,New York,123,Yates County,13,0,13
55,Wisconsin,37,North Carolina,1,Alamance County,6,0,6
55,Wisconsin,37,North Carolina,13,Beaufort County,8,0,8
55,Wisconsin,37,North Carolina,19,Brunswick County,0,10,-10
55,Wisconsin,37,North Carolina,21,Buncombe County,115,132,-17
55,Wisconsin,37,North Carolina,23,Burke County,4,0,4
55,Wisconsin,37,North Carolina,25,Cabarrus County,96,0,96
55,Wisconsin,37,North Carolina,27,Caldwell County,0,21,-21
55,Wisconsin,37,North Carolina,31,Carteret County,39,53,-14
55,Wisconsin,37,North Carolina,33,Caswell County,0,38,-38
55,Wisconsin,37,North Carolina,35,Catawba County,38,27,11
55,Wisconsin,37,North Carolina,41,Chowan County,10,0,10
55,Wisconsin,37,North Carolina,47,Columbus County,36,16,20
55,Wisconsin,37,North Carolina,49,Craven County,28,21,7
55,Wisconsin,37,North Carolina,51,Cumberland County,194,108,86
55,Wisconsin,37,North Carolina,55,Dare County,0,2,-2
55,Wisconsin,37,North Carolina,63,Durham County,88,30,58
55,Wisconsin,37,North Carolina,67,Forsyth County,56,10,46
55,Wisconsin,37,North Carolina,71,Gaston County,5,14,-9
55,Wisconsin,37,North Carolina,77,Granville County,0,31,-31
55,Wisconsin,37,North Carolina,81,Guilford County,73,96,-23
55,Wisconsin,37,North Carolina,85,Harnett County,18,0,18
55,Wisconsin,37,North Carolina,89,Henderson County,0,23,-23
55,Wisconsin,37,North Carolina,97,Iredell County,35,26,9
55,Wisconsin,37,North Carolina,99,Jackson County,65,0,65
55,Wisconsin,37,North Carolina,101,Johnston County,35,20,15
55,Wisconsin,37,North Carolina,105,Lee County,0,10,-10
55,Wisconsin,37,North Carolina,109,Lincoln County,11,0,11
55,Wisconsin,37,North Carolina,113,Macon County,15,0,15
55,Wisconsin,37,North Carolina,119,Mecklenburg County,304,469,-165
55,Wisconsin,37,North Carolina,125,Moore County,12,11,1
55,Wisconsin,37,North Carolina,127,Nash County,0,26,-26
55,Wisconsin,37,North Carolina,129,New Hanover County,21,76,-55
55,Wisconsin,37,North Carolina,133,Onslow County,336,198,138
55,Wisconsin,37,North Carolina,135,Orange County,66,23,43
55,Wisconsin,37,North Carolina,147,Pitt County,17,14,3
55,Wisconsin,37,North Carolina,149,Polk County,0,15,-15
55,Wisconsin,37,North Carolina,151,Randolph County,10,0,10
55,Wisconsin,37,North Carolina,155,Robeson County,33,0,33
55,Wisconsin,37,North Carolina,159,Rowan County,10,0,10
55,Wisconsin,37,North Carolina,161,Rutherford County,4,0,4
55,Wisconsin,37,North Carolina,167,Stanly County,0,11,-11
55,Wisconsin,37,North Carolina,169,Stokes County,49,0,49
55,Wisconsin,37,North Carolina,173,Swain County,10,0,10
55,Wisconsin,37,North Carolina,179,Union County,0,14,-14
55,Wisconsin,37,North Carolina,181,Vance County,7,0,7
55,Wisconsin,37,North Carolina,183,Wake County,86,438,-352
55,Wisconsin,37,North Carolina,189,Watauga County,25,0,25
55,Wisconsin,37,North Carolina,191,Wayne County,8,0,8
55,Wisconsin,37,North Carolina,193,Wilkes County,20,0,20
55,Wisconsin,37,North Carolina,195,Wilson County,37,0,37
55,Wisconsin,38,North Dakota,3,Barnes County,0,8,-8
55,Wisconsin,38,North Dakota,5,Benson County,0,1,-1
55,Wisconsin,38,North Dakota,9,Bottineau County,10,0,10
55,Wisconsin,38,North Dakota,15,Burleigh County,72,45,27
55,Wisconsin,38,North Dakota,17,Cass County,186,160,26
55,Wisconsin,38,North Dakota,21,Dickey County,11,0,11
55,Wisconsin,38,North Dakota,25,Dunn County,0,20,-20
55,Wisconsin,38,North Dakota,31,Foster County,12,0,12
55,Wisconsin,38,North Dakota,35,Grand Forks County,84,94,-10
55,Wisconsin,38,North Dakota,37,Grant County,0,19,-19
55,Wisconsin,38,North Dakota,45,LaMoure County,0,15,-15
55,Wisconsin,38,North Dakota,47,Logan County,0,2,-2
55,Wisconsin,38,North Dakota,49,McHenry County,0,5,-5
55,Wisconsin,38,North Dakota,53,McKenzie County,15,0,15
55,Wisconsin,38,North Dakota,59,Morton County,8,30,-22
55,Wisconsin,38,North Dakota,61,Mountrail County,61,1,60
55,Wisconsin,38,North Dakota,63,Nelson County,0,17,-17
55,Wisconsin,38,North Dakota,71,Ramsey County,0,2,-2
55,Wisconsin,38,North Dakota,75,Renville County,0,4,-4
55,Wisconsin,38,North Dakota,77,Richland County,10,4,6
55,Wisconsin,38,North Dakota,81,Sargent County,15,6,9
55,Wisconsin,38,North Dakota,85,Sioux County,0,4,-4
55,Wisconsin,38,North Dakota,89,Stark County,22,0,22
55,Wisconsin,38,North Dakota,93,Stutsman County,10,0,10
55,Wisconsin,38,North Dakota,101,Ward County,122,127,-5
55,Wisconsin,38,North Dakota,105,Williams County,23,68,-45
55,Wisconsin,39,Ohio,3,Allen County,0,95,-95
55,Wisconsin,39,Ohio,5,Ashland County,39,0,39
55,Wisconsin,39,Ohio,7,Ashtabula County,15,1,14
55,Wisconsin,39,Ohio,9,Athens County,51,40,11
55,Wisconsin,39,Ohio,17,Butler County,2,63,-61
55,Wisconsin,39,Ohio,19,Carroll County,2,0,2
55,Wisconsin,39,Ohio,21,Champaign County,0,58,-58
55,Wisconsin,39,Ohio,23,Clark County,2,55,-53
55,Wisconsin,39,Ohio,25,Clermont County,56,0,56
55,Wisconsin,39,Ohio,29,Columbiana County,23,8,15
55,Wisconsin,39,Ohio,35,Cuyahoga County,548,289,259
55,Wisconsin,39,Ohio,37,Darke County,12,0,12
55,Wisconsin,39,Ohio,41,Delaware County,38,77,-39
55,Wisconsin,39,Ohio,43,Erie County,0,12,-12
55,Wisconsin,39,Ohio,45,Fairfield County,16,4,12
55,Wisconsin,39,Ohio,47,Fayette County,27,0,27
55,Wisconsin,39,Ohio,49,Franklin County,299,252,47
55,Wisconsin,39,Ohio,55,Geauga County,4,7,-3
55,Wisconsin,39,Ohio,57,Greene County,0,108,-108
55,Wisconsin,39,Ohio,59,Guernsey County,1,0,1
55,Wisconsin,39,Ohio,61,Hamilton County,432,174,258
55,Wisconsin,39,Ohio,63,Hancock County,6,41,-35
55,Wisconsin,39,Ohio,65,Hardin County,0,13,-13
55,Wisconsin,39,Ohio,67,Harrison County,0,1,-1
55,Wisconsin,39,Ohio,69,Henry County,13,0,13
55,Wisconsin,39,Ohio,73,Hocking County,3,0,3
55,Wisconsin,39,Ohio,77,Huron County,85,0,85
55,Wisconsin,39,Ohio,79,Jackson County,4,0,4
55,Wisconsin,39,Ohio,81,Jefferson County,0,25,-25
55,Wisconsin,39,Ohio,85,Lake County,0,3,-3
55,Wisconsin,39,Ohio,93,Lorain County,0,9,-9
55,Wisconsin,39,Ohio,95,Lucas County,205,121,84
55,Wisconsin,39,Ohio,99,Mahoning County,63,0,63
55,Wisconsin,39,Ohio,103,Medina County,15,63,-48
55,Wisconsin,39,Ohio,109,Miami County,0,2,-2
55,Wisconsin,39,Ohio,113,Montgomery County,269,190,79
55,Wisconsin,39,Ohio,117,Morrow County,3,0,3
55,Wisconsin,39,Ohio,119,Muskingum County,8,4,4
55,Wisconsin,39,Ohio,123,Ottawa County,0,6,-6
55,Wisconsin,39,Ohio,127,Perry County,0,21,-21
55,Wisconsin,39,Ohio,129,Pickaway County,12,0,12
55,Wisconsin,39,Ohio,133,Portage County,54,39,15
55,Wisconsin,39,Ohio,135,Preble County,11,0,11
55,Wisconsin,39,Ohio,141,Ross County,0,70,-70
55,Wisconsin,39,Ohio,143,Sandusky County,0,20,-20
55,Wisconsin,39,Ohio,147,Seneca County,0,5,-5
55,Wisconsin,39,Ohio,151,Stark County,0,101,-101
55,Wisconsin,39,Ohio,153,Summit County,90,141,-51
55,Wisconsin,39,Ohio,155,Trumbull County,5,46,-41
55,Wisconsin,39,Ohio,159,Union County,10,9,1
55,Wisconsin,39,Ohio,165,Warren County,29,13,16
55,Wisconsin,39,Ohio,169,Wayne County,16,13,3
55,Wisconsin,39,Ohio,173,Wood County,18,34,-16
55,Wisconsin,4,Arizona,1,Apache County,0,35,-35
55,Wisconsin,4,Arizona,3,Cochise County,69,37,32
55,Wisconsin,4,Arizona,5,Coconino County,48,67,-19
55,Wisconsin,4,Arizona,9,Graham County,0,40,-40
55,Wisconsin,4,Arizona,12,La Paz County,0,16,-16
55,Wisconsin,4,Arizona,13,Maricopa County,1751,2887,-1136
55,Wisconsin,4,Arizona,15,Mohave County,59,271,-212
55,Wisconsin,4,Arizona,17,Navajo County,22,4,18
55,Wisconsin,4,Arizona,19,Pima County,328,1117,-789
55,Wisconsin,4,Arizona,21,Pinal County,195,828,-633
55,Wisconsin,4,Arizona,23,Santa Cruz County,0,13,-13
55,Wisconsin,4,Arizona,25,Yavapai County,118,105,13
55,Wisconsin,4,Arizona,27,Yuma County,31,150,-119
55,Wisconsin,40,Oklahoma,1,Adair County,0,27,-27
55,Wisconsin,40,Oklahoma,5,Atoka County,0,7,-7
55,Wisconsin,40,Oklahoma,13,Bryan County,5,0,5
55,Wisconsin,40,Oklahoma,15,Caddo County,14,0,14
55,Wisconsin,40,Oklahoma,17,Canadian County,19,0,19
55,Wisconsin,40,Oklahoma,19,Carter County,0,3,-3
55,Wisconsin,40,Oklahoma,27,Cleveland County,117,46,71
55,Wisconsin,40,Oklahoma,29,Coal County,1,0,1
55,Wisconsin,40,Oklahoma,31,Comanche County,107,306,-199
55,Wisconsin,40,Oklahoma,39,Custer County,0,5,-5
55,Wisconsin,40,Oklahoma,41,Delaware County,55,4,51
55,Wisconsin,40,Oklahoma,47,Garfield County,24,3,21
55,Wisconsin,40,Oklahoma,65,Jackson County,8,0,8
55,Wisconsin,40,Oklahoma,71,Kay County,33,7,26
55,Wisconsin,40,Oklahoma,77,Latimer County,0,11,-11
55,Wisconsin,40,Oklahoma,79,Le Flore County,13,0,13
55,Wisconsin,40,Oklahoma,83,Logan County,43,0,43
55,Wisconsin,40,Oklahoma,87,McClain County,55,0,55
55,Wisconsin,40,Oklahoma,89,McCurtain County,5,5,0
55,Wisconsin,40,Oklahoma,97,Mayes County,18,0,18
55,Wisconsin,40,Oklahoma,99,Murray County,3,0,3
55,Wisconsin,40,Oklahoma,101,Muskogee County,0,98,-98
55,Wisconsin,40,Oklahoma,109,Oklahoma County,204,144,60
55,Wisconsin,40,Oklahoma,111,Okmulgee County,0,13,-13
55,Wisconsin,40,Oklahoma,113,Osage County,5,0,5
55,Wisconsin,40,Oklahoma,115,Ottawa County,4,0,4
55,Wisconsin,40,Oklahoma,119,Payne County,0,29,-29
55,Wisconsin,40,Oklahoma,123,Pontotoc County,73,0,73
55,Wisconsin,40,Oklahoma,137,Stephens County,0,28,-28
55,Wisconsin,40,Oklahoma,139,Texas County,29,0,29
55,Wisconsin,40,Oklahoma,141,Tillman County,2,0,2
55,Wisconsin,40,Oklahoma,143,Tulsa County,121,139,-18
55,Wisconsin,40,Oklahoma,147,Washington County,2,0,2
55,Wisconsin,40,Oklahoma,151,Woods County,30,26,4
55,Wisconsin,41,Oregon,3,Benton County,19,39,-20
55,Wisconsin,41,Oregon,5,Clackamas County,22,36,-14
55,Wisconsin,41,Oregon,7,Clatsop County,1,0,1
55,Wisconsin,41,Oregon,11,Coos County,44,86,-42
55,Wisconsin,41,Oregon,13,Crook County,3,0,3
55,Wisconsin,41,Oregon,15,Curry County,132,0,132
55,Wisconsin,41,Oregon,17,Deschutes County,41,0,41
55,Wisconsin,41,Oregon,19,Douglas County,21,1,20
55,Wisconsin,41,Oregon,29,Jackson County,35,29,6
55,Wisconsin,41,Oregon,35,Klamath County,2,5,-3
55,Wisconsin,41,Oregon,37,Lake County,5,0,5
55,Wisconsin,41,Oregon,39,Lane County,61,143,-82
55,Wisconsin,41,Oregon,41,Lincoln County,12,0,12
55,Wisconsin,41,Oregon,43,Linn County,30,26,4
55,Wisconsin,41,Oregon,45,Malheur County,0,6,-6
55,Wisconsin,41,Oregon,47,Marion County,6,129,-123
55,Wisconsin,41,Oregon,51,Multnomah County,161,355,-194
55,Wisconsin,41,Oregon,53,Polk County,19,4,15
55,Wisconsin,41,Oregon,57,Tillamook County,0,11,-11
55,Wisconsin,41,Oregon,59,Umatilla County,0,21,-21
55,Wisconsin,41,Oregon,65,Wasco County,3,0,3
55,Wisconsin,41,Oregon,67,Washington County,135,270,-135
55,Wisconsin,42,Pennsylvania,1,Adams County,26,0,26
55,Wisconsin,42,Pennsylvania,3,Allegheny County,291,209,82
55,Wisconsin,42,Pennsylvania,5,Armstrong County,17,0,17
55,Wisconsin,42,Pennsylvania,9,Bedford County,29,0,29
55,Wisconsin,42,Pennsylvania,11,Berks County,65,0,65
55,Wisconsin,42,Pennsylvania,15,Bradford County,25,0,25
55,Wisconsin,42,Pennsylvania,17,Bucks County,22,84,-62
55,Wisconsin,42,Pennsylvania,19,Butler County,30,32,-2
55,Wisconsin,42,Pennsylvania,21,Cambria County,42,0,42
55,Wisconsin,42,Pennsylvania,23,Cameron County,0,2,-2
55,Wisconsin,42,Pennsylvania,27,Centre County,46,41,5
55,Wisconsin,42,Pennsylvania,29,Chester County,71,88,-17
55,Wisconsin,42,Pennsylvania,33,Clearfield County,10,0,10
55,Wisconsin,42,Pennsylvania,37,Columbia County,1,3,-2
55,Wisconsin,42,Pennsylvania,41,Cumberland County,31,51,-20
55,Wisconsin,42,Pennsylvania,43,Dauphin County,10,203,-193
55,Wisconsin,42,Pennsylvania,45,Delaware County,15,144,-129
55,Wisconsin,42,Pennsylvania,49,Erie County,0,18,-18
55,Wisconsin,42,Pennsylvania,53,Forest County,8,0,8
55,Wisconsin,42,Pennsylvania,55,Franklin County,15,48,-33
55,Wisconsin,42,Pennsylvania,61,Huntingdon County,11,0,11
55,Wisconsin,42,Pennsylvania,65,Jefferson County,0,11,-11
55,Wisconsin,42,Pennsylvania,67,Juniata County,0,6,-6
55,Wisconsin,42,Pennsylvania,69,Lackawanna County,29,7,22
55,Wisconsin,42,Pennsylvania,71,Lancaster County,147,279,-132
55,Wisconsin,42,Pennsylvania,77,Lehigh County,123,0,123
55,Wisconsin,42,Pennsylvania,79,Luzerne County,78,27,51
55,Wisconsin,42,Pennsylvania,81,Lycoming County,0,11,-11
55,Wisconsin,42,Pennsylvania,89,Monroe County,21,0,21
55,Wisconsin,42,Pennsylvania,91,Montgomery County,69,63,6
55,Wisconsin,42,Pennsylvania,93,Montour County,0,3,-3
55,Wisconsin,42,Pennsylvania,95,Northampton County,56,0,56
55,Wisconsin,42,Pennsylvania,97,Northumberland County,17,6,11
55,Wisconsin,42,Pennsylvania,99,Perry County,0,7,-7
55,Wisconsin,42,Pennsylvania,101,Philadelphia County,283,147,136
55,Wisconsin,42,Pennsylvania,103,Pike County,2,0,2
55,Wisconsin,42,Pennsylvania,105,Potter County,0,8,-8
55,Wisconsin,42,Pennsylvania,109,Snyder County,14,0,14
55,Wisconsin,42,Pennsylvania,111,Somerset County,2,0,2
55,Wisconsin,42,Pennsylvania,119,Union County,2,3,-1
55,Wisconsin,42,Pennsylvania,121,Venango County,8,0,8
55,Wisconsin,42,Pennsylvania,125,Washington County,9,14,-5
55,Wisconsin,42,Pennsylvania,127,Wayne County,0,6,-6
55,Wisconsin,42,Pennsylvania,129,Westmoreland County,0,5,-5
55,Wisconsin,42,Pennsylvania,133,York County,0,33,-33
55,Wisconsin,44,Rhode Island,1,Bristol County,0,30,-30
55,Wisconsin,44,Rhode Island,7,Providence County,64,31,33
55,Wisconsin,44,Rhode Island,9,Washington County,23,40,-17
55,Wisconsin,45,South Carolina,3,Aiken County,21,28,-7
55,Wisconsin,45,South Carolina,9,Bamberg County,0,3,-3
55,Wisconsin,45,South Carolina,13,Beaufort County,34,104,-70
55,Wisconsin,45,South Carolina,15,Berkeley County,69,209,-140
55,Wisconsin,45,South Carolina,19,Charleston County,32,37,-5
55,Wisconsin,45,South Carolina,21,Cherokee County,0,5,-5
55,Wisconsin,45,South Carolina,25,Chesterfield County,1,0,1
55,Wisconsin,45,South Carolina,31,Darlington County,0,5,-5
55,Wisconsin,45,South Carolina,35,Dorchester County,0,23,-23
55,Wisconsin,45,South Carolina,41,Florence County,66,1,65
55,Wisconsin,45,South Carolina,45,Greenville County,126,246,-120
55,Wisconsin,45,South Carolina,47,Greenwood County,1,0,1
55,Wisconsin,45,South Carolina,53,Jasper County,8,0,8
55,Wisconsin,45,South Carolina,55,Kershaw County,22,0,22
55,Wisconsin,45,South Carolina,57,Lancaster County,0,21,-21
55,Wisconsin,45,South Carolina,59,Laurens County,33,0,33
55,Wisconsin,45,South Carolina,63,Lexington County,104,0,104
55,Wisconsin,45,South Carolina,71,Newberry County,14,0,14
55,Wisconsin,45,South Carolina,73,Oconee County,5,13,-8
55,Wisconsin,45,South Carolina,77,Pickens County,16,39,-23
55,Wisconsin,45,South Carolina,79,Richland County,102,197,-95
55,Wisconsin,45,South Carolina,83,Spartanburg County,58,61,-3
55,Wisconsin,45,South Carolina,85,Sumter County,30,30,0
55,Wisconsin,45,South Carolina,89,Williamsburg County,0,1,-1
55,Wisconsin,45,South Carolina,91,York County,0,114,-114
55,Wisconsin,46,South Dakota,9,Bon Homme County,0,6,-6
55,Wisconsin,46,South Dakota,11,Brookings County,44,44,0
55,Wisconsin,46,South Dakota,13,Brown County,33,65,-32
55,Wisconsin,46,South Dakota,23,Charles Mix County,0,4,-4
55,Wisconsin,46,South Dakota,25,Clark County,1,0,1
55,Wisconsin,46,South Dakota,27,Clay County,42,17,25
55,Wisconsin,46,South Dakota,29,Codington County,20,4,16
55,Wisconsin,46,South Dakota,33,Custer County,2,0,2
55,Wisconsin,46,South Dakota,35,Davison County,0,5,-5
55,Wisconsin,46,South Dakota,37,Day County,0,1,-1
55,Wisconsin,46,South Dakota,47,Fall River County,72,0,72
55,Wisconsin,46,South Dakota,57,Hamlin County,0,1,-1
55,Wisconsin,46,South Dakota,63,Harding County,0,5,-5
55,Wisconsin,46,South Dakota,65,Hughes County,0,38,-38
55,Wisconsin,46,South Dakota,73,Jerauld County,0,10,-10
55,Wisconsin,46,South Dakota,77,Kingsbury County,0,22,-22
55,Wisconsin,46,South Dakota,81,Lawrence County,0,11,-11
55,Wisconsin,46,South Dakota,93,Meade County,0,29,-29
55,Wisconsin,46,South Dakota,99,Minnehaha County,53,241,-188
55,Wisconsin,46,South Dakota,102,Oglala Lakota County,10,0,10
55,Wisconsin,46,South Dakota,103,Pennington County,5,124,-119
55,Wisconsin,46,South Dakota,105,Perkins County,0,3,-3
55,Wisconsin,46,South Dakota,109,Roberts County,28,35,-7
55,Wisconsin,46,South Dakota,115,Spink County,8,0,8
55,Wisconsin,46,South Dakota,127,Union County,15,9,6
55,Wisconsin,46,South Dakota,135,Yankton County,50,6,44
55,Wisconsin,47,Tennessee,1,Anderson County,191,26,165
55,Wisconsin,47,Tennessee,3,Bedford County,0,1,-1
55,Wisconsin,47,Tennessee,9,Blount County,3,42,-39
55,Wisconsin,47,Tennessee,11,Bradley County,44,2,42
55,Wisconsin,47,Tennessee,19,Carter County,0,8,-8
55,Wisconsin,47,Tennessee,21,Cheatham County,25,70,-45
55,Wisconsin,47,Tennessee,25,Claiborne County,0,7,-7
55,Wisconsin,47,Tennessee,31,Coffee County,3,0,3
55,Wisconsin,47,Tennessee,35,Cumberland County,31,0,31
55,Wisconsin,47,Tennessee,37,Davidson County,306,305,1
55,Wisconsin,47,Tennessee,43,Dickson County,0,38,-38
55,Wisconsin,47,Tennessee,55,Giles County,0,7,-7
55,Wisconsin,47,Tennessee,59,Greene County,48,0,48
55,Wisconsin,47,Tennessee,65,Hamilton County,74,69,5
55,Wisconsin,47,Tennessee,69,Hardeman County,14,0,14
55,Wisconsin,47,Tennessee,73,Hawkins County,0,10,-10
55,Wisconsin,47,Tennessee,75,Haywood County,0,2,-2
55,Wisconsin,47,Tennessee,77,Henderson County,52,0,52
55,Wisconsin,47,Tennessee,79,Henry County,9,0,9
55,Wisconsin,47,Tennessee,81,Hickman County,2,14,-12
55,Wisconsin,47,Tennessee,93,Knox County,179,144,35
55,Wisconsin,47,Tennessee,97,Lauderdale County,3,9,-6
55,Wisconsin,47,Tennessee,103,Lincoln County,24,0,24
55,Wisconsin,47,Tennessee,105,Loudon County,6,0,6
55,Wisconsin,47,Tennessee,107,McMinn County,12,15,-3
55,Wisconsin,47,Tennessee,109,McNairy County,0,4,-4
55,Wisconsin,47,Tennessee,113,Madison County,19,46,-27
55,Wisconsin,47,Tennessee,115,Marion County,7,0,7
55,Wisconsin,47,Tennessee,119,Maury County,61,2,59
55,Wisconsin,47,Tennessee,125,Montgomery County,157,44,113
55,Wisconsin,47,Tennessee,133,Overton County,7,0,7
55,Wisconsin,47,Tennessee,135,Perry County,6,0,6
55,Wisconsin,47,Tennessee,141,Putnam County,33,67,-34
55,Wisconsin,47,Tennessee,147,Robertson County,49,0,49
55,Wisconsin,47,Tennessee,149,Rutherford County,7,91,-84
55,Wisconsin,47,Tennessee,155,Sevier County,6,93,-87
55,Wisconsin,47,Tennessee,157,Shelby County,289,154,135
55,Wisconsin,47,Tennessee,163,Sullivan County,23,0,23
55,Wisconsin,47,Tennessee,165,Sumner County,95,287,-192
55,Wisconsin,47,Tennessee,167,Tipton County,2,0,2
55,Wisconsin,47,Tennessee,179,Washington County,20,64,-44
55,Wisconsin,47,Tennessee,183,Weakley County,0,6,-6
55,Wisconsin,47,Tennessee,187,Williamson County,4,48,-44
55,Wisconsin,47,Tennessee,189,Wilson County,18,0,18
55,Wisconsin,48,Texas,1,Anderson County,12,0,12
55,Wisconsin,48,Texas,5,Angelina County,22,44,-22
55,Wisconsin,48,Texas,7,Aransas County,22,3,19
55,Wisconsin,48,Texas,13,Atascosa County,0,8,-8
55,Wisconsin,48,Texas,17,Bailey County,8,0,8
55,Wisconsin,48,Texas,21,Bastrop County,0,253,-253
55,Wisconsin,48,Texas,25,Bee County,81,0,81
55,Wisconsin,48,Texas,27,Bell County,105,284,-179
55,Wisconsin,48,Texas,29,Bexar County,333,457,-124
55,Wisconsin,48,Texas,37,Bowie County,0,9,-9
55,Wisconsin,48,Texas,39,Brazoria County,12,5,7
55,Wisconsin,48,Texas,41,Brazos County,46,0,46
55,Wisconsin,48,Texas,43,Brewster County,12,0,12
55,Wisconsin,48,Texas,49,Brown County,5,6,-1
55,Wisconsin,48,Texas,57,Calhoun County,29,0,29
55,Wisconsin,48,Texas,61,Cameron County,159,43,116
55,Wisconsin,48,Texas,67,Cass County,16,0,16
55,Wisconsin,48,Texas,85,Collin County,109,193,-84
55,Wisconsin,48,Texas,99,Coryell County,20,34,-14
55,Wisconsin,48,Texas,113,Dallas County,322,532,-210
55,Wisconsin,48,Texas,121,Denton County,116,277,-161
55,Wisconsin,48,Texas,123,DeWitt County,6,0,6
55,Wisconsin,48,Texas,135,Ector County,0,7,-7
55,Wisconsin,48,Texas,139,Ellis County,0,4,-4
55,Wisconsin,48,Texas,141,El Paso County,309,94,215
55,Wisconsin,48,Texas,157,Fort Bend County,87,35,52
55,Wisconsin,48,Texas,167,Galveston County,134,26,108
55,Wisconsin,48,Texas,181,Grayson County,3,26,-23
55,Wisconsin,48,Texas,183,Gregg County,0,4,-4
55,Wisconsin,48,Texas,187,Guadalupe County,81,0,81
55,Wisconsin,48,Texas,189,Hale County,0,2,-2
55,Wisconsin,48,Texas,201,Harris County,462,986,-524
55,Wisconsin,48,Texas,203,Harrison County,15,16,-1
55,Wisconsin,48,Texas,205,Hartley County,6,0,6
55,Wisconsin,48,Texas,209,Hays County,0,63,-63
55,Wisconsin,48,Texas,213,Henderson County,87,0,87
55,Wisconsin,48,Texas,215,Hidalgo County,405,335,70
55,Wisconsin,48,Texas,221,Hood County,21,0,21
55,Wisconsin,48,Texas,227,Howard County,6,12,-6
55,Wisconsin,48,Texas,231,Hunt County,0,82,-82
55,Wisconsin,48,Texas,245,Jefferson County,3,33,-30
55,Wisconsin,48,Texas,249,Jim Wells County,6,0,6
55,Wisconsin,48,Texas,251,Johnson County,57,20,37
55,Wisconsin,48,Texas,255,Karnes County,7,0,7
55,Wisconsin,48,Texas,259,Kendall County,44,0,44
55,Wisconsin,48,Texas,273,Kleberg County,0,40,-40
55,Wisconsin,48,Texas,277,Lamar County,17,18,-1
55,Wisconsin,48,Texas,293,Limestone County,0,16,-16
55,Wisconsin,48,Texas,303,Lubbock County,16,36,-20
55,Wisconsin,48,Texas,309,McLennan County,31,31,0
55,Wisconsin,48,Texas,323,Maverick County,36,0,36
55,Wisconsin,48,Texas,329,Midland County,3,0,3
55,Wisconsin,48,Texas,339,Montgomery County,41,123,-82
55,Wisconsin,48,Texas,347,Nacogdoches County,23,0,23
55,Wisconsin,48,Texas,355,Nueces County,50,36,14
55,Wisconsin,48,Texas,359,Oldham County,0,4,-4
55,Wisconsin,48,Texas,361,Orange County,0,12,-12
55,Wisconsin,48,Texas,367,Parker County,0,142,-142
55,Wisconsin,48,Texas,373,Polk County,25,0,25
55,Wisconsin,48,Texas,375,Potter County,31,0,31
55,Wisconsin,48,Texas,381,Randall County,82,0,82
55,Wisconsin,48,Texas,397,Rockwall County,8,82,-74
55,Wisconsin,48,Texas,399,Runnels County,19,0,19
55,Wisconsin,48,Texas,409,San Patricio County,1,0,1
55,Wisconsin,48,Texas,423,Smith County,5,0,5
55,Wisconsin,48,Texas,439,Tarrant County,264,509,-245
55,Wisconsin,48,Texas,441,Taylor County,16,0,16
55,Wisconsin,48,Texas,451,Tom Green County,0,48,-48
55,Wisconsin,48,Texas,453,Travis County,352,765,-413
55,Wisconsin,48,Texas,459,Upshur County,71,0,71
55,Wisconsin,48,Texas,465,Val Verde County,0,25,-25
55,Wisconsin,48,Texas,471,Walker County,0,18,-18
55,Wisconsin,48,Texas,475,Ward County,9,0,9
55,Wisconsin,48,Texas,479,Webb County,8,56,-48
55,Wisconsin,48,Texas,485,Wichita County,57,14,43
55,Wisconsin,48,Texas,489,Willacy County,1,0,1
55,Wisconsin,48,Texas,491,Williamson County,99,210,-111
55,Wisconsin,48,Texas,497,Wise County,3,0,3
55,Wisconsin,49,Utah,3,Box Elder County,6,0,6
55,Wisconsin,49,Utah,5,Cache County,10,65,-55
55,Wisconsin,49,Utah,11,Davis County,238,112,126
55,Wisconsin,49,Utah,21,Iron County,67,0,67
55,Wisconsin,49,Utah,29,Morgan County,0,42,-42
55,Wisconsin,49,Utah,35,Salt Lake County,385,269,116
55,Wisconsin,49,Utah,39,Sanpete County,0,1,-1
55,Wisconsin,49,Utah,45,Tooele County,4,0,4
55,Wisconsin,49,Utah,47,Uintah County,203,0,203
55,Wisconsin,49,Utah,49,Utah County,169,214,-45
55,Wisconsin,49,Utah,53,Washington County,25,103,-78
55,Wisconsin,49,Utah,57,Weber County,0,4,-4
55,Wisconsin,5,Arkansas,5,Baxter County,110,16,94
55,Wisconsin,5,Arkansas,7,Benton County,128,76,52
55,Wisconsin,5,Arkansas,9,Boone County,11,3,8
55,Wisconsin,5,Arkansas,15,Carroll County,20,0,20
55,Wisconsin,5,Arkansas,23,Cleburne County,0,8,-8
55,Wisconsin,5,Arkansas,25,Cleveland County,0,66,-66
55,Wisconsin,5,Arkansas,27,Columbia County,0,20,-20
55,Wisconsin,5,Arkansas,31,Craighead County,21,54,-33
55,Wisconsin,5,Arkansas,33,Crawford County,9,0,9
55,Wisconsin,5,Arkansas,35,Crittenden County,0,34,-34
55,Wisconsin,5,Arkansas,39,Dallas County,0,65,-65
55,Wisconsin,5,Arkansas,45,Faulkner County,15,20,-5
55,Wisconsin,5,Arkansas,47,Franklin County,0,8,-8
55,Wisconsin,5,Arkansas,49,Fulton County,0,28,-28
55,Wisconsin,5,Arkansas,51,Garland County,14,56,-42
55,Wisconsin,5,Arkansas,55,Greene County,8,0,8
55,Wisconsin,5,Arkansas,59,Hot Spring County,0,112,-112
55,Wisconsin,5,Arkansas,63,Independence County,0,6,-6
55,Wisconsin,5,Arkansas,69,Jefferson County,32,2,30
55,Wisconsin,5,Arkansas,71,Johnson County,0,11,-11
55,Wisconsin,5,Arkansas,83,Logan County,0,7,-7
55,Wisconsin,5,Arkansas,85,Lonoke County,39,0,39
55,Wisconsin,5,Arkansas,93,Mississippi County,13,7,6
55,Wisconsin,5,Arkansas,97,Montgomery County,0,19,-19
55,Wisconsin,5,Arkansas,103,Ouachita County,0,3,-3
55,Wisconsin,5,Arkansas,107,Phillips County,0,12,-12
55,Wisconsin,5,Arkansas,111,Poinsett County,7,0,7
55,Wisconsin,5,Arkansas,119,Pulaski County,54,40,14
55,Wisconsin,5,Arkansas,121,Randolph County,16,7,9
55,Wisconsin,5,Arkansas,123,St. Francis County,0,1,-1
55,Wisconsin,5,Arkansas,125,Saline County,31,0,31
55,Wisconsin,5,Arkansas,127,Scott County,0,19,-19
55,Wisconsin,5,Arkansas,131,Sebastian County,27,0,27
55,Wisconsin,5,Arkansas,135,Sharp County,26,16,10
55,Wisconsin,5,Arkansas,139,Union County,4,1,3
55,Wisconsin,5,Arkansas,143,Washington County,21,31,-10
55,Wisconsin,5,Arkansas,145,White County,17,5,12
55,Wisconsin,50,Vermont,1,Addison County,8,6,2
55,Wisconsin,50,Vermont,3,Bennington County,9,15,-6
55,Wisconsin,50,Vermont,7,Chittenden County,45,13,32
55,Wisconsin,50,Vermont,11,Franklin County,15,0,15
55,Wisconsin,50,Vermont,19,Orleans County,0,2,-2
55,Wisconsin,50,Vermont,21,Rutland County,8,0,8
55,Wisconsin,50,Vermont,25,Windham County,0,8,-8
55,Wisconsin,51,Virginia,3,Albemarle County,8,24,-16
55,Wisconsin,51,Virginia,13,Arlington County,102,122,-20
55,Wisconsin,51,Virginia,19,Bedford County,0,10,-10
55,Wisconsin,51,Virginia,23,Botetourt County,0,18,-18
55,Wisconsin,51,Virginia,25,Brunswick County,0,8,-8
55,Wisconsin,51,Virginia,31,Campbell County,0,24,-24
55,Wisconsin,51,Virginia,37,Charlotte County,0,14,-14
55,Wisconsin,51,Virginia,41,Chesterfield County,27,3,24
55,Wisconsin,51,Virginia,59,Fairfax County,189,205,-16
55,Wisconsin,51,Virginia,61,Fauquier County,14,0,14
55,Wisconsin,51,Virginia,69,Frederick County,25,0,25
55,Wisconsin,51,Virginia,85,Hanover County,0,25,-25
55,Wisconsin,51,Virginia,87,Henrico County,103,52,51
55,Wisconsin,51,Virginia,95,James City County,0,20,-20
55,Wisconsin,51,Virginia,99,King George County,2,2,0
55,Wisconsin,51,Virginia,105,Lee County,0,13,-13
55,Wisconsin,51,Virginia,107,Loudoun County,111,20,91
55,Wisconsin,51,Virginia,111,Lunenburg County,0,6,-6
55,Wisconsin,51,Virginia,121,Montgomery County,16,10,6
55,Wisconsin,51,Virginia,125,Nelson County,32,0,32
55,Wisconsin,51,Virginia,135,Nottoway County,27,0,27
55,Wisconsin,51,Virginia,145,Powhatan County,7,0,7
55,Wisconsin,51,Virginia,153,Prince William County,229,88,141
55,Wisconsin,51,Virginia,155,Pulaski County,0,38,-38
55,Wisconsin,51,Virginia,171,Shenandoah County,21,0,21
55,Wisconsin,51,Virginia,173,Smyth County,0,39,-39
55,Wisconsin,51,Virginia,177,Spotsylvania County,71,9,62
55,Wisconsin,51,Virginia,179,Stafford County,10,0,10
55,Wisconsin,51,Virginia,187,Warren County,9,0,9
55,Wisconsin,51,Virginia,191,Washington County,11,0,11
55,Wisconsin,51,Virginia,197,Wythe County,3,0,3
55,Wisconsin,51,Virginia,199,York County,71,0,71
55,Wisconsin,51,Virginia,510,Alexandria city,51,104,-53
55,Wisconsin,51,Virginia,540,Charlottesville city,25,0,25
55,Wisconsin,51,Virginia,550,Chesapeake city,107,156,-49
55,Wisconsin,51,Virginia,630,Fredericksburg city,2,0,2
55,Wisconsin,51,Virginia,640,Galax city,23,0,23
55,Wisconsin,51,Virginia,650,Hampton city,50,57,-7
55,Wisconsin,51,Virginia,660,Harrisonburg city,43,0,43
55,Wisconsin,51,Virginia,680,Lynchburg city,6,20,-14
55,Wisconsin,51,Virginia,700,Newport News city,29,18,11
55,Wisconsin,51,Virginia,710,Norfolk city,38,69,-31
55,Wisconsin,51,Virginia,730,Petersburg city,2,0,2
55,Wisconsin,51,Virginia,740,Portsmouth city,17,0,17
55,Wisconsin,51,Virginia,750,Radford city,14,0,14
55,Wisconsin,51,Virginia,760,Richmond city,107,14,93
55,Wisconsin,51,Virginia,790,Staunton city,7,0,7
55,Wisconsin,51,Virginia,810,Virginia Beach city,138,308,-170
55,Wisconsin,51,Virginia,830,Williamsburg city,0,2,-2
55,Wisconsin,53,Washington,5,Benton County,60,22,38
55,Wisconsin,53,Washington,7,Chelan County,26,28,-2
55,Wisconsin,53,Washington,9,Clallam County,70,32,38
55,Wisconsin,53,Washington,11,Clark County,144,194,-50
55,Wisconsin,53,Washington,15,Cowlitz County,3,10,-7
55,Wisconsin,53,Washington,17,Douglas County,27,18,9
55,Wisconsin,53,Washington,21,Franklin County,79,0,79
55,Wisconsin,53,Washington,25,Grant County,9,0,9
55,Wisconsin,53,Washington,29,Island County,34,113,-79
55,Wisconsin,53,Washington,31,Jefferson County,0,18,-18
55,Wisconsin,53,Washington,33,King County,471,1152,-681
55,Wisconsin,53,Washington,35,Kitsap County,109,133,-24
55,Wisconsin,53,Washington,37,Kittitas County,7,0,7
55,Wisconsin,53,Washington,39,Klickitat County,19,0,19
55,Wisconsin,53,Washington,41,Lewis County,1,91,-90
55,Wisconsin,53,Washington,47,Okanogan County,12,0,12
55,Wisconsin,53,Washington,53,Pierce County,177,337,-160
55,Wisconsin,53,Washington,55,San Juan County,12,8,4
55,Wisconsin,53,Washington,57,Skagit County,2,75,-73
55,Wisconsin,53,Washington,61,Snohomish County,299,92,207
55,Wisconsin,53,Washington,63,Spokane County,165,203,-38
55,Wisconsin,53,Washington,65,Stevens County,50,4,46
55,Wisconsin,53,Washington,67,Thurston County,66,81,-15
55,Wisconsin,53,Washington,69,Wahkiakum County,4,0,4
55,Wisconsin,53,Washington,71,Walla Walla County,7,5,2
55,Wisconsin,53,Washington,73,Whatcom County,0,14,-14
55,Wisconsin,53,Washington,75,Whitman County,1,0,1
55,Wisconsin,53,Washington,77,Yakima County,25,0,25
55,Wisconsin,54,West Virginia,11,Cabell County,13,73,-60
55,Wisconsin,54,West Virginia,21,Gilmer County,3,9,-6
55,Wisconsin,54,West Virginia,25,Greenbrier County,21,0,21
55,Wisconsin,54,West Virginia,27,Hampshire County,3,0,3
55,Wisconsin,54,West Virginia,29,Hancock County,0,21,-21
55,Wisconsin,54,West Virginia,39,Kanawha County,2,13,-11
55,Wisconsin,54,West Virginia,53,Mason County,3,13,-10
55,Wisconsin,54,West Virginia,61,Monongalia County,2,37,-35
55,Wisconsin,54,West Virginia,67,Nicholas County,0,19,-19
55,Wisconsin,54,West Virginia,69,Ohio County,0,8,-8
55,Wisconsin,54,West Virginia,81,Raleigh County,69,0,69
55,Wisconsin,54,West Virginia,83,Randolph County,58,0,58
55,Wisconsin,54,West Virginia,87,Roane County,5,0,5
55,Wisconsin,54,West Virginia,107,Wood County,21,0,21
55,Wisconsin,55,Wisconsin,1,Adams County,1156,900,256
55,Wisconsin,55,Wisconsin,3,Ashland County,510,637,-127
55,Wisconsin,55,Wisconsin,5,Barron County,1659,1456,203
55,Wisconsin,55,Wisconsin,7,Bayfield County,583,337,246
55,Wisconsin,55,Wisconsin,9,Brown County,8553,7926,627
55,Wisconsin,55,Wisconsin,11,Buffalo County,464,486,-22
55,Wisconsin,55,Wisconsin,13,Burnett County,638,423,215
55,Wisconsin,55,Wisconsin,15,Calumet County,3338,1981,1357
55,Wisconsin,55,Wisconsin,17,Chippewa County,2994,3498,-504
55,Wisconsin,55,Wisconsin,19,Clark County,1652,968,684
55,Wisconsin,55,Wisconsin,21,Columbia County,3260,2582,678
55,Wisconsin,55,Wisconsin,23,Crawford County,882,796,86
55,Wisconsin,55,Wisconsin,25,Dane County,12802,15785,-2983
55,Wisconsin,55,Wisconsin,27,Dodge County,4869,5067,-198
55,Wisconsin,55,Wisconsin,29,Door County,829,794,35
55,Wisconsin,55,Wisconsin,31,Douglas County,828,627,201
55,Wisconsin,55,Wisconsin,33,Dunn County,1835,3366,-1531
55,Wisconsin,55,Wisconsin,35,Eau Claire County,4447,5599,-1152
55,Wisconsin,55,Wisconsin,37,Florence County,141,177,-36
55,Wisconsin,55,Wisconsin,39,Fond du Lac County,4357,3614,743
55,Wisconsin,55,Wisconsin,41,Forest County,538,313,225
55,Wisconsin,55,Wisconsin,43,Grant County,1742,3014,-1272
55,Wisconsin,55,Wisconsin,45,Green County,1462,1566,-104
55,Wisconsin,55,Wisconsin,47,Green Lake County,913,641,272
55,Wisconsin,55,Wisconsin,49,Iowa County,1011,860,151
55,Wisconsin,55,Wisconsin,51,Iron County,212,294,-82
55,Wisconsin,55,Wisconsin,53,Jackson County,865,1187,-322
55,Wisconsin,55,Wisconsin,55,Jefferson County,4035,4825,-790
55,Wisconsin,55,Wisconsin,57,Juneau County,1269,1390,-121
55,Wisconsin,55,Wisconsin,59,Kenosha County,4356,3944,412
55,Wisconsin,55,Wisconsin,61,Kewaunee County,1062,545,517
55,Wisconsin,55,Wisconsin,63,La Crosse County,3982,6086,-2104
55,Wisconsin,55,Wisconsin,65,Lafayette County,905,662,243
55,Wisconsin,55,Wisconsin,67,Langlade County,708,1002,-294
55,Wisconsin,55,Wisconsin,69,Lincoln County,919,1280,-361
55,Wisconsin,55,Wisconsin,71,Manitowoc County,2699,1404,1295
55,Wisconsin,55,Wisconsin,73,Marathon County,4452,4149,303
55,Wisconsin,55,Wisconsin,75,Marinette County,1242,1075,167
55,Wisconsin,55,Wisconsin,77,Marquette County,751,532,219
55,Wisconsin,55,Wisconsin,78,Menominee County,222,162,60
55,Wisconsin,55,Wisconsin,79,Milwaukee County,23987,19431,4556
55,Wisconsin,55,Wisconsin,81,Monroe County,1971,1425,546
55,Wisconsin,55,Wisconsin,83,Oconto County,1857,1324,533
55,Wisconsin,55,Wisconsin,85,Oneida County,1491,878,613
55,Wisconsin,55,Wisconsin,87,Outagamie County,8573,7677,896
55,Wisconsin,55,Wisconsin,89,Ozaukee County,3456,3906,-450
55,Wisconsin,55,Wisconsin,91,Pepin County,332,272,60
55,Wisconsin,55,Wisconsin,93,Pierce County,1224,2456,-1232
55,Wisconsin,55,Wisconsin,95,Polk County,1333,1168,165
55,Wisconsin,55,Wisconsin,97,Portage County,3027,5132,-2105
55,Wisconsin,55,Wisconsin,99,Price County,789,775,14
55,Wisconsin,55,Wisconsin,101,Racine County,6777,5722,1055
55,Wisconsin,55,Wisconsin,103,Richland County,635,755,-120
55,Wisconsin,55,Wisconsin,105,Rock County,3961,3106,855
55,Wisconsin,55,Wisconsin,107,Rusk County,588,533,55
55,Wisconsin,55,Wisconsin,109,St. Croix County,2437,1933,504
55,Wisconsin,55,Wisconsin,111,Sauk County,2275,2380,-105
55,Wisconsin,55,Wisconsin,113,Sawyer County,396,603,-207
55,Wisconsin,55,Wisconsin,115,Shawano County,1609,1763,-154
55,Wisconsin,55,Wisconsin,117,Sheboygan County,3464,2944,520
55,Wisconsin,55,Wisconsin,119,Taylor County,539,554,-15
55,Wisconsin,55,Wisconsin,121,Trempealeau County,1273,1052,221
55,Wisconsin,55,Wisconsin,123,Vernon County,1414,662,752
55,Wisconsin,55,Wisconsin,125,Vilas County,741,629,112
55,Wisconsin,55,Wisconsin,127,Walworth County,3508,4491,-983
55,Wisconsin,55,Wisconsin,129,Washburn County,687,479,208
55,Wisconsin,55,Wisconsin,131,Washington County,5123,5104,19
55,Wisconsin,55,Wisconsin,133,Waukesha County,14742,15090,-348
55,Wisconsin,55,Wisconsin,135,Waupaca County,1794,2593,-799
55,Wisconsin,55,Wisconsin,137,Waushara County,1453,1280,173
55,Wisconsin,55,Wisconsin,139,Winnebago County,7267,9980,-2713
55,Wisconsin,55,Wisconsin,141,Wood County,2812,2630,182
55,Wisconsin,56,Wyoming,1,Albany County,72,10,62
55,Wisconsin,56,Wyoming,3,Big Horn County,15,0,15
55,Wisconsin,56,Wyoming,5,Campbell County,0,122,-122
55,Wisconsin,56,Wyoming,11,Crook County,0,2,-2
55,Wisconsin,56,Wyoming,13,Fremont County,11,95,-84
55,Wisconsin,56,Wyoming,15,Goshen County,21,4,17
55,Wisconsin,56,Wyoming,17,Hot Springs County,0,25,-25
55,Wisconsin,56,Wyoming,21,Laramie County,54,66,-12
55,Wisconsin,56,Wyoming,23,Lincoln County,1,0,1
55,Wisconsin,56,Wyoming,25,Natrona County,57,10,47
55,Wisconsin,56,Wyoming,29,Park County,0,2,-2
55,Wisconsin,56,Wyoming,33,Sheridan County,3,32,-29
55,Wisconsin,56,Wyoming,35,Sublette County,11,0,11
55,Wisconsin,56,Wyoming,37,Sweetwater County,9,0,9
55,Wisconsin,56,Wyoming,39,Teton County,3,8,-5
55,Wisconsin,56,Wyoming,43,Washakie County,34,0,34
55,Wisconsin,6,California,1,Alameda County,309,181,128
55,Wisconsin,6,California,7,Butte County,52,27,25
55,Wisconsin,6,California,13,Contra Costa County,130,188,-58
55,Wisconsin,6,California,17,El Dorado County,17,56,-39
55,Wisconsin,6,California,19,Fresno County,78,123,-45
55,Wisconsin,6,California,23,Humboldt County,0,20,-20
55,Wisconsin,6,California,25,Imperial County,8,0,8
55,Wisconsin,6,California,29,Kern County,38,103,-65
55,Wisconsin,6,California,33,Lake County,6,19,-13
55,Wisconsin,6,California,35,Lassen County,118,5,113
55,Wisconsin,6,California,37,Los Angeles County,1058,1100,-42
55,Wisconsin,6,California,39,Madera County,0,12,-12
55,Wisconsin,6,California,41,Marin County,46,62,-16
55,Wisconsin,6,California,45,Mendocino County,17,83,-66
55,Wisconsin,6,California,47,Merced County,0,239,-239
55,Wisconsin,6,California,53,Monterey County,21,62,-41
55,Wisconsin,6,California,57,Nevada County,25,0,25
55,Wisconsin,6,California,59,Orange County,428,295,133
55,Wisconsin,6,California,61,Placer County,86,0,86
55,Wisconsin,6,California,65,Riverside County,175,363,-188
55,Wisconsin,6,California,67,Sacramento County,173,247,-74
55,Wisconsin,6,California,71,San Bernardino County,245,427,-182
55,Wisconsin,6,California,73,San Diego County,937,1708,-771
55,Wisconsin,6,California,75,San Francisco County,315,189,126
55,Wisconsin,6,California,77,San Joaquin County,77,14,63
55,Wisconsin,6,California,79,San Luis Obispo County,152,86,66
55,Wisconsin,6,California,81,San Mateo County,61,102,-41
55,Wisconsin,6,California,83,Santa Barbara County,33,95,-62
55,Wisconsin,6,California,85,Santa Clara County,596,732,-136
55,Wisconsin,6,California,87,Santa Cruz County,93,28,65
55,Wisconsin,6,California,89,Shasta County,1,30,-29
55,Wisconsin,6,California,93,Siskiyou County,0,21,-21
55,Wisconsin,6,California,95,Solano County,47,3,44
55,Wisconsin,6,California,97,Sonoma County,51,77,-26
55,Wisconsin,6,California,107,Tulare County,34,0,34
55,Wisconsin,6,California,109,Tuolumne County,9,0,9
55,Wisconsin,6,California,111,Ventura County,87,136,-49
55,Wisconsin,6,California,113,Yolo County,224,8,216
55,Wisconsin,72,Puerto Rico,3,Aguada Municipio,0,52,-52
55,Wisconsin,72,Puerto Rico,5,Aguadilla Municipio,0,11,-11
55,Wisconsin,72,Puerto Rico,15,Arroyo Municipio,0,20,-20
55,Wisconsin,72,Puerto Rico,17,Barceloneta Municipio,10,0,10
55,Wisconsin,72,Puerto Rico,19,Barranquitas Municipio,10,0,10
55,Wisconsin,72,Puerto Rico,21,Bayamón Municipio,0,18,-18
55,Wisconsin,72,Puerto Rico,27,Camuy Municipio,8,0,8
55,Wisconsin,72,Puerto Rico,29,Canóvanas Municipio,0,82,-82
55,Wisconsin,72,Puerto Rico,31,Carolina Municipio,109,0,109
55,Wisconsin,72,Puerto Rico,33,Cataño Municipio,0,59,-59
55,Wisconsin,72,Puerto Rico,35,Cayey Municipio,7,0,7
55,Wisconsin,72,Puerto Rico,39,Ciales Municipio,73,0,73
55,Wisconsin,72,Puerto Rico,54,Florida Municipio,9,0,9
55,Wisconsin,72,Puerto Rico,55,Guánica Municipio,7,0,7
55,Wisconsin,72,Puerto Rico,57,Guayama Municipio,6,0,6
55,Wisconsin,72,Puerto Rico,61,Guaynabo Municipio,118,0,118
55,Wisconsin,72,Puerto Rico,69,Humacao Municipio,6,0,6
55,Wisconsin,72,Puerto Rico,73,Jayuya Municipio,7,0,7
55,Wisconsin,72,Puerto Rico,91,Manatí Municipio,8,0,8
55,Wisconsin,72,Puerto Rico,95,Maunabo Municipio,123,0,123
55,Wisconsin,72,Puerto Rico,97,Mayagüez Municipio,200,20,180
55,Wisconsin,72,Puerto Rico,103,Naguabo Municipio,124,0,124
55,Wisconsin,72,Puerto Rico,113,Ponce Municipio,25,0,25
55,Wisconsin,72,Puerto Rico,119,Río Grande Municipio,0,26,-26
55,Wisconsin,72,Puerto Rico,127,San Juan Municipio,69,0,69
55,Wisconsin,72,Puerto Rico,131,San Sebastián Municipio,12,0,12
55,Wisconsin,72,Puerto Rico,141,Utuado Municipio,0,19,-19
55,Wisconsin,72,Puerto Rico,143,Vega Alta Municipio,106,0,106
55,Wisconsin,72,Puerto Rico,147,Vieques Municipio,16,0,16
55,Wisconsin,72,Puerto Rico,151,Yabucoa Municipio,68,0,68
55,Wisconsin,8,Colorado,1,Adams County,155,122,33
55,Wisconsin,8,Colorado,3,Alamosa County,10,0,10
55,Wisconsin,8,Colorado,5,Arapahoe County,164,977,-813
55,Wisconsin,8,Colorado,13,Boulder County,163,193,-30
55,Wisconsin,8,Colorado,14,Broomfield County,29,75,-46
55,Wisconsin,8,Colorado,17,Cheyenne County,0,3,-3
55,Wisconsin,8,Colorado,19,Clear Creek County,7,14,-7
55,Wisconsin,8,Colorado,27,Custer County,0,2,-2
55,Wisconsin,8,Colorado,29,Delta County,2,0,2
55,Wisconsin,8,Colorado,31,Denver County,250,508,-258
55,Wisconsin,8,Colorado,35,Douglas County,88,118,-30
55,Wisconsin,8,Colorado,37,Eagle County,73,36,37
55,Wisconsin,8,Colorado,39,Elbert County,0,5,-5
55,Wisconsin,8,Colorado,41,El Paso County,238,613,-375
55,Wisconsin,8,Colorado,43,Fremont County,30,24,6
55,Wisconsin,8,Colorado,45,Garfield County,0,17,-17
55,Wisconsin,8,Colorado,49,Grand County,0,7,-7
55,Wisconsin,8,Colorado,51,Gunnison County,12,31,-19
55,Wisconsin,8,Colorado,55,Huerfano County,0,7,-7
55,Wisconsin,8,Colorado,59,Jefferson County,136,200,-64
55,Wisconsin,8,Colorado,67,La Plata County,0,23,-23
55,Wisconsin,8,Colorado,69,Larimer County,264,326,-62
55,Wisconsin,8,Colorado,71,Las Animas County,0,4,-4
55,Wisconsin,8,Colorado,75,Logan County,0,59,-59
55,Wisconsin,8,Colorado,77,Mesa County,14,105,-91
55,Wisconsin,8,Colorado,87,Morgan County,0,20,-20
55,Wisconsin,8,Colorado,91,Ouray County,7,56,-49
55,Wisconsin,8,Colorado,93,Park County,23,0,23
55,Wisconsin,8,Colorado,101,Pueblo County,25,24,1
55,Wisconsin,8,Colorado,103,Rio Blanco County,0,3,-3
55,Wisconsin,8,Colorado,107,Routt County,42,12,30
55,Wisconsin,8,Colorado,113,San Miguel County,10,9,1
55,Wisconsin,8,Colorado,119,Teller County,13,0,13
55,Wisconsin,8,Colorado,121,Washington County,0,7,-7
55,Wisconsin,8,Colorado,123,Weld County,191,158,33
55,Wisconsin,9,Connecticut,1,Fairfield County,42,24,18
55,Wisconsin,9,Connecticut,3,Hartford County,168,72,96
55,Wisconsin,9,Connecticut,5,Litchfield County,28,30,-2
55,Wisconsin,9,Connecticut,9,New Haven County,122,97,25
55,Wisconsin,9,Connecticut,11,New London County,17,52,-35
55,Wisconsin,9,Connecticut,15,Windham County,55,0,55
55,Wisconsin,AFR,Africa,,-,950,0,0
55,Wisconsin,ASI,Asia,,-,9605,0,0
55,Wisconsin,CAM,Central America,,-,1512,0,0
55,Wisconsin,CAR,Caribbean,,-,476,0,0
55,Wisconsin,EUR,Europe,,-,4312,0,0
55,Wisconsin,ISL,U.S. Island Areas,,-,100,0,0
55,Wisconsin,NAM,Northern America,,-,602,0,0
55,Wisconsin,OCE,Oceania and At Sea,,-,463,0,0
55,Wisconsin,SAM,South America,,-,916,0,0
56,Wyoming,1,Alabama,1,Autauga County,0,5,-5
56,Wyoming,1,Alabama,3,Baldwin County,2,61,-59
56,Wyoming,1,Alabama,31,Coffee County,0,32,-32
56,Wyoming,1,Alabama,33,Colbert County,14,0,14
56,Wyoming,1,Alabama,51,Elmore County,17,0,17
56,Wyoming,1,Alabama,69,Houston County,8,0,8
56,Wyoming,1,Alabama,73,Jefferson County,0,57,-57
56,Wyoming,1,Alabama,89,Madison County,3,41,-38
56,Wyoming,1,Alabama,95,Marshall County,13,0,13
56,Wyoming,1,Alabama,97,Mobile County,0,21,-21
56,Wyoming,1,Alabama,101,Montgomery County,35,0,35
56,Wyoming,1,Alabama,115,St. Clair County,0,20,-20
56,Wyoming,1,Alabama,117,Shelby County,26,0,26
56,Wyoming,1,Alabama,125,Tuscaloosa County,13,0,13
56,Wyoming,1,Alabama,127,Walker County,46,0,46
56,Wyoming,10,Delaware,1,Kent County,29,0,29
56,Wyoming,10,Delaware,3,New Castle County,8,0,8
56,Wyoming,11,District of Columbia,1,District of Columbia,6,41,-35
56,Wyoming,12,Florida,1,Alachua County,48,0,48
56,Wyoming,12,Florida,5,Bay County,0,70,-70
56,Wyoming,12,Florida,9,Brevard County,4,6,-2
56,Wyoming,12,Florida,11,Broward County,0,15,-15
56,Wyoming,12,Florida,17,Citrus County,0,33,-33
56,Wyoming,12,Florida,19,Clay County,6,0,6
56,Wyoming,12,Florida,31,Duval County,378,8,370
56,Wyoming,12,Florida,33,Escambia County,3,0,3
56,Wyoming,12,Florida,45,Gulf County,0,11,-11
56,Wyoming,12,Florida,57,Hillsborough County,0,49,-49
56,Wyoming,12,Florida,61,Indian River County,0,4,-4
56,Wyoming,12,Florida,73,Leon County,13,0,13
56,Wyoming,12,Florida,81,Manatee County,9,0,9
56,Wyoming,12,Florida,86,Miami-Dade County,18,0,18
56,Wyoming,12,Florida,87,Monroe County,0,27,-27
56,Wyoming,12,Florida,91,Okaloosa County,2,3,-1
56,Wyoming,12,Florida,95,Orange County,12,66,-54
56,Wyoming,12,Florida,99,Palm Beach County,56,81,-25
56,Wyoming,12,Florida,101,Pasco County,19,0,19
56,Wyoming,12,Florida,103,Pinellas County,4,0,4
56,Wyoming,12,Florida,109,St. Johns County,25,0,25
56,Wyoming,12,Florida,115,Sarasota County,3,30,-27
56,Wyoming,12,Florida,117,Seminole County,4,37,-33
56,Wyoming,13,Georgia,31,Bulloch County,0,14,-14
56,Wyoming,13,Georgia,49,Charlton County,0,4,-4
56,Wyoming,13,Georgia,51,Chatham County,0,38,-38
56,Wyoming,13,Georgia,59,Clarke County,0,17,-17
56,Wyoming,13,Georgia,77,Coweta County,101,0,101
56,Wyoming,13,Georgia,115,Floyd County,2,0,2
56,Wyoming,13,Georgia,119,Franklin County,36,0,36
56,Wyoming,13,Georgia,121,Fulton County,16,0,16
56,Wyoming,13,Georgia,135,Gwinnett County,10,0,10
56,Wyoming,13,Georgia,151,Henry County,11,0,11
56,Wyoming,13,Georgia,179,Liberty County,24,0,24
56,Wyoming,13,Georgia,181,Lincoln County,0,6,-6
56,Wyoming,13,Georgia,183,Long County,0,121,-121
56,Wyoming,13,Georgia,185,Lowndes County,0,52,-52
56,Wyoming,13,Georgia,211,Morgan County,30,0,30
56,Wyoming,13,Georgia,215,Muscogee County,1,109,-108
56,Wyoming,13,Georgia,231,Pike County,1,0,1
56,Wyoming,13,Georgia,245,Richmond County,0,76,-76
56,Wyoming,13,Georgia,297,Walton County,0,11,-11
56,Wyoming,15,Hawaii,1,Hawaii County,0,15,-15
56,Wyoming,15,Hawaii,3,Honolulu County,120,7,113
56,Wyoming,15,Hawaii,9,Maui County,5,0,5
56,Wyoming,16,Idaho,1,Ada County,127,96,31
56,Wyoming,16,Idaho,5,Bannock County,154,219,-65
56,Wyoming,16,Idaho,7,Bear Lake County,30,29,1
56,Wyoming,16,Idaho,11,Bingham County,254,0,254
56,Wyoming,16,Idaho,13,Blaine County,40,22,18
56,Wyoming,16,Idaho,17,Bonner County,0,29,-29
56,Wyoming,16,Idaho,19,Bonneville County,163,252,-89
56,Wyoming,16,Idaho,21,Boundary County,2,0,2
56,Wyoming,16,Idaho,23,Butte County,0,2,-2
56,Wyoming,16,Idaho,27,Canyon County,46,89,-43
56,Wyoming,16,Idaho,31,Cassia County,0,10,-10
56,Wyoming,16,Idaho,37,Custer County,0,3,-3
56,Wyoming,16,Idaho,39,Elmore County,56,0,56
56,Wyoming,16,Idaho,41,Franklin County,8,32,-24
56,Wyoming,16,Idaho,43,Fremont County,25,68,-43
56,Wyoming,16,Idaho,47,Gooding County,3,91,-88
56,Wyoming,16,Idaho,51,Jefferson County,0,6,-6
56,Wyoming,16,Idaho,53,Jerome County,0,6,-6
56,Wyoming,16,Idaho,55,Kootenai County,32,195,-163
56,Wyoming,16,Idaho,57,Latah County,0,67,-67
56,Wyoming,16,Idaho,61,Lewis County,9,0,9
56,Wyoming,16,Idaho,65,Madison County,48,29,19
56,Wyoming,16,Idaho,67,Minidoka County,51,87,-36
56,Wyoming,16,Idaho,69,Nez Perce County,8,42,-34
56,Wyoming,16,Idaho,73,Owyhee County,0,1,-1
56,Wyoming,16,Idaho,75,Payette County,5,0,5
56,Wyoming,16,Idaho,77,Power County,10,6,4
56,Wyoming,16,Idaho,81,Teton County,14,473,-459
56,Wyoming,16,Idaho,83,Twin Falls County,76,132,-56
56,Wyoming,16,Idaho,85,Valley County,50,0,50
56,Wyoming,16,Idaho,87,Washington County,0,11,-11
56,Wyoming,17,Illinois,1,Adams County,3,0,3
56,Wyoming,17,Illinois,31,Cook County,165,22,143
56,Wyoming,17,Illinois,37,DeKalb County,2,0,2
56,Wyoming,17,Illinois,43,DuPage County,2,19,-17
56,Wyoming,17,Illinois,49,Effingham County,0,110,-110
56,Wyoming,17,Illinois,67,Hancock County,8,0,8
56,Wyoming,17,Illinois,75,Iroquois County,1,0,1
56,Wyoming,17,Illinois,81,Jefferson County,35,0,35
56,Wyoming,17,Illinois,89,Kane County,6,0,6
56,Wyoming,17,Illinois,91,Kankakee County,1,0,1
56,Wyoming,17,Illinois,93,Kendall County,20,0,20
56,Wyoming,17,Illinois,97,Lake County,15,8,7
56,Wyoming,17,Illinois,99,LaSalle County,0,13,-13
56,Wyoming,17,Illinois,103,Lee County,0,4,-4
56,Wyoming,17,Illinois,113,McLean County,31,0,31
56,Wyoming,17,Illinois,115,Macon County,29,40,-11
56,Wyoming,17,Illinois,117,Macoupin County,0,12,-12
56,Wyoming,17,Illinois,119,Madison County,35,0,35
56,Wyoming,17,Illinois,135,Montgomery County,0,11,-11
56,Wyoming,17,Illinois,143,Peoria County,1,0,1
56,Wyoming,17,Illinois,145,Perry County,12,0,12
56,Wyoming,17,Illinois,149,Pike County,0,5,-5
56,Wyoming,17,Illinois,163,St. Clair County,2,25,-23
56,Wyoming,17,Illinois,165,Saline County,0,16,-16
56,Wyoming,17,Illinois,167,Sangamon County,3,0,3
56,Wyoming,17,Illinois,179,Tazewell County,12,0,12
56,Wyoming,17,Illinois,183,Vermilion County,2,3,-1
56,Wyoming,17,Illinois,197,Will County,6,0,6
56,Wyoming,18,Indiana,3,Allen County,9,0,9
56,Wyoming,18,Indiana,5,Bartholomew County,3,0,3
56,Wyoming,18,Indiana,25,Crawford County,0,10,-10
56,Wyoming,18,Indiana,37,Dubois County,54,0,54
56,Wyoming,18,Indiana,39,Elkhart County,4,0,4
56,Wyoming,18,Indiana,51,Gibson County,10,0,10
56,Wyoming,18,Indiana,57,Hamilton County,6,0,6
56,Wyoming,18,Indiana,63,Hendricks County,46,0,46
56,Wyoming,18,Indiana,69,Huntington County,2,0,2
56,Wyoming,18,Indiana,85,Kosciusko County,30,104,-74
56,Wyoming,18,Indiana,89,Lake County,12,0,12
56,Wyoming,18,Indiana,95,Madison County,19,0,19
56,Wyoming,18,Indiana,97,Marion County,14,0,14
56,Wyoming,18,Indiana,113,Noble County,0,7,-7
56,Wyoming,18,Indiana,119,Owen County,1,0,1
56,Wyoming,18,Indiana,137,Ripley County,0,2,-2
56,Wyoming,18,Indiana,141,St. Joseph County,10,0,10
56,Wyoming,18,Indiana,145,Shelby County,0,25,-25
56,Wyoming,18,Indiana,167,Vigo County,18,0,18
56,Wyoming,18,Indiana,183,Whitley County,17,0,17
56,Wyoming,19,Iowa,11,Benton County,2,0,2
56,Wyoming,19,Iowa,23,Butler County,0,2,-2
56,Wyoming,19,Iowa,29,Cass County,0,1,-1
56,Wyoming,19,Iowa,33,Cerro Gordo County,3,0,3
56,Wyoming,19,Iowa,61,Dubuque County,0,24,-24
56,Wyoming,19,Iowa,65,Fayette County,3,0,3
56,Wyoming,19,Iowa,67,Floyd County,0,20,-20
56,Wyoming,19,Iowa,79,Hamilton County,0,79,-79
56,Wyoming,19,Iowa,83,Hardin County,9,0,9
56,Wyoming,19,Iowa,91,Humboldt County,0,10,-10
56,Wyoming,19,Iowa,93,Ida County,0,6,-6
56,Wyoming,19,Iowa,99,Jasper County,0,10,-10
56,Wyoming,19,Iowa,111,Lee County,11,0,11
56,Wyoming,19,Iowa,113,Linn County,0,12,-12
56,Wyoming,19,Iowa,127,Marshall County,12,0,12
56,Wyoming,19,Iowa,137,Montgomery County,0,7,-7
56,Wyoming,19,Iowa,147,Palo Alto County,0,2,-2
56,Wyoming,19,Iowa,153,Polk County,44,0,44
56,Wyoming,19,Iowa,155,Pottawattamie County,108,40,68
56,Wyoming,19,Iowa,163,Scott County,17,0,17
56,Wyoming,19,Iowa,165,Shelby County,69,0,69
56,Wyoming,19,Iowa,167,Sioux County,12,0,12
56,Wyoming,19,Iowa,169,Story County,3,0,3
56,Wyoming,19,Iowa,173,Taylor County,1,0,1
56,Wyoming,19,Iowa,185,Wayne County,0,14,-14
56,Wyoming,19,Iowa,193,Woodbury County,2,0,2
56,Wyoming,2,Alaska,20,Anchorage Municipality,49,34,15
56,Wyoming,2,Alaska,90,Fairbanks North Star Borough,3,15,-12
56,Wyoming,2,Alaska,122,Kenai Peninsula Borough,0,41,-41
56,Wyoming,2,Alaska,130,Ketchikan Gateway Borough,136,0,136
56,Wyoming,2,Alaska,150,Kodiak Island Borough,4,0,4
56,Wyoming,2,Alaska,170,Matanuska-Susitna Borough,28,42,-14
56,Wyoming,2,Alaska,180,Nome Census Area,0,4,-4
56,Wyoming,2,Alaska,185,North Slope Borough,11,0,11
56,Wyoming,2,Alaska,282,Yakutat City and Borough,0,15,-15
56,Wyoming,20,Kansas,5,Atchison County,0,12,-12
56,Wyoming,20,Kansas,9,Barton County,9,0,9
56,Wyoming,20,Kansas,21,Cherokee County,0,8,-8
56,Wyoming,20,Kansas,45,Douglas County,5,0,5
56,Wyoming,20,Kansas,51,Ellis County,0,39,-39
56,Wyoming,20,Kansas,55,Finney County,0,34,-34
56,Wyoming,20,Kansas,69,Gray County,1,0,1
56,Wyoming,20,Kansas,91,Johnson County,24,33,-9
56,Wyoming,20,Kansas,103,Leavenworth County,3,0,3
56,Wyoming,20,Kansas,113,McPherson County,35,0,35
56,Wyoming,20,Kansas,119,Meade County,1,0,1
56,Wyoming,20,Kansas,131,Nemaha County,0,2,-2
56,Wyoming,20,Kansas,133,Neosho County,0,13,-13
56,Wyoming,20,Kansas,151,Pratt County,47,37,10
56,Wyoming,20,Kansas,155,Reno County,0,8,-8
56,Wyoming,20,Kansas,157,Republic County,3,0,3
56,Wyoming,20,Kansas,161,Riley County,1,0,1
56,Wyoming,20,Kansas,173,Sedgwick County,101,17,84
56,Wyoming,20,Kansas,197,Wabaunsee County,0,78,-78
56,Wyoming,21,Kentucky,19,Boyd County,0,17,-17
56,Wyoming,21,Kentucky,47,Christian County,0,19,-19
56,Wyoming,21,Kentucky,67,Fayette County,0,81,-81
56,Wyoming,21,Kentucky,69,Fleming County,37,0,37
56,Wyoming,21,Kentucky,81,Grant County,1,0,1
56,Wyoming,21,Kentucky,85,Grayson County,0,42,-42
56,Wyoming,21,Kentucky,111,Jefferson County,0,62,-62
56,Wyoming,21,Kentucky,117,Kenton County,0,39,-39
56,Wyoming,21,Kentucky,151,Madison County,5,6,-1
56,Wyoming,21,Kentucky,185,Oldham County,86,0,86
56,Wyoming,21,Kentucky,233,Webster County,15,0,15
56,Wyoming,22,Louisiana,3,Allen Parish,0,2,-2
56,Wyoming,22,Louisiana,15,Bossier Parish,36,0,36
56,Wyoming,22,Louisiana,19,Calcasieu Parish,3,81,-78
56,Wyoming,22,Louisiana,37,East Feliciana Parish,69,0,69
56,Wyoming,22,Louisiana,51,Jefferson Parish,0,20,-20
56,Wyoming,22,Louisiana,53,Jefferson Davis Parish,13,0,13
56,Wyoming,22,Louisiana,55,Lafayette Parish,18,0,18
56,Wyoming,22,Louisiana,57,Lafourche Parish,0,10,-10
56,Wyoming,22,Louisiana,73,Ouachita Parish,5,3,2
56,Wyoming,22,Louisiana,103,St. Tammany Parish,0,4,-4
56,Wyoming,22,Louisiana,115,Vernon Parish,115,0,115
56,Wyoming,23,Maine,1,Androscoggin County,15,0,15
56,Wyoming,23,Maine,5,Cumberland County,0,58,-58
56,Wyoming,23,Maine,11,Kennebec County,0,3,-3
56,Wyoming,23,Maine,13,Knox County,13,0,13
56,Wyoming,23,Maine,15,Lincoln County,14,0,14
56,Wyoming,23,Maine,23,Sagadahoc County,0,3,-3
56,Wyoming,23,Maine,25,Somerset County,94,0,94
56,Wyoming,23,Maine,27,Waldo County,0,16,-16
56,Wyoming,23,Maine,31,York County,33,9,24
56,Wyoming,24,Maryland,5,Baltimore County,0,10,-10
56,Wyoming,24,Maryland,9,Calvert County,2,45,-43
56,Wyoming,24,Maryland,13,Carroll County,24,0,24
56,Wyoming,24,Maryland,31,Montgomery County,20,17,3
56,Wyoming,24,Maryland,39,Somerset County,0,15,-15
56,Wyoming,24,Maryland,45,Wicomico County,0,23,-23
56,Wyoming,24,Maryland,47,Worcester County,5,0,5
56,Wyoming,24,Maryland,510,Baltimore city,3,20,-17
56,Wyoming,25,Massachusetts,5,Bristol County,90,6,84
56,Wyoming,25,Massachusetts,9,Essex County,16,0,16
56,Wyoming,25,Massachusetts,17,Middlesex County,0,12,-12
56,Wyoming,25,Massachusetts,21,Norfolk County,0,21,-21
56,Wyoming,25,Massachusetts,25,Suffolk County,9,0,9
56,Wyoming,26,Michigan,17,Bay County,10,45,-35
56,Wyoming,26,Michigan,21,Berrien County,5,0,5
56,Wyoming,26,Michigan,31,Cheboygan County,0,13,-13
56,Wyoming,26,Michigan,33,Chippewa County,1,5,-4
56,Wyoming,26,Michigan,37,Clinton County,0,9,-9
56,Wyoming,26,Michigan,45,Eaton County,0,14,-14
56,Wyoming,26,Michigan,47,Emmet County,1,0,1
56,Wyoming,26,Michigan,49,Genesee County,18,29,-11
56,Wyoming,26,Michigan,51,Gladwin County,0,15,-15
56,Wyoming,26,Michigan,55,Grand Traverse County,2,0,2
56,Wyoming,26,Michigan,65,Ingham County,0,131,-131
56,Wyoming,26,Michigan,67,Ionia County,0,42,-42
56,Wyoming,26,Michigan,73,Isabella County,139,0,139
56,Wyoming,26,Michigan,75,Jackson County,20,11,9
56,Wyoming,26,Michigan,81,Kent County,5,25,-20
56,Wyoming,26,Michigan,93,Livingston County,17,0,17
56,Wyoming,26,Michigan,99,Macomb County,1,0,1
56,Wyoming,26,Michigan,101,Manistee County,0,61,-61
56,Wyoming,26,Michigan,103,Marquette County,3,0,3
56,Wyoming,26,Michigan,105,Mason County,0,5,-5
56,Wyoming,26,Michigan,109,Menominee County,4,0,4
56,Wyoming,26,Michigan,113,Missaukee County,0,5,-5
56,Wyoming,26,Michigan,115,Monroe County,2,0,2
56,Wyoming,26,Michigan,117,Montcalm County,29,0,29
56,Wyoming,26,Michigan,123,Newaygo County,0,2,-2
56,Wyoming,26,Michigan,125,Oakland County,29,17,12
56,Wyoming,26,Michigan,131,Ontonagon County,0,2,-2
56,Wyoming,26,Michigan,137,Otsego County,0,12,-12
56,Wyoming,26,Michigan,145,Saginaw County,12,6,6
56,Wyoming,26,Michigan,151,Sanilac County,0,7,-7
56,Wyoming,26,Michigan,153,Schoolcraft County,11,0,11
56,Wyoming,26,Michigan,161,Washtenaw County,0,12,-12
56,Wyoming,26,Michigan,163,Wayne County,4,41,-37
56,Wyoming,27,Minnesota,3,Anoka County,17,0,17
56,Wyoming,27,Minnesota,13,Blue Earth County,44,0,44
56,Wyoming,27,Minnesota,17,Carlton County,0,9,-9
56,Wyoming,27,Minnesota,19,Carver County,3,0,3
56,Wyoming,27,Minnesota,33,Cottonwood County,0,4,-4
56,Wyoming,27,Minnesota,35,Crow Wing County,5,0,5
56,Wyoming,27,Minnesota,37,Dakota County,0,30,-30
56,Wyoming,27,Minnesota,41,Douglas County,1,2,-1
56,Wyoming,27,Minnesota,45,Fillmore County,1,9,-8
56,Wyoming,27,Minnesota,53,Hennepin County,19,66,-47
56,Wyoming,27,Minnesota,55,Houston County,2,0,2
56,Wyoming,27,Minnesota,57,Hubbard County,0,12,-12
56,Wyoming,27,Minnesota,61,Itasca County,15,0,15
56,Wyoming,27,Minnesota,65,Kanabec County,0,5,-5
56,Wyoming,27,Minnesota,71,Koochiching County,16,0,16
56,Wyoming,27,Minnesota,77,Lake of the Woods County,13,0,13
56,Wyoming,27,Minnesota,79,Le Sueur County,0,6,-6
56,Wyoming,27,Minnesota,83,Lyon County,0,7,-7
56,Wyoming,27,Minnesota,97,Morrison County,0,11,-11
56,Wyoming,27,Minnesota,103,Nicollet County,22,11,11
56,Wyoming,27,Minnesota,105,Nobles County,10,0,10
56,Wyoming,27,Minnesota,109,Olmsted County,2,0,2
56,Wyoming,27,Minnesota,115,Pine County,3,0,3
56,Wyoming,27,Minnesota,119,Polk County,62,0,62
56,Wyoming,27,Minnesota,123,Ramsey County,0,31,-31
56,Wyoming,27,Minnesota,129,Renville County,0,6,-6
56,Wyoming,27,Minnesota,131,Rice County,0,5,-5
56,Wyoming,27,Minnesota,137,St. Louis County,16,58,-42
56,Wyoming,27,Minnesota,139,Scott County,0,91,-91
56,Wyoming,27,Minnesota,141,Sherburne County,9,0,9
56,Wyoming,27,Minnesota,147,Steele County,53,0,53
56,Wyoming,27,Minnesota,157,Wabasha County,0,7,-7
56,Wyoming,27,Minnesota,163,Washington County,43,0,43
56,Wyoming,27,Minnesota,169,Winona County,5,18,-13
56,Wyoming,27,Minnesota,171,Wright County,71,17,54
56,Wyoming,28,Mississippi,59,Jackson County,0,47,-47
56,Wyoming,28,Mississippi,133,Sunflower County,0,2,-2
56,Wyoming,28,Mississippi,139,Tippah County,0,2,-2
56,Wyoming,29,Missouri,1,Adair County,17,0,17
56,Wyoming,29,Missouri,9,Barry County,0,6,-6
56,Wyoming,29,Missouri,19,Boone County,8,0,8
56,Wyoming,29,Missouri,27,Callaway County,2,8,-6
56,Wyoming,29,Missouri,29,Camden County,19,0,19
56,Wyoming,29,Missouri,43,Christian County,0,21,-21
56,Wyoming,29,Missouri,47,Clay County,227,8,219
56,Wyoming,29,Missouri,51,Cole County,36,0,36
56,Wyoming,29,Missouri,53,Cooper County,2,0,2
56,Wyoming,29,Missouri,61,Daviess County,0,9,-9
56,Wyoming,29,Missouri,63,DeKalb County,0,1,-1
56,Wyoming,29,Missouri,65,Dent County,0,18,-18
56,Wyoming,29,Missouri,71,Franklin County,6,0,6
56,Wyoming,29,Missouri,91,Howell County,7,0,7
56,Wyoming,29,Missouri,93,Iron County,0,2,-2
56,Wyoming,29,Missouri,95,Jackson County,28,0,28
56,Wyoming,29,Missouri,105,Laclede County,0,7,-7
56,Wyoming,29,Missouri,107,Lafayette County,0,1,-1
56,Wyoming,29,Missouri,135,Moniteau County,1,0,1
56,Wyoming,29,Missouri,147,Nodaway County,0,3,-3
56,Wyoming,29,Missouri,161,Phelps County,0,75,-75
56,Wyoming,29,Missouri,169,Pulaski County,3,69,-66
56,Wyoming,29,Missouri,175,Randolph County,0,66,-66
56,Wyoming,29,Missouri,183,St. Charles County,5,0,5
56,Wyoming,29,Missouri,187,St. Francois County,0,6,-6
56,Wyoming,29,Missouri,189,St. Louis County,26,52,-26
56,Wyoming,29,Missouri,209,Stone County,0,3,-3
56,Wyoming,29,Missouri,213,Taney County,7,0,7
56,Wyoming,29,Missouri,215,Texas County,0,3,-3
56,Wyoming,29,Missouri,217,Vernon County,5,0,5
56,Wyoming,29,Missouri,229,Wright County,0,106,-106
56,Wyoming,29,Missouri,510,St. Louis city,34,16,18
56,Wyoming,30,Montana,1,Beaverhead County,0,18,-18
56,Wyoming,30,Montana,3,Big Horn County,15,19,-4
56,Wyoming,30,Montana,5,Blaine County,18,31,-13
56,Wyoming,30,Montana,9,Carbon County,11,34,-23
56,Wyoming,30,Montana,11,Carter County,0,1,-1
56,Wyoming,30,Montana,13,Cascade County,7,29,-22
56,Wyoming,30,Montana,15,Chouteau County,0,6,-6
56,Wyoming,30,Montana,17,Custer County,123,24,99
56,Wyoming,30,Montana,21,Dawson County,38,166,-128
56,Wyoming,30,Montana,23,Deer Lodge County,0,19,-19
56,Wyoming,30,Montana,25,Fallon County,5,1,4
56,Wyoming,30,Montana,27,Fergus County,26,2,24
56,Wyoming,30,Montana,29,Flathead County,44,13,31
56,Wyoming,30,Montana,31,Gallatin County,281,294,-13
56,Wyoming,30,Montana,35,Glacier County,3,0,3
56,Wyoming,30,Montana,37,Golden Valley County,0,8,-8
56,Wyoming,30,Montana,41,Hill County,1,41,-40
56,Wyoming,30,Montana,45,Judith Basin County,0,6,-6
56,Wyoming,30,Montana,47,Lake County,28,1,27
56,Wyoming,30,Montana,49,Lewis and Clark County,3,51,-48
56,Wyoming,30,Montana,53,Lincoln County,0,13,-13
56,Wyoming,30,Montana,57,Madison County,9,0,9
56,Wyoming,30,Montana,59,Meagher County,2,16,-14
56,Wyoming,30,Montana,61,Mineral County,25,0,25
56,Wyoming,30,Montana,63,Missoula County,71,272,-201
56,Wyoming,30,Montana,67,Park County,5,19,-14
56,Wyoming,30,Montana,75,Powder River County,4,6,-2
56,Wyoming,30,Montana,77,Powell County,12,5,7
56,Wyoming,30,Montana,79,Prairie County,0,8,-8
56,Wyoming,30,Montana,81,Ravalli County,21,12,9
56,Wyoming,30,Montana,83,Richland County,16,12,4
56,Wyoming,30,Montana,85,Roosevelt County,17,28,-11
56,Wyoming,30,Montana,87,Rosebud County,21,13,8
56,Wyoming,30,Montana,89,Sanders County,0,12,-12
56,Wyoming,30,Montana,91,Sheridan County,64,3,61
56,Wyoming,30,Montana,93,Silver Bow County,54,27,27
56,Wyoming,30,Montana,95,Stillwater County,15,28,-13
56,Wyoming,30,Montana,101,Toole County,8,4,4
56,Wyoming,30,Montana,103,Treasure County,2,5,-3
56,Wyoming,30,Montana,105,Valley County,0,1,-1
56,Wyoming,30,Montana,107,Wheatland County,2,0,2
56,Wyoming,30,Montana,111,Yellowstone County,259,684,-425
56,Wyoming,31,Nebraska,3,Antelope County,0,2,-2
56,Wyoming,31,Nebraska,7,Banner County,4,17,-13
56,Wyoming,31,Nebraska,13,Box Butte County,4,10,-6
56,Wyoming,31,Nebraska,19,Buffalo County,0,43,-43
56,Wyoming,31,Nebraska,33,Cheyenne County,11,5,6
56,Wyoming,31,Nebraska,39,Cuming County,0,9,-9
56,Wyoming,31,Nebraska,41,Custer County,0,51,-51
56,Wyoming,31,Nebraska,43,Dakota County,1,0,1
56,Wyoming,31,Nebraska,45,Dawes County,140,69,71
56,Wyoming,31,Nebraska,47,Dawson County,1,0,1
56,Wyoming,31,Nebraska,49,Deuel County,2,0,2
56,Wyoming,31,Nebraska,53,Dodge County,0,9,-9
56,Wyoming,31,Nebraska,55,Douglas County,129,58,71
56,Wyoming,31,Nebraska,59,Fillmore County,0,4,-4
56,Wyoming,31,Nebraska,63,Frontier County,22,0,22
56,Wyoming,31,Nebraska,65,Furnas County,0,12,-12
56,Wyoming,31,Nebraska,69,Garden County,4,0,4
56,Wyoming,31,Nebraska,75,Grant County,0,1,-1
56,Wyoming,31,Nebraska,79,Hall County,4,0,4
56,Wyoming,31,Nebraska,81,Hamilton County,1,0,1
56,Wyoming,31,Nebraska,89,Holt County,0,1,-1
56,Wyoming,31,Nebraska,93,Howard County,0,2,-2
56,Wyoming,31,Nebraska,97,Johnson County,2,0,2
56,Wyoming,31,Nebraska,99,Kearney County,0,1,-1
56,Wyoming,31,Nebraska,101,Keith County,3,3,0
56,Wyoming,31,Nebraska,105,Kimball County,97,45,52
56,Wyoming,31,Nebraska,109,Lancaster County,35,64,-29
56,Wyoming,31,Nebraska,111,Lincoln County,16,196,-180
56,Wyoming,31,Nebraska,117,McPherson County,10,0,10
56,Wyoming,31,Nebraska,119,Madison County,13,5,8
56,Wyoming,31,Nebraska,121,Merrick County,0,14,-14
56,Wyoming,31,Nebraska,123,Morrill County,9,6,3
56,Wyoming,31,Nebraska,131,Otoe County,95,0,95
56,Wyoming,31,Nebraska,135,Perkins County,48,0,48
56,Wyoming,31,Nebraska,137,Phelps County,2,0,2
56,Wyoming,31,Nebraska,139,Pierce County,0,15,-15
56,Wyoming,31,Nebraska,141,Platte County,9,0,9
56,Wyoming,31,Nebraska,153,Sarpy County,20,31,-11
56,Wyoming,31,Nebraska,155,Saunders County,10,0,10
56,Wyoming,31,Nebraska,157,Scotts Bluff County,29,102,-73
56,Wyoming,31,Nebraska,161,Sheridan County,58,0,58
56,Wyoming,31,Nebraska,165,Sioux County,0,4,-4
56,Wyoming,31,Nebraska,167,Stanton County,8,0,8
56,Wyoming,31,Nebraska,175,Valley County,0,6,-6
56,Wyoming,31,Nebraska,185,York County,0,7,-7
56,Wyoming,32,Nevada,1,Churchill County,0,32,-32
56,Wyoming,32,Nevada,3,Clark County,128,590,-462
56,Wyoming,32,Nevada,5,Douglas County,0,18,-18
56,Wyoming,32,Nevada,7,Elko County,5,0,5
56,Wyoming,32,Nevada,13,Humboldt County,0,7,-7
56,Wyoming,32,Nevada,15,Lander County,7,0,7
56,Wyoming,32,Nevada,19,Lyon County,49,0,49
56,Wyoming,32,Nevada,21,Mineral County,0,4,-4
56,Wyoming,32,Nevada,23,Nye County,0,13,-13
56,Wyoming,32,Nevada,31,Washoe County,157,94,63
56,Wyoming,33,New Hampshire,15,Rockingham County,2,0,2
56,Wyoming,34,New Jersey,5,Burlington County,0,7,-7
56,Wyoming,34,New Jersey,15,Gloucester County,0,3,-3
56,Wyoming,34,New Jersey,19,Hunterdon County,0,13,-13
56,Wyoming,34,New Jersey,23,Middlesex County,26,0,26
56,Wyoming,34,New Jersey,25,Monmouth County,42,0,42
56,Wyoming,34,New Jersey,31,Passaic County,0,38,-38
56,Wyoming,34,New Jersey,35,Somerset County,25,0,25
56,Wyoming,35,New Mexico,1,Bernalillo County,114,66,48
56,Wyoming,35,New Mexico,7,Colfax County,0,4,-4
56,Wyoming,35,New Mexico,9,Curry County,37,0,37
56,Wyoming,35,New Mexico,13,Doña Ana County,7,19,-12
56,Wyoming,35,New Mexico,15,Eddy County,188,0,188
56,Wyoming,35,New Mexico,19,Guadalupe County,0,2,-2
56,Wyoming,35,New Mexico,21,Harding County,6,0,6
56,Wyoming,35,New Mexico,31,McKinley County,7,0,7
56,Wyoming,35,New Mexico,35,Otero County,0,33,-33
56,Wyoming,35,New Mexico,37,Quay County,11,0,11
56,Wyoming,35,New Mexico,39,Rio Arriba County,2,0,2
56,Wyoming,35,New Mexico,43,Sandoval County,0,17,-17
56,Wyoming,35,New Mexico,45,San Juan County,28,66,-38
56,Wyoming,35,New Mexico,47,San Miguel County,0,4,-4
56,Wyoming,35,New Mexico,49,Santa Fe County,1,20,-19
56,Wyoming,35,New Mexico,53,Socorro County,67,0,67
56,Wyoming,35,New Mexico,55,Taos County,6,0,6
56,Wyoming,35,New Mexico,57,Torrance County,0,42,-42
56,Wyoming,35,New Mexico,61,Valencia County,0,55,-55
56,Wyoming,36,New York,7,Broome County,5,0,5
56,Wyoming,36,New York,9,Cattaraugus County,0,4,-4
56,Wyoming,36,New York,11,Cayuga County,0,4,-4
56,Wyoming,36,New York,13,Chautauqua County,53,0,53
56,Wyoming,36,New York,19,Clinton County,0,9,-9
56,Wyoming,36,New York,23,Cortland County,0,21,-21
56,Wyoming,36,New York,29,Erie County,0,21,-21
56,Wyoming,36,New York,47,Kings County,12,30,-18
56,Wyoming,36,New York,55,Monroe County,96,11,85
56,Wyoming,36,New York,59,Nassau County,0,12,-12
56,Wyoming,36,New York,61,New York County,47,10,37
56,Wyoming,36,New York,63,Niagara County,38,34,4
56,Wyoming,36,New York,81,Queens County,0,32,-32
56,Wyoming,36,New York,103,Suffolk County,73,0,73
56,Wyoming,36,New York,115,Washington County,0,6,-6
56,Wyoming,36,New York,117,Wayne County,17,12,5
56,Wyoming,36,New York,119,Westchester County,0,13,-13
56,Wyoming,37,North Carolina,19,Brunswick County,6,0,6
56,Wyoming,37,North Carolina,21,Buncombe County,3,0,3
56,Wyoming,37,North Carolina,25,Cabarrus County,0,24,-24
56,Wyoming,37,North Carolina,31,Carteret County,0,17,-17
56,Wyoming,37,North Carolina,47,Columbus County,0,8,-8
56,Wyoming,37,North Carolina,51,Cumberland County,6,7,-1
56,Wyoming,37,North Carolina,57,Davidson County,0,12,-12
56,Wyoming,37,North Carolina,61,Duplin County,0,46,-46
56,Wyoming,37,North Carolina,65,Edgecombe County,0,7,-7
56,Wyoming,37,North Carolina,67,Forsyth County,0,7,-7
56,Wyoming,37,North Carolina,71,Gaston County,29,0,29
56,Wyoming,37,North Carolina,81,Guilford County,4,0,4
56,Wyoming,37,North Carolina,87,Haywood County,0,14,-14
56,Wyoming,37,North Carolina,113,Macon County,0,41,-41
56,Wyoming,37,North Carolina,121,Mitchell County,3,0,3
56,Wyoming,37,North Carolina,129,New Hanover County,0,20,-20
56,Wyoming,37,North Carolina,133,Onslow County,0,9,-9
56,Wyoming,37,North Carolina,145,Person County,0,15,-15
56,Wyoming,37,North Carolina,147,Pitt County,114,0,114
56,Wyoming,37,North Carolina,161,Rutherford County,0,53,-53
56,Wyoming,37,North Carolina,191,Wayne County,0,11,-11
56,Wyoming,38,North Dakota,1,Adams County,0,4,-4
56,Wyoming,38,North Dakota,9,Bottineau County,0,3,-3
56,Wyoming,38,North Dakota,13,Burke County,0,4,-4
56,Wyoming,38,North Dakota,15,Burleigh County,14,59,-45
56,Wyoming,38,North Dakota,17,Cass County,86,0,86
56,Wyoming,38,North Dakota,23,Divide County,78,0,78
56,Wyoming,38,North Dakota,25,Dunn County,13,12,1
56,Wyoming,38,North Dakota,35,Grand Forks County,149,23,126
56,Wyoming,38,North Dakota,41,Hettinger County,38,0,38
56,Wyoming,38,North Dakota,47,Logan County,0,11,-11
56,Wyoming,38,North Dakota,49,McHenry County,55,0,55
56,Wyoming,38,North Dakota,53,McKenzie County,42,20,22
56,Wyoming,38,North Dakota,55,McLean County,0,15,-15
56,Wyoming,38,North Dakota,57,Mercer County,8,0,8
56,Wyoming,38,North Dakota,59,Morton County,0,3,-3
56,Wyoming,38,North Dakota,67,Pembina County,0,1,-1
56,Wyoming,38,North Dakota,73,Ransom County,0,25,-25
56,Wyoming,38,North Dakota,83,Sheridan County,0,7,-7
56,Wyoming,38,North Dakota,85,Sioux County,0,1,-1
56,Wyoming,38,North Dakota,89,Stark County,48,80,-32
56,Wyoming,38,North Dakota,93,Stutsman County,0,2,-2
56,Wyoming,38,North Dakota,97,Traill County,16,9,7
56,Wyoming,38,North Dakota,101,Ward County,56,296,-240
56,Wyoming,38,North Dakota,105,Williams County,19,94,-75
56,Wyoming,39,Ohio,5,Ashland County,0,9,-9
56,Wyoming,39,Ohio,7,Ashtabula County,17,0,17
56,Wyoming,39,Ohio,17,Butler County,0,12,-12
56,Wyoming,39,Ohio,29,Columbiana County,2,30,-28
56,Wyoming,39,Ohio,35,Cuyahoga County,10,6,4
56,Wyoming,39,Ohio,43,Erie County,6,0,6
56,Wyoming,39,Ohio,49,Franklin County,11,26,-15
56,Wyoming,39,Ohio,55,Geauga County,0,9,-9
56,Wyoming,39,Ohio,57,Greene County,0,32,-32
56,Wyoming,39,Ohio,71,Highland County,3,0,3
56,Wyoming,39,Ohio,79,Jackson County,0,8,-8
56,Wyoming,39,Ohio,85,Lake County,1,0,1
56,Wyoming,39,Ohio,93,Lorain County,3,0,3
56,Wyoming,39,Ohio,95,Lucas County,1,0,1
56,Wyoming,39,Ohio,103,Medina County,3,0,3
56,Wyoming,39,Ohio,143,Sandusky County,44,0,44
56,Wyoming,39,Ohio,145,Scioto County,42,0,42
56,Wyoming,39,Ohio,157,Tuscarawas County,0,21,-21
56,Wyoming,4,Arizona,1,Apache County,5,17,-12
56,Wyoming,4,Arizona,3,Cochise County,6,10,-4
56,Wyoming,4,Arizona,5,Coconino County,51,30,21
56,Wyoming,4,Arizona,9,Graham County,0,9,-9
56,Wyoming,4,Arizona,13,Maricopa County,433,561,-128
56,Wyoming,4,Arizona,15,Mohave County,83,271,-188
56,Wyoming,4,Arizona,17,Navajo County,18,0,18
56,Wyoming,4,Arizona,19,Pima County,57,46,11
56,Wyoming,4,Arizona,21,Pinal County,46,365,-319
56,Wyoming,4,Arizona,25,Yavapai County,14,409,-395
56,Wyoming,4,Arizona,27,Yuma County,87,113,-26
56,Wyoming,40,Oklahoma,13,Bryan County,0,9,-9
56,Wyoming,40,Oklahoma,17,Canadian County,32,0,32
56,Wyoming,40,Oklahoma,19,Carter County,0,11,-11
56,Wyoming,40,Oklahoma,21,Cherokee County,0,60,-60
56,Wyoming,40,Oklahoma,27,Cleveland County,11,12,-1
56,Wyoming,40,Oklahoma,31,Comanche County,0,25,-25
56,Wyoming,40,Oklahoma,37,Creek County,4,0,4
56,Wyoming,40,Oklahoma,39,Custer County,5,0,5
56,Wyoming,40,Oklahoma,47,Garfield County,13,0,13
56,Wyoming,40,Oklahoma,53,Grant County,1,0,1
56,Wyoming,40,Oklahoma,61,Haskell County,0,8,-8
56,Wyoming,40,Oklahoma,65,Jackson County,24,0,24
56,Wyoming,40,Oklahoma,71,Kay County,0,1,-1
56,Wyoming,40,Oklahoma,77,Latimer County,0,3,-3
56,Wyoming,40,Oklahoma,79,Le Flore County,3,0,3
56,Wyoming,40,Oklahoma,109,Oklahoma County,42,24,18
56,Wyoming,40,Oklahoma,113,Osage County,0,1,-1
56,Wyoming,40,Oklahoma,115,Ottawa County,0,3,-3
56,Wyoming,40,Oklahoma,119,Payne County,110,42,68
56,Wyoming,40,Oklahoma,123,Pontotoc County,0,4,-4
56,Wyoming,40,Oklahoma,125,Pottawatomie County,0,2,-2
56,Wyoming,40,Oklahoma,131,Rogers County,0,20,-20
56,Wyoming,40,Oklahoma,133,Seminole County,0,10,-10
56,Wyoming,40,Oklahoma,135,Sequoyah County,0,5,-5
56,Wyoming,40,Oklahoma,137,Stephens County,4,40,-36
56,Wyoming,40,Oklahoma,139,Texas County,0,12,-12
56,Wyoming,40,Oklahoma,143,Tulsa County,32,99,-67
56,Wyoming,41,Oregon,1,Baker County,0,59,-59
56,Wyoming,41,Oregon,3,Benton County,0,54,-54
56,Wyoming,41,Oregon,5,Clackamas County,1,0,1
56,Wyoming,41,Oregon,7,Clatsop County,0,15,-15
56,Wyoming,41,Oregon,9,Columbia County,1,0,1
56,Wyoming,41,Oregon,11,Coos County,0,40,-40
56,Wyoming,41,Oregon,13,Crook County,3,0,3
56,Wyoming,41,Oregon,17,Deschutes County,14,62,-48
56,Wyoming,41,Oregon,23,Grant County,8,23,-15
56,Wyoming,41,Oregon,25,Harney County,0,10,-10
56,Wyoming,41,Oregon,27,Hood River County,1,0,1
56,Wyoming,41,Oregon,29,Jackson County,136,21,115
56,Wyoming,41,Oregon,31,Jefferson County,44,0,44
56,Wyoming,41,Oregon,35,Klamath County,22,0,22
56,Wyoming,41,Oregon,39,Lane County,263,219,44
56,Wyoming,41,Oregon,43,Linn County,6,30,-24
56,Wyoming,41,Oregon,45,Malheur County,0,4,-4
56,Wyoming,41,Oregon,47,Marion County,72,261,-189
56,Wyoming,41,Oregon,51,Multnomah County,86,72,14
56,Wyoming,41,Oregon,53,Polk County,2,0,2
56,Wyoming,41,Oregon,59,Umatilla County,7,13,-6
56,Wyoming,41,Oregon,61,Union County,48,5,43
56,Wyoming,41,Oregon,67,Washington County,41,29,12
56,Wyoming,41,Oregon,71,Yamhill County,3,17,-14
56,Wyoming,42,Pennsylvania,3,Allegheny County,15,87,-72
56,Wyoming,42,Pennsylvania,13,Blair County,0,14,-14
56,Wyoming,42,Pennsylvania,17,Bucks County,4,0,4
56,Wyoming,42,Pennsylvania,19,Butler County,4,0,4
56,Wyoming,42,Pennsylvania,27,Centre County,7,0,7
56,Wyoming,42,Pennsylvania,29,Chester County,0,16,-16
56,Wyoming,42,Pennsylvania,31,Clarion County,0,4,-4
56,Wyoming,42,Pennsylvania,33,Clearfield County,18,26,-8
56,Wyoming,42,Pennsylvania,43,Dauphin County,1,0,1
56,Wyoming,42,Pennsylvania,49,Erie County,117,0,117
56,Wyoming,42,Pennsylvania,51,Fayette County,0,8,-8
56,Wyoming,42,Pennsylvania,59,Greene County,179,0,179
56,Wyoming,42,Pennsylvania,63,Indiana County,1,0,1
56,Wyoming,42,Pennsylvania,65,Jefferson County,0,9,-9
56,Wyoming,42,Pennsylvania,71,Lancaster County,45,0,45
56,Wyoming,42,Pennsylvania,81,Lycoming County,20,0,20
56,Wyoming,42,Pennsylvania,95,Northampton County,44,0,44
56,Wyoming,42,Pennsylvania,99,Perry County,0,4,-4
56,Wyoming,42,Pennsylvania,101,Philadelphia County,0,11,-11
56,Wyoming,42,Pennsylvania,117,Tioga County,27,0,27
56,Wyoming,42,Pennsylvania,125,Washington County,0,78,-78
56,Wyoming,42,Pennsylvania,133,York County,3,0,3
56,Wyoming,44,Rhode Island,7,Providence County,3,0,3
56,Wyoming,45,South Carolina,3,Aiken County,4,0,4
56,Wyoming,45,South Carolina,15,Berkeley County,3,84,-81
56,Wyoming,45,South Carolina,19,Charleston County,9,18,-9
56,Wyoming,45,South Carolina,77,Pickens County,26,0,26
56,Wyoming,45,South Carolina,79,Richland County,18,0,18
56,Wyoming,45,South Carolina,85,Sumter County,0,10,-10
56,Wyoming,45,South Carolina,91,York County,1,0,1
56,Wyoming,46,South Dakota,11,Brookings County,5,51,-46
56,Wyoming,46,South Dakota,13,Brown County,19,7,12
56,Wyoming,46,South Dakota,19,Butte County,146,47,99
56,Wyoming,46,South Dakota,21,Campbell County,0,9,-9
56,Wyoming,46,South Dakota,27,Clay County,0,21,-21
56,Wyoming,46,South Dakota,31,Corson County,3,1,2
56,Wyoming,46,South Dakota,33,Custer County,7,139,-132
56,Wyoming,46,South Dakota,35,Davison County,22,9,13
56,Wyoming,46,South Dakota,37,Day County,0,6,-6
56,Wyoming,46,South Dakota,47,Fall River County,8,64,-56
56,Wyoming,46,South Dakota,53,Gregory County,1,0,1
56,Wyoming,46,South Dakota,55,Haakon County,77,0,77
56,Wyoming,46,South Dakota,59,Hand County,0,15,-15
56,Wyoming,46,South Dakota,61,Hanson County,0,1,-1
56,Wyoming,46,South Dakota,63,Harding County,0,2,-2
56,Wyoming,46,South Dakota,65,Hughes County,51,0,51
56,Wyoming,46,South Dakota,75,Jones County,41,0,41
56,Wyoming,46,South Dakota,81,Lawrence County,149,358,-209
56,Wyoming,46,South Dakota,83,Lincoln County,0,25,-25
56,Wyoming,46,South Dakota,85,Lyman County,0,2,-2
56,Wyoming,46,South Dakota,87,McCook County,0,23,-23
56,Wyoming,46,South Dakota,91,Marshall County,0,2,-2
56,Wyoming,46,South Dakota,93,Meade County,93,50,43
56,Wyoming,46,South Dakota,95,Mellette County,0,7,-7
56,Wyoming,46,South Dakota,99,Minnehaha County,19,7,12
56,Wyoming,46,South Dakota,102,Oglala Lakota County,4,7,-3
56,Wyoming,46,South Dakota,103,Pennington County,59,597,-538
56,Wyoming,46,South Dakota,107,Potter County,1,1,0
56,Wyoming,46,South Dakota,109,Roberts County,0,15,-15
56,Wyoming,46,South Dakota,115,Spink County,0,1,-1
56,Wyoming,46,South Dakota,129,Walworth County,1,8,-7
56,Wyoming,46,South Dakota,135,Yankton County,0,18,-18
56,Wyoming,46,South Dakota,137,Ziebach County,9,0,9
56,Wyoming,47,Tennessee,1,Anderson County,20,5,15
56,Wyoming,47,Tennessee,31,Coffee County,3,0,3
56,Wyoming,47,Tennessee,49,Fentress County,2,0,2
56,Wyoming,47,Tennessee,73,Hawkins County,1,0,1
56,Wyoming,47,Tennessee,93,Knox County,0,29,-29
56,Wyoming,47,Tennessee,107,McMinn County,0,69,-69
56,Wyoming,47,Tennessee,109,McNairy County,0,6,-6
56,Wyoming,47,Tennessee,119,Maury County,45,0,45
56,Wyoming,47,Tennessee,125,Montgomery County,17,0,17
56,Wyoming,47,Tennessee,129,Morgan County,0,29,-29
56,Wyoming,47,Tennessee,143,Rhea County,44,0,44
56,Wyoming,47,Tennessee,157,Shelby County,7,16,-9
56,Wyoming,47,Tennessee,187,Williamson County,50,0,50
56,Wyoming,47,Tennessee,189,Wilson County,4,49,-45
56,Wyoming,48,Texas,5,Angelina County,3,0,3
56,Wyoming,48,Texas,11,Armstrong County,0,10,-10
56,Wyoming,48,Texas,27,Bell County,19,50,-31
56,Wyoming,48,Texas,29,Bexar County,229,35,194
56,Wyoming,48,Texas,37,Bowie County,23,0,23
56,Wyoming,48,Texas,39,Brazoria County,36,5,31
56,Wyoming,48,Texas,41,Brazos County,0,11,-11
56,Wyoming,48,Texas,43,Brewster County,0,7,-7
56,Wyoming,48,Texas,55,Caldwell County,2,0,2
56,Wyoming,48,Texas,61,Cameron County,60,134,-74
56,Wyoming,48,Texas,73,Cherokee County,0,10,-10
56,Wyoming,48,Texas,85,Collin County,2,0,2
56,Wyoming,48,Texas,93,Comanche County,2,0,2
56,Wyoming,48,Texas,97,Cooke County,0,5,-5
56,Wyoming,48,Texas,99,Coryell County,22,0,22
56,Wyoming,48,Texas,113,Dallas County,49,80,-31
56,Wyoming,48,Texas,117,Deaf Smith County,49,62,-13
56,Wyoming,48,Texas,121,Denton County,41,28,13
56,Wyoming,48,Texas,129,Donley County,0,13,-13
56,Wyoming,48,Texas,141,El Paso County,109,23,86
56,Wyoming,48,Texas,143,Erath County,0,65,-65
56,Wyoming,48,Texas,157,Fort Bend County,160,0,160
56,Wyoming,48,Texas,163,Frio County,2,0,2
56,Wyoming,48,Texas,165,Gaines County,10,0,10
56,Wyoming,48,Texas,167,Galveston County,27,17,10
56,Wyoming,48,Texas,183,Gregg County,22,0,22
56,Wyoming,48,Texas,185,Grimes County,0,11,-11
56,Wyoming,48,Texas,187,Guadalupe County,3,76,-73
56,Wyoming,48,Texas,189,Hale County,2,0,2
56,Wyoming,48,Texas,197,Hardeman County,0,23,-23
56,Wyoming,48,Texas,201,Harris County,177,352,-175
56,Wyoming,48,Texas,203,Harrison County,0,21,-21
56,Wyoming,48,Texas,209,Hays County,0,26,-26
56,Wyoming,48,Texas,215,Hidalgo County,253,0,253
56,Wyoming,48,Texas,223,Hopkins County,13,0,13
56,Wyoming,48,Texas,227,Howard County,1,15,-14
56,Wyoming,48,Texas,229,Hudspeth County,0,4,-4
56,Wyoming,48,Texas,231,Hunt County,1,0,1
56,Wyoming,48,Texas,235,Irion County,0,17,-17
56,Wyoming,48,Texas,245,Jefferson County,0,66,-66
56,Wyoming,48,Texas,253,Jones County,0,2,-2
56,Wyoming,48,Texas,257,Kaufman County,16,0,16
56,Wyoming,48,Texas,265,Kerr County,21,0,21
56,Wyoming,48,Texas,275,Knox County,10,0,10
56,Wyoming,48,Texas,287,Lee County,0,25,-25
56,Wyoming,48,Texas,303,Lubbock County,67,0,67
56,Wyoming,48,Texas,309,McLennan County,13,27,-14
56,Wyoming,48,Texas,323,Maverick County,12,0,12
56,Wyoming,48,Texas,329,Midland County,2,0,2
56,Wyoming,48,Texas,339,Montgomery County,0,85,-85
56,Wyoming,48,Texas,347,Nacogdoches County,16,41,-25
56,Wyoming,48,Texas,353,Nolan County,1,0,1
56,Wyoming,48,Texas,363,Palo Pinto County,0,57,-57
56,Wyoming,48,Texas,373,Polk County,15,0,15
56,Wyoming,48,Texas,375,Potter County,5,0,5
56,Wyoming,48,Texas,381,Randall County,0,132,-132
56,Wyoming,48,Texas,387,Red River County,0,16,-16
56,Wyoming,48,Texas,409,San Patricio County,13,18,-5
56,Wyoming,48,Texas,423,Smith County,97,20,77
56,Wyoming,48,Texas,439,Tarrant County,183,92,91
56,Wyoming,48,Texas,441,Taylor County,0,79,-79
56,Wyoming,48,Texas,451,Tom Green County,28,0,28
56,Wyoming,48,Texas,453,Travis County,74,130,-56
56,Wyoming,48,Texas,463,Uvalde County,0,138,-138
56,Wyoming,48,Texas,473,Waller County,39,0,39
56,Wyoming,48,Texas,475,Ward County,6,15,-9
56,Wyoming,48,Texas,485,Wichita County,50,0,50
56,Wyoming,48,Texas,491,Williamson County,12,0,12
56,Wyoming,48,Texas,495,Winkler County,0,106,-106
56,Wyoming,48,Texas,497,Wise County,37,0,37
56,Wyoming,48,Texas,499,Wood County,3,0,3
56,Wyoming,49,Utah,3,Box Elder County,69,0,69
56,Wyoming,49,Utah,5,Cache County,33,257,-224
56,Wyoming,49,Utah,7,Carbon County,9,20,-11
56,Wyoming,49,Utah,11,Davis County,264,342,-78
56,Wyoming,49,Utah,13,Duchesne County,186,27,159
56,Wyoming,49,Utah,15,Emery County,0,9,-9
56,Wyoming,49,Utah,17,Garfield County,0,16,-16
56,Wyoming,49,Utah,21,Iron County,3,256,-253
56,Wyoming,49,Utah,23,Juab County,12,0,12
56,Wyoming,49,Utah,27,Millard County,14,9,5
56,Wyoming,49,Utah,29,Morgan County,3,0,3
56,Wyoming,49,Utah,33,Rich County,59,10,49
56,Wyoming,49,Utah,35,Salt Lake County,427,723,-296
56,Wyoming,49,Utah,37,San Juan County,9,0,9
56,Wyoming,49,Utah,39,Sanpete County,68,9,59
56,Wyoming,49,Utah,41,Sevier County,135,0,135
56,Wyoming,49,Utah,43,Summit County,2,4,-2
56,Wyoming,49,Utah,45,Tooele County,40,21,19
56,Wyoming,49,Utah,47,Uintah County,84,299,-215
56,Wyoming,49,Utah,49,Utah County,125,216,-91
56,Wyoming,49,Utah,51,Wasatch County,35,66,-31
56,Wyoming,49,Utah,53,Washington County,66,108,-42
56,Wyoming,49,Utah,57,Weber County,62,180,-118
56,Wyoming,5,Arkansas,7,Benton County,3,45,-42
56,Wyoming,5,Arkansas,31,Craighead County,5,0,5
56,Wyoming,5,Arkansas,45,Faulkner County,59,19,40
56,Wyoming,5,Arkansas,51,Garland County,11,0,11
56,Wyoming,5,Arkansas,83,Logan County,16,0,16
56,Wyoming,5,Arkansas,89,Marion County,0,15,-15
56,Wyoming,5,Arkansas,97,Montgomery County,0,2,-2
56,Wyoming,5,Arkansas,119,Pulaski County,10,0,10
56,Wyoming,5,Arkansas,131,Sebastian County,89,0,89
56,Wyoming,5,Arkansas,135,Sharp County,49,0,49
56,Wyoming,5,Arkansas,143,Washington County,0,26,-26
56,Wyoming,50,Vermont,3,Bennington County,0,51,-51
56,Wyoming,50,Vermont,7,Chittenden County,0,5,-5
56,Wyoming,50,Vermont,13,Grand Isle County,0,6,-6
56,Wyoming,50,Vermont,19,Orleans County,18,8,10
56,Wyoming,50,Vermont,23,Washington County,0,46,-46
56,Wyoming,50,Vermont,27,Windsor County,1,0,1
56,Wyoming,51,Virginia,1,Accomack County,58,0,58
56,Wyoming,51,Virginia,13,Arlington County,3,6,-3
56,Wyoming,51,Virginia,15,Augusta County,0,50,-50
56,Wyoming,51,Virginia,31,Campbell County,1,0,1
56,Wyoming,51,Virginia,41,Chesterfield County,15,0,15
56,Wyoming,51,Virginia,59,Fairfax County,118,6,112
56,Wyoming,51,Virginia,61,Fauquier County,11,0,11
56,Wyoming,51,Virginia,87,Henrico County,2,37,-35
56,Wyoming,51,Virginia,107,Loudoun County,1,0,1
56,Wyoming,51,Virginia,137,Orange County,5,0,5
56,Wyoming,51,Virginia,153,Prince William County,0,12,-12
56,Wyoming,51,Virginia,165,Rockingham County,0,5,-5
56,Wyoming,51,Virginia,177,Spotsylvania County,30,0,30
56,Wyoming,51,Virginia,179,Stafford County,3,0,3
56,Wyoming,51,Virginia,181,Surry County,6,0,6
56,Wyoming,51,Virginia,187,Warren County,0,5,-5
56,Wyoming,51,Virginia,197,Wythe County,2,0,2
56,Wyoming,51,Virginia,199,York County,6,0,6
56,Wyoming,51,Virginia,510,Alexandria city,35,0,35
56,Wyoming,51,Virginia,550,Chesapeake city,71,0,71
56,Wyoming,51,Virginia,700,Newport News city,4,5,-1
56,Wyoming,51,Virginia,710,Norfolk city,0,15,-15
56,Wyoming,51,Virginia,770,Roanoke city,5,0,5
56,Wyoming,51,Virginia,810,Virginia Beach city,0,12,-12
56,Wyoming,53,Washington,5,Benton County,63,0,63
56,Wyoming,53,Washington,7,Chelan County,2,0,2
56,Wyoming,53,Washington,9,Clallam County,0,17,-17
56,Wyoming,53,Washington,11,Clark County,130,0,130
56,Wyoming,53,Washington,17,Douglas County,2,0,2
56,Wyoming,53,Washington,25,Grant County,1,16,-15
56,Wyoming,53,Washington,27,Grays Harbor County,0,22,-22
56,Wyoming,53,Washington,29,Island County,0,11,-11
56,Wyoming,53,Washington,31,Jefferson County,0,5,-5
56,Wyoming,53,Washington,33,King County,222,228,-6
56,Wyoming,53,Washington,35,Kitsap County,6,25,-19
56,Wyoming,53,Washington,37,Kittitas County,6,40,-34
56,Wyoming,53,Washington,39,Klickitat County,8,0,8
56,Wyoming,53,Washington,41,Lewis County,48,0,48
56,Wyoming,53,Washington,45,Mason County,67,18,49
56,Wyoming,53,Washington,47,Okanogan County,19,0,19
56,Wyoming,53,Washington,49,Pacific County,11,0,11
56,Wyoming,53,Washington,51,Pend Oreille County,0,5,-5
56,Wyoming,53,Washington,53,Pierce County,62,155,-93
56,Wyoming,53,Washington,55,San Juan County,0,3,-3
56,Wyoming,53,Washington,57,Skagit County,1,9,-8
56,Wyoming,53,Washington,61,Snohomish County,165,39,126
56,Wyoming,53,Washington,63,Spokane County,92,119,-27
56,Wyoming,53,Washington,65,Stevens County,3,15,-12
56,Wyoming,53,Washington,67,Thurston County,3,0,3
56,Wyoming,53,Washington,73,Whatcom County,80,32,48
56,Wyoming,53,Washington,75,Whitman County,56,24,32
56,Wyoming,53,Washington,77,Yakima County,88,0,88
56,Wyoming,54,West Virginia,23,Grant County,5,0,5
56,Wyoming,54,West Virginia,39,Kanawha County,4,0,4
56,Wyoming,54,West Virginia,47,McDowell County,4,0,4
56,Wyoming,54,West Virginia,81,Raleigh County,25,0,25
56,Wyoming,54,West Virginia,107,Wood County,5,0,5
56,Wyoming,55,Wisconsin,9,Brown County,2,0,2
56,Wyoming,55,Wisconsin,11,Buffalo County,0,2,-2
56,Wyoming,55,Wisconsin,15,Calumet County,25,0,25
56,Wyoming,55,Wisconsin,19,Clark County,124,0,124
56,Wyoming,55,Wisconsin,25,Dane County,36,73,-37
56,Wyoming,55,Wisconsin,33,Dunn County,0,3,-3
56,Wyoming,55,Wisconsin,35,Eau Claire County,0,24,-24
56,Wyoming,55,Wisconsin,55,Jefferson County,0,11,-11
56,Wyoming,55,Wisconsin,67,Langlade County,70,3,67
56,Wyoming,55,Wisconsin,71,Manitowoc County,0,21,-21
56,Wyoming,55,Wisconsin,73,Marathon County,0,22,-22
56,Wyoming,55,Wisconsin,75,Marinette County,3,0,3
56,Wyoming,55,Wisconsin,77,Marquette County,3,0,3
56,Wyoming,55,Wisconsin,79,Milwaukee County,59,0,59
56,Wyoming,55,Wisconsin,81,Monroe County,0,17,-17
56,Wyoming,55,Wisconsin,85,Oneida County,2,0,2
56,Wyoming,55,Wisconsin,87,Outagamie County,25,0,25
56,Wyoming,55,Wisconsin,89,Ozaukee County,0,15,-15
56,Wyoming,55,Wisconsin,93,Pierce County,0,2,-2
56,Wyoming,55,Wisconsin,101,Racine County,2,0,2
56,Wyoming,55,Wisconsin,109,St. Croix County,1,58,-57
56,Wyoming,55,Wisconsin,111,Sauk County,10,11,-1
56,Wyoming,55,Wisconsin,117,Sheboygan County,1,6,-5
56,Wyoming,55,Wisconsin,123,Vernon County,0,23,-23
56,Wyoming,55,Wisconsin,133,Waukesha County,11,0,11
56,Wyoming,55,Wisconsin,141,Wood County,2,0,2
56,Wyoming,56,Wyoming,1,Albany County,2563,1772,791
56,Wyoming,56,Wyoming,3,Big Horn County,485,445,40
56,Wyoming,56,Wyoming,5,Campbell County,1167,1357,-190
56,Wyoming,56,Wyoming,7,Carbon County,646,532,114
56,Wyoming,56,Wyoming,9,Converse County,435,626,-191
56,Wyoming,56,Wyoming,11,Crook County,249,220,29
56,Wyoming,56,Wyoming,13,Fremont County,1385,1281,104
56,Wyoming,56,Wyoming,15,Goshen County,563,353,210
56,Wyoming,56,Wyoming,17,Hot Springs County,397,215,182
56,Wyoming,56,Wyoming,19,Johnson County,362,220,142
56,Wyoming,56,Wyoming,21,Laramie County,1609,1799,-190
56,Wyoming,56,Wyoming,23,Lincoln County,181,621,-440
56,Wyoming,56,Wyoming,25,Natrona County,1609,1544,65
56,Wyoming,56,Wyoming,27,Niobrara County,165,134,31
56,Wyoming,56,Wyoming,29,Park County,668,526,142
56,Wyoming,56,Wyoming,31,Platte County,609,499,110
56,Wyoming,56,Wyoming,33,Sheridan County,456,938,-482
56,Wyoming,56,Wyoming,35,Sublette County,145,463,-318
56,Wyoming,56,Wyoming,37,Sweetwater County,1324,799,525
56,Wyoming,56,Wyoming,39,Teton County,285,598,-313
56,Wyoming,56,Wyoming,41,Uinta County,499,681,-182
56,Wyoming,56,Wyoming,43,Washakie County,268,268,0
56,Wyoming,56,Wyoming,45,Weston County,202,381,-179
56,Wyoming,6,California,1,Alameda County,20,148,-128
56,Wyoming,6,California,5,Amador County,6,11,-5
56,Wyoming,6,California,7,Butte County,0,5,-5
56,Wyoming,6,California,13,Contra Costa County,0,142,-142
56,Wyoming,6,California,15,Del Norte County,96,0,96
56,Wyoming,6,California,17,El Dorado County,19,0,19
56,Wyoming,6,California,19,Fresno County,19,0,19
56,Wyoming,6,California,25,Imperial County,0,10,-10
56,Wyoming,6,California,27,Inyo County,11,0,11
56,Wyoming,6,California,29,Kern County,6,128,-122
56,Wyoming,6,California,33,Lake County,0,10,-10
56,Wyoming,6,California,37,Los Angeles County,253,253,0
56,Wyoming,6,California,41,Marin County,35,129,-94
56,Wyoming,6,California,43,Mariposa County,17,0,17
56,Wyoming,6,California,45,Mendocino County,0,95,-95
56,Wyoming,6,California,47,Merced County,3,21,-18
56,Wyoming,6,California,51,Mono County,3,0,3
56,Wyoming,6,California,53,Monterey County,0,45,-45
56,Wyoming,6,California,55,Napa County,3,0,3
56,Wyoming,6,California,59,Orange County,32,94,-62
56,Wyoming,6,California,61,Placer County,19,12,7
56,Wyoming,6,California,63,Plumas County,10,44,-34
56,Wyoming,6,California,65,Riverside County,87,104,-17
56,Wyoming,6,California,67,Sacramento County,196,40,156
56,Wyoming,6,California,71,San Bernardino County,71,15,56
56,Wyoming,6,California,73,San Diego County,270,107,163
56,Wyoming,6,California,75,San Francisco County,26,0,26
56,Wyoming,6,California,77,San Joaquin County,3,37,-34
56,Wyoming,6,California,79,San Luis Obispo County,111,37,74
56,Wyoming,6,California,81,San Mateo County,118,44,74
56,Wyoming,6,California,83,Santa Barbara County,435,0,435
56,Wyoming,6,California,85,Santa Clara County,21,0,21
56,Wyoming,6,California,89,Shasta County,15,2,13
56,Wyoming,6,California,93,Siskiyou County,2,8,-6
56,Wyoming,6,California,95,Solano County,263,0,263
56,Wyoming,6,California,97,Sonoma County,23,0,23
56,Wyoming,6,California,99,Stanislaus County,77,2,75
56,Wyoming,6,California,105,Trinity County,9,0,9
56,Wyoming,6,California,107,Tulare County,6,0,6
56,Wyoming,6,California,109,Tuolumne County,0,13,-13
56,Wyoming,6,California,111,Ventura County,42,14,28
56,Wyoming,72,Puerto Rico,71,Isabela Municipio,10,0,10
56,Wyoming,72,Puerto Rico,127,San Juan Municipio,11,0,11
56,Wyoming,8,Colorado,1,Adams County,670,135,535
56,Wyoming,8,Colorado,5,Arapahoe County,314,270,44
56,Wyoming,8,Colorado,7,Archuleta County,3,12,-9
56,Wyoming,8,Colorado,13,Boulder County,326,36,290
56,Wyoming,8,Colorado,14,Broomfield County,97,11,86
56,Wyoming,8,Colorado,23,Costilla County,5,0,5
56,Wyoming,8,Colorado,27,Custer County,7,0,7
56,Wyoming,8,Colorado,29,Delta County,127,4,123
56,Wyoming,8,Colorado,31,Denver County,210,386,-176
56,Wyoming,8,Colorado,35,Douglas County,171,270,-99
56,Wyoming,8,Colorado,37,Eagle County,70,18,52
56,Wyoming,8,Colorado,39,Elbert County,45,2,43
56,Wyoming,8,Colorado,41,El Paso County,252,379,-127
56,Wyoming,8,Colorado,43,Fremont County,27,92,-65
56,Wyoming,8,Colorado,45,Garfield County,6,0,6
56,Wyoming,8,Colorado,49,Grand County,27,30,-3
56,Wyoming,8,Colorado,51,Gunnison County,2,0,2
56,Wyoming,8,Colorado,59,Jefferson County,256,347,-91
56,Wyoming,8,Colorado,67,La Plata County,2,0,2
56,Wyoming,8,Colorado,69,Larimer County,1237,1012,225
56,Wyoming,8,Colorado,71,Las Animas County,0,8,-8
56,Wyoming,8,Colorado,73,Lincoln County,9,3,6
56,Wyoming,8,Colorado,75,Logan County,63,43,20
56,Wyoming,8,Colorado,77,Mesa County,51,248,-197
56,Wyoming,8,Colorado,81,Moffat County,36,52,-16
56,Wyoming,8,Colorado,85,Montrose County,75,14,61
56,Wyoming,8,Colorado,87,Morgan County,6,0,6
56,Wyoming,8,Colorado,89,Otero County,0,15,-15
56,Wyoming,8,Colorado,93,Park County,3,0,3
56,Wyoming,8,Colorado,97,Pitkin County,8,0,8
56,Wyoming,8,Colorado,101,Pueblo County,140,98,42
56,Wyoming,8,Colorado,103,Rio Blanco County,32,0,32
56,Wyoming,8,Colorado,105,Rio Grande County,135,0,135
56,Wyoming,8,Colorado,107,Routt County,14,35,-21
56,Wyoming,8,Colorado,113,San Miguel County,0,17,-17
56,Wyoming,8,Colorado,115,Sedgwick County,0,6,-6
56,Wyoming,8,Colorado,117,Summit County,29,0,29
56,Wyoming,8,Colorado,119,Teller County,8,6,2
56,Wyoming,8,Colorado,121,Washington County,0,8,-8
56,Wyoming,8,Colorado,123,Weld County,280,631,-351
56,Wyoming,8,Colorado,125,Yuma County,3,8,-5
56,Wyoming,9,Connecticut,1,Fairfield County,2,25,-23
56,Wyoming,9,Connecticut,3,Hartford County,28,14,14
56,Wyoming,9,Connecticut,5,Litchfield County,6,0,6
56,Wyoming,9,Connecticut,9,New Haven County,17,0,17
56,Wyoming,9,Connecticut,11,New London County,29,36,-7
56,Wyoming,9,Connecticut,13,Tolland County,5,0,5
56,Wyoming,AFR,Africa,,-,216,0,0
56,Wyoming,ASI,Asia,,-,974,0,0
56,Wyoming,CAM,Central America,,-,432,0,0
56,Wyoming,CAR,Caribbean,,-,34,0,0
56,Wyoming,EUR,Europe,,-,391,0,0
56,Wyoming,ISL,U.S. Island Areas,,-,36,0,0
56,Wyoming,NAM,Northern America,,-,60,0,0
56,Wyoming,OCE,Oceania and At Sea,,-,31,0,0
56,Wyoming,SAM,South America,,-,62,0,0
